id,type,acct_balance,degree,inDegree,outDegree,pagerank
10114,703-004-5396,801.00714,8,4,4,1.9642712247753322
10133,703-004-5382,9837.08,3,1,2,1.1391389193227137
10250,703-004-5396,9666.745,1,0,1,0.27920371738274696
10730,703-004-5384,1378.8289,1,1,0,0.43440416425732453
10784,207-008-2398,8926.156,4,2,2,0.4106022891088725
10801,703-004-5395,2858.2275,6,1,5,0.35831143730785864
11106,703-004-5385,4412.803,4,3,1,4.480579788648471
11251,703-004-5382,8167.24,6,4,2,1.2620034691306214
11351,703-004-5388,1038.3118,2,1,1,0.3978652972704144
11667,703-004-5380,2971.1943,2,2,0,2.4634260121465417
11687,703-004-5387,7696.725,4,0,4,0.27920371738274696
11822,703-004-5380,86.16984,4,2,2,1.001864291737636
12003,703-004-5382,1851.9163,5,2,3,0.8678491364176029
12104,703-004-5387,5660.862,6,3,3,2.4132213972284795
12164,703-004-5395,4420.012,6,3,3,0.7956707017722372
12204,703-004-5382,7819.1655,2,1,1,0.511428526118494
1241,703-004-5391,3928.044,2,1,1,0.39200646416733576
1265,703-004-5384,7771.021,2,1,1,0.5117516157457107
12750,703-004-5394,1332.274,8,0,8,0.27920371738274696
1280,703-004-5382,4019.2646,4,3,1,0.7323973065269299
12811,703-004-5396,9923.098,6,2,4,0.8078876682112979
13041,703-004-5389,2561.7373,6,2,4,0.7154473677185034
13107,703-004-5393,4942.438,3,3,0,0.8835391093728324
13170,703-004-5392,4937.182,4,1,3,0.4284048706948413
13395,703-004-5396,6533.728,2,0,2,0.27920371738274696
13460,703-004-5384,859.20154,6,4,2,1.5102990016602709
1361,703-004-5391,6269.389,2,1,1,0.619113371087818
13660,703-004-5392,4559.147,5,3,2,0.6995592827956992
13866,703-004-5389,5702.2725,4,2,2,1.657650830190877
14000,703-004-5380,2397.2231,2,0,2,0.27920371738274696
14455,703-004-5384,2537.2732,3,2,1,1.7813460137938577
14525,703-004-5398,8411.295,5,3,2,0.46487444078447926
14552,703-004-5396,5314.9985,3,1,2,0.8980386891944188
15041,703-004-5387,4960.4033,4,2,2,0.7594431352735241
15273,703-004-5386,1788.2615,8,5,3,1.2536521132364462
15420,703-004-5396,4553.965,3,1,2,0.3978652972704144
15435,703-004-5397,3180.554,1,1,0,0.3978652972704144
15478,703-004-5394,1682.4388,7,2,5,0.7246337488310527
16027,703-004-5391,4264.393,4,3,1,1.7216565863182245
16303,703-004-5399,1832.7916,3,2,1,0.6168418728726779
16340,207-008-2399,741.1778,4,2,2,0.5568787325262466
16413,207-008-2398,5422.444,3,1,2,0.5061452249760349
16619,703-004-5385,3488.3481,3,2,1,0.5953307783337635
17024,703-004-5382,899.4866,7,1,6,0.3978652972704144
17256,703-004-5381,4863.393,2,1,1,0.6758248146810989
17260,703-004-5388,5540.58,7,3,4,1.4609243376405385
17275,703-004-5386,2712.0764,2,1,1,0.7049857966372497
17438,207-008-2399,3263.7644,1,0,1,0.27920371738274696
1746,703-004-5382,6689.69,3,2,1,1.147416231142821
17741,703-004-5388,5358.901,8,5,3,2.1063223946662553
17839,703-004-5389,4970.542,7,4,3,1.6203677079272536
17901,703-004-5382,8923.208,9,4,5,1.3790059897019609
1808,207-008-2399,8275.073,5,1,4,0.8572468656085331
18276,703-004-5389,7560.13,4,2,2,0.8580952260416497
18283,703-004-5384,5931.4927,1,1,0,0.677387778083896
18462,703-004-5387,6214.714,"","","",0.27920371738274696
18570,703-004-5380,9126.348,3,2,1,0.8671364558214812
18683,703-004-5384,8339.479,5,2,3,1.0736228128351029
1870,207-008-2398,9796.357,4,1,3,0.4964720851803832
18921,703-004-5382,6934.4644,5,4,1,1.9308551937949978
19051,703-004-5395,6341.6074,7,2,5,1.0025329903512157
19390,703-004-5390,3622.3584,7,1,6,0.5837684390944268
19404,703-004-5393,6292.2056,6,2,4,0.7917340932077334
19549,703-004-5388,9643.605,5,2,3,0.6510100010307718
19817,703-004-5394,2166.7559,2,1,1,1.090582308930258
19822,703-004-5385,8576.137,8,5,3,1.9630442795440384
19882,703-004-5393,7194.6763,7,5,2,3.3779547232654266
20293,703-004-5390,5140.4043,5,3,2,4.252127558112074
20546,703-004-5381,7985.7515,4,3,1,0.5974246633251136
20626,703-004-5399,6341.684,2,0,2,0.27920371738274696
21016,703-004-5388,8454.883,1,1,0,0.3797614955655527
21456,703-004-5387,7362.1963,4,1,3,0.37982502895311754
21967,703-004-5390,1755.9438,4,1,3,1.5157433802002904
22438,703-004-5396,3031.8623,8,7,1,3.7837372162590186
22529,703-004-5387,3160.3015,1,1,0,0.5207664843707994
22629,703-004-5383,2391.8086,8,4,4,1.241296358294581
23054,703-004-5386,6423.316,2,1,1,0.7155986066634804
23236,703-004-5391,4226.203,6,3,3,0.8942174246278041
23382,703-004-5395,8774.641,4,3,1,1.1456260749219072
23462,703-004-5394,5935.1836,5,4,1,1.1986591567072407
23565,703-004-5387,3133.332,3,0,3,0.27920371738274696
23595,207-008-2398,1101.3466,4,2,2,1.5053873076465554
23645,703-004-5388,5125.7246,3,2,1,0.6078884534703812
23666,703-004-5383,9808.842,3,1,2,0.530466049136307
23889,703-004-5390,3151.9312,1,1,0,0.3978652972704144
23949,703-004-5383,1353.0237,8,4,4,1.3887745447504853
24285,703-004-5395,1303.4153,2,1,1,0.643110494117215
24580,207-008-2398,4426.6055,2,0,2,0.27920371738274696
24905,703-004-5396,4255.2905,4,4,0,1.7484386430785397
25155,703-004-5391,897.3849,4,2,2,0.6216424036965678
2530,703-004-5382,544.8997,3,3,0,2.0477034087975543
25375,703-004-5385,6755.3525,2,1,1,0.49594427901635596
25685,703-004-5391,8322.746,7,5,2,1.2317267070622824
25865,207-008-2399,4837.992,4,2,2,0.9011514583381008
26079,703-004-5380,2518.909,1,0,1,0.27920371738274696
26360,703-004-5393,8691.294,5,2,3,1.097031065002078
26456,207-008-2399,245.9234,8,4,4,2.237225344128942
26576,703-004-5382,920.9162,4,1,3,0.35831143730785864
26637,703-004-5396,7895.5015,5,2,3,2.45165495116128
26705,703-004-5396,6785.5366,4,3,1,1.2525961143848148
26958,703-004-5385,8856.789,4,2,2,0.8707998169442126
2696,703-004-5380,1586.0933,4,2,2,0.4873626274593861
2700,703-004-5395,4214.944,4,1,3,0.4900924003777182
27020,703-004-5395,1100.8536,10,5,5,4.483115926017223
2725,703-004-5391,8553.754,6,4,2,1.2814153932267565
27274,703-004-5392,9128.031,5,2,3,1.2323434719908875
27732,703-004-5395,6287.934,3,2,1,0.5869392871047254
27775,703-004-5387,3627.228,5,2,3,0.736891319474471
27841,703-004-5384,940.25073,3,2,1,1.0226222077235476
28060,703-004-5395,9312.555,7,4,3,1.6836536709230039
28148,703-004-5382,3452.4387,4,2,2,1.0558470862301177
28469,703-004-5391,7025.5635,3,1,2,0.8384793236657504
28600,703-004-5390,3976.565,1,1,0,0.8090978921349374
28610,703-004-5386,2409.2788,4,2,2,0.944091616941188
28707,703-004-5383,597.207,6,4,2,2.4610287298352045
2898,703-004-5383,6697.091,5,2,3,0.529017568510534
2917,703-004-5394,5415.434,5,1,4,1.3582806276264674
29301,703-004-5392,8092.5293,5,4,1,1.622683337642349
29380,703-004-5381,7875.7925,4,1,3,0.7147739572590095
29401,703-004-5385,3211.124,6,4,2,1.8278299745937345
29922,703-004-5395,3044.1343,4,2,2,0.6201763646572511
30005,703-004-5389,4197.632,5,2,3,0.7227366144829953
30088,703-004-5392,4348.634,4,4,0,2.1371509732223277
30155,703-004-5391,7300.5347,1,0,1,0.27920371738274696
30324,207-008-2399,5390.836,2,1,1,0.6092272261405764
30414,703-004-5392,7561.568,6,4,2,2.401553288563646
30723,703-004-5396,336.97665,5,3,2,3.481600733595666
30861,207-008-2398,8097.9614,2,1,1,0.7605604934747702
30982,703-004-5388,1152.8701,5,1,4,0.5874959722845222
31217,207-008-2399,305.3105,3,2,1,0.5676111891118565
31290,703-004-5399,9554.284,2,0,2,0.27920371738274696
31418,703-004-5393,3910.3467,4,2,2,0.605425882577553
31477,703-004-5393,8606.627,10,5,5,1.5328644651383514
31596,703-004-5383,4999.79,7,2,5,0.8158686682375403
31756,703-004-5391,5048.7446,6,4,2,2.1774004599928896
31922,207-008-2399,2637.7104,"","","",0.27920371738274696
3200,703-004-5385,3750.0864,"","","",0.27920371738274696
32052,703-004-5387,611.82794,2,2,0,0.6669699835256628
32119,703-004-5380,2014.3336,5,4,1,0.7475090966422883
32157,703-004-5391,9331.456,4,1,3,0.5248325535140732
32514,207-008-2398,1604.997,2,1,1,0.47751789378162657
32964,703-004-5395,8138.8228,3,3,0,1.2449747243651765
33098,703-004-5381,8299.415,1,1,0,0.478504659392099
33284,703-004-5380,6237.023,3,1,2,0.5806288514598988
33500,703-004-5392,3634.9343,4,4,0,1.3186514451348788
33521,703-004-5384,8110.1147,5,0,5,0.27920371738274696
33558,703-004-5399,7301.13,6,2,4,1.4303377398669883
33707,207-008-2398,3854.875,6,4,2,1.0980702468697217
33776,703-004-5398,2370.785,5,2,3,0.8762471097353227
34043,207-008-2398,4239.3076,2,1,1,1.0268405634686293
34057,703-004-5388,2837.5483,5,1,4,0.33853450732658075
34155,703-004-5394,3700.5288,2,1,1,0.8961160873363001
34211,703-004-5380,5884.058,2,2,0,1.1941901296051052
34362,703-004-5386,1242.8344,2,1,1,0.4546563997891524
34452,207-008-2399,5861.054,3,3,0,0.9482926021182873
34488,703-004-5388,878.8228,3,1,2,0.35834675325425375
34602,703-004-5388,2275.3113,"","","",0.27920371738274696
34622,703-004-5381,7855.0024,3,0,3,0.27920371738274696
34711,703-004-5382,6798.339,3,2,1,0.6556783505030946
34781,703-004-5393,7845.2046,2,0,2,0.27920371738274696
35046,207-008-2399,1100.9032,6,5,1,1.9490192783384785
35249,703-004-5382,9155.508,5,3,2,0.8171433714362771
3526,703-004-5380,6204.477,4,1,3,0.8919592643945584
35297,703-004-5383,4235.0293,6,3,3,1.792413935602278
35349,703-004-5392,9662.012,5,2,3,2.0133086341729207
35659,703-004-5389,4866.1465,4,1,3,1.504730104867213
35796,703-004-5386,1407.8497,6,4,2,1.7676179111097172
35973,703-004-5395,1793.3225,6,4,2,1.1516305524001964
36019,703-004-5393,82.04341,3,2,1,0.8465836405298743
36021,207-008-2398,8471.244,3,2,1,0.5368947013262968
36077,703-004-5398,4794.254,3,1,2,0.3640890016146154
36260,703-004-5387,9347.49,5,3,2,0.6639057954366888
36937,703-004-5385,7153.0645,3,1,2,0.49034488277051835
37228,703-004-5395,1539.7394,3,2,1,0.4711553036260335
37347,703-004-5384,588.4713,7,4,3,2.1554680389336918
37591,703-004-5391,5135.116,6,2,4,0.539712467515969
37835,703-004-5385,9683.894,4,3,1,0.8788022043230085
37911,703-004-5385,2455.3596,10,8,2,3.508449231498877
38084,703-004-5397,5205.804,7,5,2,1.7782187190481986
38129,703-004-5384,6205.234,7,5,2,1.5289781198263301
38205,703-004-5399,4067.7583,5,1,4,0.6299580769469874
3836,207-008-2398,7555.3394,6,4,2,3.4804517886493738
3838,703-004-5397,2664.618,9,4,5,1.51900236618554
38623,703-004-5391,7810.088,2,1,1,0.3187575773453028
38691,703-004-5394,8041.727,5,4,1,3.119253490819307
38875,703-004-5388,2634.9336,3,2,1,0.470070188800092
38961,703-004-5399,2521.1025,5,4,1,0.9572321246971381
39149,703-004-5397,6887.6465,5,2,3,0.8635991674260123
39166,703-004-5388,4610.483,6,1,5,0.8281241063977234
39305,703-004-5395,714.48206,4,2,2,0.8635730050322438
3949,703-004-5385,6884.2373,4,2,2,1.1941118856407298
40024,703-004-5386,6714.5015,6,3,3,1.3238149202417022
40084,703-004-5386,6263.084,2,1,1,0.38384586422702993
40094,703-004-5387,2430.222,5,3,2,3.3277893139075365
40242,703-004-5390,479.2416,2,1,1,0.4424511807565348
40856,703-004-5389,9689.97,2,0,2,0.27920371738274696
40862,207-008-2399,444.1744,5,3,2,1.0083365170991283
41075,703-004-5393,6660.8613,3,2,1,0.5361292098091751
41216,703-004-5394,1137.6608,4,3,1,3.9177482415304525
4127,703-004-5385,5106.6436,9,5,4,2.253751495881332
41286,703-004-5390,7221.4717,4,2,2,0.897288838314804
41414,703-004-5398,3774.4868,9,1,8,0.35831143730785864
41445,703-004-5398,3056.4856,3,2,1,1.0372660984833155
42440,703-004-5390,8035.6494,4,2,2,0.9219192613545238
42917,207-008-2398,9885.905,3,2,1,0.7321744186156538
43044,703-004-5392,4864.797,5,1,4,0.6334722904788371
43768,207-008-2398,8958.069,6,4,2,0.8633510792673031
43813,703-004-5388,3896.194,2,0,2,0.27920371738274696
43875,703-004-5383,3152.7139,5,3,2,0.6054778507650139
43999,703-004-5394,7761.612,6,4,2,1.1183012275712227
44259,207-008-2398,680.6457,3,2,1,0.7140056591140377
44261,207-008-2399,1667.9407,4,2,2,0.9410477973100129
44500,703-004-5392,5614.9214,3,3,0,2.2275773567782307
44681,703-004-5388,2039.8396,3,2,1,0.6828678060505909
44777,703-004-5387,4231.2153,"","","",0.27920371738274696
44821,703-004-5390,270.5097,5,5,0,1.7680152498623751
44848,703-004-5380,2.5880337,2,1,1,0.47188400338982145
45196,703-004-5395,914.2745,1,1,0,0.6463954240895929
45252,703-004-5386,7253.986,7,4,3,2.556514784527861
45264,703-004-5393,9889.608,4,1,3,0.32666834933781397
46592,703-004-5395,6520.436,5,4,1,1.1115577391929792
46599,703-004-5390,7275.0513,7,3,4,1.188182113830066
46665,703-004-5383,4577.2236,5,3,2,1.8795686311956252
46721,703-004-5387,1695.8434,5,3,2,2.305841502898862
46763,703-004-5387,705.66895,4,1,3,0.35534489781066697
46887,703-004-5399,7825.203,5,4,1,1.5757587563262678
46933,703-004-5395,4694.035,5,4,1,1.309899319615156
47069,703-004-5396,1092.6455,4,2,2,0.45719608721424815
47340,207-008-2399,6318.867,2,1,1,0.33853450732658075
47794,703-004-5389,2535.8962,5,4,1,2.6463913727772823
48420,703-004-5390,4455.898,3,1,2,0.46780362861457564
4850,703-004-5394,8396.61,4,3,1,0.9331773634160336
48539,703-004-5392,4768.4346,5,1,4,0.5277449322646693
48664,703-004-5399,9194.516,1,1,0,0.35535240244927596
48946,703-004-5390,667.2955,4,2,2,0.5181360755308502
48991,703-004-5398,4879.609,2,0,2,0.27920371738274696
49192,207-008-2399,94.62535,1,0,1,0.27920371738274696
49206,703-004-5382,1183.5461,2,2,0,0.4805205040109178
49280,703-004-5380,9665.3545,8,3,5,0.7603182096506268
49289,207-008-2398,5328.6333,6,5,1,1.6673848511013745
49901,703-004-5394,4100.0815,5,2,3,0.9829733708130834
49976,703-004-5387,6192.456,4,2,2,0.9682794823381773
5044,703-004-5382,2499.3127,4,1,3,0.35647959916834276
5181,703-004-5381,9877.324,3,2,1,0.4946117639222052
5316,703-004-5397,4986.4077,4,2,2,2.388282230159235
5757,703-004-5387,4059.5918,8,4,4,1.9442864539921014
5913,703-004-5384,6763.046,5,1,4,0.7395233128063625
6081,703-004-5382,9134.93,2,2,0,1.0461711215306302
666,703-004-5397,3975.5815,3,1,2,0.6467501540673151
6848,703-004-5396,5643.664,4,1,3,0.35831143730785864
6900,207-008-2398,8924.305,8,4,4,0.7975667165460374
6903,703-004-5382,4192.952,1,0,1,0.27920371738274696
7056,207-008-2398,5503.458,3,1,2,0.39062448423860546
7208,703-004-5391,7067.9106,7,3,4,1.103450177273788
7248,703-004-5399,4581.721,2,1,1,0.42017396362992965
7263,703-004-5399,7039.9355,6,3,3,0.9392721999445222
7301,703-004-5396,8555.636,5,4,1,3.566029716443236
7378,703-004-5383,2610.985,4,1,3,0.41599308199735396
7418,207-008-2398,8450.177,2,2,0,0.6076206341156914
7487,703-004-5384,9863.664,8,4,4,1.3841414823288578
7784,703-004-5399,536.3023,4,1,3,0.7329962140331312
8621,703-004-5387,2980.2185,1,1,0,0.3640994854823793
870,703-004-5397,9935.922,5,4,1,1.285574177691365
8763,703-004-5388,1290.8917,6,2,4,0.5911779862630802
8832,703-004-5389,3675.81,3,1,2,0.5585277372211875
919,703-004-5381,4036.8235,5,3,2,0.9903844498373335
926,703-004-5384,4849.4395,4,1,3,0.4375186492683901
10260,703-004-5390,7240.6616,2,1,1,0.3579972699595974
10365,703-004-5389,3272.4004,7,3,4,1.193310464440656
10487,703-004-5389,5417.531,7,5,2,1.7356662034983976
10523,703-004-5399,2319.3877,4,1,3,0.5019944421794941
10856,703-004-5389,6659.687,4,2,2,0.5895409373701944
1104,207-008-2398,8635.295,4,2,2,0.884683460406334
11058,703-004-5390,7600.626,7,6,1,2.0108783745944616
11578,703-004-5399,3556.6802,5,1,4,0.5422420883666191
11592,703-004-5389,1440.2837,3,0,3,0.27920371738274696
11600,703-004-5394,9232.55,3,0,3,0.27920371738274696
11929,703-004-5396,7383.6265,4,2,2,3.3549805211768495
11965,703-004-5383,3635.423,3,1,2,0.3978652972704144
11966,703-004-5380,5420.45,6,2,4,0.8941322552916859
12138,703-004-5393,8132.2134,10,5,5,1.2697569713735026
12274,703-004-5395,1727.5411,5,4,1,2.056677502174552
12437,207-008-2399,5.619526,5,3,2,2.4450215957291466
12531,207-008-2399,5054.931,4,3,1,2.3659860550640164
12643,703-004-5383,6612.621,2,1,1,0.38319081522430626
13030,703-004-5380,1417.0546,4,3,1,0.5898457695295493
13051,703-004-5384,1076.8092,6,5,1,5.15159237687801
13352,207-008-2399,4062.4739,8,7,1,2.0454228799901606
13406,703-004-5392,4879.413,5,4,1,2.5079936240447216
13451,703-004-5396,2711.7402,5,2,3,0.5362049224894534
1349,703-004-5389,659.97064,3,1,2,0.361814271523527
13512,703-004-5385,700.9435,7,5,2,1.41269112278079
13851,207-008-2399,5139.608,3,2,1,0.4601098741713286
13929,703-004-5395,593.83215,2,1,1,0.35114230018964543
14114,703-004-5397,3676.4575,2,0,2,0.27920371738274696
1418,703-004-5380,3887.0632,1,0,1,0.27920371738274696
14236,703-004-5394,753.7347,4,3,1,1.4970643328953337
14618,703-004-5398,4567.552,2,1,1,0.5417739835075591
14701,703-004-5396,2020.2393,5,2,3,1.169051795387423
14835,703-004-5387,2355.0767,2,0,2,0.27920371738274696
1485,703-004-5395,9315.672,3,1,2,0.5165268771580819
14896,703-004-5395,1332.2341,5,4,1,1.3185456247740965
14991,207-008-2398,9302.934,3,1,2,0.6421999681968696
15103,703-004-5381,4458.0186,3,3,0,1.0228852705443767
15114,703-004-5399,303.12897,5,3,2,0.5801954799199733
15203,703-004-5389,5607.3945,"","","",0.27920371738274696
15409,207-008-2398,1922.7267,6,3,3,0.6256431406046333
15845,703-004-5382,7364.724,6,3,3,0.8440424815937047
15972,703-004-5395,784.7035,6,4,2,0.9996677187472256
17033,207-008-2399,406.60263,6,3,3,3.1093395802506256
17211,703-004-5387,6122.0015,5,3,2,0.6635552827162996
17348,703-004-5389,1422.7944,2,0,2,0.27920371738274696
17744,207-008-2398,8986.488,2,0,2,0.27920371738274696
17946,207-008-2398,8935.08,5,1,4,0.6411324435243253
18223,703-004-5395,4041.9883,7,4,3,2.3739462549823127
18423,703-004-5385,2728.078,3,1,2,0.35831143730785864
18454,703-004-5394,1754.9467,2,0,2,0.27920371738274696
18746,703-004-5390,4333.486,3,1,2,1.1388041323716682
18918,207-008-2398,4797.6714,9,1,8,0.46276680624443767
19225,703-004-5399,3763.1816,3,0,3,0.27920371738274696
19269,703-004-5380,3863.1963,4,0,4,0.27920371738274696
19360,703-004-5382,816.6319,3,3,0,2.05531043981133
1956,703-004-5387,6356.706,3,1,2,1.4360453670786708
19717,703-004-5390,4768.889,3,2,1,0.575487305380949
19804,703-004-5395,9222.261,2,1,1,0.4497795654231317
20058,703-004-5395,5051.0273,6,5,1,1.7213455507213224
20096,703-004-5384,5049.162,3,1,2,0.4440938711016516
20372,703-004-5385,3500.8037,3,1,2,1.510687372512995
20387,703-004-5380,5338.184,5,3,2,0.8987212353052111
20433,703-004-5389,3646.528,2,1,1,0.7095422477538247
21247,703-004-5392,1586.8252,4,2,2,0.42619598997231545
21309,703-004-5383,9029.99,3,2,1,0.41764222725169237
21484,207-008-2399,4808.687,5,2,3,0.7461478108719383
21610,207-008-2399,340.26385,5,1,4,1.444376934041489
21745,703-004-5390,4686.4097,4,1,3,0.35831143730785864
21951,703-004-5382,115.768906,2,1,1,0.7219457345493073
2200,703-004-5397,6760.225,3,0,3,0.27920371738274696
22022,703-004-5389,7127.1313,2,2,0,0.6239038628721764
2249,703-004-5382,1170.3801,3,2,1,0.4976844155751256
22543,703-004-5391,3450.2488,8,2,6,1.3777781557955995
22800,703-004-5387,5663.4243,4,2,2,0.4453299292254814
23245,703-004-5380,3397.9404,1,1,0,0.6602557157970191
23749,703-004-5381,6920.9136,4,2,2,2.4303003850705474
23895,703-004-5389,1332.9243,6,5,1,2.610946932062983
2392,703-004-5391,8558.009,4,2,2,0.5348690154278912
23928,703-004-5392,3345.8066,6,3,3,1.2307304109418493
23934,703-004-5396,7006.7764,3,2,1,0.8923023474695306
24071,703-004-5387,1677.3749,5,3,2,0.8530220703535968
24477,703-004-5390,2575.6824,4,2,2,1.5510188658704729
24708,703-004-5382,6385.0312,2,2,0,1.0166174531877898
2531,703-004-5384,7844.0664,6,2,4,0.4999077767116307
25867,703-004-5399,9161.104,2,1,1,1.2506598799068853
26132,703-004-5392,6214.7266,7,5,2,1.4551845000442774
26142,703-004-5399,4807.1235,4,3,1,0.6964567750017813
26438,703-004-5395,426.0087,5,1,4,0.5042949907126473
26593,703-004-5380,2204.9148,4,3,1,0.8017251130755166
26629,703-004-5386,8063.15,1,0,1,0.27920371738274696
26979,207-008-2399,8755.216,5,5,0,2.361952857999907
2718,703-004-5382,6032.475,2,1,1,0.5333748454653474
272,703-004-5394,8068.616,2,1,1,0.7081182177543096
27330,703-004-5382,8818.321,8,4,4,1.3264920734489418
27357,703-004-5386,731.68335,6,4,2,1.4245967056591948
27398,703-004-5387,550.25934,7,4,3,2.0864086830120905
27458,703-004-5383,3102.907,"","","",0.27920371738274696
27554,703-004-5383,4696.7803,3,2,1,0.5578082278292352
27823,703-004-5393,5500.4907,6,1,5,0.6500549330770486
27836,703-004-5385,4564.4097,1,0,1,0.27920371738274696
28255,703-004-5387,6935.5254,2,1,1,1.968260030722213
28267,703-004-5396,209.1229,4,0,4,0.27920371738274696
28360,703-004-5394,9576.025,2,2,0,1.0136859929482962
28732,703-004-5382,1339.0935,7,1,6,0.5962910500071904
28811,703-004-5384,2302.5132,6,4,2,2.281548463326907
28914,703-004-5383,266.2146,7,3,4,1.7521580400248749
29143,703-004-5387,655.46515,5,2,3,0.7277485065859453
29251,703-004-5395,7119.1978,5,0,5,0.27920371738274696
2948,703-004-5383,734.59686,4,2,2,0.6814414950910784
29556,703-004-5394,4608.0913,3,3,0,1.728519053805466
2964,703-004-5382,9313.149,6,5,1,1.279382861966317
2980,703-004-5396,6864.8154,1,0,1,0.27920371738274696
30271,703-004-5389,3804.8857,2,0,2,0.27920371738274696
30644,207-008-2398,287.1567,4,2,2,0.5251990707046857
31051,703-004-5399,2911.418,2,1,1,0.7533394343815778
31491,703-004-5384,6457.5063,5,2,3,0.6650539641372092
31766,703-004-5384,5458.583,4,2,2,1.4638410342344215
31797,703-004-5381,847.7062,4,3,1,0.9855950240856413
31944,703-004-5397,6319.2876,6,4,2,3.059915897093467
32088,703-004-5385,7519.343,6,3,3,2.1384048896134473
32301,703-004-5390,7799.5566,6,3,3,2.098104885124803
3250,703-004-5387,6399.328,6,1,5,0.3978652972704144
32501,703-004-5396,6207.9453,2,1,1,0.5599041838977561
32637,703-004-5392,1001.6543,5,2,3,2.087959674570617
32986,703-004-5389,4400.3813,4,4,0,0.9231807900044857
33045,703-004-5383,9332.709,2,2,0,0.7018801227118955
33129,703-004-5392,7252.5776,3,3,0,1.2323331112023777
33187,703-004-5394,317.42395,7,4,3,1.837680647864579
33280,703-004-5393,360.2475,1,0,1,0.27920371738274696
33480,703-004-5383,4812.8765,4,3,1,2.257660225354778
33605,703-004-5388,7649.1987,6,5,1,1.480621371869977
3365,703-004-5386,4885.4805,2,1,1,0.49983564721262635
33690,703-004-5382,2877.103,6,2,4,0.5010184678977632
33760,703-004-5389,5687.128,5,3,2,0.8449507033723138
33837,703-004-5380,43.691994,5,1,4,0.49009912151852664
33880,703-004-5390,1049.5394,5,2,3,0.7742611225631552
3408,703-004-5381,3817.7668,4,2,2,1.3586898614342529
34399,703-004-5383,7898.2134,5,1,4,0.5099307855891967
34446,703-004-5382,1911.5531,8,4,4,1.0513050998637177
34615,703-004-5384,2785.0842,"","","",0.27920371738274696
34664,703-004-5381,4072.2566,4,3,1,1.0123468723699574
35017,703-004-5396,638.00214,3,1,2,1.0752581903509784
35124,207-008-2399,4587.652,2,1,1,0.37512182779194486
3641,703-004-5395,2712.096,10,7,3,4.959169959938904
3656,703-004-5394,7639.3823,4,2,2,0.47697301719552604
36799,703-004-5397,5887.286,3,2,1,0.8283243417200452
37046,703-004-5383,3289.5315,2,1,1,0.4127646943445581
37501,703-004-5391,9903.669,5,2,3,1.1601406441250837
37713,703-004-5385,4882.1914,4,1,3,0.789124507797434
37806,703-004-5391,7696.85,3,1,2,0.7845183716809758
37848,703-004-5398,8517.009,3,1,2,0.47146668087765975
37928,703-004-5381,3887.0925,4,3,1,2.3414085843806602
38265,703-004-5399,2692.2024,4,2,2,1.324860448502998
38740,703-004-5393,455.6751,3,2,1,2.4156841853812927
38798,703-004-5395,331.14017,2,1,1,0.48233715635662283
38890,703-004-5388,3712.6636,5,2,3,0.603515739068636
3891,703-004-5391,9124.8545,4,2,2,1.3635294669310818
38935,703-004-5385,4000.2412,2,1,1,0.5150611978041488
39025,207-008-2399,2021.8373,5,2,3,0.6277936995601267
39034,207-008-2399,5097.9307,7,4,3,1.5023543431999886
39123,703-004-5397,408.1875,5,3,2,0.772423144426993
39140,703-004-5387,4292.1157,2,2,0,0.8171205379397487
39176,703-004-5390,726.9102,1,0,1,0.27920371738274696
39379,703-004-5395,814.83124,5,3,2,0.8197884246498612
39689,703-004-5392,1043.8597,3,2,1,0.6144546964112424
39812,703-004-5385,5331.6665,2,1,1,0.48367869098164246
39889,703-004-5383,2693.6394,4,3,1,1.4470965307337256
40090,703-004-5383,6833.042,5,1,4,0.9489819609686402
40123,703-004-5394,8948.252,4,3,1,1.998323241364462
40256,703-004-5398,4337.6987,7,5,2,5.242865159300098
40716,703-004-5381,2573.939,5,3,2,0.5985571080440908
4078,703-004-5395,623.2369,7,3,4,3.9684177644361918
40909,703-004-5380,9355.605,8,4,4,0.9992505245441144
41084,703-004-5395,5657.83,10,5,5,2.3980411858169135
4118,703-004-5385,5491.4307,3,1,2,0.4173578022945238
41241,703-004-5395,5450.5337,4,2,2,0.6050600569688288
41351,703-004-5385,3415.0754,7,4,3,1.7357894135860397
41382,703-004-5383,8771.48,7,4,3,1.1400377744087182
41960,703-004-5389,7042.2617,7,3,4,1.8054822051025394
42043,703-004-5393,9493.314,5,2,3,0.9436326843265153
42093,703-004-5382,6316.6953,10,5,5,3.6898832559554884
42530,703-004-5389,1130.6733,4,1,3,0.3919322182760311
42591,703-004-5399,2534.3096,3,3,0,0.9952052945877702
42758,703-004-5398,4356.9224,4,2,2,0.954106253190683
42928,703-004-5389,4995.8906,5,2,3,1.0227216836105115
42960,703-004-5384,9844.664,6,2,4,0.7488997295557681
43029,703-004-5391,4889.204,2,1,1,0.35114230018964543
43054,703-004-5398,4825.162,5,4,1,1.7747255433078104
4315,703-004-5387,7572.026,5,5,0,1.9313017221294286
43194,703-004-5392,1943.5817,5,4,1,2.368401674330466
4333,703-004-5398,2315.166,1,0,1,0.27920371738274696
43673,207-008-2399,2689.9583,4,2,2,2.353047115301913
43770,703-004-5383,7941.8794,4,1,3,0.3600518071462111
4408,703-004-5384,692.5106,4,2,2,1.1949228670528718
442,703-004-5385,9537.754,4,2,2,1.0702474217552005
44284,703-004-5391,2413.06,4,1,3,0.428399514901895
44387,703-004-5399,1992.3502,3,1,2,0.33853450732658075
44607,703-004-5386,5802.7397,8,4,4,2.767858833802099
44629,703-004-5395,9264.62,2,1,1,0.43304300472297075
44706,703-004-5396,2336.35,3,3,0,2.3138209206625047
44808,703-004-5395,8018.5537,3,1,2,0.6007307109127413
44825,703-004-5396,5922.6875,3,1,2,0.8122335405981046
45004,703-004-5395,9881.883,5,1,4,0.8155716443572494
45234,703-004-5396,4283.406,5,2,3,1.0440892304340874
45468,703-004-5396,7636.5615,1,1,0,0.36246737000691126
45472,703-004-5394,7014.55,"","","",0.27920371738274696
45695,703-004-5391,7556.803,2,2,0,1.618244077918314
45833,703-004-5380,2782.0605,3,0,3,0.27920371738274696
45906,703-004-5394,3167.9553,4,2,2,0.9204772157173907
46022,703-004-5393,2649.1929,2,1,1,0.6093011891435587
462,703-004-5390,5792.263,1,0,1,0.27920371738274696
46244,703-004-5397,8212.27,3,2,1,1.085310500958283
46395,703-004-5390,704.3117,1,1,0,0.8150245353665744
46675,703-004-5398,7093.907,6,3,3,0.6101557563928746
46808,207-008-2399,1212.4812,6,4,2,2.3627151116435274
4685,703-004-5393,290.51422,6,3,3,0.7574386129827524
46960,703-004-5384,144.67776,4,3,1,1.4978328666670773
46990,207-008-2398,3985.91,6,4,2,2.4160771796804945
470,703-004-5386,2065.223,1,1,0,0.9201104167916695
47047,703-004-5391,9759.42,5,2,3,0.8691941363619229
47202,703-004-5380,9404.474,9,7,2,4.0742996237014815
47206,703-004-5384,413.47623,2,1,1,0.8706162102708946
47412,703-004-5396,7617.668,1,0,1,0.27920371738274696
48566,703-004-5394,9080.583,2,2,0,0.8394638361414143
48788,703-004-5380,4441.207,7,5,2,3.1205250120978105
49174,207-008-2398,6421.372,6,3,3,2.4827563661289234
4934,703-004-5394,4564.5864,4,2,2,0.5597835198393234
49455,703-004-5389,731.24347,2,1,1,0.47420166508723816
49622,703-004-5398,6682.5034,4,4,0,1.2332837329210493
49654,703-004-5390,9864.266,4,2,2,0.7154201004682221
5104,703-004-5381,4294.5337,3,3,0,0.5564927564952477
5321,703-004-5398,1523.0864,1,0,1,0.27920371738274696
5498,703-004-5387,263.99374,3,2,1,0.7544512840227104
6209,703-004-5388,2352.795,7,3,4,5.224939453849018
6212,703-004-5396,1861.3339,5,1,4,0.4895000364560443
647,703-004-5391,4163.4746,2,0,2,0.27920371738274696
6744,703-004-5392,7590.267,3,1,2,0.5165268771580819
6883,703-004-5380,5777.481,3,1,2,0.36010784178115807
6958,703-004-5385,3645.5542,3,2,1,0.9179039232475297
7015,703-004-5397,2139.4265,5,2,3,1.1785858329942334
711,207-008-2399,9577.145,3,3,0,0.9072695579102807
7121,703-004-5389,7454.7617,2,2,0,1.972391808194608
7353,703-004-5381,702.0759,2,1,1,0.4350822378172273
743,703-004-5398,1272.878,5,3,2,1.5983888036716132
7539,703-004-5396,414.8245,1,1,0,0.5709892303230963
7685,703-004-5396,696.36523,3,1,2,0.4266110649982019
7689,703-004-5382,4788.078,2,0,2,0.27920371738274696
8370,703-004-5389,2846.4592,6,4,2,1.5128218043438348
8699,703-004-5385,2401.7007,4,3,1,1.441512828144773
8824,703-004-5383,6265.0137,3,3,0,0.8218243260409702
9024,703-004-5386,3489.7166,2,0,2,0.27920371738274696
9067,703-004-5396,9660.0625,6,3,3,0.6801134933250461
9361,703-004-5383,7418.41,5,2,3,0.47170111303855716
9440,703-004-5399,8429.059,4,2,2,0.5456477198565559
9654,703-004-5394,9977.107,2,2,0,0.6843031743259204
9656,703-004-5396,5714.5,6,3,3,1.1521632714246308
975,703-004-5397,1081.022,3,2,1,0.7594138534499291
10803,703-004-5385,279.6173,5,5,0,1.8285187168375134
10814,703-004-5384,2791.739,6,4,2,1.8397058963993242
10888,703-004-5397,4065.8074,4,2,2,1.5479129120446795
11021,703-004-5381,3798.5469,3,2,1,0.8176645684053869
11134,703-004-5384,289.166,2,1,1,0.6737113637550182
11379,703-004-5397,1589.6011,5,4,1,1.059916562283624
11467,703-004-5391,7631.9297,2,1,1,0.41917099552729
11756,703-004-5393,6176.68,5,3,2,1.624737506014049
12242,703-004-5389,719.0138,4,2,2,0.6064543759686112
1236,703-004-5386,6989.693,3,2,1,0.47590802499663537
12699,703-004-5381,8599.098,4,2,2,0.8545776091542993
1290,703-004-5382,1885.5673,4,3,1,1.0220762459954933
12919,703-004-5394,2481.6274,7,1,6,0.33853450732658075
13592,207-008-2398,2032.7771,5,2,3,1.1602681425719006
14417,703-004-5380,902.8429,2,1,1,0.6008094560489846
14478,703-004-5393,7042.966,1,0,1,0.27920371738274696
1492,703-004-5391,2410.6575,2,0,2,0.27920371738274696
14984,703-004-5385,4452.152,3,1,2,0.4180377658513179
15065,703-004-5388,7284.37,1,0,1,0.27920371738274696
1601,703-004-5396,5184.8667,5,2,3,1.6535304939861664
16047,703-004-5394,2658.1687,4,1,3,0.7812832475463527
16139,703-004-5395,6362.129,2,1,1,0.8213970517618943
16389,703-004-5396,6326.211,5,1,4,0.3840480260653954
16401,703-004-5393,1055.1202,"","","",0.27920371738274696
16503,703-004-5392,6145.3276,5,2,3,0.8379822786322717
16519,703-004-5388,1819.1516,3,2,1,0.9024886877307615
16626,703-004-5390,2776.3528,8,3,5,1.137202619150883
16918,703-004-5396,6264.962,"","","",0.27920371738274696
17215,703-004-5399,2483.16,4,2,2,0.620244036051406
17493,703-004-5390,3641.4128,3,3,0,1.5958573495453967
17779,703-004-5387,9172.496,4,3,1,1.0466981870748555
17884,703-004-5385,4814.2188,8,2,6,0.4917240086392111
17982,703-004-5383,2788.5388,3,1,2,0.5522410987098617
18057,703-004-5395,3765.2063,3,1,2,0.7743166886275643
18182,703-004-5390,8562.25,2,1,1,0.8237025252664915
18449,703-004-5391,4306.665,2,1,1,0.35114230018964543
18514,703-004-5395,7403.2627,4,3,1,0.7961740205951376
18549,703-004-5382,279.09158,3,1,2,0.909036764667908
18647,703-004-5380,3131.4343,4,2,2,0.8259140637678679
18695,207-008-2398,9654.183,3,2,1,0.7098979886990148
18933,703-004-5396,5003.1606,4,3,1,0.8556528516904891
18970,703-004-5394,8516.879,3,2,1,0.7165152994602465
19312,703-004-5395,971.0008,3,1,2,0.6569722331498159
19367,703-004-5397,4964.8296,4,3,1,2.6803041843593145
19421,207-008-2398,5436.642,4,2,2,0.6232645763521172
19505,207-008-2398,6622.8843,4,1,3,0.6073643767272019
19675,703-004-5387,8821.161,3,2,1,0.5327576744307123
19795,703-004-5388,1089.0419,8,6,2,2.3887571957309537
19871,703-004-5390,3336.5715,"","","",0.27920371738274696
19954,703-004-5387,4413.6216,6,2,4,1.06167025479668
19966,703-004-5391,4049.1086,2,2,0,0.5021886029216555
200,703-004-5390,9141.1455,3,2,1,0.9056226645416426
20024,703-004-5383,1709.0834,3,2,1,0.7192404094661804
2012,703-004-5382,5737.42,3,2,1,0.6742713393235956
20140,207-008-2399,1044.3324,8,3,5,0.8372531285250476
2020,703-004-5388,9742.311,4,3,1,1.1908127160928348
20352,703-004-5392,7703.7524,2,0,2,0.27920371738274696
20596,703-004-5394,909.0686,5,4,1,1.9504547240404286
20664,703-004-5387,9279.868,6,3,3,2.3471698608961558
20671,703-004-5397,993.37994,4,3,1,1.306212457977735
20734,703-004-5392,3363.9927,3,2,1,0.5458542996756705
21000,703-004-5392,7067.864,4,2,2,0.5827562252408064
21058,703-004-5399,511.71182,8,2,6,0.8644138246722961
21071,703-004-5392,5750.392,4,3,1,1.190589412149165
2115,703-004-5380,271.02112,1,0,1,0.27920371738274696
2138,703-004-5399,7229.785,2,1,1,0.37058631851623847
21440,703-004-5380,2103.9915,1,1,0,0.8792825765218721
21893,703-004-5383,8706.133,3,1,2,0.37512182779194486
21989,703-004-5390,7043.874,5,5,0,3.704064063949862
22255,703-004-5392,5196.131,2,0,2,0.27920371738274696
22285,703-004-5399,7214.2686,8,3,5,1.0222408371508458
22494,703-004-5380,350.76498,3,2,1,0.9289295396414232
22517,703-004-5383,2529.5806,2,1,1,0.5837684390944268
23499,703-004-5382,3257.491,5,1,4,0.4491101437952007
23529,703-004-5398,6372.634,6,4,2,1.1717070571150723
2363,703-004-5382,2876.4033,6,4,2,1.1289854262639132
23847,703-004-5384,2257.7583,8,2,6,0.8220003143672137
24171,703-004-5380,9382.979,2,1,1,1.9688065273475615
24189,703-004-5390,838.26184,6,4,2,1.7595117357623682
24246,703-004-5393,7799.9424,9,3,6,2.322941156041227
2431,703-004-5385,4020.5752,4,3,1,1.278442235259029
24403,207-008-2399,3565.3418,3,1,2,0.4316792450157317
24818,207-008-2398,124.35555,6,2,4,2.068051946901007
25325,703-004-5398,2271.8918,3,2,1,0.528821535296443
25593,703-004-5397,1946.0243,1,1,0,0.9276124663201183
25863,703-004-5388,6330.675,2,2,0,0.6370871539335162
25891,703-004-5386,8736.606,4,3,1,1.2947388469946892
25939,703-004-5396,8409.36,3,2,1,1.6726457389096718
26148,703-004-5388,2311.709,7,2,5,0.6840775223827179
26267,703-004-5380,7664.688,4,1,3,0.5314994307580699
26278,703-004-5384,8253.936,3,2,1,0.817037806557528
26424,207-008-2399,6208.722,2,2,0,0.996737204074233
26431,703-004-5389,9958.293,2,0,2,0.27920371738274696
26458,703-004-5398,7692.6523,3,1,2,0.8397295005026575
26654,703-004-5383,1356.0056,7,2,5,0.5562575277672932
26881,703-004-5392,622.67365,4,2,2,0.8385250460725377
26998,703-004-5391,8439.819,5,2,3,0.9723321666732003
27119,207-008-2399,1536.51,3,1,2,0.44284201186136696
27238,703-004-5399,7594.7144,5,5,0,2.0752121193818325
27562,703-004-5391,9640.998,7,6,1,2.349874572983355
27766,703-004-5387,5746.2065,8,5,3,3.8920592167240664
28194,703-004-5390,3258.1294,3,2,1,0.9625194572396804
28326,703-004-5380,5181.812,7,4,3,2.2889332417688375
28361,703-004-5396,6560.409,2,0,2,0.27920371738274696
28626,703-004-5382,1835.4452,3,3,0,1.5076949955038907
29030,703-004-5396,7063.377,4,4,0,1.6111285899054923
29167,703-004-5392,3832.8457,5,2,3,0.7903876842454625
29310,703-004-5395,6557.1187,6,3,3,2.251386876232305
29436,703-004-5383,2318.5415,9,6,3,1.931570434265925
2951,703-004-5390,7511.857,4,4,0,1.1727910137858502
29546,703-004-5382,6193.601,3,1,2,0.35834675325425375
29680,703-004-5390,8688.311,2,2,0,0.6474109669232805
29697,207-008-2399,2280.724,2,2,0,0.9347603798417935
29909,703-004-5387,2418.9258,2,1,1,0.7079797139484031
30018,703-004-5390,7008.9097,1,0,1,0.27920371738274696
30048,703-004-5394,8707.427,3,2,1,1.1984994456816611
30389,703-004-5386,5886.119,3,2,1,0.8241114157618991
30882,703-004-5398,2287.7998,4,2,2,0.693587865456495
30893,703-004-5399,9533.585,1,0,1,0.27920371738274696
30981,703-004-5389,394.6185,4,3,1,1.5892550843245479
30987,703-004-5390,3281.5796,6,3,3,1.9738656503567469
31068,703-004-5399,2565.93,7,1,6,0.33853450732658075
31157,703-004-5380,4257.256,4,3,1,1.726022790222606
31385,703-004-5390,250.89801,7,2,5,0.8541324287419317
31566,703-004-5398,3236.7158,4,2,2,1.4457880453732908
31583,703-004-5383,341.3236,2,2,0,0.6411660285944287
31964,703-004-5381,8240.238,1,1,0,0.5165268771580819
32329,703-004-5393,3082.1973,5,4,1,0.8249889725380722
32394,703-004-5380,5553.4863,3,3,0,0.6422495267001708
32561,703-004-5390,3278.5005,3,3,0,0.7631983223013962
33104,703-004-5394,5554.588,1,1,0,0.5633075569512964
33510,703-004-5389,8621.728,5,2,3,1.9411018310348511
33634,703-004-5388,4966.634,5,2,3,1.0483995410036986
33869,703-004-5385,287.5042,6,4,2,1.6239669275630308
33977,703-004-5387,9944.788,11,5,6,2.063953459600654
34345,703-004-5398,1056.1276,1,1,0,0.4141790084429525
34513,207-008-2398,2928.2207,5,2,3,0.46915445081825935
34661,703-004-5389,5596.592,6,3,3,1.027552792955402
34849,703-004-5380,1422.2467,6,3,3,2.960698008858721
35887,703-004-5388,7495.536,1,1,0,0.4727211204389286
35962,703-004-5398,8980.754,6,3,3,1.629594136385888
36035,207-008-2399,2825.6816,3,2,1,1.6490629715535001
36202,703-004-5393,9337.399,3,3,0,1.0695786062100838
36283,703-004-5394,7000.197,4,3,1,1.932067898455978
36350,703-004-5384,9077.898,5,1,4,0.6755097135473412
36508,703-004-5388,1321.1918,5,1,4,0.7263597746439407
36511,703-004-5387,9363.135,4,3,1,0.8601509641865042
36945,703-004-5380,3996.9397,4,2,2,0.724002965143269
36982,703-004-5386,9850.635,5,3,2,0.9134289578020813
37511,703-004-5393,3818.2266,4,1,3,0.38600785831764134
37741,703-004-5386,4319.4194,6,3,3,1.126203860538088
38002,703-004-5383,8125.1196,2,2,0,0.39464197022959174
38022,703-004-5386,2949.5579,6,3,3,2.50324269117563
38073,703-004-5396,2620.5742,3,2,1,1.3861609353806983
38541,703-004-5385,7181.022,5,1,4,0.35831143730785864
38684,703-004-5398,3009.2507,4,1,3,1.3677707171438906
38755,703-004-5384,8388.208,4,2,2,1.0271678523178494
388,703-004-5398,4631.4688,4,2,2,0.536856230981557
3884,703-004-5380,5822.4805,3,2,1,1.1086649342193984
39291,207-008-2399,7605.096,4,4,0,1.0252712674164852
39327,703-004-5398,7694.822,5,2,3,0.9225130622713135
39416,703-004-5381,5721.6353,6,4,2,1.7388256984273323
39427,703-004-5398,6490.4863,5,5,0,1.582308611211306
39578,703-004-5397,6944.685,2,0,2,0.27920371738274696
39681,703-004-5382,376.44266,6,3,3,0.9057549648942332
39824,207-008-2399,3545.4255,7,4,3,0.8865214524368619
40140,703-004-5398,6890.472,2,1,1,0.7401864811703908
40169,703-004-5387,8138.8735,5,1,4,0.7355302896885763
40220,703-004-5398,7216.745,6,2,4,0.5820808794345796
40229,703-004-5396,8810.505,4,2,2,0.8902239408934393
41039,703-004-5385,8634.523,6,1,5,0.3781236832355317
41135,703-004-5394,2727.5586,5,1,4,1.235624781763821
41276,703-004-5391,9888.8125,6,3,3,0.8276920227146685
41306,703-004-5391,5192.548,10,2,8,0.8599289387475045
42022,703-004-5389,2862.6584,3,2,1,0.8393843062031519
42103,703-004-5395,739.5607,4,0,4,0.27920371738274696
42285,703-004-5388,7652.0483,2,1,1,0.41985471326294643
42359,703-004-5393,7283.655,5,4,1,0.9091613217830884
42618,703-004-5395,2359.125,3,1,2,0.6189811218960154
428,703-004-5390,808.8106,5,3,2,1.9495447858786519
42863,703-004-5397,1060.8381,4,0,4,0.27920371738274696
43268,207-008-2398,145.21777,5,2,3,1.6698103531712634
43601,703-004-5396,3236.636,6,2,4,0.5305493114156101
43695,703-004-5399,8828.88,2,1,1,0.8328038906864702
43856,703-004-5381,3958.0059,4,1,3,0.5722784224977658
43946,703-004-5381,5568.5312,2,1,1,0.4463743336923703
44040,703-004-5383,5069.7925,2,0,2,0.27920371738274696
44164,703-004-5380,4707.196,4,2,2,0.6934800858426242
44427,703-004-5399,5754.575,8,3,5,0.623903481161848
44602,703-004-5380,8941.524,2,2,0,0.5623812467171094
44656,703-004-5393,5714.1323,5,2,3,0.7646982505937616
44684,703-004-5392,3055.8848,"","","",0.27920371738274696
44847,703-004-5398,8292.948,5,3,2,2.006424767180574
44929,703-004-5397,5436.651,1,1,0,0.6207265618242345
45319,703-004-5381,6391.019,4,1,3,0.5914636449486832
4546,703-004-5384,4064.1743,5,4,1,1.0215352791767658
45576,207-008-2398,1705.4248,5,2,3,1.3774325698575784
45632,703-004-5380,568.94006,4,4,0,0.8112036734809589
4580,703-004-5391,7212.741,2,1,1,0.9717495115294359
45819,703-004-5390,7704.2515,5,1,4,0.35237835831347525
45929,703-004-5385,9314.554,6,1,5,1.2799664123011687
46232,703-004-5392,9400.801,7,3,4,1.0746299654975462
46356,703-004-5386,6918.8345,3,1,2,0.7253293623515719
46752,703-004-5394,9560.041,1,0,1,0.27920371738274696
47275,703-004-5391,5465.5693,1,0,1,0.27920371738274696
47414,703-004-5391,9952.944,8,6,2,3.843864171625542
47613,703-004-5391,2937.0337,3,1,2,0.3807252912866403
47722,703-004-5397,7059.1104,4,3,1,4.618527580327068
48520,703-004-5385,7684.0186,4,1,3,0.4729669001383076
49168,703-004-5395,916.19196,4,2,2,1.0402214713993705
49210,703-004-5399,2196.566,2,1,1,0.7144095066496159
49284,703-004-5395,2260.014,4,2,2,0.7647707524947552
49313,703-004-5392,7160.121,7,3,4,1.8840384470119815
49464,703-004-5392,4835.9014,8,4,4,1.1910419754578858
495,703-004-5393,2985.3982,3,2,1,0.43741915723297026
49532,703-004-5392,6449.766,3,1,2,0.3978652972704144
49604,703-004-5382,7082.0015,2,1,1,0.7157552604192875
49778,703-004-5380,6309.7305,4,2,2,0.5330076521424801
5059,703-004-5395,7142.3467,5,2,3,0.9885090386682562
5101,703-004-5388,4046.2512,7,4,3,1.497143793243864
521,703-004-5399,2450.7166,2,2,0,1.1231557635917682
5458,703-004-5387,5951.6333,4,1,3,0.4442428467892329
5546,703-004-5399,6956.2207,7,2,5,1.4180898907438289
6059,207-008-2399,3158.2231,7,3,4,1.0098709397796606
6104,703-004-5396,2482.7886,3,1,2,0.6107049069344372
6147,703-004-5383,7821.3184,4,2,2,0.6649527991869066
6245,703-004-5389,8668.327,4,2,2,0.9975192064748205
625,703-004-5391,9975.946,2,1,1,0.35831143730785864
6527,703-004-5395,4475.668,3,1,2,0.361814271523527
6632,703-004-5393,9460.71,2,2,0,0.7145768972353598
6721,703-004-5388,9398.23,8,2,6,0.9167562098825324
6991,703-004-5381,9736.845,6,3,3,0.762662989628119
7101,703-004-5393,6571.2266,7,5,2,3.263338435200992
7335,703-004-5388,4906.8394,4,3,1,1.3050773060648515
8286,703-004-5396,9322.346,2,1,1,1.6378122504439563
8758,207-008-2398,6455.7993,6,2,4,1.2833505947308639
8876,703-004-5398,9070.612,1,1,0,0.7838824014042991
8977,703-004-5387,5321.687,7,3,4,0.6722866763005108
9139,703-004-5390,503.59964,6,3,3,0.682593895550664
9380,703-004-5390,3578.1926,2,1,1,0.8812612419991683
9456,703-004-5386,2136.445,5,1,4,0.46452021176129105
9477,703-004-5393,475.2922,1,0,1,0.27920371738274696
9560,703-004-5381,8484.753,8,5,3,1.9135782999734194
9680,703-004-5391,2688.7454,3,1,2,1.0910982591097453
10263,703-004-5382,9612.318,4,2,2,1.9635250130775677
10498,703-004-5380,4213.769,4,2,2,0.6560294170310331
10651,703-004-5384,228.40619,8,5,3,0.8845316608459405
10776,703-004-5397,819.8786,6,6,0,2.3140083015002193
10974,703-004-5386,1751.1005,3,2,1,0.7747502523836804
1099,703-004-5386,1144.0664,5,1,4,0.5177823466439362
11109,703-004-5380,3401.249,2,0,2,0.27920371738274696
11636,703-004-5391,7662.6562,6,2,4,0.5105937981636984
11845,703-004-5398,2702.5146,8,2,6,1.0536890845399352
11908,703-004-5396,4186.269,5,2,3,1.133596744439808
1205,703-004-5380,256.19626,2,1,1,1.3071026996823327
12078,703-004-5390,6276.612,5,1,4,0.5000637904229478
12158,207-008-2399,8773.729,5,2,3,2.3568146476319685
12756,703-004-5380,2275.595,2,0,2,0.27920371738274696
12903,703-004-5395,9398.902,1,1,0,0.42658263566135385
13079,703-004-5397,4104.7563,3,1,2,0.5095213549936232
13820,207-008-2399,6388.179,2,2,0,1.6570533817780029
13821,703-004-5396,7796.7363,2,0,2,0.27920371738274696
13960,703-004-5382,4135.2417,3,0,3,0.27920371738274696
14210,703-004-5398,6936.595,2,0,2,0.27920371738274696
14295,703-004-5382,5972.9785,6,1,5,0.431166531462366
14637,703-004-5380,9572.122,4,2,2,0.6302632072987641
14722,703-004-5391,5369.381,5,3,2,1.3192984775429653
14737,703-004-5385,4405.506,6,3,3,1.8608476634084106
14757,703-004-5389,5878.6274,8,2,6,0.5067502578168255
1483,703-004-5394,9411.981,6,1,5,1.5333446655823793
15168,703-004-5392,1125.3882,3,2,1,0.41922438165019454
15837,703-004-5397,2665.4124,2,2,0,1.1018499948987932
15949,703-004-5385,3635.9292,6,4,2,1.2867300016434533
16121,703-004-5388,4977.7764,1,0,1,0.27920371738274696
1623,703-004-5391,4611.9004,5,3,2,1.1161960203543135
16288,703-004-5396,9898.013,3,2,1,1.151087262744384
16381,703-004-5391,8154.848,4,2,2,0.9149966582073646
16779,703-004-5386,8843.5625,3,1,2,0.4306689824730154
16966,207-008-2398,882.40204,8,3,5,2.9174198473598705
17004,703-004-5391,4802.965,6,3,3,0.9322287011360183
1735,703-004-5394,1127.5834,4,1,3,0.38228357543464303
17652,703-004-5381,1986.5095,4,4,0,1.4229891653863689
17790,703-004-5396,4218.4536,8,4,4,1.1984496847084483
17793,703-004-5386,4092.92,8,3,5,1.1352421107492918
18403,703-004-5389,5478.2964,3,1,2,0.4316374266888603
18483,207-008-2398,9606.273,8,4,4,2.122844892619853
19191,703-004-5383,5681.395,"","","",0.27920371738274696
1943,703-004-5384,3317.0623,7,5,2,3.0059500579888714
20009,703-004-5383,356.27664,2,1,1,0.45484376559975626
2058,207-008-2398,6274.5977,3,2,1,0.7430167902589989
20751,703-004-5392,1199.7413,6,3,3,2.204645460945107
20818,703-004-5385,8910.756,6,3,3,0.9053516129552363
2108,703-004-5388,7391.7163,2,1,1,0.5165268771580819
21101,703-004-5397,6324.5386,1,0,1,0.27920371738274696
21287,703-004-5384,441.19894,7,3,4,0.7353894322184139
21410,703-004-5381,6709.728,3,1,2,0.48252914730485913
21470,703-004-5380,5576.162,6,2,4,0.9310733581141005
21674,703-004-5380,7206.9233,6,3,3,1.045125079751356
21785,703-004-5397,6558.9146,4,3,1,1.7483543407177942
2180,703-004-5396,9315.859,6,3,3,1.0407982850174367
21840,703-004-5393,4290.491,4,2,2,1.6822958094761111
21860,703-004-5396,3016.9182,8,6,2,3.1076847846451097
21884,703-004-5388,9461.482,3,0,3,0.27920371738274696
2201,703-004-5389,4650.945,4,2,2,0.6723314278498799
22054,703-004-5396,4230.5054,4,2,2,0.9915793079900072
22081,703-004-5388,951.5846,7,7,0,4.741549521045244
22082,703-004-5394,7547.0435,1,0,1,0.27920371738274696
22327,703-004-5393,6732.7075,7,5,2,1.5648822680038417
22408,703-004-5383,4365.6187,3,1,2,0.4230808829965438
22560,703-004-5397,2115.5537,3,1,2,1.852469486573522
22585,703-004-5391,2452.8098,4,1,3,0.673189585001659
22626,703-004-5398,8502.715,6,4,2,2.2867104097286357
22913,703-004-5396,8630.861,4,2,2,0.4916873827170966
23270,703-004-5384,965.66974,2,2,0,0.7093669448980897
23272,703-004-5386,4080.5156,5,2,3,0.4919780787277187
23399,703-004-5386,4868.47,3,1,2,0.5190149657488178
23476,703-004-5398,428.19977,6,3,3,1.3897793463828143
23610,703-004-5386,297.02246,7,4,3,0.762637445225358
23647,207-008-2398,4767.6953,4,2,2,0.5408107593685294
23762,703-004-5386,6456.001,6,4,2,2.262096149556079
23872,703-004-5394,4153.47,7,4,3,1.5620302166966706
24029,703-004-5388,3889.2656,3,1,2,0.47169368149562135
24143,703-004-5385,7328.5776,6,3,3,1.2284425253258666
2423,703-004-5396,9189.806,5,0,5,0.27920371738274696
2443,703-004-5390,9380.7705,9,2,7,1.221827954144689
24479,703-004-5395,7385.3564,3,1,2,0.7328691742164547
25160,703-004-5390,2897.7507,8,3,5,0.9631882871662765
25399,703-004-5387,1657.9646,3,1,2,0.37512182779194486
25527,703-004-5397,2856.4895,5,2,3,0.8684889673437974
25702,703-004-5396,3032.0447,3,1,2,0.3403309117998801
25803,703-004-5382,4938.3696,4,2,2,0.4679333121165837
25816,703-004-5393,5994.382,4,1,3,0.484761882683314
25870,703-004-5387,1427.4258,5,2,3,0.903716671175656
25962,703-004-5382,183.99,1,0,1,0.27920371738274696
26058,703-004-5380,7366.4717,4,2,2,1.0135996248549302
26187,703-004-5386,6563.5083,1,0,1,0.27920371738274696
26233,703-004-5399,3571.3518,5,2,3,2.232610805288843
26408,703-004-5387,9176.846,5,2,3,0.6195411140539108
26646,703-004-5392,7255.41,6,2,4,0.7526761840707009
26723,703-004-5386,3297.392,2,1,1,0.42247459648680524
27004,703-004-5391,1129.6439,2,1,1,0.48897652208259657
27340,703-004-5396,9440.779,3,0,3,0.27920371738274696
27754,703-004-5394,4807.606,4,2,2,0.866367093018055
28088,703-004-5386,5468.1123,5,3,2,1.450853081958068
28162,703-004-5382,7706.78,4,3,1,0.8012203367243389
28262,703-004-5392,8070.568,3,2,1,1.8084473650665234
2846,703-004-5386,9322.098,9,3,6,1.6594891864180494
28568,703-004-5387,6823.1904,2,1,1,0.4847013449562943
28888,703-004-5389,385.17712,3,2,1,0.63840047674372
29,703-004-5392,5147.17,3,2,1,0.9254193871112008
29469,703-004-5398,7274.1245,3,2,1,0.6374415664574296
29505,703-004-5393,8405.1875,2,0,2,0.27920371738274696
2989,703-004-5380,7297.5273,2,1,1,0.7269181579250302
30127,703-004-5389,4941.7285,3,3,0,0.6351884570457493
30144,703-004-5399,2827.4841,5,3,2,1.701372506447711
30281,703-004-5388,9725.795,4,2,2,0.8253315771545543
30359,703-004-5387,6109.23,8,6,2,2.6086206557269365
30459,703-004-5380,307.40262,4,1,3,0.5351219211683057
30511,703-004-5392,8903.235,5,3,2,2.245990611471017
30519,703-004-5385,4113.7593,5,4,1,1.391006872790989
30530,703-004-5380,8275.854,3,3,0,1.2601594442910329
309,207-008-2398,3922.364,4,1,3,0.5386145868139065
30921,703-004-5384,1740.6749,5,2,3,0.530241151695166
30949,703-004-5384,4690.535,1,1,0,0.5651260874304743
31288,703-004-5387,2309.0588,2,1,1,1.479390325207963
31448,703-004-5389,5747.0107,4,3,1,0.9311519140588889
31506,703-004-5389,2867.6082,4,2,2,0.5962592829475795
31850,703-004-5389,8214.399,2,1,1,0.9701632953522851
31932,703-004-5389,4658.927,3,1,2,0.587004625333506
32133,703-004-5391,9526.905,3,1,2,0.3919322182760311
32537,703-004-5389,2504.831,4,2,2,1.4426988715434579
3268,703-004-5399,3704.8179,7,6,1,1.4836869196856124
32680,703-004-5386,8864.219,6,5,1,1.6295549248040668
32827,703-004-5380,4257.573,1,1,0,0.3919322182760311
32965,703-004-5380,8200.08,3,2,1,0.6407204942747571
33346,207-008-2398,4261.605,5,3,2,4.208549115728947
33476,703-004-5385,1182.7952,3,1,2,0.38625824453236074
33735,703-004-5390,8780.473,1,0,1,0.27920371738274696
3399,703-004-5385,2207.9463,2,0,2,0.27920371738274696
34032,703-004-5386,7557.883,2,1,1,0.758966317045691
3406,703-004-5381,3021.055,5,3,2,1.037638587330459
34609,703-004-5387,6358.981,2,1,1,0.3842584717102472
34824,703-004-5392,4765.483,5,1,4,0.4607945869166548
34995,703-004-5393,6640.7114,5,4,1,2.839713231232708
35322,703-004-5391,5262.54,2,0,2,0.27920371738274696
3546,703-004-5386,4323.22,7,3,4,1.515091431921297
35569,703-004-5397,2265.1697,4,2,2,1.2103423105641609
35633,703-004-5390,6718.5474,3,2,1,1.3397926252222594
35697,207-008-2399,9009.604,4,2,2,1.5116607958830888
35956,703-004-5382,1264.6997,2,1,1,0.7576641636648718
36106,703-004-5396,8591.126,4,2,2,1.5025715691104173
36235,703-004-5395,7446.4106,7,5,2,2.1527671641890977
36427,703-004-5385,9304.5,6,3,3,1.0776851864879011
36845,703-004-5389,609.41815,"","","",0.27920371738274696
36860,703-004-5394,6617.228,2,0,2,0.27920371738274696
37016,703-004-5394,2217.506,2,1,1,0.3978652972704144
37017,703-004-5387,7376.0015,6,2,4,1.7104089646373206
37044,703-004-5390,3049.0022,7,2,5,1.3812618046584495
37059,703-004-5396,9076.004,4,2,2,0.9433080835411208
37278,703-004-5381,2322.7668,6,4,2,1.6018287030505745
37494,703-004-5389,1908.3142,4,4,0,0.8758046145140778
37778,703-004-5389,4311.3667,2,1,1,0.5380187497747851
3802,703-004-5390,6317.8047,4,3,1,1.5424820410871913
38664,703-004-5387,730.29456,1,1,0,0.3473181506045906
38696,703-004-5394,8264.49,2,1,1,0.3187575773453028
38699,703-004-5384,7475.5503,4,3,1,2.105777856419594
38710,703-004-5383,6013.079,1,1,0,0.3978652972704144
38727,703-004-5387,8992.894,3,0,3,0.27920371738274696
38825,703-004-5396,6242.864,5,3,2,1.4902944138489669
39032,703-004-5385,9120.174,3,2,1,0.6218072684021889
39377,703-004-5392,8440.562,7,3,4,1.3140964002152835
39569,703-004-5399,4679.215,"","","",0.27920371738274696
39890,703-004-5385,8065.1514,3,1,2,0.4734143040293744
39970,703-004-5387,727.0294,6,2,4,0.7922314405237575
40141,703-004-5392,9747.823,7,2,5,0.6482326548561199
40224,207-008-2398,3641.2751,4,4,0,1.33319258496103
40379,703-004-5395,9610.038,5,4,1,1.843991283905582
40603,703-004-5399,2576.471,5,2,3,1.6651532904115154
41102,703-004-5395,2162.8606,7,5,2,1.0326101162566064
41456,703-004-5394,6619.9995,3,1,2,0.33853450732658075
41682,703-004-5399,2382.996,3,1,2,0.33853450732658075
4179,703-004-5394,3904.9785,2,1,1,0.46439360658138096
41841,703-004-5389,6905.7856,5,3,2,1.4465948039523997
419,703-004-5394,4658.1025,4,1,3,0.46631685710514514
42188,703-004-5387,2140.1792,7,3,4,1.3033668643491174
42416,703-004-5393,4889.6895,5,2,3,0.9842338663987245
42491,703-004-5385,20.200611,4,2,2,1.0905360267215187
43134,207-008-2399,8501.067,4,2,2,0.6107600809752061
43166,703-004-5392,9792.747,4,1,3,1.0392383216070564
43262,207-008-2399,8414.414,4,1,3,0.4097540194115331
43464,703-004-5385,2193.5027,2,2,0,1.3435109459618075
43587,207-008-2399,3264.317,3,1,2,0.5970574599223
43648,703-004-5390,9581.911,4,2,2,0.7847630588597863
43707,703-004-5387,9277.207,6,2,4,0.9201462326690976
4402,703-004-5396,773.3876,4,1,3,0.4770614100789808
44548,703-004-5380,7777.409,7,4,3,1.7052674507528738
44566,703-004-5394,1424.6077,"","","",0.27920371738274696
45044,703-004-5383,2143.8975,6,4,2,1.3136887136723412
4542,703-004-5383,4936.618,7,2,5,0.644686265086458
45744,703-004-5381,3358.8655,4,2,2,1.1752338616522873
46363,703-004-5392,1917.3115,4,1,3,0.5165268771580819
46467,703-004-5396,6324.8984,2,0,2,0.27920371738274696
46472,703-004-5382,2653.6375,6,2,4,0.8876121733307943
46713,703-004-5386,5280.145,9,6,3,2.406062632621513
46858,703-004-5386,1814.949,3,0,3,0.27920371738274696
47592,207-008-2399,7896.0327,1,1,0,0.9805146675069667
47718,703-004-5382,2580.2468,6,2,4,0.7679668254121659
47719,703-004-5391,7877.925,2,1,1,0.6350841443499189
47813,703-004-5381,4823.7344,4,0,4,0.27920371738274696
47936,703-004-5396,7390.3335,2,2,0,0.6875620635208668
48092,703-004-5394,5416.4707,6,2,4,0.7278092271861999
48166,703-004-5386,636.0465,2,0,2,0.27920371738274696
48282,703-004-5383,7783.8926,2,1,1,0.3841200801902069
48327,703-004-5392,3254.2878,3,2,1,0.8649464389546325
48614,207-008-2398,3781.5154,5,2,3,1.1888318528437667
4862,703-004-5391,3489.5098,1,0,1,0.27920371738274696
48648,703-004-5381,8312.242,3,1,2,0.9183497947757762
48659,703-004-5381,7351.4365,2,0,2,0.27920371738274696
48687,703-004-5395,3321.4646,1,0,1,0.27920371738274696
48847,703-004-5391,9079.621,4,2,2,0.440048664881731
48979,703-004-5385,1474.1177,3,2,1,1.3353615444983815
49039,703-004-5391,9658.4,4,3,1,1.225442163593922
49150,703-004-5393,6246.9263,5,4,1,1.992687782520127
49169,703-004-5394,5408.449,3,0,3,0.27920371738274696
49322,703-004-5386,1177.8402,4,3,1,0.7395117626969905
4977,703-004-5388,6180.509,2,0,2,0.27920371738274696
49773,703-004-5396,9341.21,3,2,1,0.9555109869026871
5473,703-004-5392,1470.179,4,2,2,0.5707451280226391
5576,703-004-5395,7058.749,5,1,4,0.35831143730785864
5745,703-004-5386,1759.7157,3,3,0,0.9552234355348207
6074,703-004-5391,8431.628,5,3,2,0.819592110925325
6119,703-004-5390,2370.2878,1,0,1,0.27920371738274696
6152,703-004-5395,1553.4121,2,1,1,0.32666834933781397
6452,703-004-5384,127.67434,4,2,2,1.4265709157539148
6504,703-004-5395,2760.8438,9,4,5,1.3547171875467032
6538,703-004-5388,4659.5215,3,1,2,1.6708739958128875
6555,703-004-5392,8960.184,4,2,2,2.755995213374697
6772,703-004-5384,9614.113,7,2,5,0.45427897327232064
6825,703-004-5397,6082.218,3,1,2,0.33853450732658075
6857,703-004-5384,2156.3298,3,1,2,0.4427101658349302
69,703-004-5388,512.3544,1,0,1,0.27920371738274696
703,703-004-5381,6333.0005,4,2,2,0.5979192873458967
724,703-004-5381,767.6518,1,1,0,0.9579033990643434
7387,703-004-5384,3355.528,3,1,2,0.5165268771580819
7396,703-004-5389,5532.615,4,1,3,0.39713460020793445
7584,703-004-5391,1802.8152,2,1,1,0.4432533515774473
7841,703-004-5399,567.1823,4,3,1,0.9231990449594398
788,703-004-5396,2333.3145,3,2,1,0.5202934244812406
7912,703-004-5391,4464.361,3,3,0,1.3479695576411996
7927,703-004-5396,1096.0752,1,0,1,0.27920371738274696
8273,703-004-5396,8616.871,4,1,3,0.6218719908583555
8292,703-004-5397,1026.1732,4,2,2,0.6771319337038245
836,703-004-5387,8762.14,6,2,4,0.8361417947600365
8419,703-004-5389,1242.3975,2,0,2,0.27920371738274696
8614,703-004-5395,8336.19,1,1,0,0.3978652972704144
8991,703-004-5398,8211.68,2,1,1,0.6097225115114098
9081,703-004-5383,8512.988,4,1,3,0.37635788591577474
9221,703-004-5395,2049.9377,3,1,2,0.5299751481970489
9526,703-004-5393,3144.8972,9,5,4,1.910433645476149
9610,703-004-5392,9606.493,2,1,1,1.5866239803474944
9623,703-004-5391,3633.191,3,2,1,1.3384589292546405
9784,703-004-5383,14.75513,1,1,0,2.3634560294590528
9979,207-008-2399,558.0771,5,5,0,1.7581739874313256
10039,703-004-5387,4302.247,8,4,4,1.277981483819429
1021,703-004-5394,9549.024,5,4,1,1.3425454140972828
10328,703-004-5392,5647.8267,5,4,1,2.1427865003396604
10381,703-004-5391,3167.0027,4,2,2,0.47400647769833437
10609,703-004-5389,3246.4421,4,1,3,1.1992166827497142
11147,703-004-5382,5223.515,4,1,3,0.4538719148998951
11238,207-008-2399,9702.538,4,1,3,0.5165268771580819
11327,703-004-5390,6478.6147,3,2,1,1.73695395540513
11385,207-008-2399,9806.668,7,5,2,2.077756275603303
11388,703-004-5391,1762.7365,6,2,4,0.9152801639737773
11708,207-008-2398,5686.4517,9,7,2,3.3732184803925502
11794,703-004-5396,4388.1216,5,2,3,0.7308774193503532
11864,703-004-5395,8975.818,4,2,2,0.8491883609127783
11978,703-004-5395,3418.0547,2,1,1,0.3131070259220805
12031,703-004-5385,4128.88,8,4,4,1.6456309236493518
12037,703-004-5385,9592.253,3,2,1,0.7715293604158093
12140,703-004-5388,8759.47,4,2,2,0.4566321271605637
12402,703-004-5386,4091.177,5,2,3,2.188593140277734
12407,703-004-5391,419.92487,1,1,0,0.4819172496908456
12532,207-008-2398,4155.111,3,1,2,0.48623986616082837
12917,703-004-5391,2335.921,7,4,3,1.398386531446232
12935,703-004-5390,4532.1733,5,4,1,1.8108706602570364
13031,703-004-5380,7153.7446,1,0,1,0.27920371738274696
13033,703-004-5396,9452.881,2,1,1,0.5158924934631673
13148,703-004-5393,5007.5747,5,2,3,1.673957983340636
13309,703-004-5380,9313.583,3,1,2,0.45156465747608077
13312,703-004-5381,860.3847,4,0,4,0.27920371738274696
13375,703-004-5394,6460.3125,7,4,3,2.0708612996048243
13589,703-004-5380,1280.6207,4,2,2,0.5641262362524033
13782,703-004-5381,1473.3607,1,1,0,1.4927281308463698
14159,703-004-5398,752.8889,4,2,2,0.7713376633162513
14255,703-004-5383,7175.1855,2,1,1,0.8491576752672856
1429,703-004-5389,2578.8706,7,3,4,2.2328315456478753
14400,703-004-5388,7802.777,5,1,4,0.4561602918628163
14681,703-004-5384,742.5761,4,1,3,0.49264777379114133
14897,703-004-5398,3157.7344,7,3,4,1.704294197699748
15012,703-004-5391,7063.018,3,1,2,0.7697193697828106
15353,703-004-5389,745.85736,4,1,3,0.5255170755100846
1584,703-004-5382,8492.293,2,0,2,0.27920371738274696
16003,703-004-5382,2479.7905,2,2,0,0.6080673346083124
16200,703-004-5384,7379.7173,5,3,2,1.2011811911146428
16508,703-004-5387,5042.1006,3,0,3,0.27920371738274696
16643,703-004-5396,7878.61,4,1,3,0.8082147901138087
1673,703-004-5389,9063.665,2,1,1,1.2005373449724142
16756,703-004-5382,463.7295,2,2,0,0.5065308751106697
16844,703-004-5382,6840.382,5,3,2,1.27313720312588
1692,703-004-5387,2577.6367,6,4,2,1.853893335714739
16943,703-004-5387,9804.049,3,3,0,0.8537049537062924
17311,703-004-5392,3968.1978,4,3,1,1.0403144610329487
17461,703-004-5388,4979.06,5,1,4,1.0194693025137502
17836,703-004-5384,466.78723,2,0,2,0.27920371738274696
17944,703-004-5382,5517.78,9,5,4,1.8832867493347414
17961,207-008-2399,5088.463,7,3,4,1.062098471751196
18178,703-004-5388,6793.0913,5,3,2,1.3986855591846354
18376,703-004-5380,3955.0537,4,2,2,2.2935810815061033
18771,703-004-5384,5643.6978,1,0,1,0.27920371738274696
18830,703-004-5392,8069.296,6,4,2,2.7457832474596744
18859,703-004-5386,4273.7646,6,2,4,0.7366139437948273
18870,703-004-5391,6835.6396,8,3,5,1.3920529303783575
19182,703-004-5381,3984.9692,2,2,0,0.9387730157090446
19207,703-004-5398,4863.276,3,1,2,0.9234969577814703
19220,703-004-5395,640.08356,3,3,0,0.7293610636455202
19553,703-004-5394,6388.201,4,1,3,0.9664045346502461
19679,703-004-5393,6474.5156,4,3,1,1.1972141648987562
1972,703-004-5382,2138.567,3,1,2,0.48503786812504107
19788,703-004-5380,1027.4493,4,1,3,0.6532508158655934
2031,703-004-5383,2806.5432,6,2,4,0.48729512912727974
20415,703-004-5395,7062.7104,4,2,2,0.9539480357526228
20601,207-008-2398,3702.7341,6,4,2,0.9751285008452213
20636,703-004-5399,5006.739,5,1,4,0.6402303042435704
20746,703-004-5387,3868.0232,1,1,0,2.2958998777454918
20760,703-004-5385,2094.7712,8,2,6,1.0915645458975252
20995,703-004-5396,6458.457,7,5,2,3.320294362897778
2149,703-004-5381,935.15515,1,0,1,0.27920371738274696
2155,703-004-5380,4766.64,4,4,0,1.8335659658674497
21845,703-004-5383,9539.892,3,0,3,0.27920371738274696
22053,207-008-2399,4300.3433,4,3,1,1.1488232500404838
22124,703-004-5380,1408.1943,3,2,1,0.45719608721424815
22126,703-004-5390,7119.623,4,3,1,0.8166932167817298
2224,703-004-5396,9864.6455,9,4,5,1.8470335346423712
22647,703-004-5393,6245.351,3,2,1,0.8075129275674807
22726,703-004-5396,3806.0737,2,2,0,0.49961349774072206
22766,207-008-2398,6543.156,4,1,3,1.6621717192936816
22791,703-004-5383,2633.884,2,1,1,0.4806205412431694
22836,703-004-5399,9968.962,4,4,0,2.6685973046753437
22865,703-004-5391,6603.702,5,4,1,1.4522046308653815
22989,703-004-5390,5503.375,8,4,4,2.323845597656268
23158,703-004-5399,854.0982,6,3,3,0.8654498622523786
23242,703-004-5391,2183.7014,2,2,0,2.3864270252698
23260,703-004-5398,682.13226,1,1,0,0.5165268771580819
2349,703-004-5383,4688.291,5,3,2,0.7716357115923167
23663,703-004-5391,6168.077,7,2,5,1.2248791100093577
23701,703-004-5388,9294.626,6,1,5,0.5343241472619003
23710,703-004-5391,5499.576,5,3,2,0.7307164551504852
23881,703-004-5381,1596.6392,3,1,2,1.7327339728955506
24048,703-004-5384,7177.921,1,1,0,0.3187575773453028
24175,703-004-5394,2420.371,1,0,1,0.27920371738274696
24545,207-008-2398,7432.3276,4,2,2,1.9759515151301779
25320,703-004-5394,4399.786,4,0,4,0.27920371738274696
25567,207-008-2399,8907.17,5,5,0,1.6142636765619744
25684,703-004-5393,1451.1991,4,2,2,0.515867646158706
26050,703-004-5399,574.14056,6,4,2,2.2734537533847
26086,207-008-2398,4214.4985,1,1,0,0.7194754082911156
26111,703-004-5398,4627.757,6,4,2,2.01890565511815
26121,703-004-5380,271.99387,2,0,2,0.27920371738274696
26362,703-004-5395,3813.4712,3,2,1,1.5080694796071028
26378,703-004-5389,126.99008,5,3,2,0.9821184292247078
26473,703-004-5390,8170.1367,4,1,3,1.05040999173528
26508,703-004-5394,9187.884,7,3,4,1.138240845848275
26551,703-004-5383,9020.032,5,4,1,1.099872460872857
26741,207-008-2398,4802.48,4,1,3,0.8346046223333079
26956,207-008-2398,2007.5613,4,2,2,0.8973893729947819
2701,703-004-5384,4836.9624,6,2,4,0.5368603853867435
27011,703-004-5390,5788.699,1,0,1,0.27920371738274696
2702,703-004-5381,7546.2373,5,5,0,5.489492442698529
27075,703-004-5391,6726.8735,5,1,4,1.175035753271711
27295,703-004-5390,4624.839,2,1,1,0.3978652972704144
27386,703-004-5389,4612.9727,3,1,2,0.674761698561393
27423,703-004-5387,9526.489,2,1,1,0.37808489762820296
27435,703-004-5393,6361.3247,6,4,2,3.100427128398329
27728,703-004-5383,1811.1432,5,1,4,0.5402791340788808
27748,703-004-5394,341.31647,4,1,3,0.4349917454377653
27839,703-004-5396,20.572544,2,0,2,0.27920371738274696
27892,703-004-5397,8917.932,2,1,1,0.7829114828448671
27913,703-004-5388,8632.209,2,2,0,1.5952503163051839
27926,703-004-5398,8393.476,2,1,1,0.6838271970568295
28308,207-008-2399,2626.3184,4,1,3,0.414689895176534
28364,703-004-5399,3604.883,3,2,1,1.2858263195938486
28551,703-004-5390,9156.617,3,3,0,0.5805248434410379
28761,703-004-5398,3256.4116,6,3,3,0.7258086983046735
28786,703-004-5398,9768.784,3,2,1,1.3059473214732136
29077,703-004-5381,6138.656,3,1,2,0.5999060534421967
29085,703-004-5393,5672.299,5,1,4,0.708858054948131
29267,703-004-5399,3335.343,2,2,0,1.3051419020322537
29395,703-004-5394,9020.668,4,1,3,0.5012226388777931
29564,703-004-5397,3110.361,7,2,5,0.5966036666522762
29853,207-008-2398,3891.793,4,1,3,0.4395307101967336
29856,703-004-5387,1050.0168,4,1,3,1.6509678351674868
30067,703-004-5389,7831.7817,3,1,2,0.4836987635627723
30252,703-004-5388,7865.605,4,1,3,0.6755868012934875
30460,703-004-5385,6196.956,5,2,3,0.7856908692192505
308,703-004-5395,9360.843,3,3,0,0.9662101596719004
30819,703-004-5396,6421.49,7,1,6,0.35114230018964543
30863,703-004-5395,8705.737,5,2,3,1.046733870391327
3090,703-004-5382,5819.038,5,2,3,0.5160618353459742
31240,703-004-5382,6142.4004,8,3,5,2.6739218521178123
31308,703-004-5387,8350.423,"","","",0.27920371738274696
31520,703-004-5399,6592.5957,8,4,4,1.7317759440633334
31525,703-004-5382,1823.0062,3,1,2,0.4995368728434766
31946,703-004-5396,485.2432,1,1,0,1.3077685725844348
32048,703-004-5386,6001.5825,3,1,2,0.956935828080501
33579,703-004-5381,6557.3965,4,2,2,1.2257257898639078
33944,703-004-5392,1269.3774,3,1,2,0.5690876639499585
34601,703-004-5398,8120.578,6,3,3,1.3925794925277741
348,703-004-5394,8080.0063,9,6,3,2.57622580033621
34904,703-004-5396,369.7568,4,3,1,2.30833471242644
34932,703-004-5396,1025.998,7,2,5,1.306144525406818
3496,703-004-5382,90.267654,1,0,1,0.27920371738274696
35032,703-004-5389,7248.615,3,0,3,0.27920371738274696
35287,703-004-5396,8727.983,5,2,3,0.5957301881156942
35365,703-004-5383,390.38123,1,0,1,0.27920371738274696
356,703-004-5394,6831.71,5,1,4,0.436610037018606
3582,703-004-5391,5332.668,6,0,6,0.27920371738274696
36002,703-004-5383,5421.459,5,2,3,1.116702315532418
36191,703-004-5384,94.9508,1,1,0,0.3986625840973518
36192,703-004-5389,9457.132,5,2,3,0.8200539123979567
36252,703-004-5393,927.8542,2,1,1,0.40573287857051776
3646,703-004-5398,1986.9948,5,1,4,2.237212202448988
36724,703-004-5381,872.96246,4,2,2,4.116128219033843
36848,703-004-5384,722.51855,7,2,5,1.5411731622151028
37015,703-004-5399,3366.4233,3,3,0,4.223370837732349
37302,207-008-2398,3124.0774,2,2,0,0.5477784058273578
37330,207-008-2398,7177.368,4,2,2,1.0271797347073723
3745,703-004-5398,7848.4116,6,2,4,1.104383171491361
37464,703-004-5390,4891.786,3,0,3,0.27920371738274696
37646,703-004-5380,2500.999,2,0,2,0.27920371738274696
3777,703-004-5392,1777.811,4,1,3,1.6647636755825677
37844,703-004-5395,7204.9507,5,3,2,1.8712554212924504
37878,703-004-5399,8446.815,3,0,3,0.27920371738274696
37907,703-004-5383,2410.7295,3,2,1,0.5786477686677705
38038,703-004-5391,1450.19,4,1,3,0.5899902888374998
38089,207-008-2398,5431.518,4,4,0,2.0377210327332267
38191,207-008-2398,5382.215,1,1,0,0.4710797787821933
38263,703-004-5387,2349.2312,2,1,1,0.6163130690808011
38451,703-004-5396,4981.632,4,3,1,1.9463336117994914
38560,703-004-5380,9513.57,1,0,1,0.27920371738274696
38818,207-008-2399,8059.867,3,1,2,0.6545245234053183
3914,703-004-5395,2996.4722,5,3,2,1.1381966337385354
39199,703-004-5382,7544.8765,4,3,1,1.6618412758389178
39411,703-004-5396,8774.586,5,1,4,0.46737626192211096
39491,703-004-5386,4030.8357,4,2,2,1.047215190500906
40071,703-004-5389,6672.5903,2,2,0,0.9834262048709275
40073,703-004-5380,8685.134,1,1,0,0.4314860782385869
40375,703-004-5394,4189.578,2,0,2,0.27920371738274696
41070,703-004-5384,2413.8445,4,4,0,0.9937435997815417
41097,703-004-5383,2520.0862,5,3,2,1.4556915563373223
4132,703-004-5386,9993.072,4,2,2,0.5859439013923673
4144,703-004-5394,4269.025,5,0,5,0.27920371738274696
41667,703-004-5395,1222.4401,2,1,1,0.4243707156874192
42191,703-004-5386,6541.5366,7,4,3,1.0333369177882494
42485,207-008-2398,3982.5684,3,1,2,0.3870291877181726
42569,703-004-5391,4919.1284,3,0,3,0.27920371738274696
42792,703-004-5382,9015.585,1,1,0,0.6119691811559242
43318,703-004-5386,2150.3699,4,3,1,0.6657285340323913
43453,703-004-5389,2437.737,3,3,0,0.873175233617076
43509,703-004-5390,7641.4727,4,3,1,2.3778253166107284
4370,703-004-5387,8570.183,2,2,0,0.5153312191696187
43742,703-004-5389,3284.8687,5,2,3,1.3594356057676658
43788,703-004-5390,322.63516,"","","",0.27920371738274696
44015,703-004-5398,138.24522,6,3,3,0.9705421106598854
44108,703-004-5396,2006.3395,5,3,2,0.571938828073997
44258,703-004-5391,7293.95,6,3,3,1.1482867542744302
44392,703-004-5399,3502.0823,2,1,1,0.7175355821768297
44488,703-004-5383,9469.623,7,4,3,2.413681886067082
44623,207-008-2398,2395.0017,1,0,1,0.27920371738274696
45288,703-004-5387,3142.354,2,1,1,0.5547201254843733
45787,703-004-5382,4670.516,2,2,0,0.6696667513359694
4584,703-004-5382,2482.1294,3,2,1,0.9417598959017012
459,703-004-5391,4984.717,5,2,3,1.0267301297878073
46131,703-004-5398,331.6748,4,3,1,0.9432010480416743
4631,703-004-5390,1368.5215,1,0,1,0.27920371738274696
46333,703-004-5392,8142.2437,4,1,3,1.178893505111093
46349,207-008-2398,7321.111,5,5,0,1.360871965078598
46618,703-004-5383,8427.631,4,2,2,1.1748218914789172
46701,703-004-5393,9961.882,1,1,0,0.8807686994689994
46872,703-004-5386,1100.2606,4,1,3,0.3691084050195126
46941,703-004-5384,5024.871,3,0,3,0.27920371738274696
46973,703-004-5385,44.113995,6,4,2,2.148256393536017
47351,703-004-5391,5679.8916,1,1,0,0.3978652972704144
47554,703-004-5388,6306.5337,2,2,0,0.671384201606045
47750,703-004-5394,7943.929,4,2,2,0.6652296136873105
4817,703-004-5394,7820.9307,2,1,1,0.3705171274703748
48366,703-004-5385,4763.0044,4,2,2,0.5640479500191066
4837,703-004-5385,6233.6475,5,1,4,1.032346921119937
48605,703-004-5385,3484.4219,2,1,1,0.4419105943559622
48633,703-004-5383,8252.491,2,1,1,0.49982388311078957
48883,703-004-5394,2204.5874,5,3,2,1.1676885833463053
49020,703-004-5390,9716.744,1,1,0,0.35831143730785864
49348,703-004-5387,6085.588,5,3,2,2.180884160845945
4953,703-004-5381,9343.665,6,5,1,1.4467188802497495
49899,703-004-5395,58.61223,6,4,2,1.8127760144811862
512,703-004-5399,6959.3887,3,2,1,0.6786210725158015
5193,703-004-5391,5270.415,4,2,2,1.2316842739982943
5199,703-004-5387,5172.1553,1,0,1,0.27920371738274696
5735,703-004-5380,294.52502,4,1,3,0.5439615794026641
5911,703-004-5399,2742.7603,2,2,0,0.6417989822011915
6140,703-004-5396,4045.1782,2,1,1,0.7589229645055086
6305,703-004-5386,5714.086,4,1,3,1.445794808929145
6375,703-004-5392,1235.9828,6,3,3,0.8249615205935846
6376,703-004-5384,606.78186,4,2,2,1.7537263288258318
64,703-004-5393,1671.5175,1,1,0,0.8017751888294763
6445,703-004-5387,9272.173,2,1,1,0.35831143730785864
6708,703-004-5385,8424.977,1,1,0,0.33853450732658075
710,703-004-5386,8626.332,4,1,3,0.4321949606799161
7565,703-004-5383,6435.5854,3,2,1,0.7351897205620076
7609,703-004-5391,3903.6226,3,2,1,0.6033637718054455
7910,703-004-5380,1332.3146,2,0,2,0.27920371738274696
8220,207-008-2399,3496.2004,3,1,2,0.39794505880720815
8742,703-004-5396,2615.3462,3,1,2,0.5549606949965645
8840,207-008-2399,530.1845,5,5,0,1.6437780333156433
8908,703-004-5386,8862.805,8,3,5,1.9551473539969522
9071,703-004-5396,9745.301,4,1,3,0.32666834933781397
9553,703-004-5386,6996.3247,7,5,2,2.068504296586472
9880,703-004-5394,6500.9824,2,2,0,0.9640221524298028
10124,703-004-5392,5508.047,1,1,0,0.42383203551839527
10145,703-004-5385,6825.032,3,1,2,0.543315599012958
10191,703-004-5383,3095.9993,4,0,4,0.27920371738274696
1032,703-004-5384,2363.9006,4,1,3,0.8568496303699549
1056,703-004-5380,6131.988,3,0,3,0.27920371738274696
10638,703-004-5383,7432.9873,2,0,2,0.27920371738274696
10809,703-004-5383,5401.8955,5,2,3,0.5667468130004802
10890,703-004-5382,8843.828,5,2,3,0.6251536182479227
10936,703-004-5383,3270.3752,2,0,2,0.27920371738274696
11113,703-004-5398,886.4945,6,2,4,0.5797493475453674
11175,703-004-5396,1096.8268,7,2,5,1.7296629018228988
11471,207-008-2399,6287.221,6,4,2,0.6108840137045614
11745,703-004-5396,9992.694,3,2,1,1.1429395341986321
12559,703-004-5395,8407.548,6,2,4,0.92802363533679
12651,703-004-5384,3724.5488,4,2,2,1.4752989071590754
12747,703-004-5387,9617.614,6,3,3,1.3637830220390932
12766,703-004-5380,7206.87,4,3,1,1.3063186706573384
12795,703-004-5394,6486.9155,3,3,0,0.8256416147833412
13076,703-004-5389,4470.08,9,5,4,2.107175514089304
13543,703-004-5384,1409.651,4,3,1,1.8730536586516773
13634,703-004-5380,1270.619,9,5,4,2.327302745451074
14076,703-004-5390,7398.0396,6,4,2,2.647723595898301
14384,703-004-5389,1562.3379,1,0,1,0.27920371738274696
14444,703-004-5394,9856.181,3,1,2,0.5901594057758648
14450,207-008-2399,6345.2524,3,3,0,0.7560547178202549
14731,703-004-5389,3132.7593,3,1,2,1.6404002949369234
14967,703-004-5386,9791.548,2,0,2,0.27920371738274696
15153,703-004-5388,4391.491,6,3,3,0.9302073627017411
15156,703-004-5396,7488.1787,6,4,2,1.9084502128862835
15275,703-004-5386,82.29554,5,1,4,0.38204671979179156
15470,703-004-5396,5056.946,2,1,1,0.5281370599798456
15505,207-008-2399,198.55916,6,4,2,1.0138493388679908
15702,703-004-5385,9853.28,8,4,4,2.049096782898295
16141,703-004-5383,5326.1733,9,3,6,1.1755100320405583
16238,703-004-5386,9940.76,1,1,0,0.3994294131173468
16271,703-004-5382,6687.1963,3,2,1,0.6822945312769678
16582,703-004-5387,557.0519,5,2,3,0.9589762083813745
17088,703-004-5384,6776.512,2,2,0,1.9570833857696344
17089,703-004-5394,8296.96,4,1,3,0.366537816141321
17288,703-004-5385,5370.7744,4,4,0,0.8900980771066095
1729,703-004-5393,1647.7365,3,2,1,0.7492695781467313
17296,703-004-5384,7360.9585,3,2,1,0.5911330593630333
17305,703-004-5394,1912.8251,5,2,3,1.1498936390453145
17464,703-004-5399,8224.764,6,3,3,0.7788403664672948
1805,703-004-5388,9204.93,1,0,1,0.27920371738274696
18103,703-004-5382,3730.7842,4,2,2,0.7730091273785887
18438,703-004-5398,4562.7812,1,1,0,0.37175974969512765
18451,703-004-5398,8844.409,2,2,0,1.5134168868946718
18520,703-004-5386,4208.249,5,2,3,1.0302270194198841
18551,703-004-5389,3393.171,2,0,2,0.27920371738274696
18851,703-004-5392,2284.3093,4,2,2,1.5530612977404767
18934,207-008-2398,4457.471,5,2,3,0.5521710852749638
1931,703-004-5389,8620.354,4,3,1,1.6316322558020455
19409,703-004-5391,3091.1814,1,1,0,0.35831143730785864
19556,703-004-5380,3556.081,8,5,3,2.2039155593745394
19783,703-004-5390,5850.385,10,7,3,1.7142804430634193
19906,703-004-5380,810.6953,1,1,0,0.6801150821843472
20032,703-004-5386,926.4773,5,3,2,0.7668252678476433
20136,703-004-5384,8695.525,1,1,0,0.3978652972704144
20204,703-004-5399,19.19329,2,2,0,1.1033645783639587
20777,703-004-5399,444.37708,3,3,0,1.3930257177264018
20883,703-004-5382,7377.8413,5,2,3,0.6280128401285886
2090,703-004-5399,5695.2427,5,5,0,1.7510071925957034
21082,207-008-2399,7620.85,8,6,2,1.8156472026031019
2111,703-004-5386,2978.236,4,2,2,0.45719608721424815
21552,703-004-5397,516.783,3,1,2,0.35831143730785864
21621,703-004-5383,4092.6987,5,2,3,1.1349077691984708
21751,703-004-5397,3806.417,4,4,0,1.3355624333240974
21887,703-004-5383,9277.187,7,4,3,1.6435706374454224
21971,703-004-5396,2263.148,4,1,3,0.576236048870044
22139,207-008-2398,7828.841,5,3,2,1.5337044035064191
22262,207-008-2399,7607.358,2,1,1,1.8399457765436031
22470,703-004-5381,1337.2856,6,4,2,1.5059971257572953
22692,207-008-2398,8841.001,4,2,2,1.0239778260013075
22828,703-004-5384,7897.1543,4,3,1,1.4726514727343687
22856,703-004-5384,955.25146,4,3,1,1.032610524258317
23090,207-008-2399,4461.18,4,1,3,0.48596822671960194
23183,703-004-5381,2768.7502,5,3,2,0.7794361935258424
23750,703-004-5395,1994.1044,4,2,2,1.1314749914262594
24105,703-004-5383,667.305,3,1,2,0.35831143730785864
24387,207-008-2398,3718.096,2,0,2,0.27920371738274696
24969,703-004-5382,4039.092,3,2,1,0.8073587159327803
24979,703-004-5395,7033.4067,5,4,1,2.272612073116423
25334,703-004-5394,298.32364,1,0,1,0.27920371738274696
25412,703-004-5382,668.453,6,1,5,0.8887621442576464
25919,703-004-5389,4333.682,8,3,5,0.862427042612855
25975,703-004-5387,4088.7046,4,1,3,0.5959192895564175
25976,703-004-5391,9558.498,4,3,1,1.5714323803873202
2633,207-008-2398,3863.492,3,2,1,0.8807029621833168
26371,703-004-5383,6636.5635,5,4,1,2.892442540810314
26521,703-004-5386,4286.4365,5,2,3,1.23690243823344
26544,703-004-5396,3694.864,5,2,3,0.5640911867222858
2699,703-004-5395,9000.472,2,1,1,0.39968230271244437
27114,207-008-2399,3768.028,4,3,1,0.7157219283685134
27215,703-004-5386,6985.262,9,3,6,1.8104199914987875
27324,207-008-2399,3017.77,4,3,1,1.2199187922873809
27420,703-004-5389,6195.528,3,1,2,0.525970979253204
27585,703-004-5394,7493.488,3,3,0,2.0933726611324364
27673,703-004-5396,5950.76,6,6,0,2.239231755829497
28244,703-004-5381,7959.462,5,1,4,0.5165268771580819
28450,703-004-5392,2986.9097,7,4,3,1.6764365710177198
28507,207-008-2398,2581.386,3,1,2,0.40329466527157276
28706,207-008-2399,5887.303,3,1,2,0.6967994034106121
28980,703-004-5390,4486.119,8,7,1,1.854173422087943
29001,207-008-2399,3857.3938,3,0,3,0.27920371738274696
29093,207-008-2398,160.06053,2,0,2,0.27920371738274696
29356,703-004-5394,3095.0432,1,0,1,0.27920371738274696
2942,703-004-5392,9090.935,5,3,2,1.2702488723354237
29471,703-004-5399,5093.2954,3,1,2,0.7457297221874634
29646,703-004-5397,8574.717,4,1,3,0.5165268771580819
29869,703-004-5399,8902.206,3,1,2,0.36287606681374174
29943,703-004-5382,6341.3086,7,3,4,1.1693034872858636
3,703-004-5384,7240.307,4,3,1,0.7937069577916207
30084,703-004-5399,5473.708,7,4,3,1.4658614090758806
30313,703-004-5380,9245.701,4,3,1,1.3139415212836116
30379,703-004-5392,3152.383,3,2,1,0.4608279083984517
30413,703-004-5385,4935.788,5,2,3,1.0234230528606432
30455,207-008-2398,7279.7515,3,2,1,0.6393162410161692
30544,703-004-5393,4407.85,3,1,2,0.8492160701392018
30587,703-004-5381,5069.815,5,3,2,1.27672397223655
30665,703-004-5381,3956.7112,5,3,2,0.8509459047249373
31253,703-004-5380,1172.9526,4,1,3,0.5328085802221175
31295,703-004-5390,4097.4473,3,0,3,0.27920371738274696
31459,703-004-5398,765.25507,5,3,2,0.8877101717026845
31684,703-004-5387,1760.4154,8,3,5,1.1092112481642658
31855,703-004-5386,9068.595,3,2,1,1.010178730786206
32290,703-004-5388,6673.5483,4,0,4,0.27920371738274696
32498,703-004-5383,1939.4827,5,4,1,2.1536557243616503
32540,703-004-5384,7791.8555,1,1,0,0.5112972101694069
32713,703-004-5388,4909.765,5,3,2,1.1341729265147342
33097,703-004-5386,2175.6143,3,1,2,1.0751730156971313
33158,703-004-5383,3472.5613,7,4,3,3.127357400106333
3325,703-004-5387,8954.492,5,2,3,0.7090098319131973
3337,703-004-5392,6242.465,4,2,2,0.4580116523889756
33428,703-004-5389,9266.553,7,2,5,1.1361193583471083
33583,703-004-5386,4291.811,4,1,3,0.3807252912866403
33654,703-004-5380,350.95395,6,4,2,1.4295984223240334
33713,703-004-5380,2838.0852,4,2,2,0.8349590736454303
34266,703-004-5381,7381.4443,5,3,2,1.2050242614681268
34476,703-004-5397,2465.679,3,3,0,0.42555299924420353
34491,703-004-5399,1997.3678,1,0,1,0.27920371738274696
34947,703-004-5391,4493.4766,2,0,2,0.27920371738274696
35026,703-004-5385,913.0055,6,1,5,0.8782366913314783
35463,703-004-5388,2835.1455,1,0,1,0.27920371738274696
35518,703-004-5391,6318.0405,14,5,9,1.556101214474484
35674,703-004-5397,9340.922,5,2,3,2.0166460045737042
35744,703-004-5391,1330.0854,3,3,0,1.054636044513655
35905,703-004-5380,3161.6377,4,2,2,1.1237979701524181
36001,703-004-5388,8426.675,2,2,0,0.5315864399991008
36266,703-004-5397,6232.602,8,4,4,1.4738995309771836
36433,703-004-5397,5861.97,2,1,1,0.9874766244473923
3662,703-004-5397,6664.3315,5,2,3,1.7523047649856291
36676,703-004-5383,3707.6753,10,3,7,0.9338110289169574
36837,703-004-5398,6064.3726,2,2,0,0.5523350871619496
36855,703-004-5394,7244.65,3,1,2,0.5165268771580819
36901,703-004-5397,1528.6284,8,4,4,0.9446823547736629
37009,703-004-5380,8045.827,3,3,0,1.9088529509297658
37025,703-004-5392,6409.144,3,1,2,2.238948126403143
37321,703-004-5390,915.17865,3,1,2,0.9757809666115885
37872,703-004-5395,8170.973,6,1,5,0.33853450732658075
38258,703-004-5382,9130.826,2,1,1,1.1740005046858275
38311,703-004-5396,4007.3115,3,1,2,1.1423309401782258
38322,207-008-2399,9739.933,2,1,1,1.0926527150683953
38544,703-004-5391,3011.7815,4,3,1,0.7390366966487513
38793,703-004-5394,8579.744,5,3,2,1.1725388975452498
38838,703-004-5389,9906.512,6,4,2,2.6879742877076747
39153,207-008-2399,645.8819,4,3,1,1.2425189619148405
39161,703-004-5389,392.54428,3,2,1,0.6939697756916502
3952,703-004-5384,1326.9132,5,4,1,1.2426850756316592
39620,207-008-2399,1977.0056,2,1,1,0.5181370429839995
39704,703-004-5398,8332.178,6,1,5,1.9410511518425684
3978,703-004-5392,1831.5596,4,2,2,1.0884534349300228
40370,703-004-5390,3830.75,3,2,1,1.079634929445421
40413,703-004-5381,1955.2034,4,3,1,0.8467824941679114
40431,703-004-5391,7584.226,5,2,3,1.0789240668550286
40608,703-004-5389,1909.1923,4,1,3,0.4553597281608097
40643,703-004-5396,483.9891,2,1,1,0.3978652972704144
40870,207-008-2398,2684.365,7,4,3,2.745758428801481
40901,703-004-5392,3408.317,3,1,2,0.49157041778884863
40937,703-004-5394,6976.934,7,5,2,1.1052259723684872
41126,703-004-5381,9884.502,3,2,1,0.7913790061223899
41141,703-004-5391,2094.397,2,1,1,0.3978652972704144
41404,703-004-5389,835.15405,2,0,2,0.27920371738274696
41428,703-004-5393,6148.8706,4,1,3,0.6402647574229743
41484,703-004-5390,1322.6777,7,1,6,0.5396850397015717
41516,703-004-5394,4850.5503,2,2,0,0.5894592687889111
41586,703-004-5386,2158.4045,7,5,2,1.7147853929334889
41856,703-004-5395,1815.3125,12,9,3,2.2846141311683503
4195,703-004-5384,5403.4785,5,2,3,1.3883098676753887
42122,703-004-5383,8689.546,7,5,2,1.9306298695856035
42340,703-004-5389,6433.0264,"","","",0.27920371738274696
42349,703-004-5391,2915.2273,6,3,3,1.3477296895587412
42460,703-004-5388,3938.4734,2,1,1,0.7945732164191343
42598,703-004-5387,1914.2395,7,5,2,1.7941381385822723
42747,703-004-5389,9706.461,3,3,0,1.204481651649505
42842,703-004-5381,6944.739,4,3,1,1.875474232598388
43521,703-004-5386,2206.254,6,5,1,1.804052179533477
43623,207-008-2398,4745.539,3,2,1,0.9776866102232713
44234,703-004-5385,5643.8506,3,1,2,1.1439912644020118
44425,703-004-5382,4380.1523,5,4,1,0.6901199480229678
44447,703-004-5391,870.88885,3,2,1,0.9418748444105893
44573,703-004-5392,6845.4624,6,3,3,1.0369694770632711
446,703-004-5388,8288.092,7,5,2,2.2489419121628824
44665,703-004-5391,8852.878,3,2,1,0.4925014926491974
44698,703-004-5388,7689.481,2,2,0,0.7283377972575683
44729,703-004-5396,9619.577,5,1,4,0.3131070259220805
44787,703-004-5389,4405.314,4,1,3,0.6873148410129032
45029,703-004-5392,6488.9736,5,4,1,1.8718102343121368
45402,703-004-5397,3151.4316,3,2,1,1.8530909315997814
45467,703-004-5391,1821.8881,1,0,1,0.27920371738274696
45485,703-004-5390,4050.3896,6,4,2,1.9579145004994833
45568,703-004-5394,1372.6259,3,2,1,1.1846235270408887
45577,703-004-5387,3620.4863,3,2,1,0.739008770210935
45633,703-004-5388,6974.139,2,1,1,0.33853450732658075
45915,703-004-5396,9038.673,3,2,1,1.172846596514647
46274,703-004-5381,2514.9226,2,2,0,0.49810487289020877
46496,703-004-5395,9130.907,5,2,3,0.6991879255168199
46807,703-004-5384,4521.052,6,2,4,0.4769869353326693
46964,207-008-2398,1463.2821,6,2,4,0.6447532209073427
46974,703-004-5383,7262.605,2,2,0,1.3658989938699666
47111,703-004-5384,5338.4985,4,2,2,0.8420629251969961
47248,703-004-5389,5917.3,4,2,2,1.4417183616244207
478,703-004-5383,1392.7233,2,1,1,0.573638942769641
4786,207-008-2398,7122.6377,5,3,2,1.0232789463920025
48042,703-004-5391,1137.1887,9,4,5,1.713873409042581
48067,703-004-5387,5949.2944,3,2,1,1.0343492945349007
48161,703-004-5391,5668.1514,2,0,2,0.27920371738274696
48193,703-004-5385,1853.6753,7,3,4,1.3164730267098066
48251,703-004-5385,8602.923,5,3,2,1.170010853238539
49018,703-004-5391,4687.924,4,1,3,1.1196802517582847
49027,703-004-5391,2900.4734,3,2,1,1.2792846100244386
49080,703-004-5398,9694.81,2,2,0,1.3783804905911623
49180,703-004-5380,2268.219,2,2,0,0.5928547001554535
49218,703-004-5399,9883.2705,2,1,1,0.5964746616693384
49243,207-008-2398,9942.144,3,1,2,0.3978652972704144
49687,703-004-5393,976.51245,2,1,1,0.7732511229312397
49722,703-004-5387,8341.417,3,3,0,0.8880931824390272
5000,703-004-5397,1285.3348,2,1,1,0.5032176427551603
5064,703-004-5399,8337.228,4,2,2,0.9132119217364439
5072,703-004-5399,2863.9023,"","","",0.27920371738274696
5092,703-004-5397,1822.555,8,3,5,2.1459859756084034
5345,703-004-5399,1888.5625,5,0,5,0.27920371738274696
541,703-004-5382,8839.998,4,3,1,0.9871396942914683
6047,703-004-5398,5413.733,2,2,0,0.7204369305843056
7058,207-008-2398,8125.9204,2,0,2,0.27920371738274696
7188,703-004-5398,7957.8403,4,4,0,1.1683839497087831
7601,703-004-5398,9502.47,10,1,9,0.5579194095913657
7780,703-004-5389,1843.9012,1,0,1,0.27920371738274696
7948,703-004-5380,8091.0137,6,4,2,7.415972216134909
8159,703-004-5394,8149.8105,3,1,2,1.015658034207044
8235,703-004-5392,7133.2563,3,2,1,0.44176958740560185
8324,703-004-5384,7044.1074,6,4,2,1.3813176989324054
8328,703-004-5393,632.75696,5,1,4,0.34269361601437026
8496,703-004-5386,7437.1924,2,1,1,0.6592460990620721
8527,703-004-5385,6080.35,6,4,2,1.176582883648869
8681,703-004-5380,7727.1367,2,1,1,0.35831143730785864
8790,703-004-5386,7499.225,4,1,3,1.0578476796617033
8865,703-004-5395,7738.791,5,3,2,1.5358116568976612
8888,703-004-5382,4247.4424,3,1,2,0.35831143730785864
8907,703-004-5391,5200.8633,2,1,1,0.7296266522307595
8974,207-008-2398,6783.193,3,1,2,0.6114737688272005
8989,703-004-5392,9991.065,7,5,2,1.1440103926265848
9107,703-004-5384,653.09045,6,4,2,1.2798807631528797
9511,703-004-5394,33.85663,6,3,3,1.3377369089547964
9670,703-004-5390,3415.0398,4,1,3,0.510975210384766
970,703-004-5399,9184.658,5,2,3,3.137406577033791
9791,207-008-2398,6200.559,6,2,4,1.4442431537170946
9961,703-004-5386,4056.1538,4,1,3,0.9705983128002296
10128,207-008-2398,6532.018,4,2,2,1.0583145404124306
10379,703-004-5393,356.40717,3,0,3,0.27920371738274696
10861,703-004-5399,4383.8506,4,3,1,0.7502138789720864
1089,703-004-5392,2977.2705,4,2,2,1.6117923729707064
11079,703-004-5388,8049.051,6,4,2,1.028268065559427
11136,703-004-5392,9423.174,4,2,2,0.6924240790273665
11355,703-004-5391,76.7684,6,2,4,0.862980248606917
11586,703-004-5396,9234.506,"","","",0.27920371738274696
11616,703-004-5391,6126.9824,4,3,1,1.5240745235518438
11835,703-004-5382,6541.144,5,1,4,1.0742909892533898
11987,703-004-5382,8729.497,3,2,1,1.7748039533005369
12088,703-004-5393,3841.0234,7,5,2,4.531747740202291
12216,207-008-2398,6582.6626,3,2,1,0.8238457439501657
12244,703-004-5393,9927.74,5,2,3,0.6859822055476649
12413,703-004-5386,4479.729,9,6,3,1.8024522310682258
12467,703-004-5392,6967.1978,6,3,3,1.304776288324577
12775,703-004-5393,8337.609,2,1,1,0.40013676253353453
12840,703-004-5381,1627.5203,3,2,1,0.7995060168817619
1296,703-004-5392,2447.7004,3,1,2,0.4980808732195917
13270,703-004-5398,6015.8833,5,0,5,0.27920371738274696
13532,703-004-5392,5746.994,4,2,2,0.6431225350786833
13548,703-004-5399,1853.8606,"","","",0.27920371738274696
13835,703-004-5399,5561.334,5,1,4,1.1217519706050647
13860,703-004-5392,7998.212,4,2,2,0.6466068267737818
14100,703-004-5381,3505.888,2,0,2,0.27920371738274696
14175,703-004-5383,8220.888,2,2,0,1.1694671856670533
14198,703-004-5394,7112.0293,7,5,2,2.465597241964878
14252,703-004-5381,3215.277,1,1,0,0.35831143730785864
14391,703-004-5383,4633.626,4,3,1,1.5523635142769132
14847,703-004-5386,5898.0005,7,1,6,0.35831143730785864
14938,703-004-5391,9781.882,5,2,3,0.8262327182035428
14987,703-004-5381,1560.446,5,2,3,0.9224500616361393
15105,207-008-2398,8228.47,6,1,5,0.44646729553044845
15172,703-004-5381,2233.3867,7,3,4,1.4854468494677724
15607,703-004-5391,9211.741,4,0,4,0.27920371738274696
160,703-004-5388,1292.3599,6,4,2,1.0424461419425668
16266,703-004-5399,1066.8254,5,2,3,0.9140633856306014
16480,703-004-5398,5679.658,7,5,2,3.1552788090995536
1679,703-004-5386,4121.872,"","","",0.27920371738274696
17233,703-004-5381,3116.7412,4,4,0,2.4369445521395807
1747,703-004-5382,1253.9185,5,3,2,1.9073162060620898
17537,703-004-5391,2948.6025,3,1,2,0.32436104083999817
17594,703-004-5393,7389.8877,6,5,1,2.3626995387501575
17749,703-004-5385,5807.5576,5,3,2,0.9453956571452513
17814,703-004-5394,9540.9795,8,5,3,1.6442499197489733
18372,703-004-5381,344.95114,2,1,1,0.6960973263744864
18385,703-004-5384,4620.4336,4,0,4,0.27920371738274696
18424,703-004-5397,6018.3804,2,2,0,0.6290471785651012
18600,703-004-5384,9332.336,4,0,4,0.27920371738274696
18739,703-004-5394,7446.556,6,2,4,0.6780088845122243
1882,207-008-2398,7386.3984,2,2,0,1.6590938774574389
19147,207-008-2399,1776.5325,5,1,4,0.3807252912866403
19262,703-004-5395,5270.408,5,2,3,1.189105381517574
1932,703-004-5382,6018.0957,4,0,4,0.27920371738274696
19395,703-004-5381,8303.67,8,3,5,1.280408863401402
19627,703-004-5383,7332.5522,2,1,1,0.3640890016146154
2017,703-004-5381,4826.3433,7,2,5,0.6918040858233129
20230,703-004-5393,3183.289,6,1,5,0.457429047283995
20420,703-004-5399,3209.753,8,3,5,0.5956345970831936
20563,703-004-5395,4240.5654,1,0,1,0.27920371738274696
20687,703-004-5385,286.88907,2,2,0,0.6123072115533653
20689,703-004-5397,4718.9844,5,3,2,1.0620166435544
20853,703-004-5383,297.79196,5,3,2,1.646342830843028
20936,703-004-5392,3166.817,4,3,1,1.0725208862514894
21040,703-004-5394,5615.062,2,1,1,0.486192164746489
21183,207-008-2399,7599.541,4,3,1,0.7537511522835104
21186,703-004-5397,7264.697,3,0,3,0.27920371738274696
21323,703-004-5396,5576.081,5,2,3,0.526886456873632
21565,703-004-5398,6520.1807,5,2,3,0.8344364969039146
21712,703-004-5382,1988.6792,1,1,0,0.35139163077119506
21808,703-004-5382,2896.9072,5,3,2,1.2387516975281572
22545,703-004-5397,9075.174,4,3,1,1.3458294735459508
22761,703-004-5384,739.54224,5,4,1,1.9816126966533567
23132,703-004-5388,202.70705,5,2,3,1.240582830206297
23222,703-004-5380,9548.187,4,2,2,0.8844826413316352
23254,703-004-5399,1871.9923,2,0,2,0.27920371738274696
23306,703-004-5393,3064.8286,2,0,2,0.27920371738274696
23332,703-004-5381,6211.111,1,0,1,0.27920371738274696
23451,703-004-5394,2336.6697,4,2,2,0.668964863474487
24044,703-004-5399,8686.126,"","","",0.27920371738274696
24411,703-004-5399,113.34538,6,1,5,0.7286278551996119
24442,207-008-2399,8926.079,3,1,2,0.5165268771580819
24467,703-004-5380,1516.8262,6,2,4,1.7475899207504622
24548,703-004-5386,8607.219,1,0,1,0.27920371738274696
24622,703-004-5395,7188.991,2,1,1,0.35831143730785864
2478,703-004-5382,3680.0205,4,1,3,0.6588967306148479
25258,703-004-5383,5379.8843,1,1,0,0.8393764391265661
25441,703-004-5397,2236.8909,3,1,2,0.32666834933781397
25601,703-004-5398,2296.6128,6,3,3,1.527109449597711
2576,703-004-5384,5297.581,5,0,5,0.27920371738274696
25793,703-004-5387,6387.269,3,1,2,0.5386119757815407
25989,703-004-5394,9832.37,2,1,1,0.35831143730785864
26073,703-004-5381,3924.9795,3,1,2,0.5397659665953036
26100,703-004-5385,8760.665,4,1,3,0.3384747645172622
26156,703-004-5382,2874.3308,5,4,1,1.3920695949041983
26644,207-008-2398,4166.9614,6,2,4,0.8185091856792991
26830,703-004-5385,6762.2925,4,1,3,0.5210965537999314
26945,703-004-5393,2508.5693,3,2,1,1.1033963547543075
2708,703-004-5380,4319.234,6,2,4,0.6878339431929259
27129,703-004-5387,7059.012,4,3,1,1.2470122116023663
2749,703-004-5396,9094.755,1,1,0,0.8603379370242467
28074,207-008-2398,253.28815,2,1,1,0.5940211406344426
28446,703-004-5393,168.7479,5,1,4,1.4232589169815515
28816,703-004-5381,5956.2446,6,2,4,0.8393644380746091
29221,207-008-2399,3965.2659,3,1,2,1.110384789452262
29305,703-004-5395,7344.751,6,1,5,0.7542561482146722
29435,703-004-5394,6190.741,3,0,3,0.27920371738274696
29765,703-004-5388,7436.7188,4,4,0,2.539697700284775
30019,703-004-5391,4462.0337,5,5,0,2.8580536259450695
30057,703-004-5394,6654.447,3,2,1,0.49132278699307896
30126,703-004-5384,8438.49,6,2,4,0.8298006608701165
30154,207-008-2398,4993.9146,3,2,1,1.9968862203140416
30188,703-004-5385,2376.3286,4,3,1,0.7455270140626019
30366,703-004-5384,4020.5574,6,2,4,0.861641420286856
30496,703-004-5392,5258.9995,3,2,1,1.3650281941688722
30502,703-004-5382,491.07135,5,1,4,0.6472330946727298
30528,703-004-5382,4479.46,6,5,1,3.879898172370122
30570,703-004-5399,2916.478,6,5,1,3.8375995731489647
31610,703-004-5383,9676.871,3,1,2,1.0625833466087071
31676,703-004-5392,1975.1185,5,3,2,1.1518023859310775
31694,703-004-5394,6555.232,7,2,5,0.8799943358017174
32037,703-004-5399,5738.8896,4,3,1,2.506518854178153
32097,703-004-5389,5618.915,4,3,1,0.7735395501373816
32505,703-004-5388,5223.518,4,1,3,1.3178702092114256
32643,703-004-5398,5087.3027,3,3,0,1.143636323301054
32745,703-004-5380,3724.2424,4,2,2,0.9355186073108716
32885,703-004-5393,2802.85,6,3,3,1.2687308721030865
32985,703-004-5398,9861.084,6,3,3,1.8839900471320423
33402,703-004-5384,6837.1484,6,3,3,1.2440922479941647
33537,703-004-5392,6051.462,5,4,1,1.2750742565411988
33557,703-004-5398,3360.2441,4,3,1,1.0124082189936163
33567,207-008-2399,788.371,2,1,1,0.696296492561963
3379,703-004-5396,3072.5974,7,5,2,1.7036529150602782
33799,703-004-5394,596.59064,3,3,0,0.8813760543657603
33909,703-004-5392,7666.4956,3,1,2,0.35831143730785864
33945,703-004-5382,2355.6804,7,3,4,1.2844139478614776
34159,207-008-2398,2993.6748,5,3,2,1.1072466653491004
34281,703-004-5388,5424.3726,6,2,4,0.6580863879585508
3429,703-004-5389,9424.829,3,2,1,0.8506351927073775
34296,703-004-5390,482.25046,2,0,2,0.27920371738274696
3447,703-004-5393,4038.0818,2,0,2,0.27920371738274696
3452,703-004-5389,372.78415,3,2,1,0.7905848239312628
34996,703-004-5394,2598.0842,6,1,5,0.5796630948747451
35020,703-004-5382,1851.9354,6,1,5,0.5165268771580819
35296,207-008-2398,5393.9224,6,3,3,1.3050709146119623
35489,703-004-5396,5410.5557,"","","",0.27920371738274696
35531,703-004-5383,1635.7863,7,4,3,0.744024589799364
35759,207-008-2398,3018.3245,5,4,1,1.7503521340111043
36079,703-004-5380,8676.786,9,4,5,2.447135415963007
36317,703-004-5394,5403.6016,5,0,5,0.27920371738274696
36788,703-004-5390,4306.3677,6,2,4,1.480614275517028
36915,703-004-5384,8027.5146,1,0,1,0.27920371738274696
37360,703-004-5399,9918.16,2,2,0,0.8135347309190717
37462,703-004-5398,5010.862,5,3,2,1.8804234745396031
37637,703-004-5391,3419.823,2,1,1,0.3978652972704144
37895,703-004-5398,9465.814,5,2,3,0.8640856718522113
37981,703-004-5380,941.7331,2,2,0,0.9925417176020779
38055,703-004-5389,7349.3774,4,2,2,0.7185504838341892
3807,207-008-2399,2562.6301,7,5,2,2.2442903070990936
38148,703-004-5396,1514.6881,3,1,2,1.00965574425611
38415,703-004-5384,8239.723,6,1,5,0.33853450732658075
38948,703-004-5382,3423.726,1,1,0,0.3978652972704144
39030,703-004-5399,5334.2017,4,2,2,0.5502246281655276
39197,703-004-5388,5975.406,1,0,1,0.27920371738274696
39340,703-004-5381,3456.5818,5,2,3,0.6694526397082431
39789,703-004-5395,1143.8274,4,2,2,0.5087584743402734
39801,703-004-5387,8667.941,6,3,3,1.004436926317194
40048,703-004-5393,3727.696,2,1,1,0.3486207416170325
40363,703-004-5382,1299.3597,4,3,1,0.84492668414569
41349,703-004-5389,6813.107,10,6,4,2.1847096468666973
41441,703-004-5397,6780.966,6,3,3,0.859585246193244
41529,703-004-5382,2760.542,"","","",0.27920371738274696
42064,703-004-5388,4940.084,3,2,1,1.04121341469634
42135,703-004-5381,6884.6094,6,3,3,1.1583369760497226
42140,703-004-5390,1862.6284,1,1,0,0.6155815208441436
42264,703-004-5395,5177.906,2,2,0,0.9187061447254415
42307,703-004-5381,6203.8623,1,1,0,0.636515214556139
42392,703-004-5398,8922.526,4,2,2,1.6219949063090848
42705,207-008-2399,5627.1743,2,0,2,0.27920371738274696
42777,703-004-5385,7651.025,8,4,4,1.137249369456919
43144,703-004-5388,1695.9613,3,1,2,1.0411638234439837
43343,703-004-5390,6356.6846,6,2,4,0.6068383090339019
43651,703-004-5383,5336.463,4,4,0,1.4669537320013617
43835,703-004-5388,6614.5527,5,3,2,1.2468097300203713
43865,703-004-5393,8301.619,6,1,5,0.4577526654616318
43906,703-004-5380,4893.85,4,2,2,0.6591740880197737
44310,703-004-5391,2737.713,2,1,1,0.399459200229709
44627,703-004-5395,8626.184,2,1,1,0.7436894237346247
44635,703-004-5384,8498.865,5,2,3,1.3556590630959682
45291,703-004-5389,3123.9795,7,4,3,1.0844957365324075
45494,703-004-5391,5382.4263,7,2,5,0.46906395647716903
45617,703-004-5390,467.82495,4,2,2,0.6054023907791843
45620,703-004-5390,8164.329,4,1,3,0.8260534766458504
45662,703-004-5391,5236.846,2,1,1,0.8298989797486579
45791,703-004-5391,6977.0566,9,6,3,2.401378304272344
45831,703-004-5386,167.28879,6,3,3,0.776951674506975
4613,703-004-5390,2943.7173,4,1,3,0.42555299924420353
46172,703-004-5394,7174.3745,3,1,2,2.565418203876954
46443,703-004-5382,23.531914,6,2,4,0.6856196284980081
46530,703-004-5389,9395.191,2,1,1,0.5522809584332996
46642,703-004-5398,6697.4263,5,1,4,0.7337027832461286
46746,703-004-5398,4627.9805,1,0,1,0.27920371738274696
46762,703-004-5389,6965.959,3,2,1,1.2377988394122725
4698,703-004-5386,1748.7877,4,1,3,0.35831143730785864
47002,703-004-5397,8593.951,4,1,3,0.9103483243165091
4701,703-004-5395,8770.041,5,1,4,0.45836250135983825
47258,703-004-5381,3722.5454,2,1,1,0.33473733677017536
47278,703-004-5393,9278.336,4,2,2,0.5485245951312265
47512,703-004-5397,2309.606,8,4,4,2.4035162175938436
48041,703-004-5394,1165.4961,4,2,2,0.42604742249373545
48412,703-004-5382,9175.39,4,3,1,1.9157817594507833
48517,207-008-2398,8428.116,4,1,3,0.4728463298109771
48814,703-004-5395,3519.8499,1,0,1,0.27920371738274696
49048,703-004-5386,5445.937,5,3,2,1.8368339742347575
49058,703-004-5394,2424.2913,1,1,0,0.5862479716908295
49643,703-004-5385,9950.264,4,3,1,2.207628712487603
49672,703-004-5396,9747.294,2,1,1,1.2386693256790764
5210,703-004-5382,9068.202,1,0,1,0.27920371738274696
5632,703-004-5392,1984.9539,5,4,1,1.0186227592385302
5653,703-004-5390,9059.611,4,2,2,1.489176828492818
5744,703-004-5397,820.7518,6,2,4,1.1581303670488894
5972,207-008-2399,2878.4954,3,1,2,0.3971434393260978
6021,703-004-5394,6664.567,1,1,0,0.3978652972704144
6384,703-004-5388,4341.481,5,3,2,1.5736604346648069
695,703-004-5393,5330.7305,2,1,1,0.3978652972704144
7166,703-004-5392,7053.9956,2,1,1,0.35831143730785864
7540,703-004-5381,6535.637,6,6,0,2.298890634927064
7637,703-004-5390,1997.1824,3,1,2,0.5228487997453142
7805,207-008-2398,7181.2188,7,5,2,0.8561449845711834
7921,703-004-5398,4710.8584,4,2,2,0.6413301998355284
7945,703-004-5383,9359.067,2,1,1,0.35831143730785864
8,703-004-5394,9919.29,3,3,0,2.0730485347105643
8017,703-004-5385,525.0579,3,2,1,0.42431383802588374
8126,207-008-2398,2371.4834,5,3,2,1.4959919617585453
8172,703-004-5384,7897.9795,4,1,3,0.48021440096802825
8284,703-004-5387,1735.3684,2,1,1,0.9964633923280332
8394,703-004-5397,3472.2168,4,2,2,1.41415145668478
8425,703-004-5389,3429.4785,3,3,0,1.2772875440517044
8756,703-004-5382,6808.5034,2,0,2,0.27920371738274696
9035,703-004-5385,7404.451,"","","",0.27920371738274696
9110,703-004-5384,6673.0005,4,3,1,1.1082817910207523
9550,703-004-5384,357.01932,5,2,3,0.6610593201665526
9796,703-004-5395,4497.0483,2,2,0,0.702832346214076
10337,703-004-5382,6204.247,4,3,1,0.7643366247018336
10464,703-004-5387,1025.3853,4,1,3,1.479216304715499
10906,703-004-5391,6819.758,3,1,2,2.425142795715
10926,703-004-5388,4566.24,3,0,3,0.27920371738274696
1117,703-004-5392,6324.3413,5,2,3,0.5759151839203774
11239,207-008-2399,5773.789,6,4,2,2.0772623026507944
11350,703-004-5394,4357.8647,2,2,0,0.6721346463863987
11824,703-004-5388,3397.6365,2,0,2,0.27920371738274696
11866,703-004-5399,7162.095,3,2,1,1.0433949048946218
12188,703-004-5396,5278.0513,6,6,0,1.617043316839605
1227,703-004-5395,9624.335,3,3,0,1.801280128327232
12276,207-008-2399,8027.8613,7,3,4,1.172335564021394
12338,703-004-5382,8938.173,1,1,0,0.3716021436362243
12371,703-004-5395,454.6994,6,3,3,2.3192674850619435
12397,703-004-5387,179.56137,5,4,1,2.157186789835469
12409,703-004-5396,8216.837,5,4,1,1.4973131151036794
12533,703-004-5381,8112.9087,4,3,1,2.209293538689018
12782,703-004-5397,2089.0403,2,1,1,0.35831143730785864
13021,703-004-5396,1774.7725,3,0,3,0.27920371738274696
13258,703-004-5390,1130.0999,1,1,0,0.45144421434081833
13313,703-004-5382,5356.946,2,1,1,0.5357336135268371
13350,703-004-5398,4201.309,5,4,1,3.8918448308968645
13539,703-004-5399,5876.3438,2,1,1,0.5866833385727374
13605,703-004-5383,8910.672,1,1,0,0.5968881851571362
13764,703-004-5389,4994.3667,2,1,1,0.4452384677818655
13956,703-004-5392,7359.8,5,1,4,0.4758601971383323
1407,703-004-5398,560.59064,3,2,1,1.6246380774434872
14130,703-004-5396,4291.914,7,2,5,1.263298842883483
14272,703-004-5383,8668.304,7,2,5,1.700618774293242
14736,703-004-5399,1128.8792,3,2,1,1.1069958525196586
14891,703-004-5386,5798.777,9,5,4,3.4581604678969056
15314,703-004-5398,2616.7112,"","","",0.27920371738274696
15569,703-004-5384,8863.677,3,2,1,0.5603213298466435
15654,703-004-5394,8344.039,6,4,2,0.9259506718409704
15738,703-004-5392,9731.125,6,2,4,1.5592988101800587
16212,703-004-5382,1978.687,3,3,0,1.1804033135159704
16258,703-004-5388,7843.5986,4,3,1,0.9797043153746607
16294,703-004-5395,518.5658,3,1,2,0.32666834933781397
16325,703-004-5394,2721.2888,2,1,1,1.2375258138171437
16802,703-004-5385,1939.804,2,1,1,0.44032118823007727
16853,703-004-5391,6850.3477,8,3,5,1.121607609745465
16913,703-004-5384,9112.393,5,3,2,0.9002885200285409
17313,703-004-5390,2533.133,5,3,2,0.9766216035468331
17314,703-004-5392,2224.2654,3,2,1,1.1708775268099874
1737,703-004-5398,1206.7974,4,1,3,0.967905962471814
17377,703-004-5383,5443.4814,5,4,1,1.006508446935624
17552,703-004-5399,4598.61,1,1,0,1.4601007857855504
1764,703-004-5384,8570.876,5,0,5,0.27920371738274696
17683,703-004-5392,9573.696,8,3,5,0.8172968293706483
17908,703-004-5398,1283.8262,2,0,2,0.27920371738274696
18058,703-004-5385,9609.469,4,2,2,0.5884654599649802
18065,207-008-2399,5013.9653,5,1,4,0.6686400509980844
18077,703-004-5381,4188.263,10,6,4,2.0243313969225154
18084,703-004-5399,3844.0703,1,1,0,0.5165268771580819
1821,207-008-2399,3949.386,4,2,2,1.333522499482409
18542,703-004-5385,2108.4248,6,1,5,0.35831143730785864
18642,703-004-5380,1830.557,6,4,2,3.972221090291466
18894,703-004-5393,7649.549,4,2,2,0.696713087629565
19041,703-004-5391,4607.23,7,4,3,0.7099615309811919
19102,703-004-5395,9970.173,1,0,1,0.27920371738274696
19160,703-004-5398,5441.9785,3,2,1,0.7913751005757884
19273,703-004-5394,5925.306,5,4,1,0.6782232881230025
19547,703-004-5381,5503.634,2,2,0,0.7113358492555306
19575,703-004-5399,6267.9995,4,2,2,0.9389109424566827
19596,703-004-5397,2355.861,2,1,1,0.5165268771580819
19652,703-004-5397,3963.169,4,4,0,3.1350980627318417
19677,703-004-5385,8027.8184,3,3,0,2.1255483996103925
19682,703-004-5397,1128.258,4,2,2,1.499824205150017
1977,207-008-2399,8816.209,5,3,2,0.8843777748098511
19842,703-004-5383,4634.262,7,5,2,1.9431040309555885
20224,207-008-2399,2505.3013,4,1,3,0.4675454886211377
20321,703-004-5391,404.42526,3,2,1,1.243873440851926
20344,703-004-5398,1674.3362,7,4,3,1.595991970099153
20432,703-004-5381,9045.238,4,1,3,0.7047567401216915
20478,703-004-5393,7970.3647,8,3,5,0.8473405076508168
20624,703-004-5389,6916.4536,5,3,2,2.2479954139876672
20974,703-004-5386,2054.9453,4,3,1,1.1385300249665553
21060,703-004-5384,1918.8177,1,0,1,0.27920371738274696
21111,703-004-5389,8706.987,5,3,2,0.9300038473233055
21149,703-004-5384,8276.437,7,2,5,2.4017990661371953
21209,703-004-5389,2294.7234,3,3,0,1.9434358564446437
21429,703-004-5398,3381.1855,3,0,3,0.27920371738274696
21543,703-004-5394,5355.894,3,2,1,0.4591078571124384
21994,703-004-5396,8525.991,7,3,4,0.8054494605104557
22059,207-008-2399,2359.7915,3,2,1,1.3560279476832615
2211,703-004-5382,3418.5225,5,2,3,1.9326902326273996
22260,703-004-5382,8480.426,3,1,2,0.5237393215685373
22320,703-004-5392,348.93393,3,1,2,0.5469399430621418
22337,703-004-5388,2536.6926,2,2,0,1.8633856648572305
22341,703-004-5386,5565.005,1,1,0,0.35831143730785864
22358,703-004-5393,5891.286,3,2,1,0.5308527908132701
22392,703-004-5392,4649.111,2,2,0,0.8453173830624936
23220,703-004-5385,5676.2812,1,0,1,0.27920371738274696
23401,703-004-5388,2497.9531,3,1,2,0.9770206986844687
23859,703-004-5392,9031.902,5,3,2,0.9872975806079617
2454,703-004-5395,3905.8506,4,2,2,1.1326153978661746
24665,703-004-5389,8848.363,5,1,4,0.3978652972704144
24724,703-004-5392,1227.1947,3,0,3,0.27920371738274696
25244,703-004-5387,2197.8552,6,1,5,0.7063767848463341
25272,703-004-5384,7323.117,6,4,2,2.386904319142986
25503,703-004-5395,3316.1074,7,3,4,0.7990588628124943
25570,703-004-5390,1253.6204,4,1,3,0.5570898287358543
2561,703-004-5399,4181.8164,4,2,2,0.4512630082198648
25696,703-004-5393,7050.731,7,3,4,0.8706870384076311
25874,703-004-5385,7869.8687,2,2,0,0.3978652972704144
25925,703-004-5393,9996.882,3,1,2,0.3978652972704144
25947,703-004-5392,307.2274,1,0,1,0.27920371738274696
26021,703-004-5382,3716.7173,1,0,1,0.27920371738274696
26098,703-004-5396,5244.388,2,0,2,0.27920371738274696
26202,703-004-5395,7984.7456,3,0,3,0.27920371738274696
26565,703-004-5398,256.98245,2,1,1,1.0153584561587923
26729,703-004-5382,9224.344,3,1,2,0.5238612918773475
26938,703-004-5394,9725.878,6,4,2,2.0452473836109353
27044,703-004-5380,8329.147,3,1,2,0.541060493593161
27189,703-004-5389,5650.8857,8,3,5,0.9562294596109867
27258,703-004-5381,3679.5796,4,2,2,0.6905354456121607
27441,703-004-5385,6743.5864,5,3,2,0.9956495049514161
27530,703-004-5384,6058.816,4,1,3,0.32666834933781397
27695,703-004-5397,2472.5188,3,1,2,0.8568496303699549
27866,703-004-5399,880.26526,3,1,2,0.5319744974674097
28098,703-004-5392,6824.4214,5,2,3,0.6110133843338036
28143,703-004-5396,2873.4707,6,4,2,1.4516225646684864
2816,703-004-5388,7517.533,3,2,1,1.254113345140747
28164,703-004-5382,2167.263,6,4,2,1.4503141238231263
28468,703-004-5392,4065.4211,3,2,1,0.49189731507772755
28489,703-004-5386,788.37933,7,5,2,1.2585122939941744
28755,703-004-5385,8077.1465,2,2,0,0.7695787364399194
2882,703-004-5392,9264.113,4,1,3,0.4008021713726342
29350,703-004-5384,8579.26,1,1,0,0.344918747536162
2975,703-004-5395,3184.3687,3,2,1,1.0039732144926938
29973,703-004-5389,3346.3567,3,1,2,0.5582704728699271
30083,703-004-5384,768.1572,1,0,1,0.27920371738274696
30203,703-004-5387,8062.5864,3,2,1,1.0505340584290441
30307,703-004-5388,7254.2866,1,1,0,0.3807252912866403
30400,703-004-5380,3081.7747,9,2,7,0.7628458447578638
30599,703-004-5389,602.7484,5,3,2,1.4856861547889006
3063,703-004-5386,673.0962,2,2,0,0.610256044380288
30632,703-004-5385,207.24834,5,3,2,2.1457481586804197
31074,703-004-5391,256.84833,2,2,0,1.3264671608302938
31304,703-004-5383,1781.4636,4,3,1,1.897033666088691
31513,703-004-5388,2109.6636,6,3,3,2.1883344623080023
31757,703-004-5384,5916.6367,2,1,1,0.6525500798141469
31840,703-004-5398,6963.911,5,4,1,1.352793176284462
31948,703-004-5380,2391.1936,4,2,2,1.0513530097674888
32111,703-004-5387,2123.0955,1,1,0,0.4845095980121125
32128,703-004-5399,83.20868,7,4,3,1.8675395699438064
32366,703-004-5393,3972.4863,1,0,1,0.27920371738274696
32388,207-008-2399,6791.9927,3,2,1,1.3845732075830863
32413,703-004-5393,1052.1567,4,2,2,0.6344308371658768
32461,703-004-5384,1349.5762,8,7,1,2.6147059387828473
32670,703-004-5383,6373.784,1,0,1,0.27920371738274696
33267,703-004-5399,3283.2378,2,1,1,0.3367545836282657
33312,207-008-2398,4818.3833,3,2,1,1.058566133713213
33473,703-004-5380,7194.455,4,3,1,3.5998966045428142
33902,703-004-5396,2911.9963,5,3,2,1.6494884989880236
3391,207-008-2398,7066.8804,4,3,1,0.9314328560135372
34036,703-004-5394,656.0046,3,0,3,0.27920371738274696
34338,703-004-5398,6286.773,1,0,1,0.27920371738274696
34484,703-004-5381,1592.8573,2,0,2,0.27920371738274696
34852,207-008-2399,6604.439,4,2,2,0.6894222669772104
34959,703-004-5384,7456.544,2,2,0,0.9744042708226518
34967,703-004-5393,7629.1807,5,4,1,3.5437144906330076
35149,703-004-5394,3168.7314,2,1,1,0.5165268771580819
35162,703-004-5395,2055.1794,3,2,1,0.8810222687974917
35186,703-004-5385,4335.087,6,4,2,1.453730267658829
35460,703-004-5384,7661.546,4,2,2,0.7648531845285663
35500,703-004-5387,2561.2808,1,1,0,0.5130164720864051
35665,703-004-5398,8261.494,4,2,2,3.1527870354806975
35748,703-004-5392,2782.9893,3,1,2,0.6261762255836508
3577,703-004-5380,2677.7327,3,1,2,0.8000534142786091
36386,703-004-5385,555.6023,7,2,5,0.5687533755061697
36619,703-004-5398,4266.929,3,2,1,2.8176060615062646
36698,703-004-5396,909.68964,3,0,3,0.27920371738274696
36820,703-004-5392,6722.1323,2,1,1,0.3804904402431126
37222,703-004-5380,1778.1758,9,5,4,1.6244129457770258
3723,703-004-5394,5932.0034,5,2,3,0.5375488856562005
37284,703-004-5385,8768.404,5,2,3,0.5630942689581822
37459,703-004-5381,5322.992,3,2,1,1.011408543465034
37909,703-004-5385,2339.8877,1,0,1,0.27920371738274696
38098,703-004-5388,5854.5215,3,0,3,0.27920371738274696
38124,703-004-5380,876.28424,4,3,1,0.7637258867491789
38207,703-004-5395,5206.9585,1,0,1,0.27920371738274696
38239,703-004-5397,3570.8667,2,0,2,0.27920371738274696
38562,703-004-5394,3644.8813,7,2,5,1.9072534487291406
38704,207-008-2398,4428.6763,7,2,5,0.4963001824498312
38888,703-004-5388,1355.1205,5,2,3,0.6482760758858546
39037,703-004-5382,5638.2476,3,2,1,0.5048917908646791
39048,703-004-5389,8689.969,4,3,1,0.6208501828093229
39195,703-004-5382,2711.2996,3,2,1,0.48736814881491763
39549,703-004-5380,8138.2773,4,1,3,0.9344290043910124
39680,703-004-5389,4339.5195,6,3,3,2.989876524724764
39927,703-004-5388,9965.006,5,2,3,1.4792160973771558
40031,703-004-5389,7918.297,5,2,3,1.9533721111615512
40160,703-004-5399,800.49695,5,3,2,0.8442244530306618
4020,703-004-5391,2595.5498,4,1,3,0.42233443460076847
40485,703-004-5391,246.52184,7,4,3,1.9827083184212109
40635,703-004-5388,9369.519,3,2,1,0.8487749092330292
40890,703-004-5397,5342.521,3,2,1,0.9161727058983838
40980,207-008-2399,6888.208,2,1,1,0.3978652972704144
41016,703-004-5396,9240.852,8,5,3,2.524074978400075
41051,703-004-5391,3320.9824,4,2,2,1.9022857589465434
41136,703-004-5386,2151.081,3,2,1,0.8553315472505211
41183,703-004-5386,3403.879,5,4,1,2.8333880394403685
41265,703-004-5394,8009.6816,6,2,4,1.28770544960357
41324,703-004-5394,9672.788,3,1,2,1.2513884013349972
42476,703-004-5383,4323.9653,4,3,1,1.113406412514881
43081,703-004-5396,3252.8752,5,2,3,0.9777473090891863
43167,703-004-5388,3460.4924,3,2,1,1.1587128634595407
43312,703-004-5397,8341.887,3,3,0,1.347925157172387
43379,703-004-5399,8053.561,5,1,4,0.890684428896823
43395,703-004-5381,5680.047,3,2,1,0.8305506734493434
43518,703-004-5382,5218.66,2,1,1,0.5797445087027244
43559,703-004-5382,34.26194,4,2,2,0.677108243388441
44289,703-004-5388,2237.5227,1,1,0,0.7411770416608182
44739,703-004-5380,941.82196,2,1,1,0.5244682073607914
45307,703-004-5392,9413.511,2,2,0,1.1016420404681748
45805,703-004-5395,7266.224,3,1,2,0.53194175230803
46044,703-004-5380,630.9253,2,1,1,0.48121970228793826
46243,703-004-5387,5120.7334,6,2,4,0.6405897354875432
46509,703-004-5397,9164.9375,1,0,1,0.27920371738274696
46645,703-004-5394,4888.2925,5,4,1,1.983290736814228
46733,703-004-5392,6567.4224,4,3,1,1.3949373451942981
4681,703-004-5397,7961.607,4,1,3,0.6300564518706936
46833,207-008-2398,6922.4204,1,0,1,0.27920371738274696
46854,703-004-5380,8046.486,3,1,2,0.43579441834310556
46894,207-008-2399,8502.439,3,1,2,0.8149248114578344
46926,207-008-2398,8084.36,7,2,5,0.837204782383235
47119,703-004-5380,9651.224,6,4,2,2.065126942369191
47325,703-004-5395,3423.0977,1,1,0,0.9435747917687238
47432,703-004-5393,7854.9365,4,1,3,0.8529851519027998
47564,703-004-5384,252.35355,2,1,1,0.5934987576161668
47571,703-004-5398,4420.218,"","","",0.27920371738274696
47653,703-004-5399,4789.1646,7,2,5,1.5543382173564326
48145,207-008-2399,4505.7153,3,1,2,0.5380220820565085
4819,703-004-5386,3300.547,3,2,1,0.9725313898722687
48228,703-004-5396,9973.848,3,1,2,1.581749569825391
48247,703-004-5394,9570.01,3,3,0,0.9694046236568603
48332,703-004-5387,8260.378,3,1,2,0.47915499100371267
48498,703-004-5393,6166.9434,4,2,2,1.387618983378621
48518,703-004-5391,3003.072,5,2,3,0.6114332803007949
48541,703-004-5397,7108.3647,2,0,2,0.27920371738274696
48721,703-004-5389,1674.0471,3,0,3,0.27920371738274696
4896,703-004-5392,9172.54,4,2,2,0.9351688479141497
49190,703-004-5384,2679.1323,3,1,2,0.5267644966002911
49305,703-004-5385,2052.284,5,3,2,1.7687306710478587
49543,703-004-5391,2944.2578,4,1,3,0.7105643901761731
49633,703-004-5394,8829.461,6,5,1,0.950351977375013
49809,703-004-5389,9878.573,3,3,0,2.4774839989018798
49909,703-004-5380,1271.5739,2,2,0,0.7647730863918031
5204,703-004-5390,5003.5654,3,3,0,0.9977870613247678
5575,207-008-2399,6977.946,8,3,5,1.7430212382493349
5700,703-004-5383,1086.6702,4,4,0,2.395478481462793
5786,703-004-5381,8071.4165,3,2,1,1.1239209778452433
6282,703-004-5387,8285.207,3,1,2,0.6225957121247325
6327,703-004-5391,4945.2935,4,2,2,1.0759538364111805
6754,703-004-5392,1141.4515,4,2,2,1.5808635956644368
7002,703-004-5395,4043.7817,4,1,3,0.518470354236145
7038,703-004-5384,8992.39,5,1,4,0.7087876819594766
7066,703-004-5393,2573.8018,4,3,1,1.8834766314388633
7239,703-004-5388,1772.2368,3,1,2,1.5904046650041181
7523,703-004-5397,9401.54,5,3,2,1.0243908182749772
7877,703-004-5392,8159.215,2,2,0,1.3987805647641083
8330,703-004-5387,1898.867,3,1,2,0.3752948633058228
8446,703-004-5396,2122.2847,7,4,3,1.874585315785093
8579,703-004-5397,9899.861,3,1,2,0.4457749101500602
894,703-004-5386,6613.461,4,1,3,0.8680012228816399
9504,703-004-5397,4568.4023,5,4,1,1.002986762141097
10388,703-004-5396,7441.3823,2,0,2,0.27920371738274696
10450,703-004-5386,5873.5786,1,1,0,0.5659302384144766
1054,703-004-5392,387.07376,2,0,2,0.27920371738274696
10635,703-004-5395,4131.7363,7,1,6,0.3919322182760311
11566,703-004-5381,2308.0688,4,2,2,0.6950598195576297
11634,703-004-5390,4784.976,7,2,5,0.9351245085542376
11695,703-004-5398,1712.8569,7,4,3,1.3540824216210392
11874,703-004-5380,5879.2817,3,0,3,0.27920371738274696
12160,207-008-2398,3925.6965,4,2,2,1.1892896940356021
12419,703-004-5396,2240.6663,2,2,0,0.7752822995919167
12684,703-004-5384,2772.562,6,3,3,0.8611837196219907
1277,703-004-5397,2688.7583,8,3,5,0.806120863153895
12788,703-004-5388,6109.4595,3,2,1,1.4270600145649555
12975,703-004-5381,3566.5823,8,2,6,1.246346969253259
13342,703-004-5392,1539.6029,3,1,2,0.42733319518351554
1345,703-004-5388,4168.489,2,1,1,0.35831143730785864
1367,703-004-5389,6254.349,5,2,3,1.4772630586049869
14072,703-004-5392,6820.7925,4,3,1,0.9716612088364845
14089,703-004-5399,2324.2415,3,2,1,0.7035415218177823
14395,703-004-5397,2928.9497,4,2,2,0.6854795419106405
1452,703-004-5384,7244.159,12,6,6,1.708712384125403
14539,703-004-5380,7455.796,7,3,4,1.257193531779814
15022,207-008-2398,9371.635,2,1,1,0.6878669953375474
15234,703-004-5394,5854.4844,3,0,3,0.27920371738274696
15425,703-004-5393,7873.738,4,1,3,0.9338151074874805
15602,703-004-5398,3738.4993,1,1,0,0.6175989377254907
15625,703-004-5387,6739.74,3,1,2,0.6468189202828276
1563,703-004-5390,7381.7007,1,0,1,0.27920371738274696
15870,703-004-5389,6738.004,2,0,2,0.27920371738274696
1589,703-004-5390,2033.4154,5,2,3,1.2283756735987386
1605,703-004-5382,2209.7927,6,4,2,1.7710126235183417
16075,703-004-5392,9070.755,1,0,1,0.27920371738274696
16204,703-004-5380,3791.1428,3,0,3,0.27920371738274696
16452,703-004-5387,1121.4406,3,1,2,0.33853450732658075
16535,703-004-5392,9706.852,7,6,1,2.703607262047644
16680,703-004-5390,6350.425,5,1,4,0.4582364970796709
16753,207-008-2399,4768.1694,3,1,2,0.87273210167567
16942,703-004-5389,8956.394,9,6,3,2.1320027011124356
17002,703-004-5392,5792.994,4,2,2,0.697273903120649
17384,703-004-5389,234.80058,4,2,2,1.9134936552388762
17421,703-004-5397,1490.4642,"","","",0.27920371738274696
17676,703-004-5390,6083.814,3,1,2,0.7224976708333577
17918,703-004-5393,6402.9453,3,2,1,0.7770269068275996
18028,703-004-5398,9027.7,5,3,2,1.4809427819368035
1814,703-004-5391,7608.966,5,1,4,0.3554845439956296
18303,703-004-5390,9425.475,6,5,1,1.8231605299339741
18480,703-004-5383,8757.244,5,5,0,2.017251223640442
18639,703-004-5382,1453.7269,4,1,3,0.5777987541924637
19122,703-004-5384,7560.814,4,1,3,1.505770611337967
19337,703-004-5397,8659.029,7,4,3,1.3906299142236689
19516,207-008-2398,5679.0913,3,2,1,0.44937665972088836
19552,703-004-5390,5339.853,3,2,1,1.952960682332266
1971,703-004-5392,5614.0127,"","","",0.27920371738274696
19752,703-004-5396,5983.8525,3,1,2,0.686866185403606
19949,703-004-5380,5550.331,5,2,3,1.8674735359314634
20054,703-004-5386,3206.3203,3,1,2,0.3884965200629352
2014,703-004-5387,1604.5547,2,1,1,0.4804273423875632
20191,703-004-5395,8722.482,5,2,3,0.436249022209078
20237,703-004-5386,3956.0789,2,0,2,0.27920371738274696
20520,703-004-5381,6812.0073,3,2,1,0.5933124146859544
20956,703-004-5393,8101.2397,3,1,2,1.2396302503715018
20989,703-004-5386,404.1469,7,3,4,0.6966565005549299
21184,703-004-5384,327.6068,2,0,2,0.27920371738274696
21189,703-004-5398,2109.5537,4,2,2,1.2964919269444872
21290,703-004-5399,7488.0215,2,2,0,1.3022085635413077
21603,703-004-5389,7303.1426,2,2,0,1.272104682658736
21728,703-004-5395,5703.041,6,4,2,2.5609091842245384
21784,207-008-2398,8999.364,7,5,2,1.3266920731490957
21812,703-004-5392,1705.0237,6,4,2,1.2140071251571105
21861,703-004-5385,6307.2417,1,1,0,1.2507302388954464
21940,207-008-2398,1226.2856,3,2,1,0.9017954251972968
21947,703-004-5381,2925.1658,7,3,4,2.915807136254465
22125,703-004-5399,679.35767,4,1,3,0.4927522026899003
22455,703-004-5390,1392.2828,9,4,5,1.5155779151100817
22617,703-004-5394,9077.179,3,2,1,1.6086203681992612
22620,207-008-2398,9109.492,4,2,2,1.6045909093399955
22809,703-004-5398,3627.4136,3,2,1,0.6611641377512003
2309,703-004-5382,8804.094,2,0,2,0.27920371738274696
23123,703-004-5389,5069.891,3,0,3,0.27920371738274696
2323,703-004-5383,9543.88,4,2,2,0.871826587298726
23387,703-004-5397,2186.5808,2,2,0,0.48698179184355117
23614,703-004-5392,9004.06,5,3,2,1.0860495485784876
23638,703-004-5385,3735.397,4,0,4,0.27920371738274696
23777,703-004-5386,787.8303,6,2,4,0.9312255145882825
2380,703-004-5394,1708.6738,1,1,0,1.6926529230921545
24034,703-004-5395,704.4011,2,0,2,0.27920371738274696
24101,703-004-5382,9641.793,1,0,1,0.27920371738274696
24204,703-004-5381,7770.3247,1,0,1,0.27920371738274696
24247,703-004-5394,7951.7544,4,1,3,0.35831143730785864
24263,703-004-5383,5109.3154,4,1,3,0.8378729235809789
24278,703-004-5383,643.6545,10,6,4,3.63984467397314
24454,703-004-5393,5431.502,4,1,3,0.40905069455215637
24508,703-004-5397,5937.3403,4,2,2,1.099768484314169
25189,703-004-5394,2831.9163,2,1,1,0.3978652972704144
25216,703-004-5386,5258.8774,4,3,1,2.2714925411566247
25261,703-004-5383,5704.538,2,1,1,0.7081412596675848
25635,703-004-5389,8562.9795,4,0,4,0.27920371738274696
25705,703-004-5386,1427.6564,2,2,0,2.2091163723590608
25741,703-004-5382,8888.736,5,4,1,1.7778499294881251
258,703-004-5397,4929.105,6,2,4,0.8362191636754116
26062,703-004-5393,4881.0596,4,2,2,0.5583654273833408
26423,703-004-5387,7107.585,2,1,1,0.4505983117495594
26444,703-004-5388,6048.2676,4,2,2,1.4828785838787664
26447,703-004-5395,333.30856,2,2,0,0.642216838285717
26556,703-004-5394,1481.8228,6,4,2,1.5561085993395922
27067,703-004-5399,4833.5396,8,6,2,3.1797931369526835
27349,703-004-5388,3477.146,5,1,4,1.0748994766549098
27534,703-004-5386,2423.8813,3,1,2,0.6558776501809256
27809,703-004-5390,4402.317,4,3,1,1.4881668345451273
28001,703-004-5397,2805.8118,1,0,1,0.27920371738274696
28107,703-004-5397,6251.092,5,3,2,1.3174758906643809
28139,703-004-5396,7191.7476,5,4,1,1.1030302079390912
28230,703-004-5393,5608.942,4,3,1,2.0741625026531723
28482,703-004-5397,2581.187,6,2,4,2.0641905007134804
28896,207-008-2399,9352.5625,5,2,3,0.6110261618818814
29026,703-004-5380,7283.1226,1,1,0,1.4792338176734743
29204,703-004-5385,5457.401,5,2,3,0.9388058145188026
29286,703-004-5380,828.91406,4,1,3,0.4505103002942635
29306,703-004-5398,6864.073,2,0,2,0.27920371738274696
29421,703-004-5382,7185.7417,5,2,3,1.4640730069343555
29803,703-004-5393,8361.726,3,0,3,0.27920371738274696
29956,703-004-5394,6521.926,4,2,2,2.2562013886859194
29967,703-004-5385,8610.258,4,2,2,0.7381520987607775
29986,703-004-5397,9989.653,3,1,2,0.5453446894165154
30104,703-004-5380,4721.956,4,3,1,0.9199321347568634
30236,703-004-5389,8710.717,3,3,0,1.025668412221014
30257,703-004-5395,7483.121,2,1,1,0.4314860782385869
30282,207-008-2399,9848.975,4,2,2,0.6563173364768379
30303,703-004-5390,3426.9548,4,3,1,1.0557144429229797
30353,703-004-5380,5993.971,3,2,1,0.6173892200625992
30962,207-008-2399,818.51184,4,3,1,0.694519246989583
30964,703-004-5397,3117.094,7,2,5,1.023353540824522
31223,703-004-5396,1235.3414,3,3,0,1.5421458451061418
31337,703-004-5395,1046.4781,1,0,1,0.27920371738274696
31446,703-004-5399,5507.0186,6,2,4,0.64483935321606
31628,207-008-2398,8763.653,2,0,2,0.27920371738274696
31651,703-004-5388,6171.9995,1,0,1,0.27920371738274696
31752,703-004-5387,6722.7236,3,2,1,1.2714274651801587
32056,703-004-5392,7940.789,2,1,1,0.7069448195242383
32149,207-008-2399,5159.701,4,2,2,0.8474491241640503
32261,703-004-5382,9814.281,7,5,2,3.422871855998652
32308,703-004-5388,4213.687,4,3,1,1.0688717275448656
32934,703-004-5392,2399.2668,9,5,4,2.022844732422806
33193,703-004-5399,8860.475,3,1,2,0.851831571569684
33272,703-004-5382,2834.1716,4,2,2,1.3798977026603274
33279,703-004-5381,9633.672,8,7,1,2.081158420015719
33736,703-004-5389,7492.584,4,2,2,0.7153311438132174
33855,207-008-2399,2512.3901,2,1,1,0.33561239209256655
33886,207-008-2398,3246.5005,4,3,1,1.9687507524434298
34210,703-004-5396,226.2187,5,1,4,0.3807252912866403
34253,703-004-5398,251.09589,7,4,3,1.2063049593416824
3449,703-004-5392,6592.683,1,0,1,0.27920371738274696
34501,703-004-5382,12.007356,6,4,2,0.7122660909139037
34603,703-004-5380,8385.513,2,1,1,0.4316047395525695
34763,703-004-5398,7884.833,1,1,0,0.49013110751627365
35016,703-004-5380,9124.175,2,1,1,0.5585085470367229
35076,703-004-5396,3402.8447,5,3,2,1.3881532844876285
35137,703-004-5394,2489.7468,1,1,0,0.49009910752858477
35470,703-004-5386,1519.1365,3,0,3,0.27920371738274696
35528,703-004-5389,5224.462,6,3,3,1.0745428073447667
35809,207-008-2399,179.9631,3,0,3,0.27920371738274696
36130,703-004-5384,2458.642,6,2,4,0.7694475361228423
36262,703-004-5385,7367.8745,5,2,3,0.568754215079158
36362,703-004-5380,863.4162,4,1,3,0.4485644971685419
36655,703-004-5388,3448.2515,"","","",0.27920371738274696
37068,703-004-5393,1730.7567,2,1,1,0.4318321745132593
37654,703-004-5386,5328.193,3,1,2,0.4142059856674453
37672,703-004-5397,238.0091,1,1,0,1.3616671376989227
37758,207-008-2399,9564.364,6,3,3,1.8433114581237733
37965,703-004-5396,6175.5503,3,1,2,0.3670132864996209
38185,703-004-5385,3707.3838,1,0,1,0.27920371738274696
38200,703-004-5394,6161.2485,4,1,3,0.35114230018964543
38585,703-004-5392,1168.3882,3,1,2,0.4748937603429675
38597,703-004-5386,5240.3413,4,2,2,0.7390273757390583
38834,703-004-5392,5438.893,2,1,1,0.3292988913822361
39348,703-004-5380,8731.539,2,0,2,0.27920371738274696
39539,703-004-5394,135.11598,3,1,2,0.3649094745402494
39732,703-004-5399,7717.8306,4,3,1,1.2397061611417182
39746,703-004-5390,3370.2273,3,0,3,0.27920371738274696
3981,703-004-5399,9579.223,4,3,1,1.7273381911325127
40171,703-004-5380,9990.189,3,2,1,1.6763861624388123
40314,703-004-5381,6676.5015,5,4,1,1.0647543003353213
40412,703-004-5385,4915.595,1,1,0,0.7772295803208472
40478,703-004-5399,2129.4744,4,1,3,0.6159680663549195
4054,207-008-2399,4770.6187,8,3,5,1.3842152803554366
40677,207-008-2398,1374.4987,5,1,4,0.643303000693275
40832,207-008-2398,4389.0386,4,4,0,1.1966381283963368
41029,703-004-5386,5018.243,2,1,1,0.7291059373845108
4112,703-004-5398,6855.6626,4,2,2,0.8582152709146857
41137,703-004-5398,6544.726,5,0,5,0.27920371738274696
41190,703-004-5390,8518.939,5,1,4,0.4600637420615335
41194,703-004-5384,5827.1797,4,2,2,1.4899161009788815
41913,703-004-5394,1341.983,3,0,3,0.27920371738274696
42069,207-008-2399,8601.115,5,3,2,1.2696397558438233
42077,703-004-5394,9647.853,3,0,3,0.27920371738274696
42101,703-004-5386,1445.5581,4,4,0,1.0343083263417179
42293,703-004-5380,3075.7092,6,2,4,1.96849407413876
42385,703-004-5381,4956.2793,3,2,1,0.7117341010905497
4246,703-004-5398,9211.781,4,4,0,0.9007471342486869
42684,703-004-5381,4845.5645,3,1,2,0.40622105018750443
4271,703-004-5380,4078.4849,3,0,3,0.27920371738274696
43091,703-004-5384,2805.9233,2,1,1,0.4966740013681031
4310,703-004-5389,9868.316,1,1,0,1.090582308930258
43139,703-004-5388,4700.8745,3,1,2,1.3731686775530725
43152,703-004-5399,8575.948,1,0,1,0.27920371738274696
43354,703-004-5392,2988.6414,7,3,4,1.4954283395461727
44217,703-004-5384,882.87054,5,2,3,1.0649641362200217
44869,703-004-5387,2005.8578,1,1,0,0.5751615191665747
45185,703-004-5380,5707.322,3,2,1,1.0101090398211512
45241,703-004-5381,6921.6514,5,2,3,0.556144021267894
45269,703-004-5388,5653.752,4,1,3,0.45895127553910825
45456,703-004-5389,4018.0862,6,0,6,0.27920371738274696
45667,703-004-5381,3844.5793,1,1,0,0.5036392510362666
45676,703-004-5387,2741.3374,5,1,4,0.5402068500584776
46016,703-004-5396,2836.3115,5,1,4,0.38130427662286237
46017,703-004-5392,2858.2651,2,2,0,0.4852110355763212
46367,703-004-5399,5559.352,3,1,2,0.6225522794408087
46533,703-004-5398,3120.4307,5,4,1,1.7664936901131296
47640,703-004-5398,8720.777,4,2,2,0.5681112111827947
47691,703-004-5391,4579.4634,6,2,4,0.5778353601000434
47766,703-004-5398,4157.417,3,3,0,1.7494438688140665
47879,703-004-5386,4056.968,3,3,0,1.7334263650014485
479,703-004-5395,4193.355,4,3,1,1.8920068215201729
48076,703-004-5387,9356.17,4,1,3,0.5304362273978531
48189,703-004-5389,527.41406,4,2,2,1.0358855669190665
48431,703-004-5394,1483.1669,5,4,1,1.0407139764156952
4863,703-004-5397,4468.3574,1,0,1,0.27920371738274696
48827,703-004-5385,9054.531,1,0,1,0.27920371738274696
49056,703-004-5389,8565.386,"","","",0.27920371738274696
49658,703-004-5380,1415.5084,7,4,3,1.0513358952012335
49714,703-004-5381,2194.751,3,1,2,0.4167334004758485
5326,703-004-5397,4566.0674,5,3,2,0.8568208945492849
5346,703-004-5386,2764.641,3,2,1,1.0182001082423662
5421,207-008-2399,9027.697,7,5,2,3.1117298906084354
5464,703-004-5396,9799.261,4,2,2,0.7760181672888705
5550,703-004-5391,5986.3784,2,2,0,1.1788508899681378
5582,703-004-5388,7673.104,1,0,1,0.27920371738274696
5592,703-004-5390,1552.9507,3,1,2,1.0780203856408876
5640,207-008-2399,6899.146,5,2,3,0.7466397356461851
5673,703-004-5392,1171.3904,5,2,3,0.732128251608107
5817,703-004-5381,1126.0021,3,2,1,0.6397784198320526
6101,207-008-2399,3064.7998,5,3,2,4.630170214569457
6243,703-004-5380,7375.8022,5,2,3,0.8542589962528623
6374,703-004-5393,8217.447,2,1,1,0.7178579982380325
6682,703-004-5392,2289.3733,2,2,0,2.7989409477019263
6753,703-004-5390,9153.9,6,3,3,1.4429496363008762
692,703-004-5397,8232.177,6,0,6,0.27920371738274696
7099,703-004-5387,5464.7114,4,1,3,1.356225399914147
7117,703-004-5395,3532.943,3,2,1,0.9923597350250395
7261,703-004-5397,3326.8022,3,2,1,1.0076807812299449
7492,703-004-5392,8210.818,4,1,3,0.4024743451466392
787,703-004-5386,9434.312,2,1,1,0.7923709093879088
796,703-004-5381,6305.703,2,1,1,0.500587495734926
7983,703-004-5398,3679.9443,7,3,4,3.486966146957603
8300,703-004-5395,3676.755,7,4,3,1.1490704347676508
8584,703-004-5394,5570.0864,4,2,2,1.3248820995476287
8585,703-004-5391,1007.0413,9,7,2,4.885135015100869
8732,703-004-5380,3175.096,4,3,1,0.9551841050003841
9156,703-004-5384,3214.1216,2,1,1,0.5453674587225184
951,703-004-5389,7548.9795,2,1,1,0.40656631791996994
9745,703-004-5399,1488.6278,5,4,1,3.0441301516027632
9919,703-004-5385,99.87295,3,2,1,0.989535209450986
1013,703-004-5389,1582.2988,8,3,5,0.5879257784472443
10562,703-004-5391,9187.661,2,0,2,0.27920371738274696
10699,703-004-5385,8176.3296,3,2,1,1.15746416725025
1070,703-004-5396,8760.452,2,1,1,1.4170951733052337
10718,703-004-5394,931.7541,6,4,2,1.7042102562225643
10802,703-004-5382,1122.2219,4,2,2,0.711618817107122
11304,207-008-2399,1944.0692,7,3,4,1.0829829088979461
11632,703-004-5383,2309.7456,5,3,2,1.8846444736201358
11673,703-004-5394,1658.9684,1,1,0,1.1459328614796644
11690,703-004-5396,2957.6338,2,2,0,0.48061991484390054
11973,703-004-5381,3484.4958,2,1,1,0.3804447884964058
12300,207-008-2398,9786.107,1,1,0,0.43675992623359433
12372,703-004-5390,634.56476,6,6,0,3.4522047590738216
12535,703-004-5397,7611.389,1,0,1,0.27920371738274696
12640,703-004-5381,5052.391,1,1,0,0.33853450732658075
13208,703-004-5399,2161.6055,3,2,1,0.63466874651912
13255,703-004-5382,2676.9792,5,4,1,0.9090952245793168
1334,703-004-5398,7234.329,7,3,4,1.002396347267813
13681,703-004-5387,4516.996,2,1,1,0.6256917653896125
14036,207-008-2398,4676.933,2,0,2,0.27920371738274696
1427,703-004-5385,8228.699,4,3,1,0.8469254160043717
14409,703-004-5387,343.06766,2,2,0,1.0102185588143966
1455,207-008-2398,9237.429,4,2,2,0.49949894044420157
14662,703-004-5397,7142.625,4,4,0,1.356102821075012
14693,703-004-5389,1324.8956,4,0,4,0.27920371738274696
15159,703-004-5381,6309.8936,3,2,1,1.6170579542001073
15270,703-004-5385,7236.3633,5,1,4,1.0721136833442577
15312,703-004-5398,7765.5127,3,2,1,0.6546796425165402
15578,703-004-5394,4346.208,"","","",0.27920371738274696
15621,207-008-2398,1401.8756,2,1,1,1.4140150629923824
15884,703-004-5382,4830.5566,1,1,0,0.43696689880159406
16052,703-004-5384,7199.499,1,0,1,0.27920371738274696
16193,703-004-5396,2817.8613,5,2,3,0.7896946323298014
16365,703-004-5381,5212.181,2,1,1,0.4312390307071142
16664,703-004-5395,4731.6562,6,3,3,0.9674996237028886
16876,703-004-5388,5241.1636,6,3,3,3.0523496495677125
16884,703-004-5384,5702.282,8,5,3,1.2135660110040147
16896,703-004-5392,256.68503,5,3,2,1.358770044970934
16992,703-004-5391,2802.0156,3,0,3,0.27920371738274696
17162,703-004-5387,1339.283,1,0,1,0.27920371738274696
1722,703-004-5384,79.96142,2,1,1,1.022130666580307
17290,703-004-5397,9017.266,2,2,0,0.8207682135687299
17393,703-004-5380,1339.7086,9,3,6,1.3278498735607638
17608,703-004-5382,2747.2222,2,1,1,0.6108492290971699
17631,703-004-5394,1521.0682,1,1,0,0.35831143730785864
17727,703-004-5389,7638.0474,1,0,1,0.27920371738274696
17883,703-004-5385,527.50586,3,1,2,1.1488143118563094
18222,703-004-5399,3359.3523,"","","",0.27920371738274696
18293,703-004-5389,8143.3545,1,1,0,0.3978652972704144
18326,207-008-2398,9600.139,4,3,1,0.9250467953564093
18456,703-004-5389,9589.433,2,0,2,0.27920371738274696
18560,703-004-5398,8144.6953,4,2,2,0.9050493166363721
18742,703-004-5389,7689.712,1,0,1,0.27920371738274696
18763,703-004-5394,8974.378,3,2,1,0.6460657685354522
1888,703-004-5394,8429.289,8,5,3,2.0777160684403535
19212,703-004-5386,3551.9521,3,1,2,0.5100002114327952
19521,703-004-5392,1030.6096,8,5,3,1.4955316051827487
19839,703-004-5392,1603.0216,6,1,5,0.42161534083243113
19859,207-008-2399,9021.136,2,0,2,0.27920371738274696
19944,703-004-5382,8695.987,7,2,5,2.92116276550421
20060,703-004-5387,6763.652,8,1,7,0.4153301805310686
20209,703-004-5391,6300.316,8,4,4,2.14949813664812
20412,703-004-5386,9097.343,6,3,3,0.7942461981096725
20449,703-004-5383,8618.721,1,0,1,0.27920371738274696
21132,703-004-5393,8155.6416,1,0,1,0.27920371738274696
21268,703-004-5388,2317.688,6,4,2,0.995051013400103
21389,703-004-5392,8977.323,6,4,2,1.6119776469424258
21532,703-004-5380,3939.5166,3,0,3,0.27920371738274696
21599,703-004-5389,4657.527,1,1,0,0.4987276401749318
21658,703-004-5389,2015.956,4,3,1,1.037751886926251
21756,703-004-5389,3664.5847,3,1,2,0.4569606319137206
21829,703-004-5381,1072.8062,"","","",0.27920371738274696
22085,703-004-5396,9494.757,6,5,1,2.2706937549574726
2231,703-004-5390,4824.3027,6,4,2,1.606239922358419
22500,703-004-5386,7267.58,2,1,1,0.4262028126578741
22541,703-004-5382,3486.6487,2,0,2,0.27920371738274696
22589,703-004-5380,7839.464,7,2,5,1.145284469413901
22796,703-004-5393,516.4605,2,1,1,0.5592168047758151
2282,703-004-5390,9846.989,1,1,0,0.3978652972704144
22843,703-004-5381,3696.5918,4,1,3,0.722241576739426
22957,703-004-5380,1413.2244,6,3,3,1.498469682029068
23660,703-004-5393,9424.6875,8,4,4,2.883018050053733
23715,703-004-5382,3207.1453,4,2,2,1.0213075025711427
23849,703-004-5391,4981.4443,2,1,1,0.40868873379339227
23945,703-004-5397,9080.43,3,2,1,0.524201611605001
24081,703-004-5392,2684.4167,6,3,3,1.0807072295811906
24379,703-004-5391,3119.836,8,5,3,1.3139320170154805
24711,703-004-5384,4913.693,5,3,2,0.8291884177278042
24891,703-004-5386,5986.1577,3,1,2,0.7086316539301796
25051,703-004-5391,1169.4199,2,1,1,0.7187498871800486
25459,703-004-5383,3916.0347,3,3,0,1.942097760501632
25473,703-004-5380,240.2234,4,3,1,0.6459640455856581
25698,207-008-2398,8662.115,2,1,1,0.6393045879086031
26004,703-004-5394,3191.7996,8,6,2,2.5196912509155323
26374,703-004-5390,2267.3477,5,3,2,1.268634751084748
26412,207-008-2398,2897.396,2,1,1,0.4738132748320325
26419,703-004-5391,2113.313,4,1,3,0.5420598218159397
26491,703-004-5382,8657.622,4,2,2,0.6665428259068659
26569,703-004-5390,5278.228,2,0,2,0.27920371738274696
26652,703-004-5389,4806.843,4,3,1,2.2776371606207277
26744,703-004-5396,9840.053,3,1,2,0.45165854681949036
26757,703-004-5382,7845.0083,3,1,2,0.32666834933781397
26809,703-004-5393,9360.795,6,4,2,1.0122503646401375
27305,703-004-5393,7636.9814,6,4,2,1.4902870131725925
2752,703-004-5393,4147.549,4,3,1,1.1890564586474779
27578,703-004-5383,799.69464,3,2,1,1.490831351130458
27622,703-004-5383,6329.758,3,2,1,0.8628915599539551
2773,703-004-5382,7969.9346,4,3,1,1.0598069702970043
27877,207-008-2399,5137.074,6,2,4,0.7746672822315974
27924,207-008-2399,123.87812,3,2,1,1.1433939727305047
2814,703-004-5390,6369.631,4,1,3,0.4410119661795691
28202,703-004-5387,5022.002,4,2,2,2.3796691742444227
28356,703-004-5383,2981.1204,5,0,5,0.27920371738274696
28425,703-004-5380,40.218235,4,2,2,0.9848276079288514
28465,703-004-5387,3684.4033,3,1,2,0.8781865105714166
28501,703-004-5392,8448.886,2,1,1,0.805605910666355
28515,703-004-5396,2414.4841,5,1,4,0.3978652972704144
28734,703-004-5398,149.61064,3,2,1,1.0348728286040136
28758,703-004-5397,537.5588,2,0,2,0.27920371738274696
28822,703-004-5390,2838.183,4,2,2,0.7230515474793852
28904,207-008-2399,1019.08746,4,0,4,0.27920371738274696
2903,207-008-2399,9953.65,5,2,3,0.5391331299393591
29246,703-004-5384,767.68994,4,2,2,0.8096789039357747
29344,703-004-5383,8271.138,7,3,4,1.6972224973808274
29550,703-004-5396,6083.7383,2,1,1,0.7799526286620903
29754,207-008-2399,4889.2754,3,1,2,1.8813498434357347
2991,703-004-5390,2988.022,7,2,5,1.7102540313894756
30117,703-004-5382,3032.688,1,0,1,0.27920371738274696
30147,703-004-5386,1659.5131,2,2,0,0.6668368499631349
30199,703-004-5389,8033.552,2,2,0,0.8740021952983336
30251,703-004-5387,7013.5986,6,4,2,1.7617319794993338
30494,703-004-5397,8993.1455,3,3,0,0.8822416138190361
30609,703-004-5395,9485.711,3,3,0,2.42717498697537
30792,703-004-5381,8032.845,1,1,0,0.5008525785970608
3084,703-004-5386,8862.254,2,2,0,1.6100516277874266
3105,207-008-2398,2384.1704,2,1,1,0.35831143730785864
3137,703-004-5394,5085.9873,1,1,0,0.6933313246402741
31514,703-004-5384,1262.1086,4,1,3,0.3571940407639164
31557,703-004-5385,4763.3315,6,4,2,1.089485170125562
31750,703-004-5382,7112.847,5,3,2,1.220583793661984
3191,703-004-5385,8395.536,7,4,3,2.4113442840397155
32253,703-004-5388,4852.845,7,1,6,0.5165268771580819
3226,703-004-5395,7401.727,6,3,3,1.471092446733982
32341,703-004-5383,1948.0234,3,3,0,1.4563085651056322
32426,703-004-5390,5811.036,4,2,2,1.6678812937128507
32460,703-004-5390,338.03522,3,1,2,0.5534558552053863
32646,703-004-5391,6019.9956,5,4,1,1.411988578822529
32784,703-004-5396,7686.6914,1,1,0,1.049526227872628
32815,703-004-5399,4258.8477,4,3,1,0.8365133083854067
33216,703-004-5385,3273.8762,1,1,0,1.5139352389150125
33980,703-004-5385,807.0695,4,2,2,1.1478453903302848
34134,703-004-5387,1810.1716,3,2,1,0.736396896224939
34705,703-004-5390,5187.5864,6,3,3,1.303267092506894
34977,703-004-5397,3302.2988,3,1,2,0.35831143730785864
35012,703-004-5391,2984.67,4,3,1,0.8318054021185541
35022,703-004-5382,9521.853,4,1,3,0.7171286671296555
3509,703-004-5384,9355.02,7,2,5,1.1603661893466852
3512,703-004-5388,5252.423,4,2,2,0.7371665484167106
35343,703-004-5392,8992.781,3,0,3,0.27920371738274696
35513,703-004-5388,4688.457,4,3,1,0.5096658355387211
35727,703-004-5389,5552.243,3,1,2,0.35831143730785864
36096,703-004-5389,4339.9175,2,2,0,0.6310274759566845
36308,703-004-5391,8649.752,6,4,2,0.9712142922793569
36506,703-004-5387,8733.305,1,1,0,0.637601822880447
36563,703-004-5399,3299.2983,4,1,3,0.35505071597719545
3663,207-008-2399,1457.2865,9,3,6,1.007272759763468
36642,207-008-2399,8506.73,2,2,0,1.2486143454410124
36648,207-008-2399,3590.6946,"","","",0.27920371738274696
36650,703-004-5399,8371.389,5,3,2,1.0139615053401616
36844,703-004-5380,4179.5806,4,2,2,1.1439785524503214
37035,207-008-2399,743.02136,5,2,3,0.5245745866066819
37102,703-004-5382,9196.471,3,1,2,0.628000214645187
37156,703-004-5380,126.464966,2,2,0,0.8264616569242785
37200,703-004-5385,1533.0446,1,0,1,0.27920371738274696
37263,703-004-5384,8745.084,4,2,2,1.2325185446751834
37426,703-004-5390,3178.737,1,0,1,0.27920371738274696
37487,703-004-5394,9920.133,3,0,3,0.27920371738274696
37578,703-004-5393,6452.826,3,1,2,0.5165268771580819
37644,703-004-5393,5510.7188,1,0,1,0.27920371738274696
3770,703-004-5393,7073.296,5,1,4,0.4306657936866386
38130,703-004-5389,5100.436,6,5,1,2.1810972686632275
38160,703-004-5380,9955.275,6,5,1,1.0423156144122958
38361,703-004-5395,9864.6045,3,1,2,0.4193091399215429
38627,207-008-2398,4829.765,6,4,2,1.0781667840112563
3879,703-004-5388,5257.257,3,0,3,0.27920371738274696
39156,703-004-5389,6679.0728,6,3,3,0.7722209811020063
39268,703-004-5383,5249.2603,5,3,2,0.9683925542733133
3999,703-004-5395,472.37872,4,3,1,1.1995856432467158
40188,703-004-5399,2517.0762,4,1,3,0.7134881938889321
40285,703-004-5390,4045.5586,6,4,2,2.4169948268619756
40496,703-004-5391,5440.849,5,3,2,0.8236595970818563
40766,703-004-5380,2721.805,4,2,2,1.3220956804328452
40837,703-004-5389,7505.5327,5,5,0,1.7238417919812687
40884,703-004-5394,8119.378,5,2,3,0.5860798677859886
40932,703-004-5383,9982.386,5,2,3,1.0791169587197764
41038,703-004-5388,5493.2065,1,0,1,0.27920371738274696
41146,703-004-5387,2364.8113,10,8,2,2.22536294696217
41312,703-004-5390,8954.99,3,1,2,0.4523558885122994
41563,703-004-5398,6748.632,7,2,5,1.61568218803115
41687,703-004-5395,128.47484,4,3,1,0.658066817105823
41788,703-004-5394,3492.3386,2,1,1,0.33853450732658075
41905,207-008-2398,4856.637,3,1,2,0.4314860782385869
42175,703-004-5398,8764.851,4,3,1,2.0658161560755466
42267,703-004-5387,4644.6045,2,0,2,0.27920371738274696
42399,207-008-2398,7382.0283,6,3,3,1.2789530917286598
42534,703-004-5384,4355.6387,7,4,3,2.742398837294127
42650,207-008-2398,2807.8223,4,2,2,0.5263214017313097
42711,703-004-5386,4940.579,5,2,3,0.8369817127275897
4305,703-004-5394,9059.23,4,1,3,0.3978652972704144
43277,703-004-5386,8229.62,4,1,3,0.4167252094636022
43406,703-004-5396,3258.4297,6,4,2,1.2892506451062167
43726,703-004-5392,4934.3916,1,1,0,3.5237436947011433
43803,207-008-2399,2652.4019,4,2,2,0.8131308183876147
43832,703-004-5393,8366.95,4,2,2,1.0069307867591852
44315,703-004-5383,7325.3457,5,3,2,1.4862082928189349
44606,703-004-5386,5047.975,1,0,1,0.27920371738274696
44666,703-004-5388,4649.4766,9,3,6,0.9034354029376801
44769,703-004-5381,5183.1226,2,0,2,0.27920371738274696
44832,703-004-5395,6461.466,2,1,1,1.117193172309041
44984,703-004-5395,4538.09,5,2,3,0.4710208857156718
45191,703-004-5387,8002.801,5,3,2,2.379055382649402
45344,703-004-5380,5329.93,7,4,3,3.567808123225744
45448,703-004-5394,3546.1277,6,3,3,1.4205119255933405
45462,703-004-5388,8947.609,7,2,5,1.0922763906932749
45701,207-008-2398,4065.1614,2,0,2,0.27920371738274696
4582,703-004-5392,9589.659,6,3,3,0.9548922244703472
45852,703-004-5387,235.15463,6,5,1,2.9344804094118913
4587,703-004-5397,7455.9146,2,0,2,0.27920371738274696
45958,703-004-5381,1579.5886,1,1,0,0.3978652972704144
46185,703-004-5397,7057.184,6,2,4,0.4810810334801094
46497,703-004-5397,9287.848,4,2,2,0.6431538992847146
4659,703-004-5383,6562.8223,4,2,2,0.4735834711404015
46621,703-004-5395,7321.2104,1,1,0,0.7647740820329415
46908,703-004-5393,6735.777,4,3,1,1.4453564132209848
4693,207-008-2399,9841.651,3,3,0,0.609695025429885
46935,207-008-2399,5950.3735,3,3,0,2.4984487493884835
47459,703-004-5396,9030.75,3,1,2,0.4930125135959472
47790,703-004-5398,8369.3,5,3,2,0.8007081763690578
48009,703-004-5382,9319.089,6,3,3,1.2718818774485412
48068,703-004-5398,3955.067,4,2,2,1.0474331545712923
48341,703-004-5384,5085.9946,4,2,2,0.702082708664909
48638,703-004-5395,9002.458,7,5,2,1.831585930296964
48762,207-008-2399,2801.034,2,0,2,0.27920371738274696
48852,703-004-5380,8718.111,3,2,1,1.5631988071018847
49042,703-004-5381,887.6234,5,3,2,1.0682088711417321
49044,703-004-5380,9680.597,10,7,3,1.9974637732201095
49073,703-004-5387,2338.5881,4,2,2,0.7791734417624846
49152,703-004-5385,3362.6372,4,3,1,0.9184772573265895
49379,703-004-5388,3537.3723,7,1,6,0.8298826684657485
4949,703-004-5393,3583.495,1,0,1,0.27920371738274696
49768,703-004-5393,5085.3267,4,3,1,1.0230110579526883
49866,703-004-5385,9266.793,2,2,0,1.4454372090436625
49894,703-004-5383,2050.8235,2,1,1,0.5192058688781354
49967,703-004-5390,8696.95,2,1,1,0.37512182779194486
5128,207-008-2398,6713.725,1,1,0,0.31887058837376725
5303,703-004-5388,1214.7731,5,1,4,1.2147351290415753
5538,703-004-5381,9578.13,8,5,3,2.021104246988484
556,703-004-5385,171.02779,3,0,3,0.27920371738274696
5615,703-004-5384,3181.5083,6,3,3,1.2447931092542992
5773,703-004-5398,7994.328,1,0,1,0.27920371738274696
597,703-004-5384,7424.7485,1,0,1,0.27920371738274696
6100,703-004-5395,5188.125,3,2,1,1.554993206958297
6308,703-004-5397,2149.4985,2,1,1,0.6350208458214418
6453,703-004-5392,7389.3105,5,0,5,0.27920371738274696
6582,703-004-5391,5156.802,4,2,2,0.898883938280687
6897,703-004-5391,8702.158,7,6,1,2.451163734559409
7041,703-004-5397,9530.849,3,1,2,0.7105970925620653
712,703-004-5399,4278.1064,3,1,2,0.4230808829965438
7194,703-004-5390,5399.887,7,1,6,0.3889656787788394
7490,703-004-5381,3897.2617,3,3,0,1.3185328291782803
7502,703-004-5388,5261.6216,10,4,6,0.7638775713466035
7639,703-004-5394,5689.5317,2,1,1,0.5641527956558267
7856,207-008-2398,2390.725,3,2,1,0.6349589601160258
8288,703-004-5391,4187.1445,3,0,3,0.27920371738274696
8313,703-004-5386,3146.5603,1,0,1,0.27920371738274696
8493,703-004-5398,9770.227,9,4,5,1.607346789794536
85,703-004-5388,1679.3763,7,5,2,3.202983807392828
8509,703-004-5398,7337.015,4,1,3,0.8803559825076454
8559,703-004-5381,9061.426,1,1,0,0.464740656218538
8764,703-004-5389,1019.0696,3,1,2,0.5213354458373427
9261,703-004-5380,5384.9106,5,2,3,0.7314702459217797
9274,703-004-5392,7228.71,4,3,1,0.8480923522463194
9470,703-004-5388,4208.6846,4,3,1,0.8136539535762985
9534,703-004-5382,8498.888,4,2,2,0.9965240758267228
9585,703-004-5380,3580.7014,1,0,1,0.27920371738274696
9998,703-004-5380,7746.9204,4,2,2,1.8719494249397852
10142,703-004-5395,7432.988,9,4,5,1.8461544008821078
10331,703-004-5398,6584.9507,2,1,1,0.463134730284426
10552,703-004-5391,4296.529,7,2,5,1.270854876633375
10867,703-004-5394,8534.893,9,5,4,3.1851445505563323
10961,703-004-5386,7937.6787,5,3,2,1.8350102174309724
1141,703-004-5388,2121.2173,3,1,2,1.080535113438043
11931,703-004-5388,8781.512,5,2,3,0.5977770978311652
12034,703-004-5398,2380.1147,4,3,1,1.798054333523446
12357,703-004-5392,5192.184,4,2,2,1.7783132877289176
12688,703-004-5399,8230.616,"","","",0.27920371738274696
12976,703-004-5386,7996.0317,4,0,4,0.27920371738274696
13085,703-004-5382,7830.2886,4,2,2,0.6416919863107606
13151,703-004-5399,9728.492,3,2,1,1.0537583816152905
1340,703-004-5397,4778.455,6,2,4,1.8128795207361965
13489,703-004-5385,9958.878,3,3,0,0.8729536050929709
13580,703-004-5380,2407.5876,3,1,2,0.40151433697318256
13813,703-004-5394,8053.5303,3,1,2,0.4589780710094363
14149,703-004-5397,9370.149,5,2,3,0.5426672013677422
14280,703-004-5394,2279.253,4,4,0,1.823315333073202
14379,703-004-5389,9064.545,5,1,4,0.745741103150427
14381,703-004-5385,5321.5723,7,4,3,1.2382324228597574
14602,703-004-5389,4247.3936,5,2,3,0.5209457540493206
14969,703-004-5397,6800.074,7,4,3,1.5406464898632388
15252,703-004-5391,4558.9717,3,1,2,0.42555299924420353
15417,703-004-5390,5579.3755,2,1,1,1.2322588935734653
15424,703-004-5384,4897.9614,6,1,5,0.6167154627778462
1549,703-004-5380,5274.7285,2,1,1,0.48586307683761015
15974,703-004-5381,3686.406,4,1,3,0.48793360612149733
16391,703-004-5391,8395.371,2,1,1,2.716875611178022
16450,703-004-5384,3378.331,9,3,6,0.9305825161498967
16867,703-004-5392,9169.21,2,1,1,0.3807252912866403
17025,703-004-5381,4138.063,2,2,0,0.4828735225590431
17254,703-004-5381,7790.5933,1,0,1,0.27920371738274696
17435,207-008-2398,4788.334,2,1,1,1.0878058508548654
17472,703-004-5397,2156.1177,"","","",0.27920371738274696
17613,703-004-5396,4836.7725,3,2,1,1.5704792758084611
18378,703-004-5390,1462.5162,6,2,4,0.4496623048146064
18384,703-004-5384,7348.0596,3,1,2,0.3480076567876128
18445,703-004-5387,7475.488,9,6,3,3.650441615680309
18563,703-004-5383,68.11678,3,3,0,0.9163119530153995
18646,703-004-5391,5644.71,6,0,6,0.27920371738274696
18836,703-004-5392,72.840454,8,6,2,2.513796283287597
18847,703-004-5382,5534.4014,2,0,2,0.27920371738274696
18902,703-004-5395,9950.798,6,3,3,1.5820905685173954
19044,703-004-5398,4422.9277,5,3,2,0.9521626763418635
19173,703-004-5396,7507.1567,5,5,0,1.5586526220482666
19298,703-004-5389,9535.854,3,1,2,0.41298070434754036
195,207-008-2399,7050.9595,1,0,1,0.27920371738274696
19721,703-004-5381,6895.6714,3,0,3,0.27920371738274696
19779,703-004-5386,9511.725,1,0,1,0.27920371738274696
19939,703-004-5388,6995.1626,4,3,1,2.4274547966534863
20059,703-004-5389,836.7437,6,1,5,0.5390000650169526
20086,703-004-5398,8027.874,2,2,0,0.7241642807597467
20338,703-004-5397,7994.454,2,1,1,0.487784462443965
2036,703-004-5394,6072.9404,4,3,1,2.5258154235616432
20594,703-004-5382,2461.0388,7,3,4,1.080558977779615
20597,207-008-2398,9390.134,3,0,3,0.27920371738274696
20891,703-004-5390,5993.763,6,4,2,3.0923163729826353
20905,703-004-5383,502.17212,5,4,1,1.9676859804645894
21123,703-004-5399,5484.0493,3,0,3,0.27920371738274696
21379,703-004-5394,1772.6207,3,1,2,0.7693799487787574
21436,703-004-5392,7236.828,3,3,0,0.7514439244421371
21593,703-004-5384,9505.59,3,2,1,0.5478798462285309
22113,703-004-5391,1996.7616,4,0,4,0.27920371738274696
223,703-004-5381,2888.89,6,3,3,1.3721677752812969
22466,703-004-5385,1179.9723,3,1,2,1.4177929266634928
2253,703-004-5384,6288.3584,5,4,1,1.5284371571836723
22712,703-004-5390,5690.994,3,0,3,0.27920371738274696
22924,703-004-5396,9271.318,1,0,1,0.27920371738274696
23050,703-004-5380,993.34717,5,1,4,0.5837684390944268
23194,703-004-5380,8579.56,9,3,6,1.0755569317109726
23582,703-004-5381,6525.0713,3,2,1,0.966527078914041
23658,703-004-5393,4441.6084,4,3,1,1.2735048681729755
23745,703-004-5384,7625.8887,6,3,3,0.8725543727992321
24115,703-004-5398,4450.0083,5,2,3,1.520684785868447
24317,703-004-5392,3595.9326,2,1,1,0.35939340018558436
24418,703-004-5395,4222.15,1,0,1,0.27920371738274696
24573,703-004-5396,6009.3145,3,1,2,0.5002087723714146
24706,703-004-5391,2568.3862,8,3,5,1.6738159721065309
24913,703-004-5392,5584.8496,3,2,1,0.5533597518676594
24977,703-004-5387,9726.995,7,2,5,0.6687918602032381
24984,703-004-5398,700.8243,4,3,1,2.4372573851545383
25407,703-004-5389,7920.225,4,4,0,2.139892182398996
25530,703-004-5385,8224.394,3,2,1,0.7572103131209899
2557,703-004-5388,2598.9092,9,3,6,2.8512037436813755
26061,703-004-5381,682.0744,5,2,3,0.9389403171131909
26085,703-004-5396,5648.429,7,5,2,2.51479976216851
26143,703-004-5386,7914.741,4,0,4,0.27920371738274696
26294,703-004-5396,2384.6138,4,2,2,1.157687903382393
26384,703-004-5390,2892.0896,7,3,4,0.6797774272436844
26666,703-004-5388,3426.956,"","","",0.27920371738274696
26801,703-004-5390,2388.5166,3,0,3,0.27920371738274696
26883,703-004-5398,6312.7686,4,3,1,0.9532909323275981
26946,703-004-5394,8371.502,3,1,2,0.48688523145347884
27012,703-004-5380,4400.587,4,2,2,0.6996279471470875
27085,703-004-5396,7848.648,6,4,2,2.571348279751254
27117,703-004-5394,9244.597,4,0,4,0.27920371738274696
27171,703-004-5398,1306.0421,2,1,1,0.6459668838855458
27249,703-004-5399,7506.63,4,3,1,2.2001645863676056
27634,703-004-5389,2840.0808,5,2,3,0.8977231047619217
27964,703-004-5388,8361.842,3,0,3,0.27920371738274696
28385,703-004-5399,3732.7368,2,1,1,0.3833377001313547
28596,703-004-5397,2550.404,6,5,1,1.5414660533631281
28664,703-004-5387,8861.207,3,1,2,1.4698862378360518
28703,703-004-5383,3205.1016,5,2,3,0.854006551172479
28933,703-004-5399,1901.0133,5,2,3,0.5705941833947809
29038,207-008-2399,7138.329,3,2,1,1.1815573723028652
29111,703-004-5388,1915.3708,3,2,1,0.6861583658729179
29123,207-008-2399,8811.037,3,3,0,1.0123430496674208
29211,703-004-5388,2768.7002,6,6,0,2.130105878036485
29292,703-004-5383,1548.6372,4,1,3,0.609053617954734
29326,703-004-5399,586.95435,5,4,1,1.4180227142510717
29417,207-008-2398,7327.4683,2,0,2,0.27920371738274696
29535,703-004-5398,9025.785,5,4,1,2.167832345181316
29790,703-004-5380,6949.2275,1,1,0,0.4658826324613648
30284,703-004-5382,9041.57,4,2,2,1.4848606879571555
30346,703-004-5390,6064.1313,5,3,2,0.6442967933936439
30357,703-004-5387,1575.4133,6,2,4,1.2358339984645124
30578,703-004-5389,2672.8647,5,1,4,0.35831143730785864
30604,703-004-5383,2389.5938,4,3,1,1.8784775164577292
30801,703-004-5384,8223.011,4,1,3,1.2232737633176813
31131,703-004-5382,511.12772,5,2,3,0.75520766674723
31193,703-004-5382,9051.904,3,1,2,0.7094658877893065
31404,703-004-5395,7007.976,3,2,1,0.7783956268073744
31430,703-004-5394,8034.8574,4,2,2,1.0724499513000199
31688,703-004-5382,8293.169,1,1,0,0.32666834933781397
31926,703-004-5383,370.1335,4,3,1,1.6609901462763583
32013,703-004-5394,5732.3438,8,4,4,2.377477546233728
32076,703-004-5392,9842.787,6,3,3,3.701361638269442
32139,207-008-2399,4245.876,2,1,1,0.5804515387609438
32752,703-004-5393,3208.2344,4,3,1,1.0758019673645975
33066,207-008-2398,2257.5789,5,2,3,0.6819603483431126
33285,703-004-5399,8315.703,6,1,5,1.188027239340196
33438,703-004-5390,1403.082,3,2,1,0.967853829776744
33862,703-004-5384,1293.8022,5,2,3,1.1719359844203172
34031,703-004-5394,5670.78,3,3,0,1.4297277683473502
34053,703-004-5392,3543.418,5,3,2,1.1379306337393484
34221,703-004-5399,6445.1826,4,1,3,0.31304424201737807
34243,703-004-5397,9764.16,4,3,1,0.5491588116271904
34389,703-004-5390,8629.038,3,1,2,0.49179890503127066
34560,703-004-5382,3499.94,2,2,0,0.645535313882596
34732,703-004-5384,2013.0092,2,2,0,0.6637128106698986
35193,703-004-5384,9134.263,5,3,2,1.4102157379248503
35346,703-004-5382,8821.854,3,1,2,0.6279767340354074
35440,703-004-5390,4496.3975,3,3,0,0.8845433839857557
3551,703-004-5397,5096.316,1,1,0,0.3978652972704144
3627,703-004-5382,8647.189,5,3,2,0.975698434810569
36480,703-004-5382,3139.193,5,2,3,0.46425430859389444
36509,703-004-5389,658.3732,4,1,3,0.35831143730785864
36679,703-004-5389,2600.063,3,2,1,0.5044718409075903
36959,703-004-5382,6369.247,4,2,2,0.8507977832273862
37018,703-004-5386,9615.261,2,1,1,0.4391922406138993
37448,703-004-5399,5054.6313,7,7,0,1.9230596113288287
37573,207-008-2399,5496.1616,5,0,5,0.27920371738274696
37599,703-004-5398,7536.8643,2,2,0,0.9416837828935019
37919,703-004-5389,9051.974,2,2,0,0.7592196821356534
37929,703-004-5386,7530.8022,2,2,0,2.518335174507514
38180,703-004-5381,1129.0968,3,2,1,1.1625217654095
38199,207-008-2399,4078.7202,3,1,2,0.5165268771580819
3821,703-004-5393,5777.1016,1,1,0,0.3978652972704144
38666,703-004-5384,7989.8467,3,0,3,0.27920371738274696
38812,703-004-5394,6873.274,4,2,2,0.7833958726382336
39364,207-008-2398,3655.1345,5,3,2,1.072171634891008
39625,703-004-5385,8851.968,1,1,0,0.6139695977324964
40076,703-004-5388,7459.128,3,0,3,0.27920371738274696
40356,703-004-5397,6053.164,2,0,2,0.27920371738274696
40471,703-004-5384,8799.971,7,3,4,1.654606342607953
40810,703-004-5382,7571.1494,1,0,1,0.27920371738274696
40930,703-004-5385,3188.0974,6,2,4,0.9427521670464399
40974,207-008-2398,940.7884,4,3,1,0.7673935156025221
41148,703-004-5390,7328.7314,3,2,1,0.689575835252297
41174,703-004-5383,2932.9187,4,2,2,2.1758886672357893
41315,703-004-5383,5897.0024,2,1,1,0.5197174227733923
41641,703-004-5393,5151.3994,4,3,1,1.4042485851868924
41869,703-004-5390,376.13034,12,4,8,2.026748423013325
42110,703-004-5396,5496.5596,4,1,3,1.177813021178525
4217,703-004-5393,4641.138,6,2,4,0.5578066407076775
42329,703-004-5383,5468.0444,7,3,4,1.0791280314451746
42588,703-004-5393,9958.6875,2,1,1,0.5256282223955628
43036,207-008-2398,474.39755,5,1,4,0.4126618645812136
43102,703-004-5380,5880.0566,1,0,1,0.27920371738274696
43178,703-004-5393,5734.903,2,1,1,0.48616355453664795
43294,703-004-5394,4818.568,5,4,1,2.999775658403059
43443,703-004-5383,8350.372,4,2,2,0.6326836354262494
43686,703-004-5382,2532.0667,4,3,1,0.5908225984152771
43776,703-004-5385,9605.582,4,2,2,4.055381265770737
44056,703-004-5390,8703.725,6,4,2,0.8387163205994661
44247,703-004-5391,9240.823,4,1,3,0.6030918343374282
44814,703-004-5382,7538.261,5,2,3,1.6347080281648825
45082,703-004-5394,8765.382,4,1,3,0.3760322932799521
45100,703-004-5382,5481.877,6,3,3,1.2264194758209461
45453,703-004-5398,8049.1704,7,1,6,0.5165268771580819
45525,703-004-5381,5652.301,2,0,2,0.27920371738274696
45652,207-008-2398,680.3858,7,3,4,1.4730063775803268
458,207-008-2399,5489.575,4,3,1,0.7843848256042844
45919,703-004-5385,8483.862,6,3,3,2.5992810862474234
4607,703-004-5383,252.48587,3,1,2,0.4290353316913857
4609,703-004-5393,3549.949,3,1,2,0.7616469489376811
46096,703-004-5397,6327.425,4,3,1,5.382725627772991
46365,703-004-5393,7138.6553,7,4,3,2.635413426238797
466,703-004-5391,3639.911,3,2,1,0.5374853751268267
46606,703-004-5398,1705.1393,3,1,2,0.47624426822716903
47,703-004-5387,8152.5063,3,2,1,0.8263604590543178
47415,703-004-5387,1223.722,4,0,4,0.27920371738274696
4769,703-004-5389,7549.2754,9,4,5,1.5116128578817178
47862,703-004-5381,3592.4172,3,2,1,0.5687566926496243
48110,703-004-5382,9881.699,4,4,0,1.4072324906812865
48148,703-004-5388,9182.282,6,6,0,3.837232059978874
48239,703-004-5394,4032.7793,4,2,2,0.7179988565898241
4829,703-004-5392,1604.504,3,1,2,0.5606371987442431
48314,703-004-5398,1655.0809,4,3,1,1.1599248092306025
48515,703-004-5386,8024.753,5,4,1,1.036346814844081
49086,703-004-5395,6577.4707,2,0,2,0.27920371738274696
49340,703-004-5385,2605.3845,2,1,1,0.941155201505827
49498,703-004-5390,9856.833,1,1,0,0.8593403718765045
49619,703-004-5388,8395.257,1,1,0,0.4257754567449429
49688,703-004-5387,34.11472,4,3,1,1.6801576645722576
5152,703-004-5382,7608.8823,3,1,2,0.4575726537865762
5378,703-004-5388,3451.0564,7,2,5,0.7657149167081012
5482,207-008-2399,9836.353,6,2,4,0.49655750469890586
5665,703-004-5381,5370.6978,5,2,3,0.7244535200304631
568,703-004-5394,4115.3145,5,1,4,0.8710557360604156
5833,703-004-5380,6741.077,3,0,3,0.27920371738274696
5890,703-004-5396,1495.6045,7,6,1,2.3357640229492906
594,703-004-5391,6060.0776,2,1,1,0.6650869022810906
629,703-004-5396,2358.1206,2,0,2,0.27920371738274696
6544,703-004-5392,6046.0947,1,0,1,0.27920371738274696
6568,703-004-5382,7422.442,4,3,1,1.641641802441441
6785,703-004-5394,4922.4917,6,4,2,2.6265954388897463
7021,703-004-5384,2064.5332,3,1,2,0.475059275753839
7079,703-004-5395,8302.128,1,0,1,0.27920371738274696
7138,703-004-5391,6873.38,4,3,1,1.153610407928212
7284,703-004-5393,7656.5366,4,0,4,0.27920371738274696
7649,703-004-5398,2263.1787,4,2,2,2.407774319713104
7714,703-004-5398,5211.652,3,2,1,0.9484219186785569
8008,703-004-5380,7246.2607,4,4,0,1.209659721905182
8035,703-004-5386,4683.789,1,1,0,0.5383791487292702
8113,703-004-5398,878.7513,1,0,1,0.27920371738274696
8144,703-004-5396,9589.763,4,4,0,2.4032511520926785
8198,703-004-5383,1095.2532,5,4,1,1.0600050576843465
8492,703-004-5380,5.528331,2,1,1,0.43461706785280546
8562,703-004-5396,7180.7812,1,0,1,0.27920371738274696
8641,703-004-5384,3195.5708,7,2,5,0.653308774632688
8710,703-004-5380,6439.305,3,1,2,0.3978652972704144
8767,703-004-5390,9295.743,3,0,3,0.27920371738274696
8777,703-004-5395,5805.907,4,1,3,0.8055794272262207
902,207-008-2398,9408.215,6,3,3,2.89857800569308
9063,703-004-5394,1886.1312,4,2,2,0.6899008447372942
9241,703-004-5381,3683.0002,5,4,1,1.9523642963002057
9587,703-004-5392,7088.6846,2,1,1,0.5083867197369432
99,703-004-5381,6153.145,4,3,1,3.500956024869333
10014,703-004-5397,2280.4927,4,2,2,0.5475206225937413
1022,703-004-5380,8834.972,4,1,3,0.6532965861450631
10270,207-008-2398,364.7393,9,8,1,7.247037983797184
10305,703-004-5383,1206.482,1,1,0,1.0128271019641044
10332,703-004-5396,6782.557,5,4,1,2.7036032255686795
10545,703-004-5397,8812.039,2,1,1,0.47500716040762675
10763,207-008-2399,4412.223,5,2,3,0.692676955501609
1082,703-004-5396,1999.9362,6,1,5,0.5683124684826292
10978,703-004-5394,1490.379,4,3,1,0.9844280961015968
11155,703-004-5381,2762.6663,4,3,1,0.5401673497796041
11216,703-004-5389,4507.244,1,1,0,0.8484486569727421
11540,703-004-5395,3090.552,4,1,3,0.6934156454073878
11601,703-004-5390,6464.12,5,2,3,0.7994395675988166
12258,703-004-5384,2298.8384,1,0,1,0.27920371738274696
12462,703-004-5385,1109.106,6,5,1,2.504000132703823
12512,703-004-5392,8021.826,3,3,0,0.686866513717636
1307,703-004-5389,6485.7383,3,0,3,0.27920371738274696
13145,703-004-5399,4542.5435,"","","",0.27920371738274696
13619,703-004-5381,1044.82,2,1,1,0.537977353525925
13910,703-004-5382,5666.277,5,1,4,0.41703483231588095
13965,703-004-5386,6462.839,7,1,6,0.566434430872893
14113,703-004-5383,6274.361,7,4,3,1.3001468461319738
14201,703-004-5387,4101.822,1,1,0,0.5297854222551327
14247,703-004-5387,3226.8787,4,3,1,0.9183936173120417
14549,207-008-2398,5461.7266,2,0,2,0.27920371738274696
15091,703-004-5387,4111.377,6,2,4,0.880652101881009
15590,703-004-5395,7929.683,4,2,2,0.6793345029198272
1576,703-004-5384,8606.6045,2,1,1,0.5149611157457294
15780,703-004-5396,1325.1078,5,3,2,3.7515642886538565
16184,703-004-5395,7223.968,5,3,2,1.2319262449319508
16214,703-004-5390,8941.345,5,2,3,0.7486930658995606
163,703-004-5381,3650.1616,8,4,4,1.5358752412348209
16392,703-004-5399,840.6335,"","","",0.27920371738274696
16515,703-004-5386,1204.3333,5,4,1,0.9232359571237054
16617,703-004-5399,8923.018,4,3,1,0.8420567103235398
16743,703-004-5388,1500.0337,4,2,2,0.866657228878332
16914,703-004-5398,642.0946,4,2,2,0.43025002011475705
17522,703-004-5382,3062.9492,2,0,2,0.27920371738274696
1782,703-004-5387,2896.9878,5,2,3,0.5014132048908054
18125,703-004-5392,7547.0835,3,0,3,0.27920371738274696
18289,207-008-2399,3151.775,4,1,3,0.5165268771580819
18620,703-004-5388,463.11856,3,1,2,0.3672522577368947
1940,703-004-5393,1276.5085,6,4,2,1.68138902385561
20171,703-004-5388,3947.1377,7,1,6,0.5347292122225521
20312,703-004-5390,4964.9688,3,1,2,1.5248528603337739
20373,703-004-5390,5211.597,8,4,4,4.6477788419285115
20375,703-004-5387,5583.118,4,2,2,1.2689022636599632
20441,703-004-5392,2164.9219,7,6,1,3.3905373911169416
20453,703-004-5388,4193.626,4,3,1,1.139716715480144
20593,703-004-5395,3690.6992,6,4,2,1.258147186571111
20826,703-004-5397,7462.358,5,1,4,0.6173892200625992
20931,703-004-5390,3718.468,4,3,1,1.743629477632817
20962,207-008-2399,7046.224,2,1,1,1.012262528566004
21110,703-004-5398,8229.739,5,4,1,1.7900969911992923
2123,703-004-5380,8621.784,3,1,2,0.42912396056092694
21330,703-004-5382,3139.3367,2,1,1,0.6194857315920088
21399,703-004-5381,8227.49,5,2,3,1.5144122086617597
21544,207-008-2398,109.43353,3,1,2,1.0241493894845046
21647,703-004-5391,3907.91,3,2,1,0.7952326479926874
2174,703-004-5380,5910.3823,3,3,0,1.4505045240733074
2183,703-004-5387,1476.2521,4,3,1,2.0844593325519964
22379,703-004-5380,4738.1846,5,4,1,1.2213998011283977
22407,703-004-5391,2750.3616,1,0,1,0.27920371738274696
22449,207-008-2399,6811.426,3,2,1,1.121198904312285
22684,703-004-5399,8713.552,3,2,1,0.566741579797157
22999,703-004-5384,744.56213,7,5,2,1.913074937991918
2336,703-004-5384,1954.3785,5,0,5,0.27920371738274696
23398,703-004-5381,8783.235,7,5,2,1.361421785730179
23478,703-004-5380,8435.536,4,2,2,0.8832084973268606
23966,703-004-5386,3845.8354,5,4,1,1.2960703222278647
24088,703-004-5397,6952.632,5,3,2,0.8488254569286008
24480,703-004-5383,5175.5845,4,1,3,0.5358677321045509
2463,703-004-5388,156.40259,6,4,2,1.6748058875886214
25312,703-004-5382,2594.365,3,1,2,0.5548926061696149
25347,703-004-5380,410.30765,6,3,3,0.9719909995463679
25602,703-004-5390,3039.4102,5,2,3,1.060216425204922
26191,703-004-5392,8542.698,4,2,2,0.7189107939664925
2626,703-004-5387,9599.773,2,1,1,0.38169518489447213
2660,703-004-5397,4262.9473,4,1,3,0.5110167782580598
26665,703-004-5386,5819.568,5,1,4,0.5840781530282727
27106,703-004-5392,315.68228,2,1,1,0.5669580486103406
27113,703-004-5382,2554.868,7,3,4,2.0037392317194485
27142,703-004-5397,8628.841,5,2,3,1.9757473502121432
27224,703-004-5389,9708.553,2,2,0,0.4703140092643429
2731,703-004-5389,9918.5,5,4,1,2.488793775277529
2737,207-008-2399,4772.5522,2,2,0,0.5222863119604338
27524,703-004-5385,5858.7617,"","","",0.27920371738274696
27543,703-004-5386,8167.8105,7,4,3,0.973757887640576
2779,703-004-5390,2696.8103,1,1,0,1.6123142471647303
27956,703-004-5398,2219.8403,4,2,2,0.9332635131281379
28059,703-004-5392,5174.8164,6,2,4,0.7060813472840649
28176,703-004-5389,6026.0747,5,3,2,2.604476982340816
28387,703-004-5388,480.57318,1,1,0,0.8228304459471281
2845,703-004-5399,9714.238,1,1,0,0.5808381087787725
28609,703-004-5395,1990.2032,6,3,3,2.1394594323644105
28877,703-004-5389,1494.9209,4,2,2,1.3661553730623
29006,703-004-5396,3330.9507,7,2,5,2.1020468009429396
29125,703-004-5398,3699.05,6,4,2,1.21841488855148
29281,703-004-5382,8398.1875,3,1,2,0.757674275997707
29354,703-004-5395,2486.208,7,4,3,1.0872445515821707
29361,703-004-5383,8954.118,"","","",0.27920371738274696
2947,703-004-5387,9870.247,2,1,1,1.1193778797673284
29597,703-004-5391,805.73975,4,1,3,0.729270543501583
29698,703-004-5392,2204.1887,8,4,4,2.486785301290636
29776,703-004-5382,719.2928,3,0,3,0.27920371738274696
29899,703-004-5397,566.6077,5,4,1,1.971553928125851
29932,703-004-5385,6251.0312,3,1,2,0.4953749940797723
30330,703-004-5383,5888.987,1,0,1,0.27920371738274696
3036,703-004-5383,6622.1904,5,1,4,0.47522639589276217
30515,703-004-5381,4582.2007,4,2,2,1.0018401864811826
30596,703-004-5382,1234.644,2,1,1,0.6142512805055698
30911,703-004-5395,288.955,8,4,4,3.0596312424442282
30971,703-004-5393,7682.8086,4,3,1,2.340178927185718
31,703-004-5383,986.87885,4,4,0,1.3247139829965389
3117,207-008-2398,3148.7388,1,1,0,0.42898451625378436
31191,703-004-5386,4955.5615,2,1,1,0.6835506866713238
31324,703-004-5399,6860.043,5,3,2,1.7668468540558373
31328,703-004-5395,7048.376,5,0,5,0.27920371738274696
3172,703-004-5398,8221.994,6,4,2,2.0611989301043305
3194,703-004-5396,8032.927,5,3,2,0.8275172496441378
31982,703-004-5393,6374.268,2,2,0,0.7358581809570959
32118,703-004-5386,7477.1436,3,1,2,0.44783692196023817
32344,207-008-2398,4556.6904,3,1,2,0.7989632094979
33016,703-004-5386,7868.7666,3,2,1,0.4989651894566372
33035,703-004-5383,4976.6475,2,1,1,1.586302280936311
33038,703-004-5397,843.1834,4,1,3,0.5922537059869883
33177,703-004-5392,5593.7686,2,0,2,0.27920371738274696
33418,207-008-2398,6653.1997,2,2,0,0.6539292340166076
33526,703-004-5398,5555.169,6,3,3,1.352724733290261
33933,703-004-5385,6237.363,3,3,0,0.6816760742370658
34033,703-004-5397,5667.062,3,0,3,0.27920371738274696
34128,703-004-5397,2507.6497,6,2,4,0.8117263501351804
34193,703-004-5382,499.13705,7,5,2,1.412363609688349
34333,703-004-5386,4565.2725,6,3,3,2.301741434285322
34360,703-004-5380,7924.6274,6,2,4,0.3870291877181726
34456,703-004-5398,632.4679,3,2,1,0.6139873496953865
34716,703-004-5398,7093.0527,"","","",0.27920371738274696
34744,703-004-5399,5784.763,7,2,5,1.1972917882907579
34786,703-004-5384,206.2279,4,1,3,1.0686926449809169
35057,703-004-5391,1156.1614,2,0,2,0.27920371738274696
35554,703-004-5391,144.14847,6,4,2,0.9099583465641713
35669,703-004-5381,6945.517,3,1,2,0.5616928007095401
36201,703-004-5399,9814.336,5,3,2,1.0367492918697676
36671,703-004-5384,9850.098,2,0,2,0.27920371738274696
36700,703-004-5384,3685.4731,10,6,4,2.4223612044812115
36880,703-004-5386,2586.4219,6,5,1,1.9165221080323014
37197,703-004-5391,5155.1436,5,3,2,0.7956888306397535
37460,703-004-5397,7474.239,2,1,1,0.7899494215545318
3748,703-004-5382,1840.9371,6,3,3,0.7663620352918846
37676,703-004-5383,156.76201,4,2,2,1.6072416861964691
37779,703-004-5388,1902.4563,5,2,3,0.700413606136238
37901,703-004-5384,4603.293,4,3,1,0.8932887051519869
37999,703-004-5387,8661.18,1,1,0,0.3978652972704144
38099,703-004-5392,3431.726,7,3,4,1.4709697584420462
38215,703-004-5380,9691.271,7,2,5,1.009859260412103
38259,703-004-5398,1908.6003,1,0,1,0.27920371738274696
38649,703-004-5399,3734.1965,4,2,2,0.5372525700392652
38959,703-004-5387,2713.1223,8,2,6,0.6773514621130025
39433,703-004-5380,2325.681,5,3,2,1.0322344709812432
39766,703-004-5390,6287.1294,1,1,0,0.4234221799141138
39956,703-004-5388,6613.758,11,3,8,1.4490928165127075
40050,703-004-5386,7270.1465,3,2,1,1.0202087012190602
40085,703-004-5392,2705.0305,4,1,3,0.3929946389203118
40571,703-004-5397,1591.6329,5,2,3,1.102702202709023
4071,703-004-5398,7089.063,3,2,1,0.6309709836374365
41020,703-004-5385,8355.598,1,1,0,0.43292628509936143
41072,703-004-5380,3041.597,7,3,4,0.9629220349508867
41089,703-004-5392,5540.1807,3,1,2,0.43675992623359433
41403,207-008-2398,4320.8984,3,2,1,2.154314952245612
4160,703-004-5389,5981.6807,1,1,0,0.5472448783861431
41724,703-004-5388,5402.192,1,0,1,0.27920371738274696
41877,703-004-5391,9988.427,4,3,1,1.1352935540606552
41893,703-004-5398,8522.696,5,3,2,1.1995093124965643
42151,703-004-5390,3611.375,8,5,3,1.0558449916916066
42238,703-004-5398,435.17767,4,2,2,0.5961975405233516
4237,703-004-5387,9450.478,5,3,2,0.8018430984513987
43025,703-004-5388,9781.355,2,1,1,0.475970395515371
43288,703-004-5396,2642.8574,4,2,2,1.2345077917303808
4330,703-004-5389,1701.8336,5,3,2,0.8482729871636865
43358,703-004-5385,701.6969,5,3,2,1.2385339343793624
43467,703-004-5398,2565.4417,1,0,1,0.27920371738274696
43494,207-008-2399,2909.543,5,4,1,1.7237573582903645
44235,703-004-5399,4937.4424,3,1,2,0.5134059969199086
44414,703-004-5391,2021.299,5,2,3,1.4831795742739735
44703,703-004-5381,8387.37,3,3,0,2.871033748582068
44772,703-004-5389,6037.3545,4,2,2,0.6188423502607212
45071,703-004-5397,9809.2705,4,1,3,0.42582271210472183
45144,703-004-5389,2555.0825,2,2,0,1.3775719860832585
45609,207-008-2399,1908.5795,7,3,4,0.8701990578644014
45982,703-004-5396,3349.5933,3,2,1,0.5220620767745271
46040,703-004-5386,9658.378,1,1,0,0.6024737604880764
46069,703-004-5399,1743.3547,2,1,1,0.33853450732658075
46371,703-004-5393,1237.0175,4,1,3,0.3646108949173285
46431,703-004-5383,8523.639,4,2,2,1.9591316462561286
46441,703-004-5387,93.15014,7,2,5,1.310090696977688
46473,703-004-5388,4112.6484,1,1,0,0.3978652972704144
46588,703-004-5389,9341.757,5,2,3,0.7705680847563691
46904,703-004-5384,3317.9968,5,3,2,0.7688912305125847
46972,703-004-5388,8603.56,5,4,1,1.2306427900145525
47001,703-004-5393,7750.433,7,4,3,1.2377757190724652
47138,703-004-5389,3399.4026,2,1,1,0.5105933711530418
47169,703-004-5386,3894.0627,3,1,2,1.1701124345548333
4792,703-004-5390,781.8824,2,2,0,0.6413193053399455
48452,703-004-5386,9438.542,1,1,0,0.3807252912866403
48807,703-004-5384,8231.318,3,2,1,0.6810891051717585
49393,207-008-2398,7088.6455,6,4,2,2.718179435730781
49530,703-004-5388,8385.853,1,0,1,0.27920371738274696
49659,703-004-5393,4125.8203,8,5,3,3.9833120919965666
49695,703-004-5394,2254.6113,6,2,4,0.7994096141937642
49700,703-004-5395,8811.558,3,3,0,1.3837020390160386
49842,207-008-2398,7812.5107,7,6,1,4.144456548019345
4986,207-008-2398,8538.642,3,3,0,1.060022943975635
5029,703-004-5385,9793.509,6,3,3,2.5207653344692034
5069,703-004-5386,1067.0876,"","","",0.27920371738274696
5183,703-004-5391,5661.413,4,1,3,0.7743980473730995
5692,703-004-5394,6986.643,6,5,1,3.265811574537859
5755,703-004-5393,44.77799,4,3,1,1.4121042496930705
5907,207-008-2399,8447.587,7,7,0,4.829481232588299
6093,703-004-5386,4662.345,3,1,2,0.576560332018608
6151,703-004-5396,1951.3154,4,1,3,0.4557116544241929
6213,703-004-5398,7766.8228,8,5,3,1.4810512731534287
6368,703-004-5398,2241.922,1,1,0,0.3847804644514323
7182,703-004-5393,4459.967,2,2,0,1.7320538529934069
7320,703-004-5388,8474.984,4,2,2,1.4930928208847742
7376,703-004-5381,3863.2488,5,3,2,1.0263760556258994
7400,703-004-5385,531.03986,3,3,0,0.8490582253775588
7875,703-004-5392,7940.112,1,0,1,0.27920371738274696
7890,703-004-5380,5967.713,4,2,2,0.6967540428462737
797,703-004-5385,8036.2993,2,0,2,0.27920371738274696
7978,703-004-5383,3793.267,3,2,1,0.511006697338648
8056,703-004-5397,5458.388,3,1,2,0.4293572466351117
815,703-004-5387,7494.037,5,3,2,1.1899595166552719
8262,207-008-2398,9746.195,4,0,4,0.27920371738274696
8439,207-008-2398,5326.182,2,0,2,0.27920371738274696
8825,703-004-5395,9403.0,3,1,2,0.37137220427136947
8943,703-004-5390,7411.7495,5,4,1,1.141964595360632
9083,703-004-5381,3474.0388,8,4,4,0.9515410530650201
9114,207-008-2399,9042.378,6,3,3,1.2193656183342276
9143,703-004-5395,8134.023,4,1,3,0.5436665704096759
9385,703-004-5390,6059.728,7,3,4,1.6860788667759719
9466,703-004-5383,3502.777,3,1,2,0.3546794865206719
9474,703-004-5398,2404.471,6,2,4,0.7811155805955166
9730,703-004-5395,6768.755,4,4,0,1.9548325185736612
9731,703-004-5390,3817.8962,1,1,0,0.6132440314373474
9756,703-004-5385,9251.223,4,2,2,0.8646492566673734
9868,703-004-5382,7394.9824,6,2,4,3.6475655172191113
10185,703-004-5386,5475.388,5,2,3,1.7630784717083419
10278,703-004-5394,7026.3926,3,2,1,0.5788168974311019
1052,703-004-5387,4920.935,1,1,0,0.9405980382326712
10675,703-004-5383,5692.1484,5,3,2,1.7030642206066278
10835,703-004-5387,7677.6177,3,1,2,0.4373697149080171
11246,703-004-5386,4335.7856,1,0,1,0.27920371738274696
11335,703-004-5383,4968.0986,6,4,2,1.6083062413168216
11456,207-008-2398,4128.261,2,0,2,0.27920371738274696
11696,703-004-5391,3322.5679,5,3,2,1.4681792999726822
11833,703-004-5388,4810.3813,3,2,1,1.8106119776985923
12206,703-004-5380,4256.005,5,3,2,1.1371402056680462
1250,703-004-5389,5848.4336,5,2,3,0.7601894973835946
12672,703-004-5386,3090.6875,4,2,2,1.2998333118666716
12704,703-004-5397,3892.3687,6,3,3,0.9320696644166397
13096,703-004-5395,7189.3394,4,2,2,0.8184216327011004
13227,703-004-5386,49.803257,8,6,2,2.582108920414082
13238,703-004-5394,5011.0845,7,2,5,0.6405223231305198
13554,207-008-2398,5666.5044,4,3,1,1.0004520836386612
13584,703-004-5396,6604.7466,9,1,8,0.8148564609667142
13609,703-004-5393,8795.92,3,2,1,0.4996423231865659
13656,703-004-5393,9681.582,6,2,4,2.4471422140589962
13726,703-004-5387,1281.448,4,2,2,0.670074178819497
13896,703-004-5393,246.22917,3,1,2,0.6825352367447001
14045,703-004-5390,4532.0835,5,2,3,1.1553007764003633
14367,703-004-5397,609.8264,7,2,5,0.7572566413682049
1473,703-004-5393,8935.775,1,1,0,0.45315922947456067
14756,703-004-5388,7777.7744,7,3,4,1.7635527744267
15230,703-004-5390,450.37567,4,3,1,1.272556597739151
15240,703-004-5395,1263.0737,4,2,2,0.8296331656106133
15438,703-004-5385,9839.841,7,4,3,1.0011707063337991
15913,703-004-5389,9474.407,5,3,2,1.6832874525130648
16017,207-008-2398,7867.169,4,1,3,0.5462912192992392
1630,703-004-5399,8581.302,6,3,3,2.1759587209556894
16490,703-004-5397,3073.802,2,0,2,0.27920371738274696
16836,703-004-5393,5686.959,3,1,2,0.5165268771580819
17182,703-004-5396,7036.363,4,2,2,0.8935944056174758
17239,703-004-5387,8018.49,2,1,1,0.4390923596728738
17368,703-004-5382,9423.221,2,1,1,0.4755772224212032
17783,703-004-5395,6518.595,5,2,3,1.4408520497166122
18226,703-004-5385,348.55127,5,2,3,1.151609175003014
18450,703-004-5395,8632.538,1,0,1,0.27920371738274696
18552,703-004-5390,1098.6107,3,2,1,0.8672746684683775
18587,703-004-5390,5388.0566,3,1,2,0.5020561283857213
18735,703-004-5389,6406.685,6,2,4,1.3051002999021182
18979,703-004-5385,1995.1707,2,0,2,0.27920371738274696
19059,703-004-5382,6579.3325,4,2,2,1.028851864415532
19062,703-004-5384,4727.808,4,3,1,1.2583282831390559
19163,703-004-5398,1678.7505,3,2,1,0.906110161235445
19197,703-004-5395,9035.21,7,5,2,3.447851394387101
19229,703-004-5392,4492.284,8,4,4,1.220635797733168
19259,703-004-5388,7384.513,3,2,1,1.9897593108302059
19347,703-004-5396,8538.547,5,3,2,0.5968175814649793
19405,703-004-5390,8154.755,5,3,2,0.7879078945160127
19700,703-004-5396,1190.5873,2,0,2,0.27920371738274696
19708,207-008-2398,3467.9556,5,1,4,0.6059137977174031
19711,703-004-5393,9410.318,6,3,3,1.8602325406024247
1974,703-004-5398,6684.0376,3,2,1,0.5462591707758034
19767,703-004-5394,8581.799,3,2,1,0.4722993440895338
19952,703-004-5380,3586.0461,5,2,3,0.7943664367875358
19963,703-004-5387,386.82162,4,3,1,1.4702730608029273
20082,703-004-5385,4013.707,4,3,1,0.605334879091469
20152,703-004-5392,4980.402,5,2,3,0.49378340767961226
20202,703-004-5393,4922.8857,2,0,2,0.27920371738274696
20302,703-004-5395,8994.484,7,4,3,2.5810222428570078
20402,703-004-5384,2121.0044,1,1,0,0.5165268771580819
20650,703-004-5399,4847.596,10,4,6,1.198491772336046
2099,703-004-5386,6287.139,5,3,2,0.8624246746666167
21288,703-004-5389,6215.551,5,3,2,1.1900492547167936
21321,703-004-5397,1028.3965,5,1,4,0.5711548536208918
21411,703-004-5388,4172.506,3,2,1,0.9299398570057075
21684,703-004-5398,7526.655,1,0,1,0.27920371738274696
21794,703-004-5380,7558.35,7,1,6,0.612622312129986
22339,703-004-5390,9452.273,7,2,5,0.7046954764182076
22380,207-008-2398,6770.486,4,2,2,1.0807419821433495
22495,703-004-5389,7150.236,10,6,4,1.259152696525696
22937,703-004-5399,1338.3918,2,1,1,0.6087639945259525
23019,703-004-5393,3312.3816,3,2,1,0.9610973348650742
23067,703-004-5393,6909.8174,7,4,3,1.7625529358851733
2322,703-004-5386,7915.9395,4,2,2,0.5706899975751405
23400,703-004-5382,6834.87,1,1,0,0.5173094214544549
23627,703-004-5386,3418.501,4,2,2,0.928999487534283
23630,703-004-5385,4177.3467,5,3,2,1.7321287971201067
23765,703-004-5382,3343.135,6,4,2,2.8389352104216554
23867,703-004-5380,8105.7544,1,1,0,0.35534489781066697
23878,703-004-5388,3329.7341,2,0,2,0.27920371738274696
23906,703-004-5383,8200.273,4,3,1,0.9097285638838366
24013,703-004-5389,6961.147,3,0,3,0.27920371738274696
24050,703-004-5398,2630.903,4,1,3,0.33853450732658075
24120,703-004-5393,8933.507,4,0,4,0.27920371738274696
24131,703-004-5388,4470.281,4,3,1,1.3645080615401324
24193,703-004-5383,9870.009,8,3,5,0.8298318164707988
24330,703-004-5380,7257.898,2,2,0,0.8023709285237757
24372,703-004-5397,8976.816,1,1,0,0.48431747182819596
2448,703-004-5395,510.66458,1,1,0,0.7331998467794061
24985,703-004-5397,1333.4108,"","","",0.27920371738274696
25058,703-004-5388,5016.461,3,0,3,0.27920371738274696
25186,703-004-5393,5913.6562,5,2,3,0.5354158072547821
25266,703-004-5384,5340.9624,3,2,1,1.269340697718905
25344,703-004-5395,2949.3284,3,2,1,0.7360507999502667
25852,703-004-5397,3451.7593,4,1,3,0.3668247134722495
25961,703-004-5381,1322.8494,2,1,1,0.35831143730785864
26157,703-004-5390,6292.026,5,2,3,0.5767918178154858
26205,703-004-5399,9635.018,4,3,1,1.6241068377638974
26364,207-008-2398,5687.5864,4,2,2,1.0467701877864553
26791,703-004-5384,7392.9375,2,0,2,0.27920371738274696
26917,703-004-5387,4446.805,2,0,2,0.27920371738274696
26933,703-004-5393,4351.1724,4,1,3,0.8645302975947944
27118,703-004-5398,8010.6045,2,2,0,0.6449982929495591
27163,703-004-5383,7169.5107,8,3,5,1.0661874839056993
27411,703-004-5382,4089.4258,3,2,1,1.2786163991334543
27856,703-004-5383,1731.9524,4,1,3,0.43684544085479465
27915,703-004-5386,1615.8617,2,2,0,3.6847702165711844
28205,703-004-5386,5479.7666,4,2,2,0.7545771689677778
28670,207-008-2399,8314.817,5,2,3,1.089411741189256
28702,703-004-5397,7622.1274,5,4,1,2.2753917008952187
29104,703-004-5385,4489.3594,4,1,3,0.32537964429389504
29105,703-004-5386,392.2385,4,1,3,1.1591580846571954
29188,703-004-5395,4213.9233,5,3,2,1.2450995760067511
29260,703-004-5388,6738.6567,1,1,0,0.3755664467280731
29348,703-004-5389,7726.469,3,1,2,0.8073242109694159
29413,703-004-5386,1545.0502,2,1,1,1.0401623870626535
29931,703-004-5391,5393.6074,3,3,0,0.7215519625149144
30014,703-004-5388,9338.011,1,0,1,0.27920371738274696
30038,703-004-5386,9114.082,2,1,1,0.5165268771580819
30128,703-004-5390,5007.3164,1,0,1,0.27920371738274696
3027,703-004-5388,5443.2607,5,1,4,0.6894795619171505
30374,207-008-2398,7583.951,5,1,4,0.383527023033988
30409,703-004-5393,7554.1143,1,0,1,0.27920371738274696
30457,703-004-5383,5661.6787,6,3,3,0.7456750349284952
30461,703-004-5396,3148.902,6,2,4,0.4890064980525552
30480,703-004-5392,2033.6271,6,4,2,1.4890519216755613
30536,703-004-5397,5177.559,7,5,2,1.3778363895290622
30867,703-004-5389,4407.8574,7,3,4,1.4240855431776769
31099,703-004-5393,4685.655,4,2,2,3.8789131277413427
3134,703-004-5385,5100.705,5,4,1,1.6760811228748769
31439,703-004-5398,9050.528,5,4,1,1.4534499980416908
3221,703-004-5380,4228.9785,2,1,1,0.9533952958871679
32397,207-008-2398,6116.265,2,2,0,1.1287017414446219
32613,703-004-5397,6146.3423,7,3,4,0.9214743458144787
32925,703-004-5396,2110.3955,5,4,1,2.810973687346614
33078,207-008-2399,2296.819,4,2,2,0.7619380478508512
33147,703-004-5393,1392.9492,3,3,0,1.1911338605306614
33227,207-008-2399,7154.7065,4,2,2,1.7039610208752836
3338,703-004-5395,4690.9165,7,4,3,0.9947591875269589
33477,703-004-5385,7985.9316,4,2,2,1.5310746306908993
33574,703-004-5385,4222.818,3,2,1,1.3477712906759143
33722,703-004-5384,4705.017,4,3,1,1.4899255612334905
33928,703-004-5389,859.1694,5,1,4,0.6446438743632982
34165,703-004-5387,4432.0137,6,0,6,0.27920371738274696
34355,207-008-2399,5338.0464,6,2,4,1.0845095536005644
3444,703-004-5396,8536.481,8,3,5,0.6644672887434099
34451,703-004-5388,9545.715,6,2,4,0.7252184755643525
34455,703-004-5390,5504.56,6,1,5,0.5063966326815051
34641,703-004-5381,3967.2458,4,1,3,0.3978652972704144
34735,703-004-5383,8450.1875,6,5,1,1.7513565000992788
34765,703-004-5385,7196.5273,4,1,3,0.3978652972704144
34974,207-008-2399,3450.027,2,1,1,0.36951836429724944
36062,703-004-5385,5769.4463,7,1,6,0.32666834933781397
36564,703-004-5391,363.91498,4,1,3,2.2686539752187995
37014,703-004-5384,1288.3907,"","","",0.27920371738274696
37116,703-004-5394,2425.7493,5,3,2,2.171241104200429
37208,703-004-5388,2367.1443,5,3,2,1.4847460672082822
37884,703-004-5394,7834.094,5,3,2,1.0202563203119974
38026,703-004-5381,7987.334,1,1,0,0.478303015736767
38027,703-004-5397,2392.2808,4,0,4,0.27920371738274696
38213,703-004-5384,1972.171,2,2,0,1.780841916260984
38327,703-004-5398,9638.834,3,1,2,0.42233443460076847
38447,703-004-5380,7506.0117,6,2,4,1.6368330750159135
38668,703-004-5382,9897.158,3,2,1,0.5057187849233135
38901,703-004-5394,118.546486,11,6,5,3.807300599530226
39120,703-004-5382,824.1308,4,2,2,1.4198903447482056
39210,703-004-5383,4433.7744,2,1,1,0.5897528238349791
39743,703-004-5389,6754.65,4,0,4,0.27920371738274696
39985,703-004-5382,2619.5383,6,1,5,0.5165268771580819
40508,703-004-5382,277.1753,1,0,1,0.27920371738274696
40758,703-004-5399,5480.9453,4,3,1,1.3989413111820947
41411,207-008-2398,1900.9161,4,2,2,0.6495522307427427
41653,703-004-5396,8350.607,6,3,3,0.8682439219938357
42026,703-004-5397,2563.6572,5,1,4,0.3803330488420116
42146,703-004-5398,3611.7393,3,2,1,0.703631739931137
42407,703-004-5387,5533.254,3,1,2,0.42545960818595857
4244,703-004-5395,1060.8059,2,0,2,0.27920371738274696
42463,703-004-5389,2257.6648,3,3,0,1.2776129219723753
42477,703-004-5393,1360.2036,3,0,3,0.27920371738274696
42583,703-004-5399,9363.837,2,0,2,0.27920371738274696
42780,703-004-5382,1182.4811,2,0,2,0.27920371738274696
42799,703-004-5391,4039.2815,1,0,1,0.27920371738274696
42949,703-004-5382,9215.153,7,3,4,1.3277510163022694
43039,703-004-5397,404.59753,3,1,2,0.4622167084550939
43362,703-004-5381,7735.6177,3,1,2,0.42902947675215286
43602,703-004-5385,6282.8647,"","","",0.27920371738274696
43797,703-004-5390,8398.685,4,3,1,0.6010238105030917
43884,703-004-5398,2264.7542,5,3,2,0.923826825201516
43954,703-004-5392,1396.957,2,2,0,0.6322737228235389
44046,703-004-5380,445.7432,6,2,4,0.6439470430531056
44051,207-008-2399,2505.7834,2,1,1,0.36466335150735635
44709,703-004-5380,1715.2458,4,3,1,2.5675802464377275
44840,703-004-5380,9006.339,4,2,2,1.012992138970303
44886,703-004-5390,3986.2705,5,2,3,0.5645738298292643
44962,703-004-5391,6436.544,3,1,2,0.661160821734423
4512,703-004-5388,2549.156,4,2,2,1.2737994108190145
45260,703-004-5397,3447.6738,1,0,1,0.27920371738274696
45514,207-008-2399,8559.656,8,4,4,1.3607714545528697
45570,703-004-5384,3943.4897,3,2,1,1.1065851921494514
45629,703-004-5380,5887.146,5,1,4,0.61218649771524
45726,703-004-5384,2670.0437,3,1,2,0.3978652972704144
46019,703-004-5380,8614.782,4,3,1,1.3144281496865469
46064,703-004-5390,2772.8384,1,0,1,0.27920371738274696
46195,207-008-2399,5209.0293,3,1,2,1.3597493526261957
46320,703-004-5395,3592.459,6,3,3,2.433601119894937
46437,703-004-5381,30.643345,6,5,1,3.166168773088341
46469,703-004-5398,902.6003,3,2,1,0.43741915723297026
46548,703-004-5399,8254.606,3,1,2,0.33853450732658075
46680,703-004-5387,6933.4272,1,1,0,0.40359590049487803
46739,703-004-5392,9167.736,1,1,0,0.5165268771580819
46791,703-004-5384,9351.456,1,0,1,0.27920371738274696
46812,207-008-2399,2580.2087,2,1,1,0.607283658283721
47488,703-004-5388,7360.255,1,0,1,0.27920371738274696
476,703-004-5384,9993.604,4,2,2,0.8752864996016271
4767,703-004-5384,6492.105,3,1,2,0.35831143730785864
47910,703-004-5388,2676.0232,4,3,1,0.5758576671019155
4796,703-004-5384,5769.8696,5,2,3,0.7480326010190119
47968,703-004-5398,9919.077,3,1,2,0.6912110031284457
47972,703-004-5397,8699.169,7,4,3,2.158597196030754
48216,703-004-5398,373.88266,10,4,6,1.2878963685141596
48522,703-004-5381,2801.8845,4,3,1,0.7679599176892997
48623,703-004-5399,1065.0027,2,1,1,0.42980118992703426
48952,703-004-5384,861.485,4,2,2,0.750805722877955
49153,703-004-5393,9808.682,5,2,3,0.712993707402694
49172,703-004-5383,6445.721,5,3,2,1.2795740105770952
49184,703-004-5389,6589.339,5,3,2,0.9830294655449604
49536,703-004-5399,6681.327,2,2,0,0.6921721881307398
49759,703-004-5394,989.6523,6,1,5,0.378405690877482
49798,703-004-5394,4386.2246,3,3,0,2.186655242639438
5087,703-004-5388,8530.252,3,3,0,1.7448907471006092
5120,703-004-5396,838.50024,1,1,0,0.508821794892578
5158,703-004-5382,4652.2725,5,3,2,2.133122639283638
5392,703-004-5391,6083.0303,5,3,2,1.124496321666402
5739,703-004-5392,5707.5977,5,3,2,1.99237442868778
5929,703-004-5382,44.96157,5,4,1,1.6057876635806176
6004,703-004-5399,8504.354,5,3,2,0.7303452405343008
617,703-004-5394,5377.1763,4,2,2,1.2008959839671574
6237,703-004-5391,6477.229,2,2,0,0.8629959045011387
6509,703-004-5399,3882.433,2,1,1,0.45472927818346964
6916,703-004-5382,7194.994,4,2,2,0.7164024029848485
70,703-004-5382,5633.2456,4,2,2,0.6010256122875138
7332,703-004-5392,6213.6865,5,4,1,2.1194038261988033
7698,703-004-5382,5910.259,5,2,3,0.622342180759183
8021,703-004-5381,2471.0632,7,4,3,1.1749995846142605
8298,703-004-5395,7208.4653,6,3,3,0.9647208476026128
8308,703-004-5392,3715.0173,1,1,0,0.6205411682783655
8314,703-004-5387,4353.5674,4,1,3,0.33853450732658075
8420,703-004-5382,7761.7466,3,2,1,1.0074886960726752
8568,703-004-5384,9373.744,6,2,4,1.012218221408187
8734,703-004-5386,4506.457,4,0,4,0.27920371738274696
8747,703-004-5391,6692.8535,5,2,3,2.1647352757157257
9034,703-004-5383,3865.096,1,1,0,0.49569296668019786
9060,703-004-5388,6007.186,1,1,0,0.5165268771580819
9087,703-004-5385,1291.5581,1,1,0,0.7402160078717024
9245,207-008-2399,9019.364,2,1,1,0.36661177374754705
9356,207-008-2399,9553.364,2,0,2,0.27920371738274696
9983,207-008-2398,6710.4644,3,2,1,0.6906298848598132
1016,703-004-5390,6462.499,1,0,1,0.27920371738274696
10247,703-004-5386,2584.0986,5,4,1,2.3789791920081345
10357,703-004-5386,6013.128,4,1,3,1.2485373642288302
10394,703-004-5396,5750.042,5,2,3,0.7405910571569876
10462,703-004-5391,7678.7676,3,2,1,0.6409190602702127
10544,703-004-5385,9692.654,2,2,0,1.3444224884715155
10946,703-004-5390,3842.8562,6,4,2,1.4726105729286207
11017,703-004-5387,3311.2747,1,1,0,1.0433956841950334
11242,703-004-5384,1759.0636,7,5,2,1.457048806742605
11502,703-004-5388,2383.4382,10,5,5,2.0810115238967555
11550,703-004-5381,2528.531,6,2,4,2.0637439713215455
12193,207-008-2399,8512.447,7,2,5,1.4144030330990656
13339,703-004-5398,5590.116,4,2,2,0.9454085671831681
1354,703-004-5385,7718.593,3,1,2,0.5774145077757602
13621,703-004-5399,7809.4834,5,0,5,0.27920371738274696
13627,703-004-5397,8733.887,7,3,4,1.2005620601293057
13678,703-004-5385,8028.7944,6,1,5,0.9817659654295606
13724,703-004-5395,2102.5884,4,3,1,2.2985760712631453
13797,703-004-5396,1108.1809,4,4,0,1.9712336531373333
13979,703-004-5388,711.0214,6,4,2,1.2171996306604411
14085,703-004-5386,5317.381,3,1,2,0.5107895312027622
14228,703-004-5397,947.59467,4,3,1,1.8982912925708069
14363,703-004-5389,5964.57,2,1,1,0.3919322182760311
14398,703-004-5391,8254.166,6,5,1,3.36423821269997
14559,207-008-2399,6923.859,4,1,3,0.35290739119047443
14623,703-004-5394,7077.7393,5,4,1,2.622957784652266
15179,703-004-5397,7012.64,2,2,0,0.8267876469045085
1520,703-004-5394,728.7234,2,1,1,0.547124760796273
15526,703-004-5399,7429.3994,2,0,2,0.27920371738274696
15640,207-008-2398,3457.3132,4,0,4,0.27920371738274696
16083,703-004-5380,4534.242,3,2,1,0.7542659735822308
16335,703-004-5389,6356.321,3,2,1,0.8416529160768543
1659,703-004-5384,3297.6836,3,2,1,1.5414801165099117
16874,703-004-5382,4542.8936,3,2,1,2.139199931887793
17191,703-004-5390,3548.777,5,3,2,0.7906226242102293
17347,703-004-5384,5759.617,7,5,2,1.043848965545921
174,703-004-5399,6254.359,6,1,5,0.3883204972791438
17842,207-008-2398,5540.3257,4,3,1,1.9658777984235822
1829,703-004-5381,5807.3677,6,2,4,0.4761048423079639
18583,703-004-5386,647.3863,8,4,4,1.8508512807149093
19040,703-004-5392,5561.533,5,3,2,1.4766025661395763
19304,703-004-5387,5045.4556,4,4,0,1.7587059155294646
19661,703-004-5390,3687.4062,6,4,2,0.7640450761231172
19848,703-004-5388,6869.382,1,1,0,0.693377298001315
20283,703-004-5389,5226.927,3,2,1,2.055486529454692
20328,703-004-5380,224.8764,7,7,0,3.2961046676781773
206,703-004-5383,5740.611,3,2,1,1.1167160465360249
20674,703-004-5393,927.8423,6,3,3,1.1316846384299484
2077,703-004-5384,6680.65,4,1,3,0.4158623035533774
20834,703-004-5395,2119.837,8,5,3,2.6046391989796898
20949,703-004-5392,7598.648,4,2,2,1.3604219308238126
21622,703-004-5393,8348.434,3,1,2,1.22759278519405
21635,703-004-5380,2753.401,2,1,1,0.5165268771580819
21772,703-004-5382,6775.751,4,1,3,0.6795876648537181
21931,703-004-5384,1633.045,6,4,2,1.3992085287584979
22187,207-008-2398,5602.9004,2,1,1,2.1759398689633818
22421,703-004-5386,5425.0664,4,1,3,1.79904099280263
22457,703-004-5390,6171.366,7,4,3,1.2730109968521104
22547,703-004-5382,9532.196,4,2,2,1.3260592902618464
22609,703-004-5386,8446.932,6,3,3,1.1655759575958242
22702,703-004-5393,1639.3865,3,3,0,1.23006647506029
22795,703-004-5387,7928.934,4,3,1,0.896532614110792
22858,703-004-5381,5143.4033,7,1,6,0.4708587561146528
2300,703-004-5386,7309.8423,1,1,0,0.35831143730785864
23099,703-004-5394,1542.4537,"","","",0.27920371738274696
23259,703-004-5398,5427.6587,3,2,1,0.5902132176049185
23941,703-004-5396,7655.4697,1,0,1,0.27920371738274696
2438,703-004-5391,1936.9459,4,2,2,1.026466251834379
2444,703-004-5391,4733.878,1,1,0,0.5813991086199556
24547,703-004-5396,612.489,3,0,3,0.27920371738274696
24729,703-004-5394,7969.8096,2,1,1,0.6388224679298091
24793,703-004-5380,2813.0251,3,1,2,0.7585113010162942
25214,703-004-5390,6484.5557,6,4,2,1.3959701954563464
25510,703-004-5399,9957.302,3,1,2,0.5771198123833304
25690,703-004-5390,2274.5847,5,2,3,0.8221975715783374
25844,703-004-5381,1977.9003,4,1,3,0.616741618139247
26511,703-004-5387,1234.374,2,2,0,1.10635651900235
27103,703-004-5392,6739.022,1,0,1,0.27920371738274696
27491,703-004-5397,2928.4065,5,3,2,1.0582716204810634
27588,703-004-5392,369.19952,3,1,2,0.6913803873327357
27615,703-004-5381,667.6209,7,4,3,1.6984972000204277
2766,703-004-5385,5259.585,5,3,2,2.009886032816651
2798,207-008-2399,9269.818,3,2,1,0.6145071341494599
28231,703-004-5388,7868.151,6,5,1,2.1743688610723293
2826,703-004-5392,4484.0864,3,1,2,1.1342489855280393
28292,703-004-5394,6970.4204,6,4,2,2.0892036515643544
28386,703-004-5392,8692.489,6,1,5,0.47128621378604374
28393,703-004-5384,5966.508,3,2,1,0.9814880379263129
28623,703-004-5387,7339.8726,4,3,1,0.9691447693220111
29064,703-004-5387,6376.1406,3,2,1,0.6665567282056579
29110,703-004-5388,8561.84,7,2,5,0.99620027130942
29524,703-004-5383,7183.7,2,0,2,0.27920371738274696
30033,703-004-5392,7028.1343,3,2,1,0.4632065351810446
30240,207-008-2399,2528.5422,3,1,2,0.9775082803530396
30354,703-004-5387,1952.2452,3,1,2,1.12993475723535
30464,703-004-5398,9700.413,8,6,2,1.124174020233747
30576,703-004-5388,7398.549,6,1,5,0.3637500930527101
3113,703-004-5390,2013.5367,4,3,1,0.8260852185476549
31184,207-008-2398,5034.314,3,1,2,0.3919322182760311
31322,703-004-5389,3895.327,2,0,2,0.27920371738274696
31346,703-004-5385,4564.381,2,1,1,0.5131226778349266
31891,703-004-5392,9554.08,5,3,2,0.7894541434061088
32273,703-004-5391,2881.2402,4,2,2,0.5830303869700347
32624,703-004-5399,2935.629,7,4,3,1.2271328599282516
32818,703-004-5380,8844.711,3,2,1,0.9379479224025065
3282,703-004-5398,4988.182,2,1,1,0.40035536366859825
33251,703-004-5388,4265.7446,3,1,2,0.7037447041243164
33325,703-004-5385,2954.2417,3,2,1,0.3922147458471921
33462,703-004-5381,2706.7583,2,2,0,0.8271041580609951
33781,703-004-5397,1292.4773,8,5,3,2.7907811062774406
33936,703-004-5383,7895.0723,2,1,1,0.9769431069726475
34004,703-004-5399,7334.373,2,1,1,0.3889656787788394
34350,703-004-5383,2757.9587,3,3,0,0.8145832534224482
34363,207-008-2399,5560.83,6,1,5,0.5284285282784336
34365,207-008-2399,3987.7253,3,1,2,0.5281773430042404
34526,703-004-5385,598.92175,2,0,2,0.27920371738274696
34918,703-004-5390,8070.257,4,3,1,1.0778824156262914
35427,703-004-5382,2508.6594,2,2,0,1.4269815946827034
35478,703-004-5385,608.5628,6,1,5,0.7333699379160409
35609,703-004-5393,7867.6533,4,2,2,1.0112971285694927
35641,703-004-5392,1137.5463,6,2,4,1.8337580378358518
35719,703-004-5396,3217.027,"","","",0.27920371738274696
36338,207-008-2399,1181.4851,4,2,2,1.258415147420848
36421,703-004-5387,3395.3994,6,3,3,0.8357030213084421
36453,207-008-2399,3026.809,9,4,5,1.7080850363759763
36607,703-004-5385,1139.6461,3,2,1,0.5181242748842015
3674,703-004-5383,1649.5597,4,3,1,1.1502416358394578
36858,703-004-5388,8837.0,3,2,1,0.6719638912518736
36948,207-008-2399,27.71318,3,1,2,0.35831143730785864
37133,703-004-5391,6923.1523,4,3,1,1.3314282846430625
37270,703-004-5397,2944.3806,3,2,1,1.0988076804598745
37719,703-004-5389,6813.1646,1,0,1,0.27920371738274696
37764,703-004-5388,3558.6423,2,1,1,0.5448979648981335
3789,207-008-2399,7254.2285,6,5,1,2.5106048016641864
38373,703-004-5389,6654.869,4,3,1,0.5783297833495753
38518,703-004-5397,1088.7725,4,3,1,1.543586852335487
38690,703-004-5394,2000.3408,4,3,1,1.1384209195550454
39174,703-004-5381,7810.116,1,1,0,0.33853450732658075
39212,703-004-5392,6840.019,2,1,1,0.4674213744331319
39345,703-004-5390,1413.0664,3,1,2,0.5369114388287168
3955,703-004-5382,7333.488,4,2,2,0.41548736592248237
40081,703-004-5390,4247.6606,6,3,3,1.9270692403872614
40551,703-004-5390,6968.1216,5,3,2,2.019077436591141
40925,703-004-5387,5481.1455,7,5,2,1.2872312222258873
41132,703-004-5383,4123.4033,7,4,3,1.649419415691891
41237,703-004-5389,5454.547,6,3,3,1.1281001459901834
4140,703-004-5396,3686.3457,2,0,2,0.27920371738274696
41513,703-004-5399,3898.2307,3,2,1,1.0061452284491257
41557,703-004-5383,6271.4673,2,0,2,0.27920371738274696
41591,207-008-2399,8210.935,10,5,5,2.1667032630859624
41842,703-004-5387,6239.3975,8,3,5,0.931018368015698
41934,703-004-5382,4348.0938,5,1,4,0.6746394038389635
42013,703-004-5397,6298.823,4,1,3,0.35534489781066697
42060,703-004-5382,5300.9014,7,4,3,1.9709603930887407
42174,703-004-5389,820.1688,5,1,4,0.6123461029173735
42184,703-004-5389,1255.5922,4,2,2,0.8506648348857987
42255,703-004-5388,7199.7886,1,0,1,0.27920371738274696
42405,703-004-5385,4741.548,4,2,2,1.3872342081094624
42468,703-004-5380,586.09607,6,2,4,0.7138324328662905
42744,703-004-5397,1192.6079,8,4,4,1.5128820836598085
42746,703-004-5380,2845.89,3,1,2,0.7321381287982034
42981,703-004-5385,8613.419,1,1,0,0.5165268771580819
43137,703-004-5382,2046.079,4,1,3,0.3737466080357567
43560,703-004-5384,529.39294,5,3,2,0.9499837710327875
43846,703-004-5381,6661.5005,5,0,5,0.27920371738274696
44167,703-004-5394,8470.317,3,0,3,0.27920371738274696
44303,703-004-5386,8421.857,6,2,4,1.5960040507568019
44311,703-004-5381,5677.4966,3,3,0,1.7911929292204596
44750,703-004-5389,5589.51,4,1,3,0.3978652972704144
44760,703-004-5383,2929.642,9,4,5,1.0233953169423455
45116,703-004-5380,4974.217,5,1,4,0.37696726257082286
45310,207-008-2398,8735.183,7,4,3,3.911842375394925
45411,703-004-5387,6468.239,1,0,1,0.27920371738274696
45488,703-004-5392,7550.841,4,2,2,1.1477351596635912
4557,703-004-5396,7951.4263,5,3,2,2.25232545288937
45702,207-008-2399,4244.5205,"","","",0.27920371738274696
45759,703-004-5381,7500.0713,3,3,0,0.802466206018937
45777,703-004-5395,4585.271,8,3,5,3.1741650192130306
45808,703-004-5393,7476.278,4,3,1,1.5552601544805023
45955,703-004-5398,1649.0721,1,0,1,0.27920371738274696
46029,703-004-5383,1955.2451,5,2,3,0.664366890095659
46100,207-008-2398,7300.51,4,3,1,3.82099061423324
46134,703-004-5380,8233.816,3,2,1,0.7257125302325967
46499,703-004-5383,2782.3066,8,3,5,1.7800618893333742
46600,703-004-5380,5883.908,8,4,4,0.8147975203482387
46699,703-004-5399,8695.478,6,3,3,2.135918023376863
46828,703-004-5397,5314.4976,4,0,4,0.27920371738274696
46864,703-004-5398,176.26225,4,2,2,0.7056437170869256
46916,703-004-5382,7454.617,4,2,2,1.1934560868381952
47349,703-004-5382,5019.188,3,3,0,0.7256306931693638
47605,703-004-5385,3330.5215,1,0,1,0.27920371738274696
4762,703-004-5383,6080.5815,4,2,2,0.9672328702898674
47682,703-004-5380,9218.367,5,1,4,0.6343844679675545
48492,703-004-5387,1184.2979,9,5,4,4.409616554268893
4867,703-004-5384,8478.94,4,3,1,1.6402618158723987
48898,703-004-5394,4998.681,3,2,1,1.100604742188431
48973,703-004-5395,2386.2737,5,2,3,1.204035786848896
49134,703-004-5389,3284.759,8,2,6,1.0957193624560884
49221,703-004-5389,7699.9287,5,3,2,0.8113537302073492
4928,703-004-5387,6964.7334,3,2,1,0.4330089018471452
49362,703-004-5397,6552.186,3,0,3,0.27920371738274696
49480,703-004-5389,8297.061,4,1,3,0.5363915827168781
49746,703-004-5388,3435.1575,3,1,2,0.6772569371746499
49867,703-004-5397,4773.8154,9,6,3,1.4706455327244365
49979,703-004-5392,1627.8035,4,4,0,3.5209702095853856
5233,703-004-5382,6674.701,2,1,1,0.36112942321953473
5699,703-004-5389,2225.1343,8,6,2,1.0417431091633362
5747,703-004-5391,1231.8278,3,2,1,0.703887014205379
5969,703-004-5388,9224.027,5,3,2,1.887139555334073
6141,703-004-5394,5721.286,8,3,5,1.3733964150869653
6160,703-004-5396,1482.9606,5,4,1,1.2566554990326713
619,703-004-5395,9366.873,7,4,3,2.3101058454117105
6461,703-004-5393,8164.7056,3,3,0,1.7457190800337286
6769,703-004-5381,8164.85,5,2,3,0.5960725026936099
6971,703-004-5380,6684.278,3,3,0,1.0026329567860022
733,703-004-5399,5210.2476,4,4,0,0.8511681925376767
745,703-004-5380,5301.9707,2,1,1,0.35831143730785864
7712,703-004-5394,6274.3794,3,2,1,0.6592961445355251
772,207-008-2399,641.57367,1,0,1,0.27920371738274696
7878,703-004-5389,7432.934,4,2,2,0.4776527331183619
7903,703-004-5391,4266.2124,5,3,2,1.2682084894738848
7946,207-008-2399,2712.9792,10,5,5,1.4609291660856794
7955,703-004-5385,6649.4688,10,5,5,2.6549414779536136
7977,703-004-5386,9503.588,1,0,1,0.27920371738274696
7984,703-004-5399,2281.385,2,0,2,0.27920371738274696
8216,703-004-5399,7984.2754,3,1,2,0.3468408179187174
8530,703-004-5386,784.39233,4,2,2,1.121165234848965
8765,703-004-5391,376.82654,5,3,2,2.7248080720551946
9205,703-004-5386,1164.67,2,1,1,0.5618245481284685
9305,703-004-5395,8142.887,3,2,1,0.6611476173335483
9646,703-004-5380,5853.919,3,3,0,0.696047564804607
10001,703-004-5386,5718.4897,1,1,0,1.4093809760041554
10437,703-004-5380,1670.2169,3,1,2,0.936744616677413
10455,703-004-5385,4381.8604,6,4,2,2.0980203475682404
10548,703-004-5383,55.000782,2,1,1,0.7705891900012282
10944,703-004-5384,4768.706,3,2,1,0.5291404147429578
11187,703-004-5395,4447.908,2,2,0,0.7127688427670547
11302,703-004-5390,3636.3328,3,0,3,0.27920371738274696
11521,703-004-5399,7021.154,7,6,1,4.377519122238669
11697,703-004-5397,8736.735,3,1,2,0.7388496140713972
11826,703-004-5390,7860.7993,6,1,5,0.6907837226815847
11828,703-004-5386,9971.92,2,1,1,0.30886911235466386
12036,207-008-2399,118.940475,3,2,1,1.376772341415519
1232,703-004-5389,7701.4556,3,2,1,0.7315954860336321
12463,703-004-5392,4522.537,3,1,2,0.6620503580634534
12999,703-004-5391,1525.0122,4,3,1,1.1138521330400337
13299,703-004-5390,1100.7816,3,1,2,0.7152375566801
13303,703-004-5394,48.128963,5,4,1,2.5904211543617395
13446,207-008-2398,8898.924,3,0,3,0.27920371738274696
13690,703-004-5381,568.074,9,6,3,2.135564705148951
13864,703-004-5380,63.04264,6,3,3,1.5432143840849621
13923,703-004-5386,3563.3271,5,2,3,1.4656938396373758
13954,703-004-5389,4112.6006,6,5,1,2.8856625625742187
14634,703-004-5380,3677.7961,4,2,2,0.8376827742578027
15038,703-004-5382,5672.4517,4,1,3,0.5292787737974164
1509,703-004-5384,6889.9536,2,0,2,0.27920371738274696
15222,703-004-5385,3246.6858,4,2,2,1.0661714002087164
15318,703-004-5386,5293.241,2,0,2,0.27920371738274696
15328,703-004-5388,9419.732,4,1,3,0.7355302896885763
15798,703-004-5390,3424.791,8,6,2,2.350571975040946
15967,703-004-5398,5039.614,9,7,2,3.644450258379879
16180,703-004-5396,7231.1616,3,2,1,0.7864819714025253
16243,703-004-5380,8135.1826,4,2,2,2.1509722098799804
16407,703-004-5391,6706.8193,6,3,3,0.8538384114817518
168,207-008-2399,4156.495,5,4,1,0.9954042557151215
16936,703-004-5386,6601.487,2,0,2,0.27920371738274696
17167,703-004-5396,4876.739,2,0,2,0.27920371738274696
17206,703-004-5382,8434.7,5,4,1,1.1405794797205013
17338,703-004-5383,8409.012,3,1,2,0.385873767671945
17385,703-004-5399,210.63864,3,1,2,0.3822662437476815
17434,703-004-5394,8283.847,6,4,2,1.1720693482796223
17526,703-004-5393,2515.8828,6,2,4,1.2156485284071874
17528,703-004-5380,4529.138,3,3,0,0.7963363211889466
17780,703-004-5393,9801.778,3,0,3,0.27920371738274696
17789,703-004-5395,2904.7227,2,1,1,0.39543778421428455
17875,703-004-5384,5550.286,1,0,1,0.27920371738274696
17965,703-004-5396,6879.1646,2,1,1,0.43219001334010804
18133,703-004-5390,5458.1523,8,5,3,2.4262623694996606
18142,703-004-5392,3991.183,2,0,2,0.27920371738274696
1816,703-004-5381,967.7601,9,5,4,2.8061692649681134
18677,703-004-5394,4592.9897,"","","",0.27920371738274696
18843,703-004-5387,8140.774,6,2,4,1.8493313796987283
18920,703-004-5392,979.50397,4,2,2,1.032676149512896
19018,703-004-5388,7988.108,3,1,2,0.33556796782938897
19110,703-004-5387,4472.304,4,2,2,1.1372825954712171
19270,703-004-5399,8384.342,3,1,2,0.790346418443955
1959,207-008-2398,6211.324,3,3,0,0.923320190463321
19769,703-004-5396,3938.2107,12,7,5,3.228987252616101
19886,703-004-5380,6506.0,3,2,1,1.1804860809531375
2002,207-008-2398,4371.565,4,1,3,0.7340927166687764
20023,207-008-2399,4565.327,8,3,5,2.1471538264874646
20088,703-004-5381,3920.486,3,3,0,2.9842697644596257
20374,703-004-5391,2909.1824,3,2,1,1.2847054347227176
20399,703-004-5390,6100.2246,2,0,2,0.27920371738274696
20405,703-004-5390,4007.578,3,0,3,0.27920371738274696
20608,703-004-5395,722.39935,4,0,4,0.27920371738274696
20654,703-004-5394,1212.827,6,4,2,0.6981470775830239
20979,703-004-5393,7670.7954,2,2,0,0.7512588400371201
21143,703-004-5398,1176.8359,5,3,2,1.0024104433846703
21265,703-004-5382,8492.98,2,1,1,0.4350018176736044
2140,703-004-5388,3965.5327,4,3,1,0.8543993202292424
22029,703-004-5386,5970.8486,7,3,4,2.6057612499224523
22427,703-004-5394,5063.722,5,1,4,0.7608654995557472
2250,703-004-5390,1375.9404,7,2,5,1.021127831329968
22867,703-004-5385,5470.543,3,1,2,1.3053409387931025
22932,703-004-5395,2968.2708,5,1,4,0.3978652972704144
23012,703-004-5390,5640.7427,5,3,2,1.4882678456446732
2330,703-004-5382,1968.3367,1,0,1,0.27920371738274696
2365,703-004-5382,154.70088,4,2,2,0.4218801408191091
2371,703-004-5384,8216.681,3,2,1,0.830459256618352
24085,703-004-5395,1518.3895,4,1,3,0.5398953212147518
24199,703-004-5384,3783.0503,2,0,2,0.27920371738274696
24415,703-004-5387,4404.7373,7,4,3,1.6075901716132022
24660,703-004-5394,5105.2476,3,2,1,0.5986473809065928
24750,703-004-5394,5954.0474,5,3,2,0.969326083392926
25005,703-004-5396,351.97018,3,1,2,0.655264491466194
25012,207-008-2398,2268.102,9,2,7,0.7281742795960147
25131,703-004-5394,5840.038,2,0,2,0.27920371738274696
25211,703-004-5398,8288.907,1,0,1,0.27920371738274696
25336,703-004-5394,6682.339,4,3,1,2.0117516093836274
25400,703-004-5395,8148.4287,2,1,1,0.7637689214910047
25402,703-004-5385,5676.4116,3,1,2,0.3807252912866403
25550,703-004-5387,5457.0156,3,2,1,0.6875657367373097
25618,703-004-5381,3770.1387,2,1,1,0.45610317751171203
25697,703-004-5399,1382.2234,3,1,2,0.3902511792276225
25751,703-004-5395,2535.0295,4,1,3,0.5996425155497119
26009,703-004-5397,5779.5244,3,1,2,0.3978652972704144
2612,703-004-5399,7579.014,4,4,0,1.1857236066975765
26382,703-004-5393,9537.876,7,6,1,1.371635161506842
26429,703-004-5386,9475.503,4,3,1,1.2551768700815267
26469,703-004-5399,5394.5967,5,2,3,0.4991706104449624
26624,703-004-5393,3116.2583,4,2,2,0.8210915988697618
27063,703-004-5395,2456.9666,4,3,1,0.8369562307145094
2711,703-004-5390,771.60596,6,3,3,1.096546059222254
27146,703-004-5385,2272.4878,4,1,3,0.614105445864063
27243,703-004-5392,220.80779,8,4,4,1.6773520800375987
2734,703-004-5389,2191.59,1,1,0,0.9301305074330521
27477,703-004-5399,9855.869,7,3,4,1.43362902826868
27533,703-004-5395,1566.7075,6,4,2,1.0358169789834202
27847,703-004-5384,5307.439,7,6,1,1.6575393988506104
2803,703-004-5389,5106.553,8,4,4,1.393672942134779
2835,703-004-5389,8020.7314,9,7,2,2.1599966320925943
28520,703-004-5394,4956.065,4,4,0,1.2904957534559882
28859,703-004-5393,9424.563,6,4,2,2.127968896222563
29037,703-004-5399,8334.398,3,1,2,0.33853450732658075
29627,703-004-5397,5912.593,4,1,3,0.37175974969512765
29745,703-004-5389,2854.7812,9,6,3,2.5706817683868044
29771,703-004-5383,5863.837,4,1,3,0.5837684390944268
29833,703-004-5381,2572.6355,4,1,3,0.5165268771580819
302,703-004-5390,7606.479,5,1,4,1.5240050111138492
30249,703-004-5392,4982.27,2,2,0,0.8596963590787897
30294,703-004-5392,4804.444,5,1,4,0.4445647801509251
30517,703-004-5387,7145.3794,5,2,3,0.5936994930097648
30696,703-004-5381,2733.621,5,1,4,1.2597878841874564
30704,703-004-5399,6373.9062,4,3,1,1.900992428492673
31008,703-004-5380,7937.867,2,2,0,0.8898226885500979
31065,703-004-5383,8886.983,4,1,3,0.49674156258253066
31647,703-004-5396,9189.172,6,4,2,1.510210591633153
31710,703-004-5389,6764.7837,4,3,1,1.201116580262165
31994,703-004-5395,8883.391,3,0,3,0.27920371738274696
32269,703-004-5398,3936.9214,5,4,1,1.6055844735485365
32352,703-004-5393,9814.238,4,3,1,1.0121764626475367
32488,703-004-5387,5819.2627,4,2,2,1.6638307720731607
32616,703-004-5388,7415.1025,5,3,2,0.9797676090387901
3274,703-004-5389,7223.8076,1,1,0,0.5483892812233162
3321,703-004-5388,2090.615,3,1,2,1.2391179326220345
33246,703-004-5382,9710.16,1,0,1,0.27920371738274696
33335,703-004-5382,3622.1748,2,1,1,0.48439918023986245
33538,703-004-5388,4195.8555,1,0,1,0.27920371738274696
33689,703-004-5390,9186.646,2,1,1,0.48012232848729475
34014,703-004-5388,9922.595,3,3,0,0.8296528318893643
34330,207-008-2398,2441.4104,4,2,2,0.8395953078743074
34590,703-004-5391,3838.7405,4,2,2,0.6155147240127994
34631,703-004-5399,1337.5073,3,2,1,0.41922438165019454
35256,703-004-5381,9466.361,7,6,1,1.325270357202621
35753,703-004-5380,6373.4736,2,0,2,0.27920371738274696
35836,703-004-5386,7789.4087,2,2,0,0.6351884570457493
3595,207-008-2399,304.42297,8,4,4,1.151717895453391
36810,703-004-5397,141.31308,2,2,0,1.0177720981645697
37171,703-004-5398,6164.089,1,1,0,1.0629246780968875
37466,703-004-5395,8870.952,5,1,4,1.6198567543030062
38121,703-004-5394,1274.0446,6,2,4,0.4799970735111797
38143,703-004-5392,7685.745,3,1,2,0.4403893741455704
38343,207-008-2399,3317.489,6,4,2,1.4279917896971834
38431,703-004-5394,7975.282,5,2,3,0.6482414594223957
38669,703-004-5384,3450.4324,5,0,5,0.27920371738274696
38790,703-004-5383,8009.1523,4,2,2,1.0650408779644605
39131,703-004-5397,8136.6665,1,0,1,0.27920371738274696
39402,703-004-5397,6936.742,3,2,1,0.6531115093931821
39708,207-008-2399,6571.8574,5,3,2,0.9405331631909616
40179,703-004-5386,2491.1028,6,2,4,0.4687495224976859
40673,703-004-5398,2889.4336,3,1,2,0.6547620827904425
40875,703-004-5393,4949.3247,4,4,0,1.5304461308118504
40978,703-004-5386,4015.55,7,4,3,1.4836049740439647
41533,703-004-5384,6202.0854,1,0,1,0.27920371738274696
4159,703-004-5384,4528.947,2,2,0,0.597981285635933
41715,703-004-5386,1453.2119,3,2,1,1.589564117211944
41837,703-004-5393,9518.699,5,3,2,6.004017904597408
4201,703-004-5386,1770.0886,3,3,0,0.8314067132386838
42035,703-004-5391,3288.1372,1,0,1,0.27920371738274696
43108,703-004-5393,9503.98,6,3,3,1.3666892006367695
43392,703-004-5396,8631.38,6,3,3,1.340556671155389
43659,703-004-5393,2919.2395,7,3,4,1.2199886316831836
43757,703-004-5399,2356.4814,6,1,5,0.4191550228080743
44109,207-008-2398,9165.238,4,2,2,1.1575511033748505
4458,703-004-5396,9174.183,7,0,7,0.27920371738274696
44646,703-004-5386,9757.095,3,2,1,1.3867396137148689
44961,703-004-5399,8208.717,5,2,3,1.1386258341333804
45057,703-004-5386,3025.533,4,1,3,0.33853450732658075
45077,703-004-5386,1300.928,4,3,1,1.986385207666618
45166,703-004-5393,4026.3123,7,1,6,0.3978652972704144
453,207-008-2398,2475.7534,7,5,2,2.077169267211703
45476,703-004-5394,1470.6594,4,3,1,0.674323192105535
45478,703-004-5395,800.4433,5,2,3,2.619300221323311
45530,703-004-5394,953.0222,8,4,4,1.908317009225039
4576,703-004-5380,8062.806,6,3,3,0.8554409374446117
45898,703-004-5382,6975.6523,5,2,3,1.6056993398023705
46068,703-004-5391,3325.8862,7,4,3,1.8444597915183387
46255,703-004-5395,1972.9722,6,4,2,1.1487320115643174
46289,703-004-5395,1344.2081,5,4,1,1.1465925971699096
47256,703-004-5389,6188.384,6,5,1,1.699857930795706
48350,207-008-2398,8973.122,1,0,1,0.27920371738274696
48352,703-004-5384,3636.4858,5,1,4,0.5795537988915098
48512,703-004-5395,9940.117,2,2,0,0.6604445864281497
48711,207-008-2399,9747.828,4,3,1,1.600326841369014
48715,703-004-5396,6607.876,8,3,5,1.164745466273295
49054,703-004-5391,6803.024,1,0,1,0.27920371738274696
49539,703-004-5383,8841.766,14,5,9,1.4693333777755069
49603,703-004-5380,2334.7432,5,1,4,0.39017420964103994
4971,703-004-5385,2490.4233,4,0,4,0.27920371738274696
49957,703-004-5392,1969.3887,4,0,4,0.27920371738274696
502,703-004-5398,6787.2036,6,4,2,1.4933479502871334
5367,703-004-5380,6655.8516,3,3,0,0.6587816671830324
6131,703-004-5394,7605.5728,3,3,0,1.0147440343873624
6191,703-004-5393,9215.209,2,1,1,0.5289017152912969
6292,207-008-2399,7213.8267,9,4,5,1.9408942729332515
632,703-004-5387,2379.9622,4,2,2,0.7364866340447291
6406,703-004-5388,9431.494,4,2,2,0.8435600409370678
6736,703-004-5387,407.8561,2,1,1,0.4105080550897396
7017,703-004-5382,9165.889,2,2,0,0.6778857413713635
7479,703-004-5396,3083.797,3,2,1,0.6284079222435288
7579,703-004-5383,5507.345,3,1,2,0.551575429294277
761,207-008-2398,6460.0728,6,2,4,0.9734172297464481
7614,703-004-5399,8714.749,3,2,1,0.5905831286299956
8034,703-004-5394,1878.528,3,2,1,2.5863731769836895
8287,703-004-5381,4328.2275,4,1,3,0.4168256048512154
8589,703-004-5385,140.9632,4,3,1,0.5488974736238664
8817,703-004-5395,6191.149,4,2,2,0.7463673464112012
9070,703-004-5380,7187.7285,7,1,6,0.3496782717458438
9181,703-004-5391,7931.733,3,2,1,0.4258925032088821
921,703-004-5398,2481.277,3,2,1,1.4417737411876173
9428,703-004-5381,5411.765,1,0,1,0.27920371738274696
9499,703-004-5394,6427.19,4,2,2,2.4029568984012535
9573,703-004-5395,6255.7866,5,4,1,1.9403488317103252
9736,703-004-5389,8799.924,6,3,3,1.682874565285171
9797,703-004-5393,924.21594,"","","",0.27920371738274696
9928,703-004-5385,5261.0107,3,3,0,0.7354199462730552
9943,703-004-5389,1393.1334,4,1,3,0.33853450732658075
1007,703-004-5386,602.39435,4,3,1,2.200758493202172
10164,703-004-5394,2576.1777,6,5,1,1.9268633346600477
10194,703-004-5393,4183.2866,3,3,0,2.7535895432549347
10499,703-004-5380,6483.532,2,0,2,0.27920371738274696
1060,703-004-5388,2897.7375,6,3,3,1.3749888918966249
10697,703-004-5395,9622.147,1,1,0,0.37175974969512765
11090,703-004-5390,9538.595,5,2,3,0.6225615893998727
11287,703-004-5383,2454.0264,1,1,0,0.38364316645287805
11452,703-004-5385,1688.1305,5,2,3,0.5345735987506839
11963,207-008-2399,4703.185,3,1,2,0.39141071155093826
11986,703-004-5392,5365.9614,4,3,1,0.9374057987264033
12207,703-004-5391,2352.118,3,2,1,1.157097871644054
12326,703-004-5395,6355.58,3,2,1,0.6785440856802368
12760,703-004-5383,5592.2676,1,0,1,0.27920371738274696
1294,703-004-5392,8075.55,3,0,3,0.27920371738274696
1337,703-004-5396,1224.088,2,1,1,0.45995797668807115
13602,703-004-5391,8659.934,5,2,3,1.1122568998879498
13768,207-008-2398,7355.858,7,4,3,0.9313325986273641
13887,703-004-5396,590.1623,6,1,5,0.5867959807439311
14024,703-004-5399,5454.1206,7,4,3,1.618100048387811
14250,703-004-5391,2939.6372,3,1,2,0.9637719226114574
14342,703-004-5399,6505.651,4,2,2,0.6181407215819705
14730,703-004-5393,5665.5796,3,1,2,0.5344881047364122
15118,703-004-5392,6211.5933,3,0,3,0.27920371738274696
15225,703-004-5395,4923.3774,5,2,3,1.0136699556986013
15282,207-008-2398,4330.8447,6,2,4,0.6941929276448919
15583,703-004-5381,7111.552,9,6,3,3.0633980241463665
15713,703-004-5389,8564.003,"","","",0.27920371738274696
15749,703-004-5394,5998.1685,5,2,3,0.7121898036130474
15751,703-004-5391,2467.742,2,1,1,0.476377958811297
1639,703-004-5388,4314.267,5,0,5,0.27920371738274696
16408,703-004-5387,6084.0835,5,2,3,0.6637175891520543
166,703-004-5393,206.4699,4,0,4,0.27920371738274696
16659,703-004-5386,9708.369,3,2,1,1.1363412028350268
16905,703-004-5385,5657.5366,4,1,3,0.4700976111946808
16938,703-004-5391,3661.468,3,1,2,0.7121325965340664
16989,207-008-2399,3676.5837,2,1,1,0.4006692038855996
17148,207-008-2399,343.35138,4,2,2,0.9973578457439075
17221,703-004-5390,408.3806,4,3,1,0.9405898976782804
17410,703-004-5384,892.1474,2,0,2,0.27920371738274696
1777,703-004-5383,8395.109,"","","",0.27920371738274696
17797,703-004-5386,3404.1238,2,0,2,0.27920371738274696
17818,703-004-5385,2470.2192,6,4,2,2.033557746082626
1792,703-004-5396,3702.5857,6,3,3,1.2981981260165165
1822,207-008-2399,4369.4907,7,3,4,1.3777332054695763
18421,703-004-5394,7846.051,1,0,1,0.27920371738274696
18880,703-004-5391,7212.3887,3,3,0,0.8469037216344268
19128,703-004-5387,5961.669,7,2,5,0.88547822095969
19551,703-004-5390,4123.289,5,4,1,1.143772208184855
19741,703-004-5392,4645.664,3,2,1,0.5588087934982346
1995,207-008-2398,4237.269,8,6,2,2.4988957996800445
20085,703-004-5386,9332.931,4,3,1,1.2978770850681611
20150,703-004-5385,4666.091,6,3,3,1.4901327358652263
20169,703-004-5389,2979.9448,3,1,2,0.42921476731865355
20871,703-004-5388,8703.632,4,3,1,1.253266796456702
21020,703-004-5397,5814.453,1,1,0,0.34693970256862383
21030,703-004-5397,2892.0012,5,3,2,0.8322151349364106
21301,703-004-5393,721.1107,3,1,2,0.5310334525883924
21347,703-004-5381,5873.982,3,2,1,1.7858490069228175
21512,703-004-5398,8372.913,4,3,1,1.5656261073222182
219,703-004-5398,5731.1787,3,3,0,1.256882173733168
22002,703-004-5398,9965.682,6,3,3,0.7732502237327467
22525,703-004-5395,1675.5819,4,3,1,0.5836964622279766
22661,703-004-5388,9870.221,4,2,2,0.9615753359517593
22891,703-004-5385,2557.351,3,2,1,1.5885596068739705
23042,703-004-5383,2712.8577,5,1,4,1.2681583529401363
23231,703-004-5386,338.36127,7,3,4,0.9771682061403342
23237,703-004-5387,7796.803,4,3,1,1.165983615091169
23577,703-004-5384,6292.399,6,2,4,1.0017347867591173
23662,703-004-5395,5990.7812,1,1,0,1.110609879493305
24405,703-004-5392,1093.6702,4,2,2,0.6833619947313704
24939,703-004-5387,4523.8477,4,2,2,0.828468923113117
25158,703-004-5395,5605.618,2,1,1,0.5634476435386637
25329,703-004-5388,7479.756,5,3,2,1.4862343651990435
25352,703-004-5386,9022.456,5,1,4,0.32666834933781397
25491,703-004-5399,4462.764,4,4,0,2.0477527728821565
25547,703-004-5393,4022.4463,6,1,5,0.4099380143056523
25612,703-004-5387,4580.322,2,0,2,0.27920371738274696
25619,703-004-5393,4110.993,3,2,1,0.9123150002908296
25655,703-004-5392,8640.95,5,3,2,0.6416681159405176
25868,703-004-5386,521.1848,3,2,1,0.7622347294592047
25881,703-004-5399,5990.777,2,1,1,0.38302329501357946
26039,703-004-5395,4221.0645,2,2,0,0.8615844194346693
26163,703-004-5389,4023.6973,4,2,2,0.828989161991762
26355,703-004-5394,2389.7588,5,3,2,1.154051724829677
26657,703-004-5384,8410.728,4,3,1,2.04915949911946
26669,703-004-5398,7800.941,5,3,2,0.639802592420775
26886,703-004-5395,3025.5002,2,1,1,0.4776641280027023
26899,703-004-5395,8715.762,2,2,0,1.1855689021007723
27000,703-004-5398,7951.1074,4,1,3,0.5472957100413949
27311,703-004-5391,5901.295,8,4,4,4.02378012147899
27595,703-004-5381,2358.3413,5,3,2,1.1597383170538098
27785,703-004-5390,8117.1436,8,2,6,0.46293139690881874
27862,703-004-5396,8039.9443,6,4,2,1.2974484668994037
2833,703-004-5383,3102.132,4,2,2,0.6567793795544902
28590,703-004-5388,9200.091,4,2,2,3.422396531631492
28787,703-004-5385,2357.9038,6,1,5,0.32666834933781397
28806,703-004-5381,8949.987,3,0,3,0.27920371738274696
28954,703-004-5383,8901.009,5,0,5,0.27920371738274696
29114,207-008-2399,8043.6426,6,1,5,0.44326235664548436
29313,703-004-5388,9139.816,5,4,1,2.013417039898596
29555,207-008-2398,7177.516,4,2,2,0.8393590129828541
29708,703-004-5388,4666.1763,3,1,2,0.45670166396471623
29778,703-004-5399,1572.2173,4,3,1,0.8710924473544664
29896,703-004-5396,1915.5222,6,3,3,1.6850759682737124
30047,703-004-5399,5667.789,3,1,2,1.549457255570681
30521,703-004-5388,3985.6475,1,1,0,0.5495611797221445
30843,703-004-5381,8604.749,6,2,4,0.9608644136338351
31423,703-004-5397,6750.9907,7,3,4,1.5098532856682039
31486,703-004-5399,7108.209,6,2,4,0.6189990279274118
31590,703-004-5388,6345.275,2,0,2,0.27920371738274696
31745,703-004-5390,9995.254,2,1,1,2.175477477276502
32238,703-004-5390,609.3681,5,2,3,0.651243588957676
32292,703-004-5390,4351.9307,5,2,3,1.2553788629445892
32608,703-004-5397,8904.852,2,1,1,0.3889063479888956
32658,703-004-5389,1293.195,6,5,1,0.8136288203591335
32667,703-004-5396,9597.39,7,4,3,2.96121223201008
33124,703-004-5398,9275.266,5,3,2,0.6385384504848808
33363,703-004-5394,7330.614,6,3,3,1.9771472793472784
33600,703-004-5389,8667.286,6,1,5,0.33853450732658075
34213,703-004-5393,4964.7573,3,1,2,0.4105085645865101
34267,703-004-5396,174.90208,5,0,5,0.27920371738274696
3451,703-004-5391,6740.5586,5,1,4,0.5288986021470659
34528,703-004-5381,5585.5137,3,2,1,1.2319685263013616
34570,703-004-5390,8309.998,2,1,1,0.4314860782385869
34778,703-004-5383,7931.173,6,4,2,1.7431337307129144
34937,703-004-5385,6180.2705,4,1,3,0.42555299924420353
35251,703-004-5399,2995.4922,4,2,2,0.5236173422831678
3539,703-004-5393,2276.2573,7,2,5,0.5758576671019155
35884,703-004-5391,7385.4023,4,1,3,0.3978652972704144
3609,703-004-5392,459.0702,2,0,2,0.27920371738274696
36118,703-004-5392,4064.7554,4,3,1,1.5160960535744716
36303,703-004-5383,8943.36,1,0,1,0.27920371738274696
3640,703-004-5392,4863.626,6,1,5,0.35534489781066697
36414,703-004-5399,541.87775,3,3,0,1.2637065447919285
36571,703-004-5384,5326.082,2,1,1,0.6900115270137069
36576,703-004-5388,3673.3252,4,3,1,0.9124385603273494
37143,703-004-5384,6386.171,4,1,3,0.35831143730785864
37484,703-004-5393,8949.858,3,3,0,0.6735271070648304
37709,207-008-2398,2901.8062,4,2,2,0.7824477742855015
37794,703-004-5398,6797.945,1,0,1,0.27920371738274696
37906,703-004-5382,6530.6177,6,3,3,1.6874876795347866
37979,703-004-5380,9455.101,3,2,1,0.8786823779644539
38034,703-004-5385,5254.631,3,2,1,0.9183108366126426
38036,703-004-5386,8285.71,1,1,0,0.7519118492161484
38157,703-004-5383,9092.802,4,2,2,0.9301108886293157
38384,207-008-2399,1920.3341,3,1,2,2.316501901781462
38805,703-004-5398,3956.036,3,2,1,0.9085524232966584
3913,703-004-5397,1911.9393,3,0,3,0.27920371738274696
39157,703-004-5387,911.03076,6,1,5,1.5523765213968819
39192,703-004-5392,1040.7228,8,6,2,1.9670864768759084
39352,703-004-5386,1560.0836,4,3,1,0.5468443378354549
39670,207-008-2399,9.211302,3,0,3,0.27920371738274696
39791,703-004-5392,9704.8545,6,2,4,1.8377668653471033
39899,207-008-2399,3825.7312,6,4,2,1.3810343391471858
4014,703-004-5385,7378.848,3,2,1,0.7371793735234061
40258,703-004-5389,8302.729,2,1,1,0.8351242804550828
4037,703-004-5383,2439.199,4,3,1,1.0666236083263732
40455,703-004-5385,5912.9707,5,2,3,0.9427562720216152
40486,703-004-5384,8321.719,2,0,2,0.27920371738274696
40605,207-008-2399,9264.185,2,1,1,0.5165268771580819
41359,703-004-5386,5190.4766,3,2,1,1.7435299632737384
41371,703-004-5393,539.10077,4,3,1,1.9498269809994075
41824,703-004-5399,5758.608,4,2,2,0.5781459597424967
41847,703-004-5393,7043.442,3,1,2,0.4857829985612219
42148,207-008-2398,6891.041,1,0,1,0.27920371738274696
4261,703-004-5390,2601.3994,4,3,1,0.9928040051040037
42632,703-004-5388,146.62445,8,2,6,1.8736869166302474
42635,207-008-2399,7987.4634,3,2,1,0.6783199162838198
42803,703-004-5397,3618.2456,3,1,2,0.3187575773453028
42905,703-004-5386,9181.72,2,2,0,0.7293853508947931
42913,703-004-5398,5737.361,3,2,1,0.6177129975120259
43063,703-004-5386,6453.309,4,1,3,0.4746254981775985
43346,703-004-5397,1738.3414,6,3,3,2.2226598248020784
43821,703-004-5399,5617.2354,3,2,1,0.5469025541341482
43901,703-004-5396,7210.632,5,2,3,1.3636366138937444
44106,703-004-5399,7840.325,3,1,2,0.7463345463498171
44150,703-004-5393,334.76056,6,4,2,1.5723937043162632
44243,703-004-5380,7759.1196,8,3,5,1.1061578789449509
4445,703-004-5394,4686.2744,3,1,2,0.5842055293389731
4461,703-004-5383,3862.7612,7,6,1,1.990004053417236
44800,703-004-5381,1653.0144,3,1,2,1.224679265326789
44902,703-004-5383,4396.4785,6,5,1,1.6630986876519285
44956,207-008-2399,8208.03,3,1,2,0.47933578697636786
45158,703-004-5382,1757.3589,8,7,1,2.943258180250519
45290,703-004-5389,8618.926,4,0,4,0.27920371738274696
45325,703-004-5394,8688.105,5,3,2,0.8064566841105184
45621,703-004-5394,1188.2472,3,1,2,0.5165268771580819
45638,703-004-5386,3715.3418,5,0,5,0.27920371738274696
46279,703-004-5399,654.4816,3,2,1,1.2929803829409088
4644,703-004-5396,3899.6428,4,2,2,0.5024961113329335
46475,703-004-5383,1102.3456,3,2,1,1.0723314835458075
46900,703-004-5385,4351.823,8,5,3,1.1444596235175624
47062,703-004-5380,3522.348,3,2,1,0.8699846815170572
47602,703-004-5393,7658.945,3,1,2,0.6173892200625992
47782,703-004-5381,5162.8403,6,3,3,0.624213187949733
47912,703-004-5392,1096.62,5,4,1,1.3102103073880353
47980,703-004-5394,3939.5142,1,0,1,0.27920371738274696
48159,703-004-5383,2279.9414,1,0,1,0.27920371738274696
48347,703-004-5380,919.1424,3,1,2,0.44710199104689147
48506,703-004-5393,8187.671,7,4,3,2.1585294023739166
48514,207-008-2398,4071.1182,2,0,2,0.27920371738274696
48601,703-004-5382,1637.4963,6,3,3,1.2563983568117951
48791,703-004-5381,9198.244,2,1,1,0.5290737932020744
49031,703-004-5398,9883.447,3,1,2,0.6092639436751501
49096,703-004-5384,6860.204,6,1,5,0.39907663423176776
49127,703-004-5384,4386.1953,7,4,3,1.7043021676502823
5001,703-004-5389,6016.094,3,2,1,0.6479824265767109
5307,207-008-2399,7757.8765,2,0,2,0.27920371738274696
5351,207-008-2398,9475.81,3,2,1,0.6859020677793031
596,703-004-5392,6065.903,6,5,1,2.2971583889719978
5979,703-004-5385,3707.1484,3,2,1,1.0378452575314407
601,703-004-5389,1736.554,2,1,1,0.8774159656425127
614,703-004-5393,4025.1624,4,4,0,1.5730762846804425
6358,703-004-5398,6084.5024,5,2,3,1.3570042664909794
6425,703-004-5380,8490.931,4,1,3,0.35831143730785864
6455,703-004-5389,9804.635,3,3,0,0.9529178443096753
659,703-004-5384,8586.839,2,1,1,1.258256875414131
6788,703-004-5392,5361.0586,4,2,2,0.5795655617082244
6835,703-004-5382,4980.369,3,2,1,1.540076316623645
7009,703-004-5380,8381.558,3,1,2,0.5290737932020744
7045,703-004-5384,6478.8545,1,1,0,0.35831143730785864
7309,703-004-5395,9481.609,4,3,1,0.7365815865186843
7369,703-004-5397,4333.772,2,2,0,0.660791003164254
801,703-004-5382,5044.358,2,2,0,0.8816193801975789
8024,207-008-2398,2361.182,2,0,2,0.27920371738274696
8108,703-004-5388,4408.466,8,3,5,1.3961656952351351
8274,703-004-5395,8485.972,2,2,0,1.170162989198345
8354,207-008-2398,8260.31,3,0,3,0.27920371738274696
8391,703-004-5385,723.30414,4,1,3,0.3468408179187174
8629,703-004-5396,7156.5557,4,3,1,1.7911488209172257
8929,703-004-5399,5013.8564,5,2,3,1.186263466724031
9519,703-004-5380,7310.847,3,2,1,0.9999578584933508
9895,703-004-5386,5253.776,8,5,3,1.7989430051030963
9927,703-004-5391,4473.094,2,0,2,0.27920371738274696
9963,703-004-5388,6480.1025,8,5,3,1.436777300360668
10042,703-004-5385,2373.4104,4,3,1,0.5113354330379964
10239,703-004-5386,4952.45,7,6,1,0.976331085445524
1053,703-004-5395,8529.576,4,3,1,2.303419376299363
10610,703-004-5384,5136.888,8,4,4,2.270461621310992
10611,207-008-2399,1028.2123,2,1,1,0.6542628115894424
10820,207-008-2399,8073.7334,2,2,0,1.1413081118759947
10884,703-004-5385,9488.503,2,1,1,0.7913968623063719
11272,703-004-5393,1691.134,5,3,2,0.6727349821582094
1130,703-004-5385,6008.238,5,4,1,2.0391554635051157
11320,703-004-5395,3963.5105,4,1,3,0.7351319786342101
11366,703-004-5380,3430.1746,3,2,1,0.7487838419649899
11442,703-004-5381,9354.362,4,2,2,0.953641417700288
11701,703-004-5392,1317.7043,4,1,3,1.2129950793498525
12069,703-004-5383,6313.527,8,5,3,1.686825084780667
12118,703-004-5397,274.9777,3,2,1,0.8504596774159887
12224,703-004-5399,5300.409,4,3,1,1.6954643095300221
12305,207-008-2398,6278.055,5,3,2,0.856526422259779
12431,703-004-5399,1010.5598,1,0,1,0.27920371738274696
12527,703-004-5397,1069.3663,"","","",0.27920371738274696
1253,703-004-5388,2303.2969,4,3,1,1.1669347708544195
12856,703-004-5397,6111.7847,6,2,4,0.8299280157404165
12966,703-004-5390,1745.5083,6,2,4,0.4287446949036384
12969,703-004-5387,7680.558,5,1,4,0.7034301304346504
130,703-004-5390,1876.5432,4,1,3,0.42555299924420353
13222,703-004-5397,8699.032,4,2,2,0.9940515823004517
13396,703-004-5392,1601.1285,5,3,2,0.6668237606453369
13629,703-004-5388,4501.9077,4,0,4,0.27920371738274696
13689,703-004-5387,1428.3455,3,0,3,0.27920371738274696
13925,703-004-5399,8602.518,6,4,2,1.4390153428685424
14079,703-004-5398,7178.7764,9,3,6,0.9937497691891284
14327,703-004-5397,5819.0107,2,1,1,0.4266426768825102
14352,703-004-5382,9460.473,2,1,1,0.7212213986193052
14452,703-004-5397,6793.183,3,2,1,0.892853718737199
14696,703-004-5393,1187.2434,1,1,0,0.6017021123342458
14908,703-004-5395,4725.6577,5,3,2,1.2373925752294692
15016,703-004-5394,9844.018,2,1,1,0.5541485072355068
15133,703-004-5384,7085.723,6,3,3,1.073078070613865
15611,703-004-5391,6364.1377,5,3,2,1.310915919114818
15675,207-008-2399,4634.9775,4,2,2,0.6970004625703619
16032,703-004-5397,3284.8918,3,1,2,0.5527075293195316
16156,703-004-5388,354.9719,3,1,2,0.4827577692150498
16246,703-004-5391,55.723785,6,4,2,1.5965984859146964
16558,703-004-5394,3597.5688,3,0,3,0.27920371738274696
16850,703-004-5396,5876.2705,7,4,3,2.268476341819738
1689,703-004-5392,8809.232,4,2,2,1.5091829455562153
16950,703-004-5394,6118.9497,5,4,1,1.2024349793711622
17070,703-004-5399,3792.2515,6,4,2,1.4440309643106524
17087,703-004-5392,8486.198,6,4,2,1.177073628007311
17114,703-004-5396,6019.5522,3,2,1,0.6295272748580206
17244,207-008-2399,1111.945,8,1,7,1.7588840291609051
17259,703-004-5388,3760.5835,3,2,1,1.0993670453266287
17450,207-008-2398,6605.8677,2,1,1,0.955092528444386
17504,703-004-5381,9290.511,2,1,1,0.7385410859825721
17518,703-004-5392,8881.877,4,3,1,0.8105727442359695
17661,703-004-5398,598.4354,3,1,2,0.9077776887514201
17752,703-004-5393,580.8967,1,0,1,0.27920371738274696
1786,703-004-5380,9267.3125,4,2,2,1.1272648515855173
18001,207-008-2399,9501.368,3,2,1,0.7471449254129626
18334,703-004-5385,8714.383,3,2,1,0.5717132898238749
1851,207-008-2399,5061.159,4,1,3,0.4331895022463725
18627,703-004-5387,5849.6006,5,2,3,1.2695451222040137
18783,703-004-5399,7723.489,1,0,1,0.27920371738274696
1899,703-004-5384,6389.2944,3,0,3,0.27920371738274696
19016,703-004-5393,9942.663,3,2,1,0.8704369299943383
19067,703-004-5385,8816.082,6,3,3,1.3580953028998894
20177,703-004-5398,8585.437,2,0,2,0.27920371738274696
20185,703-004-5391,8288.907,"","","",0.27920371738274696
20455,703-004-5398,8519.98,3,2,1,0.5733562581743605
2092,703-004-5384,7343.558,5,2,3,1.2767611601918256
21965,703-004-5380,2408.3083,2,1,1,0.45535036066461304
22127,703-004-5390,2241.7737,4,3,1,2.9603936500516803
22301,703-004-5385,7664.8564,4,2,2,0.6869450655920262
22393,703-004-5383,9484.218,4,1,3,0.33853450732658075
22531,703-004-5381,5526.076,2,1,1,0.5297002306431847
22668,703-004-5394,3260.7942,8,3,5,0.9881807881413944
22683,703-004-5387,9689.564,2,2,0,1.5915369752503457
23331,207-008-2398,8960.289,4,2,2,0.5606540166715224
23674,703-004-5391,8849.148,5,2,3,1.1555815509713656
23692,703-004-5386,5161.6333,2,0,2,0.27920371738274696
23894,703-004-5383,2090.0547,4,2,2,0.9015774222407859
23917,703-004-5387,2998.5547,1,0,1,0.27920371738274696
23929,703-004-5385,6756.989,5,4,1,1.2800594857566727
24061,703-004-5385,2720.9705,8,3,5,1.3942092505229122
24090,703-004-5387,1563.1163,5,3,2,0.7129455307552209
24398,703-004-5384,8778.769,3,2,1,0.4922828622798026
24664,703-004-5390,5751.699,1,0,1,0.27920371738274696
2473,703-004-5380,6296.4165,6,2,4,0.7229334628661076
24911,703-004-5398,7018.313,3,2,1,1.1642472797267125
24920,207-008-2398,4869.306,14,7,7,1.4286519828549566
24937,703-004-5383,1721.9246,3,1,2,0.47218123186881233
24995,703-004-5393,1175.1193,3,2,1,0.5204377650618796
25074,703-004-5391,4581.807,2,0,2,0.27920371738274696
25256,703-004-5394,8731.901,6,3,3,1.6692931052859183
25488,703-004-5388,5999.1836,8,4,4,1.0692589088019115
25983,703-004-5399,1453.0707,4,1,3,0.35831143730785864
25991,703-004-5386,3113.0684,1,1,0,0.6419041431102929
26006,703-004-5382,1587.5,5,3,2,0.9904339188015044
26306,703-004-5382,8727.343,7,1,6,0.3693148415860911
26442,703-004-5388,46.76521,7,3,4,0.9603622000931892
26571,703-004-5384,4797.9106,1,0,1,0.27920371738274696
26599,703-004-5395,9934.141,3,3,0,0.8872251331140709
26750,703-004-5392,9347.323,1,0,1,0.27920371738274696
26810,703-004-5397,8141.687,3,2,1,0.735539900120263
2694,703-004-5391,727.2583,4,2,2,0.7555018832953533
27609,703-004-5391,7036.2075,2,0,2,0.27920371738274696
27863,703-004-5389,7372.9033,4,3,1,1.2208592636863465
27984,703-004-5397,810.6643,2,1,1,0.7889391030339289
28045,207-008-2398,5728.852,4,3,1,2.196593401335872
28301,703-004-5388,9639.163,6,4,2,3.08864809167699
28343,703-004-5386,533.1695,5,4,1,0.9725366224502044
28742,703-004-5381,1365.9471,2,2,0,0.8160442757971731
2914,703-004-5397,9468.665,2,2,0,0.6654283214007195
29493,703-004-5387,6667.321,1,0,1,0.27920371738274696
29722,703-004-5395,4291.01,4,3,1,1.330887056234775
29798,703-004-5380,618.6992,1,1,0,0.6618682074970694
30399,703-004-5386,8849.526,2,1,1,0.47958457070294386
3115,703-004-5388,9835.235,4,2,2,0.7376323675392662
31185,703-004-5388,7901.261,8,3,5,1.9618967310530544
31299,703-004-5399,6390.001,5,2,3,0.7245753776050705
31402,703-004-5387,3328.0288,3,1,2,1.1944330332332977
31673,703-004-5384,5692.683,5,3,2,0.8087669348936419
31708,703-004-5381,6105.083,3,1,2,0.579935921257393
31725,703-004-5392,3339.1655,8,2,6,1.077668504490119
31914,703-004-5381,8024.8623,3,2,1,0.6352924878631175
31947,703-004-5380,5056.417,2,1,1,1.4653600553772113
32527,207-008-2399,8400.218,5,2,3,0.4625885967891433
32691,703-004-5385,8449.857,3,2,1,2.4553666399006624
33110,703-004-5385,1114.0043,4,2,2,0.8431984083221502
33186,703-004-5397,4837.046,6,4,2,3.1162996920636528
33522,703-004-5391,5633.834,5,2,3,0.7623094357926803
33604,703-004-5395,9163.043,4,1,3,0.715881613103682
33981,703-004-5389,3530.7502,5,3,2,1.052036798842257
34041,703-004-5389,3929.6865,4,3,1,1.0213694464083967
34127,703-004-5385,7235.31,4,2,2,0.741324647945274
34274,703-004-5380,9139.994,4,3,1,1.7291029846210002
35040,703-004-5394,1797.1522,4,3,1,0.8941962473977526
3518,703-004-5385,2665.838,7,4,3,2.3819871351832007
35331,703-004-5399,5887.845,3,2,1,0.4975816338337693
35568,703-004-5380,5103.3525,8,4,4,2.2618848497616724
35636,703-004-5391,3930.4404,6,4,2,3.0221252140701274
35687,703-004-5398,9442.493,2,0,2,0.27920371738274696
36071,703-004-5380,1844.2905,6,2,4,0.9503281150220997
36127,703-004-5393,6206.116,2,0,2,0.27920371738274696
36460,703-004-5389,4814.9087,7,4,3,1.2743805680776472
36479,703-004-5380,5216.8486,7,3,4,0.9900676278104317
36697,703-004-5387,5961.3516,5,3,2,1.1786160367248213
36703,703-004-5398,790.56323,4,2,2,0.883023916144604
36815,703-004-5380,9568.928,2,1,1,0.6609903531960627
36831,703-004-5399,3053.2432,6,3,3,1.7785625264776233
37144,703-004-5397,1882.6031,8,4,4,2.052614895075607
37257,207-008-2399,5486.726,3,3,0,2.175550562022355
37343,703-004-5389,5095.0015,3,3,0,0.8469279989166074
374,207-008-2398,4002.2117,6,4,2,2.1475415767365584
37933,703-004-5398,5319.257,7,4,3,2.099142759468153
37942,703-004-5381,9978.432,"","","",0.27920371738274696
38216,703-004-5392,3383.6836,10,4,6,2.6457666406889366
3868,703-004-5398,2500.32,5,4,1,0.8477468168173199
38745,703-004-5399,2347.6738,4,2,2,1.2150867577599729
38846,703-004-5393,2304.8186,2,0,2,0.27920371738274696
3912,703-004-5388,2930.003,2,1,1,0.3926633399450204
39270,703-004-5396,1505.8726,5,4,1,1.4760137443907109
39309,703-004-5388,8462.654,1,0,1,0.27920371738274696
40067,207-008-2398,5575.307,3,0,3,0.27920371738274696
40248,703-004-5390,4311.1416,7,2,5,0.42368655147722045
40437,703-004-5387,7654.9453,5,3,2,1.2427886645502575
40481,703-004-5387,2116.674,8,2,6,1.386968355663149
40500,703-004-5393,5244.4487,4,3,1,1.5746111091399724
40732,703-004-5388,438.55548,5,1,4,0.6102251244164759
40738,703-004-5396,423.3134,6,4,2,1.1115656787957866
41054,703-004-5386,5995.3613,5,3,2,1.0646714021480408
41467,703-004-5396,3221.5947,3,1,2,0.45205572232631125
41673,703-004-5381,2881.6223,4,2,2,0.6262888385541743
42059,703-004-5390,9404.692,3,0,3,0.27920371738274696
42132,703-004-5389,798.7076,2,1,1,0.7112030588996113
42360,703-004-5398,1758.5331,8,3,5,0.8928413681476649
42837,703-004-5390,1613.1466,2,0,2,0.27920371738274696
42934,703-004-5385,8960.136,6,4,2,1.1618404693186342
42938,703-004-5390,1452.2683,2,1,1,0.5377017328894496
43374,703-004-5397,3287.8774,2,1,1,0.524664241900665
4364,703-004-5380,6566.324,3,2,1,1.6144622276608371
43690,703-004-5391,4332.4736,4,1,3,0.35831143730785864
43700,703-004-5397,4844.1587,7,3,4,0.8110503863620696
43790,703-004-5381,2790.1965,5,3,2,1.3885292043011581
43809,703-004-5389,3098.296,7,3,4,0.8691462942410515
43878,703-004-5397,9353.097,3,2,1,1.6179382400889362
44117,703-004-5393,6863.233,1,0,1,0.27920371738274696
44119,703-004-5396,2965.513,3,1,2,0.35831143730785864
44139,703-004-5390,8458.596,2,1,1,0.3978652972704144
44332,703-004-5380,7870.987,"","","",0.27920371738274696
44363,703-004-5386,879.65906,6,3,3,0.9558784650409814
44372,703-004-5391,2757.011,7,2,5,0.4380299896898087
44525,703-004-5398,4033.23,2,0,2,0.27920371738274696
44670,703-004-5387,6068.6426,5,3,2,1.592155779860437
44842,703-004-5396,8748.252,7,4,3,1.3884466237123558
44853,703-004-5387,9101.941,2,2,0,0.6139340190397113
44987,703-004-5391,811.84686,4,1,3,0.5614303966805735
45396,703-004-5380,9052.781,2,1,1,0.3978652972704144
45587,703-004-5389,1763.733,4,2,2,1.0670821573545548
46285,703-004-5397,2160.1086,5,2,3,0.8623003519725972
46293,207-008-2399,3896.954,2,2,0,0.8547123798379342
46641,703-004-5380,3969.9119,3,2,1,1.4930995216452658
46690,703-004-5381,234.6152,4,2,2,0.8672501912940149
46775,703-004-5392,9135.835,6,3,3,1.8608473264514898
47103,703-004-5381,6949.5645,4,1,3,1.2369368241580185
47135,703-004-5380,8635.495,3,1,2,1.3031619284702294
47164,703-004-5382,3804.8577,2,1,1,0.5998400583726875
47306,703-004-5384,3852.0557,4,1,3,0.41259516005977426
47388,703-004-5391,3262.6753,4,1,3,0.671291346582489
47422,703-004-5397,8173.7124,3,1,2,1.567641001943939
47646,703-004-5387,131.04558,7,6,1,4.079262854353063
47950,703-004-5385,3976.1357,2,2,0,0.5003339171306191
48113,703-004-5383,2072.2754,4,2,2,0.6578192382008392
48172,703-004-5387,3058.4895,3,3,0,2.2820037026955564
48223,703-004-5386,7373.2144,2,2,0,0.5665337837419557
48298,703-004-5392,73.68624,5,4,1,1.9737603106299788
48386,703-004-5389,7654.8667,2,0,2,0.27920371738274696
48761,703-004-5396,3535.437,7,3,4,1.1506023019476546
48857,703-004-5393,262.03217,7,5,2,1.8381246131905171
49015,703-004-5395,3324.6003,11,5,6,1.1485636787785858
49088,703-004-5389,8525.866,3,2,1,1.3428273066909775
49100,703-004-5391,6487.8247,4,2,2,1.1810654921590225
49292,703-004-5388,2195.39,3,3,0,1.058735447310427
49328,703-004-5389,5878.7397,3,2,1,0.707641274691831
49366,703-004-5387,6817.394,3,2,1,2.6185742327001313
49391,703-004-5395,1038.5258,3,2,1,0.5701171229656768
49427,703-004-5384,3407.4307,3,2,1,2.486689340543614
49522,207-008-2398,6521.7847,4,0,4,0.27920371738274696
49903,703-004-5399,1508.6204,8,1,7,0.7959883244219536
535,703-004-5381,5258.81,2,1,1,0.9104331039932533
5454,703-004-5381,4309.6353,5,2,3,0.8820181957443981
5519,703-004-5399,1002.2384,2,1,1,0.5487138977303075
5521,703-004-5390,4445.6284,7,1,6,0.33853450732658075
6269,207-008-2398,4045.002,6,5,1,2.3621360252536707
6321,703-004-5396,1471.6941,5,3,2,0.9198497387650912
6522,703-004-5386,2683.4512,6,4,2,1.8363676981952672
6575,703-004-5395,1547.575,2,1,1,1.6781570491638245
6620,703-004-5398,5915.7354,2,1,1,0.33853450732658075
6734,703-004-5393,1842.156,4,1,3,0.6572973125727741
6905,703-004-5381,9519.853,2,2,0,0.466565782727641
6972,703-004-5382,422.65414,5,1,4,0.5755502279845297
7219,703-004-5389,4917.013,5,3,2,1.1599214397773199
7758,703-004-5395,6240.8936,4,1,3,0.6364009765696306
7849,703-004-5392,1145.2675,3,1,2,0.35831143730785864
7884,703-004-5390,2682.3955,5,1,4,0.3187575773453028
8031,703-004-5385,9142.431,2,2,0,0.6633514704748174
8429,703-004-5383,5047.1367,5,2,3,0.619892939373694
8586,703-004-5380,1720.4583,5,1,4,1.1074358202865884
906,703-004-5386,3250.0225,5,3,2,0.8235649154627479
9311,703-004-5390,9819.554,1,1,0,0.5594383654082092
9422,703-004-5385,6533.163,"","","",0.27920371738274696
9496,703-004-5398,2849.1252,1,1,0,0.33853450732658075
9716,703-004-5399,1239.2372,3,0,3,0.27920371738274696
9739,703-004-5389,8868.12,4,2,2,1.7109445081801828
9913,703-004-5384,1892.4891,3,2,1,0.48442524033991546
1017,703-004-5384,1987.7767,9,4,5,1.0903299024309732
10340,703-004-5384,934.3588,7,1,6,0.590246809916491
10713,703-004-5394,760.6685,2,0,2,0.27920371738274696
11362,703-004-5382,2387.8718,6,1,5,0.9525133065563336
12023,703-004-5390,3308.1584,4,3,1,1.5918333280016204
12053,703-004-5381,9423.004,4,2,2,0.8978236460422961
12571,703-004-5392,9528.472,3,1,2,0.8325569456216867
12792,703-004-5390,8345.104,6,1,5,0.39417360367390925
1288,703-004-5381,4708.2935,1,1,0,3.310328976359498
13534,207-008-2398,5051.8994,4,2,2,0.5640261187406161
13683,703-004-5390,9724.69,3,3,0,1.626191490546945
13749,703-004-5391,9403.429,4,3,1,0.6883613037127133
13799,703-004-5396,7173.522,2,0,2,0.27920371738274696
13984,703-004-5398,3776.5188,2,2,0,1.2087016162758069
14009,703-004-5388,2109.4875,5,2,3,0.5530160041163108
14431,703-004-5398,696.1441,4,3,1,1.2084936237681918
14462,703-004-5387,827.96454,6,3,3,1.678903674596198
14472,703-004-5395,8808.222,6,3,3,1.4728420978449086
14589,207-008-2399,8467.201,4,1,3,0.4423633897282897
14645,703-004-5397,4487.3394,"","","",0.27920371738274696
14685,703-004-5388,8285.567,5,2,3,0.49291064749449426
14911,703-004-5380,7687.091,3,1,2,0.6313471726226069
15066,703-004-5396,9024.734,9,3,6,1.8093617163167572
1515,703-004-5389,2506.5452,4,1,3,0.5100797553135417
15265,703-004-5380,1087.3425,5,1,4,0.8214098741101218
15293,703-004-5388,3295.9187,5,3,2,0.7853766852338755
15531,703-004-5394,836.18286,5,4,1,1.4262098173041144
15954,703-004-5385,3054.9436,2,0,2,0.27920371738274696
16106,703-004-5399,5717.1523,2,2,0,0.7757175054272183
16523,703-004-5389,8453.542,3,1,2,0.5951666388769845
16795,703-004-5391,5478.7915,6,5,1,2.584441709751402
16902,703-004-5392,9576.166,6,3,3,1.8459702655300172
16909,703-004-5384,8406.001,5,2,3,0.6472391596525926
17151,207-008-2398,6126.7524,2,1,1,0.8434879166936733
17159,703-004-5387,7921.353,"","","",0.27920371738274696
17561,703-004-5391,2347.9207,6,6,0,2.644954295644463
17591,703-004-5380,8531.793,4,2,2,0.5669417110907731
18243,703-004-5380,2391.467,7,4,3,1.1830459602261425
1835,207-008-2398,7566.5015,6,2,4,0.7382685355732971
18353,703-004-5386,4170.915,5,3,2,1.2724352369154017
1858,703-004-5386,1504.705,6,1,5,0.46423803752235393
18782,703-004-5383,823.2695,6,2,4,0.9441093862958665
19162,703-004-5385,290.52795,1,1,0,0.440587975887633
19314,703-004-5384,7662.538,6,3,3,1.2626550370065464
19424,703-004-5385,9158.754,1,1,0,0.5499882781351354
19478,703-004-5393,9730.129,3,2,1,1.0093730497244857
19611,703-004-5391,9889.839,2,0,2,0.27920371738274696
19892,703-004-5384,9312.241,5,1,4,1.147904537337931
19901,703-004-5383,2873.9185,8,4,4,1.512137309084687
20131,703-004-5380,6052.8926,4,2,2,0.6065082216911708
20162,703-004-5395,6999.504,4,3,1,1.1079752484008825
20341,703-004-5381,6209.515,4,1,3,1.8716518626277237
20672,703-004-5382,4021.1355,4,3,1,0.9534536066793183
20756,703-004-5387,6579.6772,1,0,1,0.27920371738274696
208,703-004-5395,3948.2166,5,1,4,0.35831143730785864
21005,703-004-5381,2131.5933,"","","",0.27920371738274696
21057,703-004-5391,922.3604,7,3,4,0.946773509969259
2106,703-004-5388,820.57355,3,1,2,1.311669864338608
21200,703-004-5399,8791.681,4,1,3,0.32666834933781397
21252,703-004-5387,4282.009,5,3,2,1.398363729467758
21437,703-004-5393,6899.2227,4,3,1,0.6210968325171032
2148,207-008-2399,766.4955,3,3,0,1.8390484897990864
21522,703-004-5396,9976.117,5,4,1,1.0022747509222203
21763,703-004-5395,6150.0728,2,1,1,0.5417739835075591
21780,703-004-5399,26.484728,3,1,2,0.4063639385066191
22010,703-004-5382,5684.3247,3,1,2,0.4629635905300687
22136,703-004-5384,5550.7188,3,2,1,0.8068068842611582
22608,703-004-5388,8121.5615,5,2,3,3.5987372461778944
22763,703-004-5384,4751.198,4,3,1,1.7211081290993429
22992,703-004-5399,5824.38,4,3,1,0.8700282167918808
23084,207-008-2399,2909.0674,6,2,4,0.5927914711585162
23173,703-004-5397,6392.9243,4,2,2,0.6881370066206436
23437,703-004-5396,2710.4998,2,1,1,0.4532126060484773
23536,703-004-5399,7492.7515,2,2,0,1.338560593699725
24053,703-004-5381,5843.1,3,2,1,1.5148820807548513
24332,703-004-5399,5464.902,4,3,1,1.6278965006725596
24633,703-004-5384,6847.84,4,1,3,0.5654469848023527
25231,703-004-5381,2555.3066,3,0,3,0.27920371738274696
25311,703-004-5388,4588.576,3,3,0,1.217656325567215
25442,703-004-5387,3161.5388,5,4,1,1.0898641686049426
25552,703-004-5380,8208.798,8,4,4,1.5809144208098038
25786,207-008-2398,2272.666,1,1,0,0.48504673727012193
26024,703-004-5394,7567.9634,5,2,3,0.9730196074830632
2611,703-004-5381,8467.866,5,1,4,0.4702853704964751
26223,703-004-5395,9623.911,7,6,1,1.5356477527863845
26255,703-004-5382,1458.4082,3,1,2,0.41467568775450064
26275,703-004-5392,45.752525,3,1,2,0.8633514739590255
26788,703-004-5393,297.95587,2,1,1,0.9840048456679227
26981,207-008-2398,4004.5894,3,1,2,0.40212829846876536
27029,703-004-5391,3631.9912,3,2,1,1.673906072398893
27089,703-004-5395,8202.116,4,2,2,5.011897596783679
27159,703-004-5388,5549.0796,5,2,3,2.3173511468985883
2719,703-004-5383,1461.652,2,1,1,1.072645617801369
27551,703-004-5387,1129.3615,2,2,0,0.7638858218220151
27657,703-004-5397,8128.9478,3,2,1,1.3228066442427382
27680,703-004-5381,9687.623,4,1,3,0.32666834933781397
27948,703-004-5381,4066.3826,5,2,3,0.6372174557900462
28814,703-004-5384,8492.509,6,4,2,1.5053186964259353
29014,703-004-5399,7116.975,8,5,3,1.9453403869969854
29284,703-004-5383,9982.943,1,1,0,0.33853450732658075
29619,207-008-2399,3165.6594,5,3,2,1.020932934723144
29652,703-004-5384,1239.4648,4,3,1,0.7348852455632167
29707,703-004-5387,2760.2368,5,4,1,0.9208267045389772
29925,703-004-5381,9067.024,5,3,2,2.5021654154146487
30009,703-004-5381,5197.625,7,4,3,1.7872792420905312
30230,703-004-5381,3413.1165,5,4,1,0.8812554913114623
30401,207-008-2398,5202.4297,3,1,2,0.5008710744042991
30569,703-004-5392,7605.3237,4,2,2,1.8844092902737373
30597,703-004-5396,5662.4404,2,2,0,0.48827534138511675
31022,207-008-2399,4871.002,7,4,3,1.357454190205877
31092,703-004-5383,4823.1924,2,2,0,1.1710125692665327
31465,703-004-5385,6657.377,3,1,2,0.4987269397419949
31568,207-008-2399,4647.295,2,1,1,0.4381012006905436
3193,703-004-5383,709.9772,3,2,1,1.2020690751099177
31955,703-004-5398,7508.134,"","","",0.27920371738274696
32047,703-004-5394,8312.713,4,2,2,0.5736237392547179
32774,703-004-5380,4240.544,4,2,2,0.49880180366236154
32781,207-008-2399,2456.342,3,2,1,0.7439522076116802
32926,703-004-5383,6795.5054,1,1,0,0.36666719022494854
32933,703-004-5386,1814.0804,4,3,1,3.0645510425908515
33064,703-004-5385,4071.4978,8,4,4,1.1950033533804592
33090,703-004-5397,2097.6423,1,0,1,0.27920371738274696
33113,703-004-5380,9473.502,2,0,2,0.27920371738274696
33256,703-004-5388,9382.23,2,2,0,2.1285175506706553
33345,703-004-5380,6790.5034,5,2,3,0.6977849125527416
3343,703-004-5382,6375.81,8,3,5,1.074175149333078
33562,703-004-5390,4687.249,4,2,2,0.7956123100680943
33563,703-004-5391,1572.4069,6,4,2,1.6949617102201369
33647,703-004-5397,4275.0483,3,2,1,1.3980439418228214
33750,703-004-5386,1195.9535,7,3,4,1.2901157608228342
33899,703-004-5393,9354.754,5,4,1,1.4432428013015453
33948,703-004-5390,4306.853,6,4,2,1.5669613068162107
33989,703-004-5398,2161.1267,6,4,2,1.7269296720228484
34372,207-008-2398,2534.2463,4,2,2,0.9411789829273111
34469,703-004-5392,2743.453,5,4,1,2.593615513361135
34618,703-004-5385,735.65546,3,2,1,0.5538459440327532
34644,703-004-5396,1252.3264,6,2,4,0.5572261061177214
34665,703-004-5395,9282.598,5,3,2,1.2597788743719645
34743,703-004-5380,3801.9795,6,2,4,0.8609141000988699
34872,703-004-5383,4411.0327,5,5,0,2.0480196163075526
34883,703-004-5398,7038.587,4,1,3,0.4731537615913179
35143,703-004-5396,1428.4456,8,2,6,0.53735078374594
35258,207-008-2398,7303.3296,3,0,3,0.27920371738274696
35361,703-004-5381,7126.2974,2,1,1,0.6886237178862006
35367,703-004-5385,8846.769,1,0,1,0.27920371738274696
35811,703-004-5382,765.9137,4,1,3,0.4314860782385869
35816,703-004-5389,6298.933,4,2,2,0.5849685032056907
35823,703-004-5395,7080.8076,7,1,6,0.3187575773453028
36015,703-004-5394,8387.52,4,4,0,0.859710550244285
36337,703-004-5389,467.89288,4,2,2,0.6803543805972078
36624,703-004-5387,4298.557,7,2,5,0.7629194074073311
36732,703-004-5382,5595.03,4,1,3,0.5165268771580819
36759,703-004-5394,363.64377,4,2,2,0.8358303490713195
3699,703-004-5388,6012.5464,6,4,2,1.1570638128502329
37151,703-004-5399,1268.037,5,4,1,2.329434100080538
37303,207-008-2399,155.30586,2,2,0,0.7112086003445749
37477,703-004-5383,380.8397,6,3,3,1.0481845455690826
37700,207-008-2398,9451.25,3,2,1,0.9817037361523174
37813,703-004-5395,8916.3955,5,2,3,0.7769988112543199
37987,703-004-5389,1730.5946,6,5,1,1.4214045717886434
38072,207-008-2398,1189.1526,2,2,0,0.5379023718727414
38292,703-004-5389,8087.1616,2,2,0,0.47697301719552604
38528,703-004-5392,2335.151,6,3,3,3.313495161486638
38661,703-004-5389,2990.0598,5,4,1,1.38238347032665
39015,703-004-5394,3221.1768,7,3,4,0.7682428538062082
39285,703-004-5381,4517.9824,3,2,1,1.2054845586620853
39293,703-004-5396,5821.6025,6,5,1,7.055739815223493
39690,703-004-5393,4630.5156,9,5,4,1.873757804967736
3984,703-004-5383,7330.7603,3,2,1,0.5693154161580517
40003,703-004-5380,5547.338,2,1,1,0.7109249971259155
40107,703-004-5398,6151.4443,2,1,1,0.3982589865039096
40176,703-004-5384,4710.6006,6,3,3,1.093872776288143
40211,703-004-5398,8645.938,7,4,3,0.6698607379511631
40411,703-004-5397,123.92998,5,1,4,0.3908862384236879
40661,703-004-5392,4399.207,2,2,0,0.4802316287515517
41271,207-008-2399,930.43805,6,5,1,1.5622015308231731
41597,207-008-2398,967.88885,2,1,1,0.35831143730785864
41918,703-004-5393,8279.9795,3,0,3,0.27920371738274696
41961,703-004-5385,4131.7876,3,1,2,0.33853450732658075
42536,703-004-5398,2335.4148,1,0,1,0.27920371738274696
42561,207-008-2398,8984.766,6,4,2,1.1226270414928285
42607,207-008-2399,7381.957,1,0,1,0.27920371738274696
42765,703-004-5397,2541.58,8,4,4,1.2919738984312161
4286,703-004-5384,5173.3022,2,1,1,0.4056983212069367
43157,703-004-5396,4930.5127,1,1,0,2.1724230132065894
43161,703-004-5396,8805.283,4,4,0,1.5209980289022518
43476,703-004-5395,6233.931,4,0,4,0.27920371738274696
43806,703-004-5391,6084.539,4,1,3,0.3943239907456419
43896,703-004-5385,1911.7712,4,2,2,1.0837903958348434
43941,703-004-5388,9502.885,4,2,2,1.2526559537730808
44018,703-004-5387,6567.4927,4,2,2,1.1352316477652684
44029,207-008-2399,9210.612,2,2,0,0.9224829094914114
44230,703-004-5380,4426.7183,"","","",0.27920371738274696
44240,703-004-5386,1431.8002,5,2,3,2.157166194286433
44355,207-008-2399,6587.721,2,0,2,0.27920371738274696
44418,703-004-5393,4892.0435,3,2,1,1.019428551649112
44537,703-004-5397,612.49316,3,1,2,0.8698586895998697
4472,703-004-5387,5182.3193,3,1,2,0.4721948762101267
44871,703-004-5382,963.7994,4,2,2,1.099615525263569
45031,703-004-5388,2028.4594,7,5,2,2.5500691981686288
45046,703-004-5399,4232.743,2,1,1,0.6084714808431666
45214,703-004-5393,9701.592,6,4,2,1.0877619533853147
45218,703-004-5395,6951.5083,2,1,1,0.45890017187967663
45591,703-004-5399,9456.243,6,4,2,3.0552874626114686
45820,703-004-5391,3800.347,4,1,3,0.3892985904335242
46192,703-004-5396,9738.144,5,2,3,0.664341267696345
47226,703-004-5385,2191.9924,3,2,1,1.2361017651300468
47467,703-004-5382,6504.255,2,1,1,0.35534489781066697
47745,703-004-5394,3061.6748,6,1,5,0.3978652972704144
4847,703-004-5389,3764.357,1,1,0,0.381926033464075
48593,703-004-5388,7764.909,4,1,3,1.362923631030481
48730,703-004-5386,7899.022,4,3,1,0.9189712311001699
49055,703-004-5396,7270.54,3,2,1,0.9371675014375185
49299,703-004-5391,5631.048,1,1,0,0.35534489781066697
49514,703-004-5385,4880.7812,3,0,3,0.27920371738274696
49670,703-004-5389,4244.388,4,3,1,0.8517037365723582
49727,703-004-5388,8663.473,3,2,1,0.746617468582463
49980,207-008-2399,7720.6445,3,1,2,0.5165268771580819
5091,703-004-5391,1093.3429,3,1,2,0.58612105869767
5178,207-008-2399,6268.516,4,3,1,1.986883601095171
5339,703-004-5398,2744.2246,1,1,0,1.2593851028035974
5400,703-004-5380,4637.0264,3,1,2,0.8416549687373961
5403,703-004-5384,2282.9998,4,1,3,0.35831143730785864
5436,703-004-5383,8923.259,3,0,3,0.27920371738274696
5444,703-004-5399,1791.4736,4,1,3,1.20199609761549
5480,703-004-5381,8426.771,9,3,6,1.0396325524005752
5603,703-004-5380,237.05482,3,2,1,0.6421463498383928
5643,703-004-5388,5195.1377,6,3,3,1.292471273791371
6154,703-004-5384,9040.82,4,3,1,1.1451239221627223
6449,703-004-5386,4030.2778,3,3,0,1.095162427717168
7046,703-004-5387,9408.795,4,3,1,0.7488651076079594
7282,703-004-5387,6310.944,1,1,0,0.5165268771580819
7327,703-004-5384,164.0743,4,4,0,1.3142156990266156
770,703-004-5399,8201.97,7,6,1,2.0991597905770787
78,703-004-5395,6378.2163,7,4,3,2.145185103986813
7811,703-004-5386,2380.0354,5,1,4,0.6852098679391849
7882,703-004-5392,4050.8313,5,0,5,0.27920371738274696
7893,703-004-5398,9866.6,2,0,2,0.27920371738274696
790,703-004-5389,5119.1855,4,2,2,1.4660536070651276
8003,703-004-5382,3974.266,6,4,2,1.8597508319092606
8551,703-004-5394,9831.263,3,0,3,0.27920371738274696
8761,703-004-5384,4074.6797,1,1,0,0.554632695028571
8890,703-004-5392,8266.29,4,2,2,0.5494714888026403
9275,207-008-2398,9756.934,3,1,2,3.3466629227264897
9325,703-004-5389,1631.8857,6,2,4,1.2887401353246477
9358,703-004-5383,6918.38,3,1,2,0.5550657864899714
9388,703-004-5385,9197.581,3,1,2,0.974631428590557
9444,703-004-5380,9496.655,6,2,4,1.190193572690175
9653,207-008-2398,5287.714,7,2,5,1.053768000149212
9665,703-004-5384,9758.1455,2,0,2,0.27920371738274696
9881,703-004-5385,4522.2773,7,2,5,0.5657186606832648
10023,703-004-5395,8555.53,4,2,2,1.024577871685219
10093,703-004-5387,4206.571,3,1,2,0.6496640612477722
10243,703-004-5386,2753.5134,2,1,1,0.39715519453232867
10319,703-004-5387,1538.9037,2,0,2,0.27920371738274696
10347,703-004-5381,9636.807,"","","",0.27920371738274696
10847,703-004-5394,8179.5186,3,3,0,0.7024354624198946
10903,703-004-5391,3270.8,5,3,2,1.0203308435775904
11033,703-004-5386,2264.5444,8,5,3,1.8926854409421183
11921,703-004-5392,5112.8877,2,1,1,1.3111316851552737
12086,703-004-5399,3354.1663,2,0,2,0.27920371738274696
12131,703-004-5388,7676.8726,3,1,2,0.432468714045152
12135,703-004-5387,6200.7256,2,1,1,0.3978652972704144
12356,703-004-5383,8907.493,4,1,3,0.9836163595955362
12503,703-004-5390,5071.1826,2,1,1,0.5518737173872283
13073,703-004-5394,2552.5535,1,1,0,0.5165268771580819
13109,207-008-2398,4774.5347,2,1,1,0.5936373059215279
13140,703-004-5397,9446.217,2,1,1,0.33853450732658075
13432,703-004-5385,9567.383,2,0,2,0.27920371738274696
13533,703-004-5384,2765.4243,1,1,0,0.9045554073412316
13576,703-004-5381,7310.0127,7,2,5,0.9004342404702941
13587,703-004-5384,888.1849,4,1,3,0.6281371780696432
13828,703-004-5393,3445.8535,9,3,6,1.2101202294260107
13901,703-004-5393,6369.82,4,2,2,0.834289158325827
14470,703-004-5382,1009.32,5,4,1,1.9151718277768168
14975,703-004-5392,2498.3323,2,1,1,0.48794697557272054
15384,703-004-5385,5961.693,8,2,6,0.4892056718261751
15436,703-004-5393,3384.547,4,2,2,0.46672132965821017
15453,207-008-2398,8215.871,3,1,2,0.6058387057414679
15833,703-004-5390,8519.01,2,0,2,0.27920371738274696
15836,703-004-5396,6832.334,5,3,2,0.6061822930732084
15885,703-004-5396,8545.937,10,2,8,0.9904036781408049
16009,703-004-5398,6592.5073,4,3,1,1.112298113066006
16101,703-004-5383,3412.134,3,1,2,0.35831143730785864
16215,703-004-5394,2867.891,5,3,2,2.970895696089659
16396,703-004-5394,3967.34,5,2,3,0.5672378372336591
1644,703-004-5389,559.49927,1,0,1,0.27920371738274696
16703,703-004-5386,3546.7983,4,3,1,1.2532155632109463
16875,703-004-5385,4832.278,6,5,1,2.766014319882314
16898,703-004-5388,2642.119,"","","",0.27920371738274696
16935,703-004-5381,7135.833,2,2,0,1.6248308014628894
17845,703-004-5397,8623.801,5,1,4,0.6656864134814271
18009,703-004-5382,1610.7207,4,2,2,0.7594082308900907
18029,703-004-5389,4088.1348,4,2,2,0.6250110610893289
18088,703-004-5384,9865.824,6,1,5,1.0577093814757643
18152,703-004-5388,3603.3142,7,3,4,1.0407210431976053
18478,703-004-5393,7090.0493,6,4,2,1.153787896449403
18546,703-004-5389,3837.573,1,0,1,0.27920371738274696
18686,703-004-5391,1962.778,4,2,2,0.6122006545635946
18774,703-004-5392,8087.2754,3,2,1,0.6210850930806356
18842,703-004-5395,1521.8055,2,0,2,0.27920371738274696
18873,703-004-5393,5570.081,4,3,1,1.6302808565366846
18931,703-004-5392,1925.869,1,0,1,0.27920371738274696
1904,703-004-5396,2598.561,6,2,4,1.2791433717815934
19049,703-004-5385,2304.4895,6,3,3,1.4065600218989585
19112,703-004-5384,503.59787,2,0,2,0.27920371738274696
19649,703-004-5380,4390.869,4,2,2,0.611747868724194
19872,703-004-5399,4299.0283,7,4,3,1.3594924195246183
19958,703-004-5389,697.02386,5,3,2,3.186075315321511
20033,703-004-5397,3297.0237,3,2,1,0.9799051247117206
20194,703-004-5392,3276.0388,4,1,3,0.9456041927138744
20351,703-004-5395,3918.268,8,3,5,2.398200389391947
20531,703-004-5393,1636.6786,8,4,4,2.4711710697578315
20669,703-004-5382,5387.1997,7,4,3,2.2390132009487673
2075,703-004-5390,5835.0693,7,4,3,1.9648498399551724
20761,703-004-5393,3255.4387,3,0,3,0.27920371738274696
20779,703-004-5396,6389.4272,4,3,1,1.276452383424245
20944,703-004-5390,5883.7563,"","","",0.27920371738274696
2127,703-004-5396,76.8435,3,2,1,0.6987715605947373
21316,703-004-5384,1305.5629,4,4,0,1.0790391427101478
21334,703-004-5394,3372.783,5,3,2,2.093363735349342
21350,703-004-5387,6459.108,5,2,3,0.731200845210926
21866,207-008-2398,7377.2163,2,0,2,0.27920371738274696
22191,703-004-5387,7586.131,2,1,1,0.37512182779194486
22241,703-004-5382,4290.9785,2,0,2,0.27920371738274696
22338,703-004-5396,2664.1453,1,0,1,0.27920371738274696
22572,703-004-5389,6634.7993,8,5,3,1.2745044253919688
2267,703-004-5390,134.22787,5,5,0,1.8945157921810512
228,703-004-5388,5713.722,6,3,3,1.309938363410715
2280,703-004-5384,212.9209,5,4,1,2.488016883822161
22974,703-004-5388,3679.7004,3,3,0,1.115458702699883
23003,703-004-5388,24.210812,6,3,3,1.778937302299018
23073,703-004-5396,9729.162,1,1,0,0.3978652972704144
2324,207-008-2398,707.71454,4,2,2,3.80537430402229
23378,703-004-5395,9866.595,1,0,1,0.27920371738274696
23875,703-004-5397,8176.6753,1,1,0,0.5695162435548103
24094,207-008-2398,3573.101,1,1,0,0.35831143730785864
24194,703-004-5381,243.9487,4,2,2,1.6579651140337446
24304,207-008-2398,9214.8,3,1,2,0.508609197955055
24453,703-004-5381,2821.1702,4,3,1,2.0767623405608737
24722,703-004-5385,7089.549,4,1,3,0.4485271995724547
24733,703-004-5388,6247.9253,5,1,4,0.5063966326815051
24929,703-004-5387,1995.7072,4,3,1,1.9938005849850233
2510,703-004-5395,5617.3115,7,3,4,1.1074344045223508
25172,703-004-5393,79.53942,3,2,1,0.5442145791318709
25369,703-004-5394,8740.982,3,2,1,0.47697301719552604
2538,703-004-5395,1490.3456,4,1,3,0.3459550674941238
2591,703-004-5390,8831.327,2,2,0,1.0637000843959397
25930,703-004-5391,5236.779,7,6,1,3.646525806763808
26385,207-008-2399,3387.4165,2,2,0,1.7365631407687925
2684,703-004-5386,4719.4365,4,1,3,0.5003636262781246
27211,703-004-5393,2332.4644,4,2,2,0.8650644785814644
27422,703-004-5392,1750.4668,3,3,0,1.446511433178159
27735,703-004-5391,7329.5195,7,4,3,1.561313379897337
27896,703-004-5396,2521.1567,2,0,2,0.27920371738274696
28249,703-004-5384,4909.46,2,1,1,0.33853450732658075
28608,703-004-5382,8097.354,4,2,2,0.4363886683940407
28701,703-004-5393,4124.521,3,2,1,0.440056081230474
28728,207-008-2398,2263.2444,4,3,1,1.0611886083680295
28746,703-004-5385,8030.8716,5,2,3,0.9107651651698979
28872,703-004-5389,685.5714,1,0,1,0.27920371738274696
2925,703-004-5399,8818.891,6,4,2,2.2920560848086273
29582,703-004-5381,9255.443,5,3,2,1.5357322315013922
29595,703-004-5394,9745.594,6,1,5,0.4474442264842623
29703,703-004-5394,3572.0874,7,5,2,3.3278816368582365
29832,703-004-5388,8908.536,4,2,2,1.145188697337399
30008,703-004-5385,1065.5535,5,4,1,0.9372975054354263
3020,703-004-5385,4430.766,4,2,2,1.0510358226556713
30332,703-004-5383,669.54254,1,1,0,0.8122490228201943
30631,703-004-5388,2164.5522,4,2,2,0.6265621406352758
30675,703-004-5384,2630.8203,7,1,6,0.3978652972704144
30881,703-004-5386,6351.9175,7,4,3,1.5855314560679579
30894,703-004-5394,1960.0219,1,1,0,0.3825072917917585
30957,207-008-2399,1979.0668,5,1,4,0.6025359062818367
31161,703-004-5382,611.0477,4,4,0,1.005302792998188
31211,703-004-5399,1263.0469,4,1,3,0.5231740969395303
31221,703-004-5398,889.9605,6,5,1,1.2093889162968736
31405,703-004-5381,9098.9,2,2,0,1.79737242924389
31425,703-004-5391,5618.202,1,1,0,0.4551437128432267
31541,703-004-5391,7872.763,4,1,3,0.4230241055822243
31591,703-004-5390,1891.9247,6,1,5,1.4061477416153816
3160,703-004-5387,4131.9536,4,3,1,1.1278722107310457
3182,703-004-5385,8045.3066,5,1,4,0.33853450732658075
31833,703-004-5398,4887.744,9,5,4,1.585077913713572
31836,703-004-5380,5535.025,1,1,0,0.6484140959979741
31848,207-008-2399,2168.3909,7,2,5,2.032717767750851
32050,703-004-5383,598.86334,6,1,5,0.9501090839079379
32403,703-004-5399,401.44028,3,0,3,0.27920371738274696
32659,703-004-5396,7963.2593,2,1,1,0.33853450732658075
32931,703-004-5395,5790.761,2,0,2,0.27920371738274696
33046,703-004-5386,865.71875,9,7,2,3.925086838600095
33048,207-008-2399,1808.5951,2,0,2,0.27920371738274696
33575,703-004-5387,5692.36,2,1,1,0.47619734319378904
33578,703-004-5382,3128.1125,3,0,3,0.27920371738274696
33588,703-004-5394,9804.362,5,2,3,0.9001622370511585
33813,703-004-5395,8591.3125,2,1,1,3.397730787001529
33839,703-004-5388,4258.2466,3,3,0,1.191549491578001
33922,703-004-5398,5124.89,4,2,2,1.1236257231854503
33941,703-004-5392,3074.8618,4,2,2,1.85198927869847
34009,703-004-5384,7578.432,3,0,3,0.27920371738274696
34187,703-004-5391,5619.339,3,2,1,0.7229776247066135
3421,207-008-2398,4870.71,7,5,2,2.484207674544331
34224,703-004-5380,9027.571,4,0,4,0.27920371738274696
34412,703-004-5381,565.48474,3,3,0,0.8214122854643882
34589,703-004-5399,254.33957,3,2,1,0.4859723072204381
34759,703-004-5383,5456.387,2,2,0,1.3232764276554185
34906,703-004-5384,1973.8079,5,3,2,1.312343126806774
35307,703-004-5395,2250.4795,4,1,3,0.47552864323495303
35382,703-004-5393,5663.2163,5,4,1,1.2695473278459524
35413,703-004-5388,9765.341,4,2,2,2.040557670160901
3560,703-004-5385,9686.19,1,1,0,0.6220052089212229
35920,703-004-5392,4199.3867,3,2,1,0.47738864895000294
36094,703-004-5388,1343.2032,5,5,0,1.5534350871298799
36195,703-004-5390,7101.5884,2,2,0,0.6241758176751531
36246,703-004-5387,1397.4136,4,1,3,0.32666834933781397
36411,703-004-5386,6606.9146,7,3,4,0.9869331691178312
36461,703-004-5384,5965.53,3,1,2,0.7145878632717482
37305,703-004-5398,257.02716,4,1,3,0.35831143730785864
37438,703-004-5393,5669.922,1,1,0,0.3459550674941238
37452,703-004-5386,6141.3457,4,1,3,0.6045740849792186
37527,703-004-5389,7535.092,1,1,0,0.3187575773453028
37816,207-008-2399,8057.358,8,4,4,1.219194755979566
37840,703-004-5388,3954.0928,4,3,1,0.8073523884434368
37843,703-004-5384,1830.2316,5,2,3,0.9593114033398242
37886,703-004-5399,4838.0225,"","","",0.27920371738274696
38360,703-004-5386,2100.2275,3,1,2,0.42555299924420353
38400,703-004-5380,2877.5938,6,3,3,1.6515113532922616
38513,703-004-5383,5037.1846,3,2,1,0.6958493380643587
38579,703-004-5388,9659.582,4,1,3,0.914185518314243
38918,207-008-2398,8455.322,5,2,3,0.5693217637503932
39385,703-004-5398,3942.4246,2,1,1,0.3817025394403089
39700,703-004-5395,3317.5588,8,4,4,0.8605439243963596
4019,207-008-2398,3750.4595,3,1,2,0.4356245176209351
40388,703-004-5386,8836.51,5,2,3,1.9383341197152983
40422,703-004-5392,9674.414,4,3,1,1.3178535410667076
40511,703-004-5399,1924.2704,9,4,5,1.1554798782402043
40648,703-004-5381,4599.739,6,3,3,0.8844228004497341
40689,703-004-5394,6638.607,2,2,0,1.314517240530892
40991,703-004-5399,7162.3457,6,3,3,0.8207819069483812
41339,703-004-5392,6540.073,4,2,2,0.9884661733025375
41364,703-004-5385,7228.9443,"","","",0.27920371738274696
41590,703-004-5394,709.517,4,2,2,0.49379200515056243
41882,703-004-5389,2911.9355,4,2,2,0.4547685741581183
4232,703-004-5395,9063.273,2,1,1,0.8703522528666111
42320,703-004-5382,8328.793,2,1,1,0.4827210715322519
42663,703-004-5388,2012.8315,3,3,0,0.7061022598637211
42989,703-004-5396,7717.611,2,1,1,0.4695171191271305
4313,703-004-5385,9032.455,4,1,3,0.879210283749093
4314,703-004-5384,4266.306,3,2,1,0.6200360177137578
43164,703-004-5399,4636.84,5,1,4,0.5027621338911124
43538,703-004-5380,5031.9136,3,2,1,2.196475211456486
43545,703-004-5388,5243.786,4,3,1,1.2787241589026752
43609,703-004-5397,3776.5044,2,1,1,0.7780956123688249
43616,703-004-5382,498.38663,3,1,2,0.7009419623829464
43715,703-004-5398,4005.5293,1,0,1,0.27920371738274696
43952,207-008-2399,5957.7803,3,1,2,0.9299511972150756
44295,703-004-5385,3023.6812,3,1,2,0.44457999681059845
44674,703-004-5380,9333.045,3,2,1,0.7112143421386852
44797,703-004-5394,7898.4624,8,3,5,1.34565206843137
44955,703-004-5395,4637.6045,1,1,0,0.6198739954635811
4498,703-004-5391,9805.461,4,2,2,0.48466898975407396
45284,703-004-5390,5057.489,1,0,1,0.27920371738274696
45326,703-004-5380,7384.9263,6,3,3,0.9563674664835344
45423,703-004-5398,5593.8755,2,0,2,0.27920371738274696
45579,703-004-5390,6599.8804,4,2,2,1.1216688896040103
46309,703-004-5391,5850.5654,3,1,2,1.0449624870863528
46317,703-004-5391,4562.171,6,3,3,1.7051951210947143
46346,703-004-5390,7562.1064,1,0,1,0.27920371738274696
4639,703-004-5382,2154.1387,6,3,3,1.3881155124023916
47004,703-004-5394,6869.3574,3,2,1,0.7923855761131696
47093,703-004-5389,4418.092,3,3,0,1.4519806698245283
47517,703-004-5390,754.326,4,4,0,1.9234249842312703
47688,703-004-5385,3578.9795,3,3,0,0.7136451526760356
47874,207-008-2399,4795.572,5,5,0,1.8683101713537582
47945,703-004-5392,4366.368,3,1,2,0.5233891818513272
48211,703-004-5395,5104.2124,5,3,2,0.8381006353616527
48273,703-004-5394,4123.3857,2,1,1,1.5266168986885873
48556,703-004-5382,9112.066,3,0,3,0.27920371738274696
4860,703-004-5381,1940.8387,7,4,3,1.153052679714597
48754,703-004-5381,5324.091,4,1,3,0.3978652972704144
48794,703-004-5393,3671.183,3,2,1,1.0755575818203515
48891,703-004-5380,6322.977,3,1,2,0.32666834933781397
49051,703-004-5386,9366.571,3,0,3,0.27920371738274696
49189,703-004-5391,4536.1577,6,2,4,1.5897717526165744
49194,207-008-2399,7901.001,3,2,1,1.1864851131066232
49827,703-004-5398,5220.5874,6,5,1,1.3002645229668224
5151,703-004-5398,9037.164,3,3,0,0.66885745443611
525,703-004-5383,3971.4211,"","","",0.27920371738274696
5906,703-004-5390,8632.886,1,1,0,1.1200679829636886
6369,703-004-5393,1010.85364,6,3,3,0.7937236121539342
6430,207-008-2399,1532.2739,5,2,3,0.7579085943196644
6508,703-004-5386,1771.993,8,3,5,2.7297535712359835
6666,703-004-5394,5933.0283,4,1,3,0.5130164720864051
6681,703-004-5388,1911.1896,3,2,1,1.2624677517999776
7129,703-004-5390,7127.1367,4,0,4,0.27920371738274696
7324,703-004-5394,3306.3638,3,2,1,2.256360776753126
7533,703-004-5390,32.1275,3,2,1,0.6878164194587061
77,703-004-5382,4677.168,3,1,2,0.4862848531764819
7700,703-004-5381,3930.4172,4,1,3,1.047456752044991
8673,703-004-5382,9559.716,6,3,3,1.2330427224094085
8874,207-008-2398,858.47375,2,1,1,0.6275495364584411
89,703-004-5399,8517.393,5,2,3,0.9008745557114973
904,703-004-5390,9002.522,3,1,2,0.47419354502379135
9312,703-004-5395,4102.357,10,6,4,1.9250199009182274
9645,703-004-5389,844.26044,"","","",0.27920371738274696
9700,703-004-5380,9368.288,3,3,0,2.156735953987133
9857,703-004-5381,7891.508,6,3,3,1.087549840225347
9887,207-008-2399,2726.1538,2,2,0,0.8145814493734657
9949,703-004-5392,9216.226,3,2,1,0.8954205728150364
10451,703-004-5399,740.50543,5,2,3,0.7688868329846648
10581,703-004-5393,6625.5776,5,2,3,0.5788649965171938
10748,703-004-5381,5704.198,5,2,3,1.5917440346044434
11330,703-004-5399,4402.391,1,0,1,0.27920371738274696
11378,703-004-5382,5692.153,3,2,1,2.024277619775786
11728,703-004-5390,7297.465,4,1,3,0.3978652972704144
11792,703-004-5381,1121.741,3,2,1,0.5823539124911351
12054,703-004-5382,7648.015,2,0,2,0.27920371738274696
12080,703-004-5390,9026.625,4,1,3,0.4583226016700038
1216,703-004-5385,3590.0867,1,1,0,0.7649016488444756
12196,703-004-5385,6006.296,5,2,3,0.45719608721424815
12642,703-004-5384,3786.4197,5,2,3,0.486614270561399
12695,703-004-5385,992.4459,8,7,1,1.9588899921483256
12758,703-004-5380,6835.065,5,3,2,1.2390424889929676
12762,703-004-5394,7322.2905,3,0,3,0.27920371738274696
13414,207-008-2399,8843.477,"","","",0.27920371738274696
13544,703-004-5381,2860.2368,1,0,1,0.27920371738274696
13809,703-004-5398,6765.65,5,3,2,1.2630936571166116
14059,703-004-5392,9352.946,2,0,2,0.27920371738274696
14179,703-004-5398,2057.6353,1,0,1,0.27920371738274696
1439,703-004-5381,7998.6177,6,3,3,1.847225398587608
14459,703-004-5383,2570.3394,3,1,2,0.3787652739196833
14881,703-004-5383,4871.8125,6,3,3,1.5060093708261209
15141,703-004-5399,4340.914,3,2,1,1.2045599046742008
1540,703-004-5393,8038.157,6,3,3,0.7421449255462029
1541,703-004-5395,6152.96,7,5,2,1.9958754743825209
16028,703-004-5394,3851.3755,1,0,1,0.27920371738274696
16153,703-004-5393,8930.773,6,3,3,1.0678081340324537
16411,703-004-5383,2552.0098,3,2,1,0.9171783512173964
16606,703-004-5383,3983.8123,1,0,1,0.27920371738274696
1668,703-004-5383,654.06976,1,1,0,2.4810814560273693
16797,703-004-5384,1302.2167,4,2,2,2.434987949978647
17000,207-008-2398,8891.271,6,3,3,0.9799220266026514
17155,703-004-5398,281.98898,2,1,1,1.0386985290010133
17180,703-004-5395,3822.9812,7,3,4,0.8789103084004786
17293,703-004-5392,6336.4893,3,3,0,0.9261290279783465
17455,703-004-5395,6210.266,8,4,4,2.190741369478768
17576,703-004-5381,2287.3665,4,1,3,0.4495780478770348
17598,703-004-5385,9088.145,5,2,3,0.4453299292254814
17877,703-004-5386,9918.456,6,2,4,0.7680419446565606
18035,703-004-5399,2170.099,3,2,1,0.7793817706447671
1820,703-004-5399,9963.423,3,0,3,0.27920371738274696
19100,703-004-5387,1296.3247,4,2,2,0.5011688549694958
1916,703-004-5392,5086.8374,1,1,0,2.147781908109397
19364,703-004-5389,3708.9534,4,2,2,1.212965176610959
19518,703-004-5392,55.305363,4,3,1,1.3009781720819702
19595,703-004-5398,6170.1733,1,1,0,0.3367545836282657
19955,703-004-5393,9925.128,6,4,2,2.0830361481035315
20003,703-004-5380,7686.1323,2,1,1,0.5780430354455773
20165,703-004-5386,4448.089,5,4,1,1.6531791264159763
20466,703-004-5398,7025.197,5,1,4,0.33853450732658075
20568,703-004-5393,3600.1855,1,1,0,0.4158870247158539
20572,703-004-5383,7212.3037,6,4,2,1.0266326584818393
20733,207-008-2398,8072.713,4,2,2,0.7833795870574278
20920,703-004-5397,3288.8137,3,2,1,1.433512394014002
21128,703-004-5393,9263.985,4,1,3,0.8892455401416539
21270,703-004-5395,3816.8782,6,5,1,2.1951907334895013
21346,703-004-5381,5803.2925,7,4,3,1.3343252371018168
21700,703-004-5387,5762.359,6,4,2,1.071226749662861
21935,703-004-5384,4822.9043,5,2,3,1.0977701289420487
22206,703-004-5383,5055.78,7,4,3,1.334098295255349
22345,703-004-5396,7796.1323,8,4,4,1.706836864432025
22640,703-004-5384,6821.034,3,2,1,0.41764222725169237
22737,703-004-5390,1569.2675,5,2,3,0.7187716398525323
22968,703-004-5385,9444.55,3,2,1,1.0944661760839038
23182,703-004-5389,4894.8926,3,2,1,0.5567037104150478
23390,703-004-5387,2946.1938,5,3,2,0.7676538084988251
23515,703-004-5389,9407.791,"","","",0.27920371738274696
23563,703-004-5389,8197.996,6,5,1,1.1683809319828662
23814,703-004-5387,435.9287,5,3,2,1.4260489645452021
23956,703-004-5383,7969.932,2,1,1,0.35831143730785864
24148,703-004-5388,2359.445,3,1,2,0.4045517605298771
24436,703-004-5387,4381.049,6,3,3,0.9519707202720593
24895,703-004-5397,1488.6927,7,2,5,0.6966603654568437
25027,703-004-5389,7212.243,2,2,0,0.8656542929241677
25042,703-004-5398,8995.638,5,1,4,0.7425326184540776
2516,703-004-5399,8457.822,4,2,2,1.1931134935473984
25514,703-004-5393,5730.456,3,1,2,0.5070278750934017
25545,703-004-5383,7421.924,7,2,5,0.5952842480570392
25831,703-004-5381,7453.4546,5,3,2,1.0855547096729952
25926,703-004-5389,9999.299,4,1,3,0.8853471665877161
25974,703-004-5385,9705.867,6,3,3,2.1689397443212735
26027,703-004-5394,306.82803,5,1,4,0.3964894797026006
26549,703-004-5384,5972.2974,7,5,2,4.378008282499122
2666,703-004-5383,3622.0776,3,2,1,1.7480332034888078
2667,703-004-5392,2962.8945,6,3,3,0.8654682191249421
26947,703-004-5385,9664.743,2,1,1,0.5842026520849563
27030,703-004-5384,1399.7524,3,2,1,1.534903419067612
27070,703-004-5383,9357.236,3,2,1,1.4220020666057505
27126,207-008-2399,4458.089,10,3,7,1.3259567952815259
27611,703-004-5386,2629.8857,4,1,3,0.4296536428823082
27774,207-008-2398,8146.5747,4,3,1,0.7390741169426451
27864,703-004-5394,8117.1255,7,2,5,0.6626287489437627
27963,703-004-5392,693.9751,4,1,3,1.9206248632802008
27995,703-004-5390,1097.2155,6,4,2,2.5771853807268874
28009,207-008-2398,1501.2878,3,2,1,1.0212965677535915
28184,703-004-5399,5330.941,2,1,1,0.6129939319389661
28635,703-004-5393,8877.39,5,3,2,2.9052506388994486
29732,703-004-5396,2454.3816,5,3,2,1.0588281852668264
29867,703-004-5390,8565.535,4,2,2,0.9103846813028397
3010,703-004-5394,9940.165,4,2,2,0.4057760692629256
30287,207-008-2398,6237.506,7,6,1,2.4168449024794643
30319,703-004-5397,551.8335,6,5,1,1.0837309975587877
30430,703-004-5382,8700.976,4,1,3,0.41711614703135846
30538,703-004-5393,7320.1416,7,5,2,2.1659762992917506
30668,703-004-5390,8800.878,5,2,3,1.1978697581822633
30944,703-004-5388,8180.536,5,2,3,1.0552974678621898
30984,703-004-5380,6839.036,1,1,0,0.3978652972704144
31156,703-004-5389,674.8956,2,1,1,0.33473733677017536
31799,703-004-5393,4992.441,5,4,1,2.125998242996364
31904,703-004-5385,1177.2131,2,2,0,1.8728261309648524
32066,703-004-5389,352.85056,2,1,1,0.5873197015271687
32203,703-004-5394,8250.392,2,1,1,0.7187851553286004
32351,703-004-5389,3059.2268,5,4,1,2.1736515488902377
32535,207-008-2399,8496.674,5,3,2,1.793337367286291
32619,703-004-5388,6387.554,2,1,1,0.7519149153736486
3348,703-004-5388,7372.514,8,6,2,2.6440404355968106
3353,703-004-5383,1087.1536,2,1,1,0.35831143730785864
33710,703-004-5392,1821.2343,1,1,0,2.2035401870574125
34047,703-004-5392,8252.799,4,3,1,1.1217901095040583
34049,703-004-5386,1939.0541,4,2,2,1.0681668041421057
34326,703-004-5399,6420.305,1,0,1,0.27920371738274696
34730,703-004-5396,4622.2637,7,3,4,1.5081479311515338
3503,703-004-5389,5084.866,5,2,3,0.8372982040620865
35048,703-004-5381,415.42053,6,2,4,0.9195402663461302
35290,207-008-2399,1869.1808,4,1,3,0.3978652972704144
35356,703-004-5397,1504.9886,2,0,2,0.27920371738274696
35570,703-004-5395,7622.76,2,0,2,0.27920371738274696
35958,703-004-5382,1726.2328,7,2,5,0.7945191208733245
37122,703-004-5395,513.47437,3,1,2,0.49534236325997705
37346,703-004-5392,4349.1084,4,2,2,0.8613274236975058
37372,703-004-5386,8594.984,2,1,1,0.30886911235466386
3758,703-004-5381,5924.142,6,3,3,0.9785752481516965
37590,703-004-5388,7138.718,3,2,1,1.1323644287960262
37833,703-004-5393,6497.6396,3,1,2,0.8064825936094788
38063,703-004-5381,5168.7104,"","","",0.27920371738274696
385,703-004-5399,7937.91,5,3,2,1.85423759064928
38712,703-004-5399,1086.5492,3,2,1,0.9918862880253239
38993,207-008-2399,4564.804,"","","",0.27920371738274696
3926,703-004-5396,2556.3967,1,1,0,0.5461719297477907
39279,703-004-5389,2444.632,2,2,0,0.5910935458402041
39370,703-004-5396,4579.1357,2,1,1,0.3899131946530576
39933,703-004-5396,9848.146,6,2,4,0.6764733138270975
40269,207-008-2398,8439.578,2,1,1,0.4894899695398899
40423,703-004-5383,7869.5117,2,1,1,0.4339777711977018
40787,703-004-5384,5191.049,9,4,5,1.5344167446526173
41049,703-004-5385,8450.524,4,0,4,0.27920371738274696
4116,703-004-5384,795.37036,7,4,3,1.2513145203264449
41173,703-004-5392,4104.1006,3,1,2,0.4753401199213634
41192,703-004-5397,6980.579,6,3,3,2.57240941990212
41253,703-004-5384,4846.7754,5,2,3,0.49411780865558025
4126,703-004-5384,6166.447,7,4,3,1.2141453648463194
41416,703-004-5388,8358.856,5,1,4,0.9631007420386116
41532,703-004-5388,9641.221,1,1,0,0.41898617973034685
41684,703-004-5390,6134.038,4,1,3,0.5469692388649472
41800,207-008-2399,172.0965,4,2,2,0.6084119437911856
41927,207-008-2399,1043.9092,3,1,2,1.8861864784771354
42144,703-004-5389,3332.5696,6,3,3,0.7880399776598249
42176,703-004-5392,9223.43,8,4,4,2.435163031798873
42240,703-004-5393,59.764385,10,5,5,2.0666881610034054
42253,703-004-5392,9256.92,3,1,2,0.8839622282575471
42410,703-004-5386,6693.1763,5,2,3,1.3784748912239946
42641,703-004-5393,347.867,4,2,2,0.9390061799503038
4319,703-004-5390,6895.263,4,1,3,0.5041782400181036
43240,703-004-5389,8246.815,5,1,4,0.42569868883098055
43428,703-004-5394,3186.8489,5,4,1,0.8123273005457305
43678,703-004-5382,5806.5117,3,1,2,0.5323484211431042
43696,703-004-5393,4300.5645,4,4,0,1.823373847756729
43730,703-004-5396,2871.1116,3,3,0,0.9349502100476903
43798,703-004-5395,9873.17,4,2,2,0.5697268188077195
43820,703-004-5383,5220.921,4,1,3,0.41131695895556847
44025,703-004-5394,2127.4788,3,2,1,0.5956345970831934
44412,703-004-5395,2811.6853,2,1,1,0.4940541710224523
44416,703-004-5396,6626.908,5,4,1,1.5975330599707853
44586,703-004-5384,9024.269,3,2,1,0.5580584301187655
44965,703-004-5390,1659.8052,6,4,2,1.1169242876399048
45054,703-004-5389,3519.8486,4,2,2,1.193800890223795
45289,703-004-5396,1430.0072,2,0,2,0.27920371738274696
45484,703-004-5381,4191.166,5,3,2,0.8897342481237365
4550,703-004-5391,5454.167,2,0,2,0.27920371738274696
46143,703-004-5382,7862.284,8,6,2,2.261569517415407
46541,703-004-5384,3653.4048,3,3,0,0.9539917038094035
46626,703-004-5394,3359.7273,3,2,1,0.49092272618176247
46659,207-008-2399,9900.873,5,2,3,1.2850562940371577
47054,703-004-5398,3107.9424,3,2,1,1.0404559503109194
47081,703-004-5388,9591.719,5,2,3,1.1012155966714752
47441,703-004-5399,6879.1,2,1,1,0.5491967673990469
47773,703-004-5388,8924.536,2,0,2,0.27920371738274696
47828,703-004-5385,3349.654,3,2,1,0.6542291032234249
47830,703-004-5382,1718.133,5,0,5,0.27920371738274696
47866,703-004-5395,625.7588,2,1,1,0.49477478635845057
47889,703-004-5386,1441.3214,6,3,3,0.7458972993942037
48532,703-004-5384,2139.7168,5,2,3,0.7351426498044956
48653,703-004-5381,8765.054,4,3,1,1.3585739976215625
48956,703-004-5390,5711.1465,4,2,2,1.55075358931442
49078,703-004-5383,3627.851,10,7,3,2.1017121386766173
49217,703-004-5396,4825.0767,6,4,2,2.052593747383074
49275,703-004-5397,4378.692,5,3,2,1.5902834656079992
49704,207-008-2399,1515.9851,2,1,1,0.8701245468893782
49742,703-004-5384,2064.371,2,1,1,0.35534489781066697
49760,703-004-5389,9703.971,2,0,2,0.27920371738274696
517,703-004-5386,251.32776,3,1,2,0.9201104167916695
5250,703-004-5390,3326.8755,4,1,3,0.7206109276617026
5551,703-004-5386,4709.2544,2,1,1,0.35831143730785864
5933,703-004-5388,5716.4106,6,3,3,1.0799720327797953
5974,703-004-5389,245.5449,3,1,2,0.3652525217022252
6001,703-004-5392,3663.0571,4,2,2,1.3125802767688384
6049,207-008-2399,4063.3928,5,3,2,1.2797996308785735
6262,703-004-5382,709.5134,6,3,3,1.3716832972758108
6336,703-004-5385,2860.1665,2,2,0,1.5690338136737587
6557,703-004-5395,1554.7937,3,2,1,0.7402159398812751
6845,207-008-2398,4286.5684,4,2,2,1.2118475330174592
6954,703-004-5385,8331.252,5,3,2,0.9821661208172212
7004,703-004-5393,6811.6377,4,3,1,0.7031369855792884
7097,703-004-5383,7858.9546,8,0,8,0.27920371738274696
7247,703-004-5396,7910.9253,5,3,2,1.6699564130377027
7348,703-004-5382,5001.064,2,1,1,1.0131386347110478
7630,703-004-5389,6918.095,2,1,1,0.41611805090231796
7741,703-004-5392,8579.297,4,2,2,1.118344796755429
8209,703-004-5386,746.1697,7,6,1,2.845226747627493
8212,703-004-5398,1007.5122,4,4,0,2.5929851004789546
8383,703-004-5380,4659.636,6,3,3,1.713338267826981
8552,703-004-5391,6713.799,5,3,2,0.7891345656041219
8560,703-004-5385,2293.7913,2,1,1,0.5977027987069667
8990,703-004-5384,2292.4214,7,4,3,1.4015839917029493
935,703-004-5385,4051.46,2,2,0,0.4858889857489389
10219,703-004-5391,7756.574,1,1,0,0.3468408179187174
10570,703-004-5388,4111.4585,6,3,3,1.1323859064783417
10845,703-004-5398,9481.238,5,4,1,0.6058673174333318
10922,703-004-5387,1780.3365,7,3,4,1.7703509773437882
11051,703-004-5383,4700.752,4,3,1,1.3333849330593328
11219,703-004-5393,6445.5654,2,1,1,0.803074921653283
11325,207-008-2398,8102.096,1,0,1,0.27920371738274696
11334,703-004-5392,7042.151,2,1,1,0.43132444910578543
11577,703-004-5384,7476.626,8,4,4,1.674732559138536
11725,703-004-5399,4401.4854,8,5,3,4.469444280867703
11741,703-004-5395,1312.6016,3,2,1,1.7019905945484513
11886,703-004-5395,4612.715,2,0,2,0.27920371738274696
1200,703-004-5384,1974.3413,7,2,5,0.5200455226172509
12199,207-008-2398,714.1447,1,1,0,1.0405087477012707
12278,703-004-5389,6965.732,3,1,2,0.4148405507795705
12631,703-004-5397,1118.1963,3,1,2,0.3187575773453028
12963,703-004-5380,456.48276,4,3,1,0.7008284480209246
1308,703-004-5392,5990.7876,3,2,1,0.6474016011996874
13098,703-004-5399,1006.8202,4,3,1,0.5215414971146466
13118,703-004-5394,3730.4895,3,1,2,0.43679707333221196
13261,703-004-5382,7428.369,3,2,1,2.6436055650101755
13614,703-004-5385,4791.5923,3,2,1,2.230426310865609
13662,703-004-5398,710.8343,5,4,1,2.532669702136827
13895,703-004-5383,4532.695,2,2,0,0.6017725746859682
14233,703-004-5389,9802.078,3,2,1,0.9157010932978928
14339,703-004-5382,5734.0156,2,1,1,0.7203560131748719
14386,703-004-5381,9824.252,10,6,4,1.8660628010789335
14843,207-008-2398,693.8005,5,3,2,0.9735142687641914
14903,703-004-5390,2047.2258,8,4,4,1.0609382996602077
15815,703-004-5382,0.2861023,2,1,1,0.8555482474949432
15929,703-004-5398,9802.594,2,1,1,0.5355197126710918
16616,703-004-5381,9756.299,"","","",0.27920371738274696
17341,703-004-5383,2159.9888,3,1,2,0.865745269953162
17568,703-004-5389,6120.671,1,1,0,1.1523267855600492
17673,703-004-5384,1061.9843,6,1,5,0.8903110517606707
17674,703-004-5388,2067.6934,5,2,3,0.47184090386538435
17970,703-004-5390,8379.886,2,1,1,0.5433965072002108
18076,703-004-5381,8339.135,1,1,0,0.5803209215670839
18094,703-004-5383,2946.39,3,1,2,0.3693583944474611
18228,703-004-5398,3963.2678,3,0,3,0.27920371738274696
185,703-004-5383,343.97662,5,2,3,1.1664741527847187
18705,703-004-5391,3281.6833,3,0,3,0.27920371738274696
18770,703-004-5387,6213.4067,3,1,2,1.0950336643661256
18839,207-008-2399,7043.7236,5,2,3,1.003489303041132
19148,703-004-5393,5742.615,5,1,4,0.4032545106903127
19323,703-004-5382,3245.9324,7,4,3,1.3847253806828892
19626,703-004-5394,5765.9556,2,1,1,0.5743743537270817
19699,703-004-5394,2219.6997,2,1,1,0.3978652972704144
19870,703-004-5383,1308.9233,3,3,0,1.1309666668021854
20010,703-004-5384,8132.848,6,4,2,1.688957554299296
20332,703-004-5386,5479.285,2,1,1,0.3978652972704144
20440,703-004-5382,3788.3884,1,1,0,0.8146031177584041
20581,703-004-5389,3747.7083,3,2,1,0.39469372471898534
20808,703-004-5392,7675.4624,2,1,1,0.4651030285207874
21311,703-004-5381,9063.292,5,5,0,2.187759469367707
21449,703-004-5398,8249.607,3,3,0,0.9790221511373074
2165,703-004-5385,5081.1816,2,0,2,0.27920371738274696
21979,703-004-5389,9383.373,5,3,2,1.4836579593040327
22046,703-004-5395,2383.4639,4,4,0,3.153748543859157
22061,703-004-5394,874.7566,3,3,0,1.076948040678845
22090,703-004-5387,8138.145,1,0,1,0.27920371738274696
22533,703-004-5388,4323.303,6,4,2,1.4409079696059444
22671,703-004-5390,1929.7249,2,2,0,2.7274642673803133
23238,703-004-5381,4493.1567,3,2,1,0.5241376884815041
23380,207-008-2398,8807.63,3,1,2,0.32666834933781397
23406,703-004-5383,3105.9282,3,0,3,0.27920371738274696
23671,207-008-2398,2984.7014,4,2,2,0.4932336561140613
23984,703-004-5398,4175.618,2,2,0,0.4913870901212753
24167,703-004-5383,6168.626,4,1,3,0.3978652972704144
24283,207-008-2399,3398.162,3,2,1,1.297319554052428
24433,703-004-5395,4726.045,4,1,3,0.9324211174451175
24462,703-004-5388,3566.096,3,2,1,0.878842981210924
25114,703-004-5399,4739.4414,3,2,1,1.0489493486004264
25188,703-004-5394,8680.599,3,1,2,0.7190804006318874
25242,703-004-5390,6401.265,4,1,3,0.8786896282438941
25447,703-004-5395,143.74196,6,2,4,1.8930696245606389
25564,703-004-5380,5273.2056,1,0,1,0.27920371738274696
25641,703-004-5391,9896.708,2,1,1,1.2510580309648769
2575,207-008-2399,6543.951,3,0,3,0.27920371738274696
25818,703-004-5390,9555.249,3,3,0,1.5476791730636141
26160,207-008-2399,8815.0,5,2,3,0.9826981448892023
26245,703-004-5398,9455.167,6,3,3,1.0178303763310992
26422,703-004-5385,8929.914,4,3,1,1.450395731717623
26434,703-004-5399,2655.9722,6,2,4,0.7334296409855152
26625,703-004-5393,4607.464,3,2,1,0.9680561940245311
27195,703-004-5382,2025.3539,1,1,0,0.6102676909590834
27570,703-004-5395,6185.109,4,2,2,0.7660732783801788
27696,703-004-5396,9947.144,3,1,2,1.9123943092482512
27886,703-004-5392,5942.428,3,0,3,0.27920371738274696
27911,703-004-5381,7557.227,8,6,2,1.71942062568749
28391,703-004-5393,3548.1501,3,1,2,0.4688908179351608
2843,703-004-5382,1020.54535,2,0,2,0.27920371738274696
28460,703-004-5381,8166.186,4,1,3,0.47698595166089336
28543,703-004-5387,5982.0864,4,2,2,0.6684796225142339
28708,703-004-5390,883.23413,4,1,3,0.7135612719074481
28818,703-004-5380,7870.0234,6,2,4,0.6081542615487232
28824,703-004-5391,6076.182,3,1,2,0.5038082345148956
29439,703-004-5383,3718.3357,5,2,3,0.6758386693536748
29496,703-004-5389,8995.362,3,0,3,0.27920371738274696
29684,703-004-5388,2102.968,3,2,1,1.0388161839933059
29795,703-004-5380,2774.9253,4,2,2,1.0664207195094078
30058,703-004-5395,2464.7456,3,2,1,2.3642471453968086
30205,703-004-5394,6935.0225,3,1,2,1.0654455885724734
30312,703-004-5399,4047.9736,4,3,1,0.9228304193576945
30562,703-004-5390,2862.9648,3,2,1,0.882312881820366
30764,703-004-5392,2318.0784,"","","",0.27920371738274696
30767,703-004-5389,4732.9062,2,2,0,1.3555533718939394
30889,207-008-2398,584.0963,3,1,2,0.4828975541440045
31536,703-004-5393,2590.5562,4,1,3,0.6230469302488651
31570,703-004-5391,9081.322,3,2,1,0.650779550584973
31692,703-004-5394,9751.297,5,4,1,2.1009114301679084
31700,703-004-5380,4010.815,4,1,3,0.7935605811163101
32414,703-004-5385,8799.521,3,2,1,0.7097091156466729
32459,703-004-5396,7109.347,5,2,3,0.5600221216173688
32620,703-004-5388,7205.7397,3,3,0,2.9039922906102436
32984,703-004-5389,4879.716,3,3,0,1.3437279693345865
33142,703-004-5390,2280.0732,6,4,2,2.4277596390530753
33553,207-008-2398,6243.841,3,0,3,0.27920371738274696
33610,703-004-5388,6418.0107,6,3,3,3.5301848378900362
33930,703-004-5384,3402.602,4,3,1,0.672033695527427
34074,703-004-5382,6061.996,2,1,1,0.37732325908246794
341,207-008-2398,8861.558,6,5,1,2.461250311344748
3415,207-008-2398,6731.2793,3,1,2,0.40199373140400624
34439,703-004-5387,862.04706,5,4,1,2.2885360255034457
3460,703-004-5397,5574.9277,3,2,1,0.45719608721424815
34819,703-004-5393,685.48975,1,1,0,0.5165268771580819
35295,703-004-5380,510.65088,4,1,3,0.770101232723617
35318,703-004-5397,5139.459,5,2,3,0.902706130216843
35707,207-008-2399,4593.6543,4,2,2,0.7382963373967292
35986,703-004-5386,9308.387,5,1,4,0.3915322276229066
35997,703-004-5387,8049.7114,4,4,0,2.0435587492774454
36034,703-004-5389,1851.0658,2,2,0,3.771167317890243
36037,703-004-5381,8974.826,5,3,2,0.9928538817773307
36612,703-004-5385,5457.627,4,2,2,0.5799228494036551
36734,703-004-5383,9295.424,6,4,2,2.2724893539930955
3718,703-004-5391,4535.2666,2,2,0,1.0456204287281103
37514,703-004-5399,1947.1007,8,4,4,1.3606118215186918
37633,703-004-5381,9131.965,4,3,1,1.1453495655028874
38248,703-004-5398,9146.865,1,1,0,0.7934374261804367
38290,703-004-5389,3488.9631,5,4,1,2.776378970047657
38632,703-004-5390,5661.162,"","","",0.27920371738274696
38882,703-004-5392,5242.764,2,2,0,1.1170902857562222
39096,703-004-5392,16.958714,1,0,1,0.27920371738274696
39471,703-004-5389,7658.384,4,2,2,0.3978652972704144
39474,703-004-5392,8577.558,4,2,2,0.887791828660284
39586,703-004-5390,4112.617,5,3,2,1.5295722004752355
39731,703-004-5386,7907.047,2,2,0,2.582661612034844
39907,703-004-5385,8539.699,5,4,1,0.7043115060702608
39947,703-004-5397,9247.991,7,4,3,1.225600570929692
40503,703-004-5386,7063.156,5,3,2,1.4002395607947868
40634,703-004-5394,213.26065,2,0,2,0.27920371738274696
40636,703-004-5390,8950.172,3,2,1,0.9735487600615857
40770,703-004-5388,9886.096,4,3,1,0.6474906511536658
40820,703-004-5395,7413.5625,2,2,0,1.2068510755626978
40822,703-004-5384,8953.34,6,2,4,1.2773399312299443
40977,703-004-5380,8117.153,6,2,4,0.496180386224323
41019,703-004-5388,8791.948,2,1,1,0.4238641731831465
4113,703-004-5384,7950.5337,5,1,4,0.5669580486103406
41556,703-004-5398,3345.2434,2,2,0,0.6441891278098438
41904,703-004-5389,2669.7605,10,8,2,4.021860158437414
41965,703-004-5384,4886.95,8,3,5,2.383478489061774
42005,703-004-5392,4268.184,3,0,3,0.27920371738274696
42244,703-004-5387,5919.2266,1,0,1,0.27920371738274696
42356,703-004-5388,655.66003,6,4,2,1.5668828806665134
42520,703-004-5382,1039.5867,6,4,2,1.0329023454966637
42666,703-004-5395,5574.4985,5,1,4,0.5837684390944268
42707,703-004-5393,2944.0254,6,4,2,1.0823455560074084
42879,703-004-5380,5054.458,6,5,1,1.4687315829913836
43035,703-004-5390,207.1184,3,2,1,0.7552540188539585
43133,703-004-5389,5704.046,5,2,3,0.6633870950529046
43664,703-004-5399,7986.15,3,1,2,0.3667166325499017
43974,703-004-5387,4659.222,3,2,1,1.1935595539170982
44552,703-004-5395,981.97815,1,0,1,0.27920371738274696
44621,703-004-5380,1944.328,3,0,3,0.27920371738274696
44626,703-004-5391,7625.7944,5,3,2,1.618225985651921
44751,703-004-5382,8223.3545,1,1,0,0.4917986073472725
45370,703-004-5397,9306.196,2,1,1,1.0150280902011821
45452,703-004-5398,6184.797,7,3,4,2.0851005505298064
45455,703-004-5391,488.382,6,3,3,1.8499844466435023
45727,703-004-5391,5037.336,4,2,2,0.867965579164523
45868,703-004-5398,9699.66,5,2,3,0.8276472812974282
45975,703-004-5380,8870.587,2,0,2,0.27920371738274696
4599,207-008-2399,4126.1626,"","","",0.27920371738274696
46153,703-004-5393,6430.0566,2,0,2,0.27920371738274696
46594,703-004-5391,688.75433,3,0,3,0.27920371738274696
46620,703-004-5383,7874.7905,2,2,0,0.6281086709787336
4694,207-008-2398,3325.472,4,3,1,1.0149873403514227
47025,703-004-5383,406.4131,1,0,1,0.27920371738274696
47026,703-004-5382,2158.3574,6,3,3,2.7763331254173744
4713,703-004-5394,2893.3071,3,1,2,0.7212347688586044
47262,703-004-5392,8915.663,4,2,2,0.6205534887753321
47390,703-004-5399,4557.7515,9,4,5,1.1984932514576627
47482,703-004-5386,8319.809,5,1,4,1.0863426670442664
47494,703-004-5391,8216.688,3,2,1,0.6057084131561998
47569,703-004-5398,7077.4136,4,2,2,0.7135672807804297
47716,703-004-5394,7910.34,2,1,1,0.3978652972704144
4781,703-004-5392,631.60895,1,0,1,0.27920371738274696
47831,703-004-5385,9298.466,2,2,0,1.2665016277280339
48024,703-004-5389,2894.1125,4,1,3,0.32666834933781397
48303,703-004-5386,534.7693,7,4,3,1.5010017227841055
48575,703-004-5390,6930.34,4,2,2,1.7123934463195003
48587,703-004-5383,3046.884,5,5,0,1.172942798976347
48615,703-004-5397,9599.8545,3,2,1,1.0168864214956317
49011,703-004-5392,5893.9766,3,3,0,1.0293289103315157
49429,703-004-5397,1995.7799,7,5,2,1.1715272631569345
49535,703-004-5390,7733.954,2,0,2,0.27920371738274696
4973,703-004-5382,2539.4644,5,2,3,0.9661575202661669
49822,703-004-5381,2488.4521,6,4,2,2.1139459808112098
5331,703-004-5392,2974.8767,5,3,2,0.8304159115285101
5396,703-004-5399,9405.125,2,2,0,1.1566608919980366
5491,703-004-5385,3470.9883,5,3,2,1.047811946614479
5675,703-004-5387,2921.7761,3,2,1,0.6511344269791647
5902,703-004-5381,9801.345,4,3,1,0.6026996786740142
5951,703-004-5386,6896.951,4,0,4,0.27920371738274696
6066,703-004-5397,509.6328,1,0,1,0.27920371738274696
6070,703-004-5387,5185.1123,4,2,2,1.2217339519001558
6294,703-004-5380,8849.833,6,3,3,1.8409259811174767
6435,207-008-2399,4106.459,3,1,2,0.4246133375579837
653,703-004-5398,4434.6206,3,2,1,1.5125750323359515
6651,703-004-5388,9349.023,6,5,1,3.12188262264098
7107,703-004-5388,8275.566,6,4,2,1.929313368942354
7375,703-004-5391,2264.3584,2,1,1,0.8490467986112915
7404,703-004-5388,9115.601,5,2,3,0.8776929542346578
753,703-004-5389,7114.8223,4,2,2,0.41764222725169237
7738,703-004-5383,998.62933,4,3,1,2.178444183875711
7753,703-004-5388,8080.407,5,3,2,1.9455211570230364
7866,703-004-5381,4918.8306,4,3,1,1.31093934560375
7916,703-004-5380,5601.1367,7,1,6,0.35831143730785864
8016,703-004-5392,9442.196,7,3,4,2.6121595392496495
8081,703-004-5396,9295.37,3,1,2,0.4457749101500602
8365,703-004-5389,7870.2114,4,2,2,0.5266790345484713
8430,703-004-5396,835.35376,5,1,4,0.9054463509405472
8692,703-004-5390,154.90651,5,3,2,1.7503663281213997
9158,703-004-5388,2316.199,7,3,4,1.7656237572846694
9829,703-004-5383,4626.635,5,1,4,0.4947713433249708
10372,703-004-5399,1310.7443,7,3,4,1.0605644843460824
10391,703-004-5386,2652.2654,8,5,3,2.910238342744845
10410,703-004-5384,1428.3419,1,0,1,0.27920371738274696
1066,703-004-5391,5083.5513,4,2,2,0.8164197568220005
10714,703-004-5381,7221.181,3,2,1,1.5476136655957817
10737,207-008-2398,4693.4746,3,2,1,1.407561834286454
11515,207-008-2399,7239.253,2,1,1,0.43990614853170473
11666,703-004-5383,8742.643,4,3,1,2.798024052330251
11812,703-004-5387,2736.9578,3,1,2,0.678154201210691
12174,703-004-5385,2926.7073,2,1,1,0.38889925649453955
12507,703-004-5386,4406.5107,5,2,3,0.49281837933389555
12510,703-004-5381,6055.047,1,1,0,0.36368004975902635
12809,703-004-5396,2057.6877,1,0,1,0.27920371738274696
12893,703-004-5387,7038.2295,3,2,1,0.5622494672702886
13914,703-004-5395,4967.279,5,1,4,0.3978652972704144
1396,703-004-5385,2297.9666,6,5,1,1.7628767573290196
14812,703-004-5392,6985.4673,3,2,1,2.5601061671511585
14954,703-004-5397,6355.8125,5,2,3,0.46920437966615985
15076,703-004-5385,5015.4434,"","","",0.27920371738274696
15260,207-008-2398,4488.229,5,0,5,0.27920371738274696
15289,703-004-5390,5109.4414,4,3,1,2.6026361646956686
15292,703-004-5395,8777.228,4,1,3,0.41122914568588836
15535,703-004-5388,6442.6177,4,1,3,0.3978652972704144
15711,703-004-5382,9444.81,3,0,3,0.27920371738274696
15718,703-004-5394,1897.583,1,1,0,0.7169642995332095
15821,207-008-2398,1134.8885,4,2,2,1.4902811220720853
15956,207-008-2399,6657.9897,4,1,3,0.33853450732658075
16019,703-004-5384,7850.367,4,3,1,0.979278303742606
16035,703-004-5390,1719.3723,6,4,2,0.8791335513490919
16220,703-004-5394,5743.4434,6,3,3,0.7144894753806323
16237,703-004-5384,8018.0454,4,3,1,1.6244687220095493
16326,703-004-5381,157.71747,5,3,2,1.309609793679758
16489,703-004-5383,5710.4136,7,3,4,1.4701121822498315
16493,703-004-5397,4264.628,1,1,0,0.597922480565864
16764,703-004-5395,4080.1167,4,2,2,0.7044453823230435
16783,703-004-5389,1058.9993,3,3,0,1.0512583093541603
16927,703-004-5383,3782.7588,4,1,3,0.587060243764842
17118,703-004-5389,7968.2847,5,4,1,0.9827930473865265
1740,703-004-5396,9377.961,1,0,1,0.27920371738274696
17430,703-004-5395,6331.854,3,0,3,0.27920371738274696
17457,703-004-5387,3186.6753,2,0,2,0.27920371738274696
17962,703-004-5387,6950.7935,4,0,4,0.27920371738274696
18099,703-004-5384,4594.0024,5,2,3,0.8073428034012856
1831,703-004-5391,1173.8986,5,0,5,0.27920371738274696
18364,703-004-5382,8443.138,2,2,0,0.9811630073601008
18893,703-004-5388,7190.2124,3,1,2,0.45165854681949036
18966,703-004-5397,8517.04,5,2,3,1.0678053031668104
19271,703-004-5394,4703.8745,5,3,2,1.438213199535713
19320,703-004-5390,8417.615,8,2,6,0.4314038858669439
19415,703-004-5385,8588.091,5,3,2,3.1992709189978954
19501,703-004-5383,5118.7217,5,4,1,3.0175313240711517
20547,703-004-5384,1402.7649,2,1,1,0.3640994854823793
20656,703-004-5384,1032.5044,7,3,4,0.8024047005847218
20821,703-004-5390,1400.5667,2,0,2,0.27920371738274696
20901,703-004-5384,2326.3115,6,3,3,1.2174161187353392
20903,703-004-5386,519.40857,3,2,1,0.7305509098583021
21219,703-004-5386,8926.818,3,2,1,0.9322181437863614
21306,703-004-5380,7774.2827,4,3,1,1.4402038471502085
21786,703-004-5392,23.574234,5,3,2,1.209076717465657
21927,703-004-5382,6033.549,3,2,1,0.9322341080924079
2198,703-004-5381,5676.0674,5,3,2,1.530134507315021
22534,703-004-5389,4817.152,6,4,2,1.17576083363338
22581,703-004-5384,9701.61,3,3,0,2.6311223715529315
2269,703-004-5397,4084.122,7,4,3,2.215271384639268
22914,207-008-2399,3511.119,2,2,0,1.5742561404858517
23115,703-004-5391,5394.454,3,1,2,0.38223822643020805
23439,703-004-5394,9470.534,5,1,4,0.3486207416170325
2348,207-008-2398,3255.6624,2,2,0,2.1608905932928577
23871,207-008-2399,6976.067,2,1,1,0.7367581726861963
24208,703-004-5389,2021.3229,4,3,1,0.6959181178786302
24297,703-004-5382,3233.4072,4,4,0,2.702795779448893
24378,703-004-5394,2553.3796,4,2,2,1.5863036628208493
24420,703-004-5384,168.84506,2,1,1,0.35831143730785864
2491,703-004-5397,6082.3037,"","","",0.27920371738274696
25054,703-004-5381,5741.845,6,3,3,1.0288173448704603
25390,703-004-5396,8243.499,4,2,2,1.081184586687963
25536,703-004-5383,1272.1348,2,0,2,0.27920371738274696
25673,703-004-5382,502.11966,9,7,2,1.7629060232021163
26110,703-004-5398,2642.991,2,2,0,0.9821586273673716
26134,703-004-5387,7951.2217,2,1,1,0.7244401888740609
26236,703-004-5392,9464.007,2,1,1,0.35831143730785864
26269,703-004-5399,1911.1503,2,2,0,0.8561231917951126
26446,703-004-5390,6964.6465,4,2,2,0.6623551852208122
26514,207-008-2398,8864.322,7,4,3,1.394006991371811
26533,703-004-5382,3563.072,5,0,5,0.27920371738274696
26575,703-004-5384,6876.82,7,2,5,0.6886433442211377
26716,703-004-5397,102.61476,3,2,1,0.8076669598120719
26764,703-004-5397,7265.7837,5,2,3,1.2977003944322267
27074,703-004-5398,2901.637,3,2,1,0.5892517192843443
27213,703-004-5394,976.8104,4,2,2,0.7760379524363427
2735,703-004-5398,5986.057,1,1,0,0.6894945883123397
27509,703-004-5396,2661.9644,5,2,3,0.9849978523261886
27520,703-004-5393,8882.363,1,0,1,0.27920371738274696
27664,703-004-5396,4418.6562,3,0,3,0.27920371738274696
27902,703-004-5393,9800.871,5,4,1,1.8765277592442569
27974,703-004-5380,2561.2568,5,3,2,1.6376676799908636
28224,703-004-5395,5402.42,4,2,2,1.3436121388953417
28273,703-004-5387,6386.7344,3,3,0,1.3382892944721154
28417,703-004-5394,3815.3018,5,3,2,0.6954389891301563
28498,703-004-5398,2148.4255,2,1,1,1.17154318675511
28743,207-008-2399,7328.448,8,4,4,1.0730605658183612
29082,207-008-2398,3981.5325,4,3,1,0.8477819950489803
2927,207-008-2399,8539.735,4,3,1,4.449351160304392
29366,703-004-5396,2897.4617,5,4,1,2.145208102822399
29801,703-004-5382,4709.1196,5,4,1,1.208735982774898
29996,207-008-2399,6552.1514,3,1,2,0.33853450732658075
30007,703-004-5389,627.59576,5,1,4,0.3978652972704144
30041,703-004-5393,9495.352,3,1,2,0.3978652972704144
30108,703-004-5390,3993.6084,5,2,3,1.536933146442869
30649,703-004-5381,9751.104,4,3,1,1.0170186973937323
30903,207-008-2399,905.6604,7,2,5,0.786098693966208
30969,703-004-5396,6723.0127,2,1,1,0.611695774561608
31016,703-004-5391,6644.449,3,1,2,0.5719314852609562
31046,703-004-5394,3743.9556,4,1,3,0.8795946071661129
31466,703-004-5386,1177.0719,3,2,1,0.677638633851851
31582,703-004-5388,5429.9136,8,3,5,1.4813696198731152
31646,703-004-5384,2951.057,7,1,6,0.5106980650398629
31726,703-004-5393,7701.8013,8,4,4,3.0943101143278406
31931,207-008-2399,2080.5442,3,2,1,1.021147610822976
32286,703-004-5380,2885.2732,5,2,3,1.645592707138023
32378,703-004-5399,1218.1008,7,6,1,4.33721468330818
32668,703-004-5389,1259.9713,3,0,3,0.27920371738274696
32977,703-004-5385,1021.70764,1,0,1,0.27920371738274696
33053,703-004-5389,2465.0217,2,2,0,0.9247569427679112
33190,703-004-5389,3679.5168,"","","",0.27920371738274696
33485,703-004-5385,1963.4795,4,2,2,1.237474360584732
33501,703-004-5394,1965.3589,3,0,3,0.27920371738274696
33821,703-004-5380,4751.989,6,2,4,0.5395286997802311
33908,703-004-5384,3176.2927,6,2,4,1.4429309833838946
34095,703-004-5395,2618.3606,5,2,3,0.9510645449786429
34162,703-004-5390,1999.9135,3,2,1,0.773526830163498
34217,703-004-5389,3601.9219,6,2,4,0.6377976876066258
34222,703-004-5390,4680.538,6,3,3,2.0844111008335746
34223,207-008-2398,9029.736,1,1,0,0.480446340523488
34239,703-004-5396,6911.7515,1,0,1,0.27920371738274696
34383,703-004-5394,5707.4185,5,5,0,1.7619375878426753
34463,703-004-5394,879.9446,4,2,2,0.6875456217031968
34832,703-004-5389,1321.2908,4,0,4,0.27920371738274696
34899,703-004-5396,8582.695,3,2,1,0.5786942017198258
34979,703-004-5387,8294.539,4,2,2,1.0142519258708635
35213,703-004-5398,9147.312,6,4,2,1.3399909623552575
35416,703-004-5383,5474.3945,7,4,3,1.5270501128157965
36032,703-004-5385,6269.714,4,3,1,0.72114473120532
36171,703-004-5395,6821.154,7,3,4,0.8034904034274217
36274,703-004-5398,2931.4685,2,0,2,0.27920371738274696
3667,703-004-5388,806.16595,4,4,0,2.022747619052056
36775,703-004-5386,1388.1981,1,0,1,0.27920371738274696
36910,703-004-5399,8643.271,5,3,2,1.0857882847930571
37105,703-004-5389,8971.524,"","","",0.27920371738274696
37435,703-004-5399,16.599297,4,3,1,3.1084457774040386
37468,703-004-5392,3282.7412,4,3,1,0.9229074000028282
38012,703-004-5396,8134.1333,5,4,1,2.869184109571388
38225,703-004-5399,8128.276,9,7,2,2.598819936798654
38245,703-004-5383,8463.951,3,1,2,1.113879972398567
38274,703-004-5382,8946.115,5,4,1,0.9243852212884304
38989,703-004-5392,2552.3298,2,0,2,0.27920371738274696
39012,703-004-5390,9764.389,3,3,0,1.3790107926601032
3915,703-004-5381,8428.203,2,2,0,1.0055150319098296
39182,703-004-5397,3980.2415,3,1,2,0.5629111701391563
39243,703-004-5391,1789.3827,5,1,4,0.35831143730785864
39366,703-004-5394,8631.506,3,1,2,0.7337230648022509
39602,703-004-5383,1123.2596,4,2,2,0.49624247186147097
39964,703-004-5393,9856.807,5,1,4,0.8457429741952835
39983,703-004-5397,2422.822,2,1,1,0.507448702479921
40834,703-004-5387,227.36847,"","","",0.27920371738274696
41348,703-004-5380,5878.032,1,0,1,0.27920371738274696
41390,703-004-5397,2375.5771,4,0,4,0.27920371738274696
41630,703-004-5381,118.56675,2,2,0,0.6116236225084699
4169,703-004-5395,502.22098,4,2,2,0.7414932370742351
41888,703-004-5395,2817.412,3,3,0,0.9276849577572103
41945,703-004-5399,2539.2507,6,4,2,1.6163122882769037
42019,703-004-5386,6286.6606,4,3,1,0.9485265580131079
42118,703-004-5396,5749.7324,2,1,1,0.3978652972704144
42205,703-004-5385,7076.3926,8,3,5,1.800330969566925
42225,703-004-5398,8141.2563,2,2,0,0.5212069559022344
42509,703-004-5399,1032.8436,2,0,2,0.27920371738274696
4301,703-004-5387,3011.4556,8,5,3,4.3027426105802835
43204,703-004-5393,2450.8792,7,4,3,1.1079240592154782
43282,703-004-5391,7308.9673,2,0,2,0.27920371738274696
43380,703-004-5386,4225.976,7,4,3,4.346579668514548
43548,703-004-5383,5934.1196,1,0,1,0.27920371738274696
43792,703-004-5392,5280.029,10,7,3,2.0598444374157507
43861,703-004-5380,9785.851,5,2,3,1.4428433269058674
44341,703-004-5391,4211.1807,3,1,2,0.40165049179699785
44466,703-004-5399,4716.291,3,0,3,0.27920371738274696
44497,703-004-5389,7932.8984,"","","",0.27920371738274696
44515,703-004-5394,451.17618,6,2,4,1.3378768645585108
44658,703-004-5387,1535.6207,1,1,0,0.33853450732658075
44714,207-008-2398,1974.4753,6,3,3,1.0211038427720787
44911,703-004-5381,9462.908,1,1,0,0.4818671687358617
45140,703-004-5389,5560.8003,3,2,1,1.0296639436765036
45394,703-004-5397,219.19489,5,5,0,1.064468782706786
45500,703-004-5389,1439.324,6,3,3,1.349571711871003
46136,703-004-5382,9258.696,3,3,0,2.819481295765046
46157,703-004-5385,3799.556,4,2,2,0.7871028526234797
4643,703-004-5386,2366.5588,6,2,4,0.8121073897705878
46650,703-004-5398,8337.786,3,3,0,1.000024198555333
46841,703-004-5389,7915.866,3,1,2,0.4256154614569312
46878,703-004-5397,6538.092,1,1,0,0.5669580486103406
46937,703-004-5385,4989.6943,4,0,4,0.27920371738274696
47003,703-004-5389,6622.8433,6,0,6,0.27920371738274696
4711,703-004-5393,1942.5404,5,2,3,1.6426772032069792
47129,703-004-5385,7940.1914,4,2,2,0.47697301719552604
47168,703-004-5392,65.79995,1,0,1,0.27920371738274696
47260,703-004-5384,97.275375,4,3,1,1.3404612015481985
474,207-008-2399,9016.623,4,2,2,0.4445388520262303
47421,703-004-5381,5257.067,4,3,1,1.4786148210362717
47444,703-004-5381,7381.8735,6,3,3,1.671812762120556
47730,207-008-2399,5771.484,4,2,2,0.5074752921871715
47737,703-004-5396,3352.9705,3,2,1,0.6261349662833926
47779,703-004-5396,5194.652,5,2,3,0.6200802680410374
48215,703-004-5398,7709.81,1,0,1,0.27920371738274696
48287,703-004-5393,861.70374,3,2,1,0.8376647083476422
48340,703-004-5382,7428.1245,2,1,1,0.3704361446896032
48572,703-004-5380,7521.73,4,2,2,0.5224481694553559
48731,703-004-5393,2329.8276,4,3,1,1.1431774519630276
4900,703-004-5381,6582.9653,3,3,0,1.04314053051874
49250,207-008-2398,2361.5503,4,2,2,0.5252624598387409
49452,703-004-5399,9341.564,1,0,1,0.27920371738274696
49550,703-004-5382,2675.4297,3,1,2,0.853692669777133
49868,703-004-5387,5265.62,"","","",0.27920371738274696
49981,703-004-5385,4587.7637,5,3,2,0.5231586216786323
5221,703-004-5383,8395.635,5,3,2,0.9443056158324247
5271,703-004-5385,761.3289,4,2,2,0.5607680596352289
5558,703-004-5388,5964.4526,5,2,3,0.6683249023243877
5879,703-004-5388,2493.612,4,2,2,0.6232737940761067
6239,703-004-5396,6417.4766,4,1,3,0.5474675110158055
6332,703-004-5397,149.40321,5,2,3,0.9927805073079792
7341,703-004-5391,69.20516,7,3,4,1.910212936574004
7821,703-004-5389,2693.5256,3,0,3,0.27920371738274696
7843,703-004-5381,2837.5815,3,3,0,1.8561870162533287
7874,703-004-5388,7513.3135,3,1,2,0.519295853365148
8036,703-004-5383,2234.6294,5,3,2,1.2615963519419673
8112,703-004-5393,5759.719,3,1,2,0.5850259003896459
8733,703-004-5389,8819.312,3,3,0,0.9238377276203141
8887,703-004-5388,9379.669,8,3,5,2.2688223637357923
8892,703-004-5392,3989.8484,6,3,3,0.5777525463316748
8933,703-004-5381,6447.95,8,5,3,2.1432965445401546
9002,703-004-5394,4628.8584,2,1,1,0.38046159888688985
9044,703-004-5389,8285.408,2,2,0,1.5516388994296855
9052,703-004-5380,7654.07,3,2,1,0.6394057465616483
9145,703-004-5396,7948.1436,3,0,3,0.27920371738274696
976,703-004-5392,2440.2947,7,3,4,1.2815993578633338
9874,703-004-5396,2634.1157,3,1,2,0.5947491417364431
10322,703-004-5389,4333.363,3,1,2,0.5296801917739247
10344,703-004-5388,3837.9531,1,1,0,0.35831143730785864
10656,703-004-5384,7114.453,5,3,2,0.8947479670806069
10842,703-004-5398,7443.7305,5,4,1,1.453060506186525
11114,703-004-5390,223.46794,4,3,1,1.1611517864615835
12075,703-004-5396,8396.808,2,1,1,0.48514969238201827
12471,703-004-5387,3591.4136,1,1,0,0.6909172949142092
12474,703-004-5389,1389.2985,8,3,5,0.8105533352374596
12546,703-004-5380,9761.119,5,1,4,0.6540284053717866
12965,703-004-5388,9525.072,2,2,0,0.6517030704771092
13253,703-004-5392,5136.752,2,1,1,0.5388308279116818
13716,703-004-5385,9581.588,4,1,3,0.4073036901745105
13842,207-008-2398,5245.053,2,0,2,0.27920371738274696
13871,703-004-5384,1951.0675,3,2,1,0.6726245618056927
1422,703-004-5393,6963.1396,4,2,2,0.5673845176630667
1456,703-004-5393,2289.0728,2,1,1,0.4338721462999562
14561,703-004-5397,1585.2207,6,5,1,1.928265875467802
14608,703-004-5387,3316.4292,3,1,2,0.3670132864996209
14677,703-004-5381,1810.4249,7,3,4,1.5038744334639589
14802,207-008-2399,9280.72,5,2,3,1.0268211130000051
15078,703-004-5384,5895.473,6,4,2,1.932482755140633
15080,703-004-5393,5337.66,2,0,2,0.27920371738274696
15366,703-004-5386,2447.937,5,2,3,0.46893171746513856
15645,703-004-5399,3013.2222,3,2,1,0.664879163856084
15691,207-008-2399,6239.5757,2,1,1,0.35114230018964543
15783,207-008-2398,9385.039,7,5,2,2.496693293420733
15919,703-004-5399,6518.555,5,3,2,0.782681293483609
16517,703-004-5385,1870.6387,5,4,1,2.0897850832763747
16599,703-004-5388,2776.528,4,2,2,0.6323201060088816
1688,703-004-5380,139.68765,3,2,1,2.0779196471716417
17037,703-004-5386,1278.8099,3,2,1,0.8933986131035498
17181,207-008-2398,7058.4575,5,2,3,1.0689635969333624
17183,703-004-5380,8676.567,3,1,2,1.0072879326509265
17370,703-004-5390,8325.97,5,2,3,0.7440357354302075
17463,703-004-5390,6981.3545,3,1,2,0.6565111517045885
17467,703-004-5382,7116.7783,6,5,1,1.217810363517235
17574,207-008-2398,907.56354,4,0,4,0.27920371738274696
17882,703-004-5399,2616.0056,5,2,3,0.6728470326356375
17890,703-004-5385,751.68787,2,1,1,0.35831143730785864
17981,703-004-5385,2464.4578,1,0,1,0.27920371738274696
18197,703-004-5388,16.851425,2,1,1,0.45597151030011307
18340,703-004-5399,511.0121,5,3,2,1.0783684884969187
18608,703-004-5380,3320.7417,1,0,1,0.27920371738274696
19458,703-004-5395,1285.1041,5,4,1,1.476331095664608
19648,703-004-5386,8498.799,6,2,4,1.5085435373664537
2004,703-004-5390,430.9666,4,3,1,0.740078729532417
20187,703-004-5387,8835.807,4,2,2,0.4723164023054725
20222,703-004-5389,9899.28,7,6,1,3.8556974781811357
20360,703-004-5392,3273.3352,4,2,2,0.47576835494804154
20770,703-004-5396,9680.397,3,1,2,0.4659172871109116
21072,703-004-5389,7933.261,2,1,1,0.5239432259010611
21299,703-004-5380,7257.5547,5,2,3,1.1077439422822057
21322,703-004-5398,5419.985,1,1,0,0.3812689679267981
21332,703-004-5380,3796.237,1,1,0,2.4367644093586427
21733,703-004-5390,3699.4194,1,1,0,0.6999072243513574
21882,703-004-5390,1108.7727,"","","",0.27920371738274696
21915,703-004-5383,4030.5488,5,2,3,1.043795218565651
21923,703-004-5389,1472.7789,4,2,2,1.2588597072803684
21999,703-004-5385,7668.781,2,1,1,0.3978652972704144
2204,703-004-5383,7940.4004,4,1,3,0.5928397525053448
22132,703-004-5395,629.9716,4,3,1,1.2223747393976507
22280,703-004-5391,5234.5044,3,1,2,0.6127248167848156
2237,703-004-5385,8491.435,10,4,6,1.2975924991894598
22510,703-004-5385,2227.1138,7,5,2,3.0003705831996546
22602,703-004-5397,7142.9507,7,5,2,1.9413058631704283
23144,703-004-5380,1307.0536,1,0,1,0.27920371738274696
23431,703-004-5399,4693.6255,4,2,2,1.72126766906975
23435,207-008-2398,6183.064,3,0,3,0.27920371738274696
23470,703-004-5389,5944.0903,2,1,1,0.6526001798960893
23546,703-004-5391,9351.867,7,7,0,3.398578303860154
23633,703-004-5398,3909.6934,3,1,2,0.41547645694922425
238,703-004-5394,6531.42,4,2,2,0.5503907042806612
24917,703-004-5393,4886.4746,4,2,2,0.8788761987909608
25137,703-004-5384,545.1381,4,4,0,2.273531110090799
25224,703-004-5381,9473.808,1,1,0,1.0554333327391374
25416,703-004-5398,8558.878,3,3,0,1.844092044344496
25483,703-004-5390,2292.2515,3,2,1,0.9115016795636053
2582,703-004-5394,8077.6763,8,5,3,1.7086835631220052
26270,703-004-5398,5867.367,7,3,4,1.18559491017211
26288,207-008-2399,9743.848,7,3,4,1.3177086465556145
2682,703-004-5386,455.23346,2,1,1,0.8778642392145171
27285,703-004-5380,5137.0806,7,2,5,0.45135090568644826
27356,703-004-5388,1486.8641,6,3,3,1.1725334024060876
27512,703-004-5389,3180.7124,3,1,2,0.6746213501800165
27519,703-004-5398,662.4448,4,3,1,2.9503994031818035
27816,703-004-5381,4852.5254,6,2,4,0.6032574497491197
27939,703-004-5382,2188.4614,2,0,2,0.27920371738274696
27999,703-004-5395,8506.817,1,0,1,0.27920371738274696
28554,703-004-5382,1777.2096,4,3,1,0.7903683950573164
2869,703-004-5388,6383.037,1,1,0,0.33853450732658075
28819,703-004-5380,3587.0283,5,4,1,1.491377987179689
29088,703-004-5386,3952.4097,4,1,3,0.33853450732658075
29517,703-004-5384,4874.9004,3,2,1,1.4616994216764496
29665,207-008-2399,3138.8499,2,1,1,0.566034706348602
2982,703-004-5389,3155.2327,4,3,1,0.5560807371206377
29982,703-004-5392,6080.7837,6,3,3,1.0511936595659457
30039,703-004-5397,6861.146,3,1,2,0.7148599037827683
30151,703-004-5399,2023.5902,5,2,3,0.4259750499897811
30262,703-004-5380,9670.825,6,1,5,2.479006613198022
30653,703-004-5383,9007.653,4,2,2,0.7379123593046547
30683,703-004-5394,830.4346,5,4,1,2.057182738622242
30685,703-004-5390,6825.599,3,3,0,0.9334125609037477
3069,703-004-5385,9280.824,5,2,3,0.6680601030933263
31096,207-008-2399,2058.2188,3,2,1,0.5709372646159019
31101,703-004-5394,8727.217,2,1,1,0.5684950046398222
31132,703-004-5390,4497.002,2,0,2,0.27920371738274696
31298,703-004-5392,4272.3037,4,3,1,1.6831460708416344
31552,703-004-5382,510.72836,2,1,1,0.4721948762101267
31736,703-004-5393,3297.9883,3,2,1,0.5790714182238733
31738,703-004-5391,7444.73,3,0,3,0.27920371738274696
319,703-004-5396,8671.333,5,2,3,0.5386087726791918
31966,207-008-2399,4784.256,4,2,2,0.9232378906336368
32103,703-004-5396,7932.9575,2,1,1,0.44829646872267315
32251,207-008-2399,9687.12,2,2,0,1.0162100089244437
32470,703-004-5392,3775.7551,4,2,2,1.5678067087494199
32584,703-004-5398,3219.4668,7,5,2,2.2466961844391466
32611,703-004-5397,7614.062,2,0,2,0.27920371738274696
32690,207-008-2398,7355.911,5,2,3,0.5472526185793706
32871,703-004-5389,3245.979,5,2,3,0.7008578627950932
33121,703-004-5399,7423.9546,3,1,2,0.6647202589697598
33171,703-004-5386,800.67096,4,2,2,0.8261134230597172
33333,703-004-5388,5206.061,2,0,2,0.27920371738274696
33354,703-004-5394,5746.868,1,1,0,0.47846301446514045
33431,703-004-5398,7474.687,3,2,1,0.7360507999502667
33483,703-004-5387,3222.789,3,1,2,0.3805573658059081
33556,703-004-5382,5220.632,3,1,2,0.5359242675635134
33687,703-004-5382,8138.7144,4,1,3,0.35390818728145046
33871,703-004-5398,4167.2153,6,3,3,2.638193900420287
34135,703-004-5385,8494.542,3,1,2,0.5740184126136567
34136,703-004-5393,5592.124,4,3,1,2.513916269651482
34279,703-004-5386,6941.0703,6,2,4,0.9987378489676362
34859,703-004-5390,7857.9556,10,5,5,2.179065491298305
34927,703-004-5386,2932.5288,7,4,3,1.5085520381362663
35660,703-004-5394,9743.629,7,4,3,1.40789967811226
35708,703-004-5399,3187.9724,"","","",0.27920371738274696
35769,703-004-5384,278.7715,5,2,3,0.6875354943721437
35940,703-004-5392,4207.902,5,3,2,1.1254042672033728
35966,703-004-5392,4347.2173,3,2,1,1.4696389416344904
36354,703-004-5393,5349.496,2,0,2,0.27920371738274696
36430,703-004-5391,7434.164,3,1,2,0.6228664964270084
36547,703-004-5398,4665.9673,5,4,1,3.520198941390817
3659,703-004-5389,3959.8262,6,3,3,2.0260376289490973
36601,703-004-5382,8548.367,4,3,1,1.9707441125199234
37054,703-004-5391,1863.9094,4,2,2,1.162718573441459
37127,703-004-5390,1501.8707,4,2,2,1.2192661331620183
37150,207-008-2399,4438.514,2,0,2,0.27920371738274696
37235,703-004-5380,5554.0215,4,1,3,0.45165854681949036
3746,703-004-5398,5105.877,5,4,1,2.887178718786886
37694,703-004-5388,2496.935,3,0,3,0.27920371738274696
37728,703-004-5397,5330.9746,4,3,1,0.931240747979112
37775,703-004-5399,7629.847,4,0,4,0.27920371738274696
38446,703-004-5386,2363.593,3,1,2,0.43965666382767865
38450,703-004-5397,7891.8784,4,1,3,0.3919322182760311
38777,703-004-5394,2603.4211,5,3,2,1.534443060988655
38781,703-004-5392,218.47069,5,2,3,2.2063250643147194
38963,703-004-5391,4390.717,3,1,2,0.36272369393064596
39323,703-004-5383,1049.0101,1,0,1,0.27920371738274696
39431,703-004-5394,1044.541,2,2,0,0.6392707481485904
39828,207-008-2399,2546.5256,2,1,1,0.3271627725873459
40394,703-004-5386,447.073,1,0,1,0.27920371738274696
40515,207-008-2398,7994.257,2,1,1,0.35534489781066697
40602,703-004-5388,8706.855,3,2,1,1.3044059180306038
41079,703-004-5390,3570.565,5,3,2,1.0301454610847873
41274,703-004-5385,8928.206,3,2,1,0.5646374887461898
41284,703-004-5399,6704.1104,3,2,1,0.8133770220797417
41478,703-004-5388,7821.2485,3,1,2,1.0168425238780694
41549,703-004-5387,7028.647,7,4,3,1.2674593374038479
41766,703-004-5386,2019.4274,6,5,1,1.7322139390463973
41917,703-004-5388,7219.5786,3,3,0,0.766002531953973
42127,703-004-5394,5463.4224,4,3,1,1.9877129555790485
42348,703-004-5394,4573.9634,4,3,1,1.0845252382809367
42706,703-004-5393,5802.1836,5,3,2,0.9853318793884223
42849,703-004-5390,881.086,10,4,6,3.004960359532293
42869,703-004-5381,1568.2572,6,4,2,1.4156095306480103
42888,703-004-5396,7801.2974,4,0,4,0.27920371738274696
43338,703-004-5393,706.01764,4,1,3,0.360251034332436
4349,703-004-5390,7007.01,2,1,1,0.45245771687471364
43698,703-004-5397,6305.2173,5,3,2,1.5818654187120091
43841,703-004-5395,1996.4213,8,1,7,0.45900085134286905
44010,703-004-5399,2509.5952,5,3,2,1.7793346804345962
44351,703-004-5388,2570.5725,3,1,2,0.46062824045958745
44471,703-004-5384,1773.3312,1,0,1,0.27920371738274696
44638,703-004-5386,1344.8828,4,1,3,0.6695154717257539
44735,703-004-5398,1713.2723,2,1,1,0.4014581062170133
44901,703-004-5385,3994.4207,5,3,2,1.6293585673308133
44931,207-008-2398,6207.864,3,2,1,1.5664307633811736
45323,703-004-5390,8723.129,1,0,1,0.27920371738274696
45535,703-004-5390,8184.8857,2,2,0,1.44518049410546
456,703-004-5389,2960.487,2,2,0,0.7489067000387258
45660,703-004-5382,3374.2166,3,2,1,0.7842924139869757
45764,703-004-5386,7397.586,4,3,1,0.7799533284298402
45845,703-004-5385,340.60718,2,0,2,0.27920371738274696
45851,703-004-5398,518.43286,1,1,0,1.1260485565783303
46109,207-008-2399,1538.0168,6,3,3,1.0426884783463766
46362,207-008-2399,220.90555,6,4,2,0.9346784185242332
46593,703-004-5389,7244.7456,2,2,0,1.0693051558948052
46688,703-004-5386,642.55176,6,3,3,1.549956346214856
46871,703-004-5387,1269.5771,3,0,3,0.27920371738274696
47154,703-004-5383,1751.1177,3,1,2,0.6272139724372454
47172,703-004-5391,2338.8933,6,3,3,2.732865545436007
47271,703-004-5388,1761.5837,5,0,5,0.27920371738274696
4739,703-004-5393,8493.805,4,2,2,0.5017373613626795
47485,703-004-5395,4594.5728,3,2,1,1.393692704973822
47585,703-004-5384,710.8956,1,0,1,0.27920371738274696
4763,703-004-5387,6332.6196,1,0,1,0.27920371738274696
47689,703-004-5381,5509.242,1,1,0,1.1696579081817267
47760,703-004-5381,6700.3145,2,0,2,0.27920371738274696
47825,207-008-2398,4847.3833,5,3,2,0.8519058120011385
47840,703-004-5392,2943.0884,4,1,3,1.2053670821532338
48074,703-004-5384,7096.914,1,1,0,0.4875982661393402
48226,207-008-2399,7220.9395,5,3,2,0.6829471676510974
48312,703-004-5398,3969.1316,"","","",0.27920371738274696
48482,703-004-5398,2598.8245,4,1,3,0.40980143247716516
48929,703-004-5388,2390.7305,4,1,3,0.47726938059044
48957,703-004-5381,5785.514,4,4,0,1.550574175884829
491,703-004-5385,9801.369,3,0,3,0.27920371738274696
49283,703-004-5391,7118.3477,5,3,2,2.9460844130752672
49354,703-004-5395,622.89594,3,1,2,0.3852080620823966
49380,703-004-5386,1612.8356,3,1,2,0.5127632655797385
49844,703-004-5386,9323.848,2,1,1,0.35831143730785864
5197,703-004-5397,4763.9946,5,3,2,2.3627104726621266
5709,703-004-5383,6758.3413,3,3,0,1.0544627559424442
5848,703-004-5399,3837.6958,3,1,2,0.3978652972704144
5931,703-004-5396,871.44257,3,2,1,1.9556836071128305
5983,703-004-5387,3322.0,5,2,3,1.2241670261338378
6451,703-004-5386,899.0896,4,1,3,0.3679173747273365
6465,703-004-5387,2077.434,7,3,4,1.9705668757793633
6837,703-004-5392,7368.978,6,5,1,1.6163282106544286
6856,703-004-5392,6438.7534,"","","",0.27920371738274696
7218,703-004-5391,597.11993,5,1,4,0.4125858639785382
7419,703-004-5395,711.9882,4,1,3,0.5400289375382027
7839,703-004-5386,4701.975,2,0,2,0.27920371738274696
8139,703-004-5389,7374.785,5,2,3,0.8779950781657941
8720,703-004-5384,3899.8162,8,4,4,2.0708082780334043
9018,207-008-2399,3904.3147,2,1,1,0.33853450732658075
9049,703-004-5386,8767.79,6,3,3,0.6184517738406404
9260,703-004-5389,1200.0352,2,1,1,0.32666834933781397
9304,703-004-5391,24.812222,4,2,2,0.838645389811604
9589,703-004-5394,4955.8687,6,2,4,0.7708389024315911
9812,703-004-5385,2565.608,1,0,1,0.27920371738274696
9939,703-004-5380,7789.4517,8,5,3,1.6595369953665053
10386,703-004-5383,9113.51,4,2,2,0.9178333607425293
10702,703-004-5380,3007.6992,8,5,3,1.3073653316347138
10964,703-004-5382,3413.282,8,3,5,1.331216402697297
10970,703-004-5390,4432.6367,6,3,3,1.0733224388830414
111,207-008-2399,6069.446,4,1,3,0.5014730115860168
11199,703-004-5384,361.4974,8,2,6,1.9546254180470348
11386,703-004-5387,5340.3926,4,2,2,0.9412848461202283
11459,703-004-5393,8238.5,3,2,1,1.1319018126038518
11558,703-004-5382,1.8101931,5,2,3,0.5784699086947325
11737,703-004-5386,319.9494,"","","",0.27920371738274696
1190,703-004-5386,8706.115,3,3,0,2.4118132596904687
11981,703-004-5396,9629.3125,4,0,4,0.27920371738274696
12171,703-004-5381,9529.599,3,2,1,0.5117792051797252
12267,703-004-5386,5532.126,3,1,2,0.4457749101500602
12423,703-004-5398,8582.964,5,3,2,1.3959862748042058
12509,703-004-5393,2292.2312,5,1,4,1.3985693519341986
12885,703-004-5388,3444.9004,6,4,2,1.4274581900165382
12977,703-004-5389,9353.011,1,1,0,0.35831143730785864
1311,703-004-5387,4276.2314,3,2,1,0.5160917846984937
13348,703-004-5387,641.0605,2,2,0,0.5476649692187124
13388,703-004-5394,2933.731,4,3,1,0.9048561289134475
13416,703-004-5397,5639.3076,5,4,1,1.1843946932726523
13774,703-004-5396,7898.857,1,1,0,0.7046551482998278
14016,703-004-5388,2717.6987,6,1,5,0.4528387763180605
14276,703-004-5384,5917.9614,3,2,1,1.2626431047169875
1468,703-004-5380,3067.7737,5,3,2,2.4020750593800106
14726,703-004-5387,3480.1453,9,3,6,0.7821826365399832
15126,703-004-5391,5202.4043,3,1,2,0.41943680570662595
15198,703-004-5386,2982.4597,5,5,0,3.528149623009713
15227,703-004-5386,202.93117,5,1,4,0.4619951620129782
1533,703-004-5391,8694.266,6,3,3,1.4056595485681918
15413,703-004-5390,9256.579,1,0,1,0.27920371738274696
15469,703-004-5390,6361.2363,7,5,2,1.3505606213701962
15484,703-004-5392,8917.616,4,2,2,1.041180554645435
15556,703-004-5392,9687.815,2,1,1,0.44829646872267315
15765,703-004-5392,3403.2446,3,1,2,2.672363795878188
15877,703-004-5389,8788.65,6,2,4,0.9979822213970237
16023,703-004-5381,4841.1387,11,7,4,3.6420278993534088
16232,703-004-5381,5965.3384,5,1,4,0.4042031775578559
16566,703-004-5388,8156.43,"","","",0.27920371738274696
16567,703-004-5392,597.9443,6,3,3,0.9728474634256477
16571,703-004-5380,9855.052,7,2,5,1.490774530922358
16707,703-004-5397,1367.5845,1,1,0,0.3964894797026006
16762,703-004-5399,2009.9789,"","","",0.27920371738274696
16961,703-004-5386,1597.9457,2,0,2,0.27920371738274696
16998,703-004-5390,841.437,3,0,3,0.27920371738274696
17017,703-004-5399,3768.7712,6,3,3,0.6495822981463766
17235,703-004-5399,9144.177,3,3,0,1.4717154648268755
17489,703-004-5399,2239.4026,3,1,2,0.5601656599481738
17514,703-004-5390,8336.45,3,1,2,1.4601869666620488
17529,703-004-5390,8509.02,1,0,1,0.27920371738274696
17546,703-004-5390,7521.0967,3,1,2,0.5837684390944268
17697,703-004-5388,9384.147,3,2,1,1.6456932805719717
17703,703-004-5387,4637.32,5,2,3,1.9331578996824959
17787,703-004-5397,5420.0894,4,1,3,0.6096421234065982
1790,703-004-5399,6042.5806,5,3,2,1.16969347832546
17941,703-004-5394,1466.6831,6,4,2,1.7164968870750066
18047,703-004-5385,7623.3184,1,1,0,0.7984119099904817
18202,703-004-5399,4044.6072,"","","",0.27920371738274696
18238,703-004-5391,8904.468,5,3,2,1.5304610689128983
18242,703-004-5398,1133.6917,8,5,3,2.97358872167154
18500,703-004-5386,1730.1304,7,5,2,1.6069142487994748
18679,703-004-5386,9554.444,4,1,3,0.6171090468878644
18917,703-004-5385,9430.927,9,3,6,1.7068678071490517
19017,703-004-5392,4984.592,1,1,0,0.33853450732658075
19089,703-004-5393,2579.568,3,0,3,0.27920371738274696
19252,703-004-5380,4118.954,6,1,5,1.0783642112481855
19590,703-004-5397,1096.6575,5,3,2,1.6620920988141097
19975,703-004-5399,5548.3496,6,3,3,1.2035800211487728
20660,703-004-5392,910.0109,2,1,1,0.3467175417218341
2105,703-004-5390,9568.632,2,1,1,0.4106216767891685
21054,703-004-5381,622.9812,4,1,3,0.9635123283600826
21602,703-004-5380,883.258,2,1,1,0.6618873290012496
21628,703-004-5389,2128.4497,6,2,4,0.55956873863882
21738,703-004-5398,1123.9207,3,0,3,0.27920371738274696
21769,703-004-5398,5108.8296,6,3,3,3.8554874863192126
22271,703-004-5383,1670.9203,3,2,1,1.0829865104520695
22548,703-004-5394,4985.8384,6,3,3,2.588989833762341
22557,703-004-5387,7867.6094,3,3,0,2.0077462815945344
22710,703-004-5389,9232.984,6,2,4,0.47578916486945483
22860,703-004-5382,7867.2417,5,1,4,0.5350696179125206
23155,703-004-5381,4423.572,6,2,4,0.5956345970831934
23351,703-004-5397,3420.3179,6,4,2,2.2501395201619325
23759,703-004-5396,6474.5254,5,1,4,0.3978652972704144
23921,703-004-5391,4809.7,6,1,5,0.8974109581865909
24128,703-004-5399,8123.3623,6,3,3,1.0054725743728588
24135,703-004-5394,4444.847,5,1,4,0.35831143730785864
24261,703-004-5383,1558.0487,3,3,0,0.7314035791019542
24290,703-004-5388,8156.0596,3,3,0,1.212043465646281
24522,703-004-5387,2445.1816,4,2,2,0.4856748663872883
24712,703-004-5397,2665.5317,3,1,2,0.3777433422648382
24923,703-004-5398,6826.174,5,2,3,0.9617858570864629
25260,703-004-5397,9968.365,3,1,2,0.6749246230971532
25262,703-004-5388,7223.2793,7,2,5,0.9264625936120139
25598,703-004-5385,5585.067,6,3,3,0.7829024269612149
25665,703-004-5394,5355.2817,"","","",0.27920371738274696
25909,703-004-5381,5995.9863,4,2,2,0.5542714960029732
26260,703-004-5384,1836.2546,5,2,3,1.007146445272475
263,703-004-5388,695.04974,3,3,0,1.0740374566117505
26358,703-004-5380,7734.9014,3,2,1,0.49447855270682733
26480,703-004-5391,779.1913,2,2,0,0.4144927511521738
26755,703-004-5395,7640.799,6,3,3,1.0773313157859479
26786,703-004-5381,9346.991,3,1,2,0.35831143730785864
26829,703-004-5397,9500.026,2,1,1,0.40057089116368655
2688,703-004-5394,8359.144,7,5,2,3.7803959922772776
27450,207-008-2399,4699.421,2,2,0,1.5303800986961007
27625,703-004-5385,8942.363,4,3,1,0.6850617677246521
2770,703-004-5382,6324.416,5,3,2,2.485624410317115
27711,703-004-5398,2735.0999,4,1,3,0.35831143730785864
28029,703-004-5389,5715.7095,3,1,2,0.5782440326284146
28033,703-004-5387,899.9759,6,3,3,0.9019937646351203
28313,703-004-5397,4745.9966,2,1,1,0.3978652972704144
28448,703-004-5389,9745.735,6,2,4,0.5308127250892973
28825,703-004-5392,4611.2905,3,2,1,0.9802284550723142
29073,703-004-5394,4062.9983,5,1,4,0.4352809739783714
29181,703-004-5393,1371.2031,6,2,4,0.7480009167818873
29791,207-008-2398,7124.8657,3,1,2,0.5488234716048895
29806,703-004-5384,1247.7302,6,3,3,1.22482112895108
29870,703-004-5385,1453.3246,2,1,1,1.0056141969635128
29992,703-004-5396,2521.398,3,0,3,0.27920371738274696
30159,703-004-5383,969.5804,4,2,2,0.8265769297344341
30485,703-004-5396,1434.6754,6,0,6,0.27920371738274696
31060,703-004-5394,1857.4506,3,2,1,0.7612940425954714
31136,703-004-5380,9889.325,5,1,4,0.35114230018964543
31212,703-004-5382,2595.057,7,6,1,2.8129429946496978
31292,703-004-5394,5722.549,2,0,2,0.27920371738274696
31334,703-004-5381,6894.83,7,2,5,0.5918572374647177
31422,703-004-5389,3076.266,6,4,2,2.6338014930622395
31737,703-004-5390,610.4541,7,4,3,1.7323496648708394
3220,703-004-5393,7813.13,2,1,1,0.6659016466683815
32212,703-004-5396,8341.833,2,0,2,0.27920371738274696
32213,703-004-5381,5261.0947,3,0,3,0.27920371738274696
32520,703-004-5397,6271.8965,5,2,3,0.8519101481527152
32665,703-004-5384,2131.9758,5,2,3,1.0779134172211362
32698,703-004-5394,5678.027,4,3,1,1.6188668694905604
33311,703-004-5382,7564.584,3,1,2,0.5165268771580819
33332,703-004-5392,729.72296,5,1,4,0.383313189400447
33498,703-004-5387,1369.294,3,1,2,0.4683838347017509
33531,703-004-5380,7843.408,2,2,0,0.7591367033993146
33571,703-004-5396,5022.3794,7,2,5,0.5610779731617049
33619,703-004-5393,4618.848,6,3,3,0.6422737654326951
3370,703-004-5386,1582.8579,2,1,1,0.7989632094979
3390,703-004-5399,7736.28,3,3,0,1.186962528739797
3453,703-004-5389,3848.1736,3,1,2,0.41226908258740397
34569,703-004-5391,5477.0605,5,4,1,1.712235385333005
34696,207-008-2399,3489.0354,"","","",0.27920371738274696
34800,703-004-5382,3112.8997,6,3,3,0.7337220163921279
34834,703-004-5389,7810.435,3,1,2,0.6232025776730727
34843,703-004-5396,1693.3989,4,2,2,0.5601188589552341
349,703-004-5386,9216.013,5,2,3,0.9012143283005495
34998,207-008-2398,8748.262,7,6,1,1.175324699328685
35008,703-004-5381,6216.201,3,2,1,0.7936414649089939
35082,703-004-5391,6526.181,5,2,3,0.6154039918187089
35267,703-004-5389,6341.182,4,2,2,0.8152945497582804
35688,703-004-5397,3132.661,3,1,2,0.984311590529571
35711,703-004-5383,380.7932,1,1,0,0.4281011019663064
36184,703-004-5381,2173.0964,5,4,1,1.721263415303543
36275,703-004-5382,1340.009,6,3,3,0.7846753411418189
36621,703-004-5387,5096.3896,6,1,5,0.37512182779194486
36626,703-004-5384,1522.3843,4,4,0,1.4942706888522048
36776,703-004-5384,356.04358,3,2,1,0.47465979724973306
36825,703-004-5380,3903.3699,5,1,4,0.3636450281121845
36926,703-004-5385,1320.8324,2,1,1,0.4424123080017059
36983,207-008-2399,1477.5032,5,3,2,2.747371652235972
37177,703-004-5391,8833.097,2,2,0,0.8481775985361701
37292,703-004-5383,4994.3877,2,0,2,0.27920371738274696
37397,703-004-5398,8290.86,6,4,2,2.5895521280030613
37470,703-004-5397,9772.532,5,2,3,0.8553274901222061
37856,703-004-5393,2927.7646,1,0,1,0.27920371738274696
38713,703-004-5396,1869.4388,"","","",0.27920371738274696
38765,703-004-5392,3655.389,4,3,1,1.1995609512173764
38942,703-004-5383,3047.6992,5,4,1,1.4227824498955037
39107,703-004-5387,796.2668,2,2,0,0.5653199277889878
39138,703-004-5383,4972.647,2,2,0,1.4713234119446514
39186,207-008-2399,1780.2208,3,1,2,0.35831143730785864
39234,703-004-5383,894.63416,5,3,2,1.1123601218050492
39481,703-004-5397,7885.23,4,2,2,1.1581695827944058
39879,703-004-5389,7972.0503,4,2,2,1.7232533243229204
403,703-004-5398,7029.212,3,3,0,0.8148424872941927
4041,703-004-5385,8081.273,7,4,3,1.0146747238107203
40421,703-004-5391,2572.5789,2,1,1,0.5453674587225184
40588,703-004-5395,6740.1064,1,0,1,0.27920371738274696
41022,703-004-5389,6595.054,5,1,4,0.35831143730785864
4115,703-004-5383,3879.5583,"","","",0.27920371738274696
41301,703-004-5381,2322.498,3,2,1,0.5047372779260865
41457,703-004-5392,9748.577,5,5,0,3.1986661272163226
41660,703-004-5388,629.0835,3,2,1,0.8435178849941558
41693,703-004-5397,9393.707,5,4,1,1.4675437893153813
41967,703-004-5381,3848.3865,5,2,3,1.0949925264381155
42341,703-004-5391,9344.279,5,3,2,0.6981149739555658
42660,703-004-5383,9456.479,5,2,3,0.6328448809912717
42865,703-004-5384,580.38116,5,5,0,2.20519511350252
43184,703-004-5391,6084.424,5,2,3,0.9998915203370999
43206,703-004-5396,5300.482,5,3,2,1.0740054638605938
43244,703-004-5396,8738.381,3,1,2,0.7522575443165489
43615,703-004-5381,2215.7603,3,0,3,0.27920371738274696
43626,207-008-2398,5521.872,8,2,6,1.180348421584215
43712,703-004-5385,3273.7,3,2,1,1.2952727363901808
43808,703-004-5393,8267.222,2,2,0,0.8844166769523573
43848,703-004-5399,3420.4941,5,0,5,0.27920371738274696
44152,703-004-5398,4492.7095,2,0,2,0.27920371738274696
44192,207-008-2399,2997.6875,2,1,1,0.4570214898840635
44219,703-004-5394,98.33813,1,1,0,0.4687700402460418
44292,703-004-5383,9976.603,8,4,4,3.6639246218741013
44349,703-004-5399,3420.6975,3,3,0,1.1722988443381024
44491,703-004-5383,3285.1672,5,4,1,1.265546123472844
44561,703-004-5391,8298.973,2,1,1,1.0292463432344525
44799,703-004-5397,4850.712,2,0,2,0.27920371738274696
44982,703-004-5383,5776.975,5,5,0,3.3401357737306228
4513,703-004-5395,4705.1523,4,2,2,0.9555747227424516
45698,703-004-5391,6302.0186,6,3,3,1.09918346770084
46161,207-008-2398,6765.4736,2,1,1,1.3199358114406885
46385,703-004-5388,4035.1545,3,0,3,0.27920371738274696
46781,703-004-5381,2586.754,2,0,2,0.27920371738274696
47090,703-004-5392,5357.5747,3,1,2,1.575948808437396
47291,703-004-5383,5686.9663,3,2,1,0.6556041974009521
47423,703-004-5382,9182.862,2,1,1,0.9687332964364344
47425,703-004-5383,9805.797,2,1,1,0.6173892200625992
47552,703-004-5388,5045.064,2,2,0,1.014738222597719
47578,703-004-5396,590.5932,3,1,2,0.8633447366336827
47721,703-004-5385,1028.7404,"","","",0.27920371738274696
4780,703-004-5389,4208.692,3,2,1,1.4160559814186409
4788,703-004-5388,6762.5957,9,4,5,1.3371729076106136
48585,703-004-5381,4333.232,5,2,3,1.0493949075842646
48843,703-004-5381,6420.712,2,2,0,0.6405324168675559
49146,703-004-5395,9866.115,6,5,1,3.627114017032626
4945,703-004-5395,757.5834,4,2,2,1.1226837908081293
49542,703-004-5395,233.20258,3,1,2,0.5041853776106221
49597,207-008-2399,8758.127,3,2,1,2.0272793678351295
5420,703-004-5381,5173.374,5,4,1,2.1456214887963334
5506,703-004-5389,4717.2905,2,1,1,0.369516338077525
5803,703-004-5395,3406.3022,2,0,2,0.27920371738274696
6201,703-004-5381,2179.8223,3,1,2,1.9252807764454645
6220,703-004-5393,9608.57,2,1,1,0.48401417079550113
645,703-004-5392,8827.431,9,5,4,0.9027520146291006
6565,703-004-5381,7976.7026,4,3,1,1.0414198988961112
6693,703-004-5398,1145.5846,5,3,2,1.9074837311240076
6773,703-004-5382,2126.5667,7,2,5,1.0366916307121978
694,703-004-5395,3526.2686,4,3,1,3.555264809785236
7078,703-004-5380,188.05026,6,4,2,1.0444091496677887
7109,703-004-5392,151.42322,6,5,1,2.256791598359323
7145,703-004-5392,9098.27,4,3,1,1.941021747699456
723,703-004-5397,7012.448,1,0,1,0.27920371738274696
7279,703-004-5396,2303.8237,3,1,2,0.41742797717689517
7423,703-004-5393,8390.667,2,1,1,0.557450484360273
7445,703-004-5390,592.3289,4,1,3,0.8544828341998484
7494,703-004-5399,7922.52,2,1,1,0.491541198242985
7627,703-004-5387,98.29283,5,4,1,1.0754721076585716
7682,703-004-5392,4441.2227,3,1,2,1.6953917200355928
7733,703-004-5393,8824.75,3,0,3,0.27920371738274696
7865,703-004-5388,5296.4614,7,4,3,1.1299923657568225
8478,703-004-5390,5402.221,7,5,2,1.9982848748752624
8753,703-004-5381,9787.76,2,1,1,0.35831143730785864
8980,703-004-5380,5793.689,4,2,2,0.8396882916728288
9169,703-004-5393,4792.589,5,3,2,1.7470967438837655
10362,703-004-5393,180.61935,2,2,0,0.7777673727926961
10519,703-004-5382,9675.313,5,3,2,4.639127657683894
10711,703-004-5388,7852.6777,4,2,2,1.636264363558099
11112,703-004-5397,1707.9001,6,5,1,4.276299159585914
11203,207-008-2398,2319.0547,7,3,4,1.2135118680934274
11259,703-004-5386,3737.6272,5,3,2,5.839937010401946
11575,703-004-5386,2337.8694,3,0,3,0.27920371738274696
11730,703-004-5388,8213.618,3,1,2,0.5651260874304743
12048,703-004-5393,7170.748,4,1,3,0.7006622992055334
12050,703-004-5399,7796.379,5,2,3,0.6253741555425401
12292,703-004-5396,7445.951,1,0,1,0.27920371738274696
12327,703-004-5384,8476.109,6,3,3,2.1583713489418654
1237,703-004-5399,3892.358,4,2,2,0.45000222893355835
12572,703-004-5391,4547.529,5,3,2,0.6546382436435868
12619,703-004-5395,6335.8276,3,1,2,0.35831143730785864
12734,703-004-5390,3285.5183,1,1,0,0.4651068592067593
12982,703-004-5383,8055.4224,5,2,3,0.4732260443329275
1301,703-004-5395,1935.351,4,3,1,2.213903602738151
13189,703-004-5395,9072.882,4,2,2,0.5629582305719917
13480,703-004-5399,6521.9136,4,1,3,0.6054217768283248
13529,703-004-5392,8751.241,3,2,1,0.7479796858291466
13628,207-008-2399,7886.833,"","","",0.27920371738274696
13944,703-004-5382,9000.249,5,3,2,1.4283764448512781
14403,703-004-5381,7183.263,5,4,1,0.7443524996333097
14442,703-004-5397,98.170044,1,1,0,0.9485406664185044
14469,703-004-5392,4532.4844,3,1,2,0.8216946536320765
14579,703-004-5380,1966.5515,7,4,3,1.2478774516225906
14629,207-008-2399,4759.655,4,1,3,0.4230808829965438
14664,703-004-5397,6149.2354,5,3,2,1.0580944183491376
14796,703-004-5396,5600.7754,5,2,3,0.9933819756752251
15032,703-004-5387,391.6943,7,4,3,2.1277603494544777
15184,703-004-5384,2323.0625,5,2,3,0.49590951005647466
15267,703-004-5386,5033.1733,8,5,3,1.8859014480478706
15411,703-004-5380,2788.6338,4,4,0,1.4504865397126163
1570,703-004-5380,7253.3623,1,0,1,0.27920371738274696
15721,703-004-5395,6983.9775,6,3,3,1.158357962622128
15858,703-004-5395,4404.1743,1,1,0,0.6156757562800586
16105,207-008-2399,112.54966,3,2,1,1.008888343017052
16130,703-004-5388,8625.209,3,1,2,0.7818507916827975
16478,703-004-5387,9637.559,2,1,1,0.37512182779194486
16514,703-004-5388,884.5889,4,2,2,0.6568470466497587
16722,703-004-5396,5162.2896,6,3,3,0.8899784798348332
16822,703-004-5392,2738.9849,3,2,1,0.9952294216532036
17095,703-004-5390,8924.122,4,2,2,0.503723139878119
17123,703-004-5392,2317.6282,7,3,4,0.9841947820313967
17134,703-004-5398,2370.379,2,1,1,0.7690698786110586
17353,703-004-5394,1404.1066,4,2,2,0.5661289059711175
17502,703-004-5395,1303.1238,5,2,3,1.956597870545191
17663,207-008-2399,42.095184,5,1,4,0.593679248826882
17724,703-004-5391,1907.9048,5,2,3,0.6041310761371365
17782,703-004-5390,4196.761,4,2,2,0.9192254424122729
17819,703-004-5395,1336.469,3,2,1,0.5666716306489354
17967,703-004-5395,5260.8096,7,5,2,2.4507975501795722
18025,703-004-5393,4827.753,3,0,3,0.27920371738274696
18049,703-004-5382,7115.69,7,5,2,2.7481154799469794
18119,703-004-5390,3954.478,1,1,0,0.33853450732658075
18287,703-004-5386,5101.5054,4,3,1,1.2075614126968288
18498,703-004-5382,8494.777,7,3,4,1.2811210003722076
18665,703-004-5397,821.16486,"","","",0.27920371738274696
18885,703-004-5386,4839.1284,4,1,3,0.4777941971173557
19256,703-004-5399,8557.581,4,2,2,0.44349067473722265
1939,703-004-5388,8169.996,3,2,1,1.562237845783772
19608,703-004-5391,778.8122,4,1,3,0.9805835559145756
19624,703-004-5399,5685.566,5,3,2,1.2286384006176723
197,207-008-2398,854.6716,6,3,3,0.6865948318670415
1989,703-004-5392,3750.884,4,2,2,1.1465481983709451
2011,703-004-5392,9516.497,6,4,2,2.0085382058445806
20211,703-004-5385,1174.6187,4,2,2,0.8422193815117843
20359,703-004-5389,4237.301,6,4,2,1.3854480836060805
20461,703-004-5399,9028.024,3,2,1,1.1039700871652627
2080,703-004-5389,8438.487,4,1,3,0.5165268771580819
20880,703-004-5381,5835.6206,3,3,0,0.9875746240900071
21002,703-004-5382,9157.506,4,3,1,1.1610797115792109
2107,703-004-5382,3922.4827,7,3,4,0.6898306814692745
21130,703-004-5385,7250.5693,7,1,6,0.35831143730785864
21591,703-004-5395,9962.573,4,1,3,0.35831143730785864
21615,703-004-5380,8233.523,4,2,2,0.5295008509559304
21761,703-004-5384,9620.174,3,3,0,0.9523856420969871
220,703-004-5388,1560.6063,2,2,0,0.6139330881076815
22045,703-004-5388,9458.865,2,1,1,1.214330005155827
22214,207-008-2398,9469.31,1,0,1,0.27920371738274696
22279,703-004-5394,4520.5483,6,3,3,2.322155727835522
22351,703-004-5395,3282.838,6,2,4,0.8344782391026125
2243,703-004-5390,2390.8699,2,2,0,0.7465506071932403
22808,703-004-5396,6495.9087,2,0,2,0.27920371738274696
22827,703-004-5394,3435.489,3,0,3,0.27920371738274696
22847,703-004-5381,9520.373,5,4,1,2.4627636456881077
22951,207-008-2398,7230.509,4,3,1,1.0928623549412644
23138,703-004-5392,4872.687,2,1,1,0.37175974969512765
23344,703-004-5382,1260.9797,3,3,0,0.7800706299897928
23545,703-004-5388,4473.702,7,4,3,1.5145693403572955
23766,703-004-5390,549.45825,3,2,1,0.45719608721424815
23965,703-004-5398,7678.182,2,1,1,0.6678203915148578
24000,207-008-2398,1060.0662,2,1,1,0.5107826733240011
24020,703-004-5390,4878.875,5,3,2,0.9427666167719553
24033,207-008-2398,5710.162,2,2,0,0.813161299015368
24052,703-004-5381,5390.3794,3,1,2,0.3978652972704144
24202,207-008-2399,9829.883,7,3,4,0.7168849139700276
24260,703-004-5390,9836.402,8,4,4,1.750657831695714
24612,207-008-2399,1787.299,7,3,4,1.5493243452535632
24765,703-004-5394,9278.16,6,2,4,0.7294959625512353
24899,703-004-5380,8169.7847,"","","",0.27920371738274696
2493,703-004-5396,8705.564,7,5,2,1.6135948073558326
24962,703-004-5383,4534.2866,5,3,2,0.5710109649488181
2540,703-004-5381,3830.5127,2,1,1,0.606548427934778
25886,703-004-5396,6352.5967,8,2,6,0.7038156828387365
25924,703-004-5399,7692.6196,1,0,1,0.27920371738274696
26180,703-004-5384,5675.6475,4,3,1,0.9823680857118806
26220,703-004-5390,6088.6235,6,0,6,0.27920371738274696
2627,703-004-5384,7575.208,2,0,2,0.27920371738274696
26733,207-008-2398,6788.584,5,1,4,0.5017044918337227
26802,703-004-5395,2390.3823,2,1,1,0.45822247897882346
26804,207-008-2399,8055.0957,3,3,0,0.683115226116831
26921,703-004-5384,3758.4692,5,3,2,1.4845654733832059
26924,703-004-5382,6021.3364,5,2,3,0.49378340767961226
27730,703-004-5392,786.36646,3,1,2,0.6602557157970191
27781,703-004-5389,6614.7505,4,3,1,1.6462684955621012
28131,703-004-5392,6123.8105,1,0,1,0.27920371738274696
28168,703-004-5382,1476.4893,6,1,5,0.6629623268581094
28213,703-004-5390,7049.6543,7,5,2,1.6895055654384166
2825,207-008-2399,7396.366,5,2,3,0.9002365461023596
28278,207-008-2399,2282.6611,6,2,4,1.2409549674791185
28319,703-004-5392,9733.294,5,1,4,0.35831143730785864
28506,703-004-5398,4103.0205,2,2,0,0.5909681738898098
28704,703-004-5395,8093.0215,3,1,2,0.5876546252240652
28941,703-004-5388,4320.025,3,2,1,0.7603589894954432
29923,703-004-5382,1826.4282,2,1,1,0.652412180297141
30217,703-004-5390,5839.9565,8,3,5,0.9035788955500959
30306,703-004-5390,581.94696,2,1,1,0.9263718892414131
3032,703-004-5390,110.02004,2,1,1,0.5973910171178397
3035,703-004-5395,7411.423,7,3,4,0.7881602563673481
30603,703-004-5383,533.8919,5,2,3,0.9100447479690461
30735,703-004-5381,1821.77,8,6,2,2.7250770001773215
30928,703-004-5381,7623.377,4,1,3,0.43483002748292127
31163,703-004-5387,7984.8037,5,3,2,1.0663209547321213
31555,703-004-5395,1370.6708,5,2,3,1.1772143329717473
32002,703-004-5387,4005.0137,5,2,3,0.43506532010843935
32078,703-004-5398,8622.607,3,2,1,0.7219196873783198
32538,703-004-5391,3991.9424,3,1,2,0.516876904564472
33230,703-004-5395,7754.3906,2,2,0,0.7076236721962051
33658,703-004-5398,1665.5284,3,2,1,1.0786465534936334
33823,703-004-5383,9775.898,4,1,3,0.4605011006276819
34098,207-008-2399,4280.9575,6,2,4,0.6082261469991482
34540,703-004-5381,5488.1006,6,4,2,1.851561306400645
34679,703-004-5380,8020.5977,3,2,1,0.8790507189745285
34792,703-004-5393,7502.724,3,2,1,0.9827058937823387
3485,703-004-5387,7989.4434,3,2,1,0.4836190162927625
35011,703-004-5394,5575.033,3,2,1,1.3694078745317695
35190,703-004-5383,1514.777,3,1,2,0.7537104657822871
35498,703-004-5380,7057.054,2,0,2,0.27920371738274696
35661,703-004-5389,4167.2207,2,2,0,0.7334906763641903
3568,703-004-5397,3998.54,6,3,3,1.15590709043357
35693,703-004-5399,6672.718,3,3,0,1.981826073493213
35750,703-004-5385,4471.8774,3,0,3,0.27920371738274696
36271,703-004-5398,902.5914,3,1,2,0.4330552317226923
36419,703-004-5385,9126.121,7,6,1,3.37606714225844
36726,703-004-5394,3320.446,4,2,2,1.5881676367493434
37264,703-004-5396,7509.926,4,2,2,1.5254085273886997
37580,703-004-5380,9806.166,4,3,1,0.7562690649177018
37598,703-004-5398,2981.689,4,4,0,1.1997364249365714
37653,703-004-5393,9909.797,4,3,1,1.1006597630285941
37852,703-004-5398,1591.1346,1,1,0,0.5004296667122813
38006,703-004-5392,65.96625,4,1,3,0.5504709880080745
38092,703-004-5394,8982.133,7,5,2,1.4366419210697086
38801,703-004-5385,9892.161,7,4,3,1.3711964364151135
38966,703-004-5389,8903.533,2,2,0,0.6240434559961132
39033,703-004-5393,840.1024,5,5,0,2.4085048238108944
39150,703-004-5398,9861.602,2,0,2,0.27920371738274696
3940,703-004-5386,9435.219,"","","",0.27920371738274696
39519,703-004-5394,2190.109,4,2,2,1.3483574057258207
39545,703-004-5390,4460.0547,4,1,3,0.33853450732658075
39571,207-008-2398,7775.6245,2,0,2,0.27920371738274696
39843,703-004-5396,1917.5977,3,2,1,0.702496822230258
4003,703-004-5386,6390.2676,1,1,0,0.6099807632798597
40624,703-004-5382,7213.4155,4,1,3,0.3578850003549393
40844,703-004-5387,6423.064,2,1,1,1.432890529257865
41259,703-004-5394,8177.22,4,2,2,0.9708090618782736
41446,703-004-5399,9252.276,2,2,0,0.749318620438909
41749,703-004-5390,6042.8164,1,0,1,0.27920371738274696
41793,703-004-5394,4186.188,"","","",0.27920371738274696
41933,703-004-5392,545.6948,3,3,0,2.274485084657194
42420,703-004-5397,95.709564,1,1,0,0.33853450732658075
42538,207-008-2399,4179.683,4,2,2,0.8782474297544008
42729,703-004-5381,9272.664,6,3,3,1.6136768795284304
42775,703-004-5385,5796.36,8,3,5,3.2695847266643963
42933,703-004-5386,1603.9777,3,2,1,0.6973856078699953
43397,703-004-5385,1119.4348,6,1,5,0.395890967952681
4356,703-004-5393,6776.963,6,3,3,0.8246497270773432
43682,703-004-5385,1326.657,5,2,3,0.6856196284980081
4380,703-004-5383,9350.668,2,0,2,0.27920371738274696
43935,703-004-5387,4794.724,2,0,2,0.27920371738274696
44245,703-004-5391,6394.3374,1,0,1,0.27920371738274696
44517,703-004-5380,3517.911,7,2,5,0.45576225979060553
4479,703-004-5389,5916.8003,9,7,2,3.6893651393517706
45262,703-004-5383,7804.6133,6,3,3,1.9950483535709858
45711,703-004-5390,9803.36,6,2,4,0.6359139410180746
45814,703-004-5390,2833.9182,4,3,1,0.8998636398551938
46156,703-004-5397,3111.2551,4,2,2,0.6946057375650162
46740,703-004-5385,4469.604,3,1,2,0.35831143730785864
46845,703-004-5384,4664.6875,4,3,1,0.5804722840975471
46928,703-004-5397,6539.2715,5,1,4,0.4495968005813816
47461,703-004-5394,8474.857,2,2,0,1.0382585358291132
47519,703-004-5389,7531.2397,3,1,2,0.5647299200116634
47527,703-004-5392,1857.2247,4,2,2,0.6790792857783091
47859,703-004-5391,775.12146,4,4,0,1.7023446673098837
47935,703-004-5391,1969.8768,1,1,0,0.5417424628842112
48111,703-004-5386,9383.441,7,1,6,0.6642422215279437
48326,703-004-5384,1007.2059,2,1,1,2.2444836366116974
48405,703-004-5380,5897.9883,3,2,1,1.3531795235264241
4845,207-008-2398,3896.7192,5,4,1,0.9501237332333474
48548,703-004-5385,5797.499,6,3,3,1.33872806027487
48573,703-004-5392,7003.5376,2,1,1,0.5238608140477939
4869,703-004-5385,8682.737,2,0,2,0.27920371738274696
48850,703-004-5382,9429.131,4,4,0,2.16574904958966
48930,703-004-5399,4080.7097,5,0,5,0.27920371738274696
48986,703-004-5399,461.76672,1,1,0,0.35831143730785864
49121,703-004-5385,2200.2578,5,3,2,1.5503289284012456
4916,703-004-5386,8765.061,3,3,0,3.0477253877403223
49434,703-004-5385,9465.101,1,1,0,0.7079010292316483
4946,703-004-5389,6022.1523,3,2,1,1.7258335321873375
5078,207-008-2398,2316.352,7,1,6,0.5699460357361188
5118,703-004-5395,9984.2295,4,2,2,1.1522739768363388
5248,703-004-5398,5049.703,6,3,3,1.2705769775567293
5494,703-004-5382,7931.073,3,0,3,0.27920371738274696
5557,703-004-5391,4888.954,5,3,2,1.1539549696311293
5623,703-004-5390,1517.0747,4,2,2,0.8078635088141007
6011,703-004-5397,5251.6655,4,2,2,1.3277173962689484
6114,703-004-5399,1955.7928,6,4,2,2.605614137735904
6129,703-004-5397,5015.243,6,2,4,0.49116632241499614
6381,703-004-5390,7138.4233,1,1,0,0.4055062412128345
6776,703-004-5393,1778.0054,4,3,1,1.4240916924664606
6819,703-004-5394,8736.385,5,2,3,3.333086851751825
719,703-004-5390,6291.6445,2,1,1,0.4230808829965438
722,703-004-5393,3721.038,2,1,1,0.8437140268163156
7281,703-004-5389,6792.8945,4,2,2,0.6443015340922161
7383,703-004-5387,6642.081,2,1,1,0.46982687903685943
7397,207-008-2399,1131.3069,7,2,5,1.6686600197712833
7462,703-004-5391,7129.154,1,1,0,0.5572101432398974
748,703-004-5396,3709.0105,1,1,0,0.3978652972704144
7498,703-004-5381,2681.1768,4,2,2,0.9135068194475722
7646,703-004-5398,1425.5762,4,1,3,0.6470519629622682
7960,703-004-5387,1537.2795,5,1,4,0.7772589096388012
8060,703-004-5386,4128.3213,6,3,3,0.6641534033848531
8174,703-004-5399,5355.4165,1,1,0,0.4105972652879679
8259,703-004-5397,7349.638,4,1,3,0.7782391311123399
8278,703-004-5390,9495.365,5,2,3,1.0549332913122855
8627,703-004-5382,4954.3354,1,0,1,0.27920371738274696
8759,703-004-5389,136.17813,4,1,3,1.1786723502843919
8813,703-004-5399,2165.6543,2,1,1,1.0416132074140374
885,703-004-5386,7061.5093,8,4,4,1.0663899255751599
8958,207-008-2399,7635.4053,3,1,2,0.7324563429261693
9596,703-004-5387,1737.3729,4,4,0,0.9349641173022459
9698,703-004-5398,7478.217,1,0,1,0.27920371738274696
10197,703-004-5399,8011.3774,3,2,1,0.9233185499429871
10414,703-004-5383,2653.9766,5,0,5,0.27920371738274696
10565,703-004-5396,5657.456,3,1,2,0.40603825092876766
11543,703-004-5398,7682.022,1,0,1,0.27920371738274696
11573,703-004-5388,7170.9404,4,2,2,0.45719608721424815
11720,703-004-5380,5737.866,4,1,3,0.6123461029173735
12068,703-004-5395,1267.3062,6,4,2,1.987645981485183
12241,703-004-5390,5912.8003,3,1,2,0.44594026725907027
12273,703-004-5380,4497.7637,6,4,2,2.341986950607717
12299,703-004-5393,2078.5635,3,1,2,0.6939295815488613
12337,703-004-5387,6273.173,4,2,2,1.0053216910079046
12482,703-004-5389,3468.5725,1,0,1,0.27920371738274696
12555,703-004-5387,2446.5627,7,3,4,2.0075708880996657
12884,703-004-5388,6486.7437,7,3,4,1.3025660732551676
1315,703-004-5396,1268.4053,3,1,2,0.7770917999361775
13356,703-004-5399,5567.362,"","","",0.27920371738274696
13377,703-004-5382,4670.105,3,3,0,1.4983810757158866
1348,703-004-5391,4277.562,5,1,4,0.6771358936710807
13597,207-008-2398,113.7197,6,3,3,0.8716997116989882
13834,703-004-5395,124.4837,5,3,2,1.3110823775984126
13882,703-004-5394,9355.244,7,3,4,1.353070259149548
13936,703-004-5392,1695.3033,5,1,4,0.7159515096480831
14060,703-004-5388,6454.7476,5,2,3,1.464599792206271
14071,207-008-2398,715.3183,8,2,6,2.021824929702596
14125,703-004-5386,3548.0398,4,4,0,1.7432295662950228
1441,703-004-5392,5409.748,3,0,3,0.27920371738274696
1443,703-004-5383,4921.828,7,3,4,1.581847696708208
14502,703-004-5388,6120.818,3,2,1,1.4238262471720464
14723,703-004-5395,5461.426,7,3,4,1.72158164130236
14823,703-004-5391,6689.4307,3,3,0,1.267432127780397
14913,703-004-5385,7205.7124,4,3,1,0.5683108325006746
15021,703-004-5386,945.4852,5,3,2,3.0763018810459934
1506,703-004-5398,6375.2104,2,2,0,0.9471548896784724
15097,703-004-5386,0.7587671,1,1,0,1.1583902318525814
15375,703-004-5381,2772.0188,3,1,2,0.3978652972704144
15613,703-004-5385,3985.5684,5,3,2,1.075178000498077
15866,703-004-5390,1483.934,5,3,2,1.687882266643878
16256,703-004-5391,4723.472,4,3,1,1.798497891123341
16269,703-004-5393,1205.6285,4,3,1,0.9482477306249767
16290,703-004-5397,8967.754,4,1,3,0.45534101118200426
16415,703-004-5392,2009.5695,6,2,4,0.7230741301623069
16432,703-004-5382,7541.294,4,2,2,0.7033243693957508
16521,703-004-5392,5168.2407,2,1,1,1.0626679405567068
16657,703-004-5380,468.30417,3,1,2,0.32666834933781397
16682,703-004-5386,9328.218,6,2,4,1.1478902471923313
16904,703-004-5386,9163.685,4,2,2,0.7385604196299104
17003,207-008-2398,3592.3809,6,3,3,1.1963957591879968
17143,703-004-5388,9237.569,8,4,4,1.952701627235364
17273,207-008-2398,6041.026,3,2,1,0.4056791189262632
17315,703-004-5398,4721.902,2,2,0,1.3634917957246726
17812,703-004-5382,8682.267,3,1,2,0.4318574067496931
18081,703-004-5386,2602.145,3,2,1,0.72926855315874
18098,703-004-5385,648.3382,7,4,3,1.4917770915780215
18127,703-004-5388,4318.839,3,3,0,0.8712522345660519
18320,703-004-5391,7501.271,4,2,2,0.5839056566608014
18554,703-004-5389,4056.0776,7,3,4,1.7740416024739696
18622,703-004-5383,4458.36,2,0,2,0.27920371738274696
18724,703-004-5380,5421.161,"","","",0.27920371738274696
19217,703-004-5387,3329.6091,9,6,3,3.4242967209111277
19305,703-004-5396,4409.2095,7,6,1,1.7675678509297146
19605,703-004-5390,6762.437,3,0,3,0.27920371738274696
19740,703-004-5388,5087.126,6,3,3,1.4466217521138924
20069,703-004-5384,5737.7285,7,3,4,0.6236943239672291
20102,703-004-5389,7281.565,4,3,1,3.6011007812584293
20417,703-004-5391,6255.6816,7,5,2,1.0935639985534322
20946,703-004-5392,7973.0044,8,3,5,0.8530812831350084
20973,703-004-5386,3990.2585,3,1,2,0.6273722727896105
21314,703-004-5397,2177.9204,3,1,2,0.4214301568636002
21681,703-004-5385,7951.309,6,5,1,1.2596035202461604
21982,207-008-2399,4904.4956,4,3,1,1.533457928382707
22183,207-008-2399,2912.364,5,2,3,1.5247035582948154
2233,703-004-5394,2479.6355,4,1,3,0.48982499147399056
22347,703-004-5386,6307.0796,3,2,1,1.3988792705896815
2246,207-008-2399,903.4389,2,0,2,0.27920371738274696
22536,703-004-5384,5560.363,2,0,2,0.27920371738274696
22942,703-004-5383,1897.5859,1,1,0,0.35831143730785864
23396,703-004-5399,9755.432,4,1,3,0.7510835449521152
2344,703-004-5386,2125.649,3,3,0,2.607547168426098
2369,703-004-5380,8026.962,2,0,2,0.27920371738274696
23791,703-004-5389,4388.805,4,2,2,0.764288139348691
23968,703-004-5399,4386.793,3,0,3,0.27920371738274696
23995,703-004-5397,5150.248,7,2,5,0.8982216257967455
24015,703-004-5398,3129.524,5,1,4,1.0421834858921843
2410,703-004-5395,2573.889,4,4,0,1.6133632576030572
24181,703-004-5382,7746.309,3,2,1,0.4310905396389613
24183,703-004-5399,1308.1902,2,1,1,0.5502773077156957
24187,703-004-5392,3048.8838,6,3,3,0.8945477559017987
24296,703-004-5399,9395.982,2,2,0,0.4668126194176446
24495,703-004-5388,8081.761,1,0,1,0.27920371738274696
24527,703-004-5394,3070.085,3,2,1,0.7386372793189748
24652,703-004-5398,9549.263,3,1,2,0.36141686338598916
2497,703-004-5381,5546.4053,7,5,2,1.4438812380661579
24971,703-004-5399,591.2727,4,1,3,0.36010784178115807
25,207-008-2398,4855.8877,5,4,1,3.234181187019393
25105,703-004-5395,660.1316,3,1,2,0.6444675414767458
25218,703-004-5380,4853.076,4,2,2,0.46123993769774047
25529,207-008-2399,9085.033,3,2,1,0.8578989914399184
25753,703-004-5383,758.7773,10,6,4,2.832197430482865
26185,703-004-5389,252.24924,7,5,2,3.218110604313464
26198,703-004-5381,2044.0769,3,2,1,0.7832213998523498
26326,703-004-5380,4590.615,2,2,0,0.4840679908263096
26342,703-004-5385,7138.7954,2,0,2,0.27920371738274696
26417,207-008-2398,3443.5647,4,1,3,0.47682450256163866
26636,703-004-5381,6880.3345,2,0,2,0.27920371738274696
27332,703-004-5389,4047.6775,3,1,2,0.33853450732658075
27466,703-004-5383,7648.2935,3,1,2,0.4893205791485314
27495,703-004-5386,554.69214,4,0,4,0.27920371738274696
27936,703-004-5393,1267.9774,"","","",0.27920371738274696
27952,703-004-5384,4951.1553,3,2,1,1.2660918059552464
28004,703-004-5397,650.51495,2,0,2,0.27920371738274696
28354,703-004-5388,1307.4886,2,2,0,0.9301271074768453
28429,703-004-5382,3372.3945,3,3,0,0.9708475003100092
28442,703-004-5380,6770.497,4,2,2,0.5003618944233534
28546,703-004-5384,7090.4478,7,3,4,1.4624934576588868
2867,703-004-5385,5106.908,6,3,3,1.3890458021929992
28849,703-004-5390,2706.8389,4,2,2,1.1839102553164824
28863,703-004-5387,6364.471,4,1,3,0.7449114251445763
29245,703-004-5394,7321.2207,4,2,2,0.6208501828093228
29455,703-004-5380,9560.462,4,2,2,0.9347435274057527
29526,703-004-5396,5434.005,5,2,3,1.6079514737725467
30874,703-004-5386,9208.048,1,1,0,0.530270714522224
31152,703-004-5383,6419.794,2,1,1,0.7504248321583731
31537,703-004-5391,2097.7354,3,2,1,0.8171280377224148
3185,703-004-5398,5470.177,1,0,1,0.27920371738274696
31895,703-004-5391,2087.9185,9,4,5,1.2758834840819466
31968,703-004-5380,7781.6963,5,3,2,1.0902206848403753
31970,703-004-5387,3049.6187,6,2,4,0.7090657968720989
32093,703-004-5382,7791.672,5,3,2,1.4266601556923622
32405,703-004-5385,9302.78,2,1,1,0.6314848741386789
32424,703-004-5398,9193.07,3,1,2,0.7371694098317273
3262,703-004-5393,7054.8125,3,3,0,1.204806064108932
32694,703-004-5393,8903.985,4,2,2,1.0517586305110995
3273,703-004-5382,6789.9565,4,1,3,0.44889306247662397
32857,703-004-5393,3654.4048,10,5,5,1.2399981353174396
33437,703-004-5397,2936.7595,2,1,1,0.3852080620823966
33554,703-004-5385,9852.923,3,2,1,0.6054259079052995
34146,703-004-5394,2673.09,4,2,2,1.5163243576225554
34348,703-004-5395,1050.2308,2,2,0,1.2075774217809871
3438,703-004-5384,8686.347,"","","",0.27920371738274696
34388,703-004-5380,8819.109,4,2,2,0.9355324932406127
3456,703-004-5393,1196.3242,8,7,1,2.0235988365230955
34761,703-004-5380,6277.74,6,4,2,1.458473147815142
34830,703-004-5386,1222.1974,3,2,1,0.5734684491524273
3498,703-004-5389,4794.976,5,2,3,1.1203139530902526
35278,703-004-5396,8527.025,3,2,1,2.3332106946862576
35345,703-004-5388,413.65445,6,1,5,0.6758407104622057
3538,703-004-5388,8600.919,4,2,2,0.4858881064268112
35418,703-004-5381,4790.0747,5,2,3,1.111292510972325
35541,703-004-5393,3214.7432,1,0,1,0.27920371738274696
35572,703-004-5380,2914.8298,1,1,0,0.34890555227583814
36100,703-004-5384,7953.041,6,3,3,2.7075736554936993
36109,703-004-5388,6351.711,4,3,1,1.1020102812895034
36384,703-004-5386,7040.245,2,1,1,0.946369424257696
36708,703-004-5391,9143.869,2,0,2,0.27920371738274696
373,703-004-5394,472.53848,4,1,3,0.46697970446925413
37632,703-004-5394,4227.0864,4,3,1,0.8279841873423647
37710,703-004-5399,7183.76,3,0,3,0.27920371738274696
37842,703-004-5399,3465.1978,7,3,4,1.312727650924416
38082,703-004-5381,1569.5834,3,2,1,1.9817340216694261
38170,703-004-5381,7869.918,2,2,0,1.4626023290665664
38436,703-004-5397,8147.378,6,2,4,0.4202902212110798
38722,207-008-2398,9594.128,5,3,2,0.7506595025775308
39290,703-004-5398,5693.2266,4,2,2,2.4163085750854045
39376,703-004-5381,3621.9238,8,2,6,2.444933634636958
39406,703-004-5380,9141.612,4,3,1,1.461002633145426
39517,703-004-5386,1468.5762,3,2,1,0.9106631789406908
39573,703-004-5382,4880.658,"","","",0.27920371738274696
39699,703-004-5385,768.4874,3,2,1,0.6842011905988513
39958,703-004-5398,3034.9844,6,1,5,0.33853450732658075
40206,703-004-5389,2015.8922,2,0,2,0.27920371738274696
40278,703-004-5388,9912.326,7,2,5,0.6079406342308883
40435,703-004-5383,258.137,5,2,3,0.6723643926742583
40440,703-004-5392,3854.9482,4,2,2,1.3462333006527163
40466,703-004-5391,9250.073,3,1,2,1.092604975079852
40662,703-004-5398,9989.234,4,3,1,1.4503598974015601
40717,703-004-5396,8956.144,5,4,1,1.1576989818307417
40778,703-004-5396,8543.667,5,2,3,1.0800207029096267
40888,703-004-5397,7891.614,1,1,0,0.5165268771580819
40946,703-004-5384,3844.1526,4,2,2,0.47645592116770985
41227,207-008-2398,9164.621,4,2,2,0.48592974491285484
41333,703-004-5382,4281.708,5,2,3,0.7051514803938465
41778,703-004-5385,2426.2803,10,4,6,1.2055136970793319
42063,703-004-5396,3598.6257,4,3,1,0.9167144316294498
42424,703-004-5389,8539.063,3,3,0,0.7715223715479156
42596,703-004-5387,579.0275,4,3,1,0.7779862577215365
42794,703-004-5385,2190.171,3,1,2,0.48888222135912035
42796,207-008-2398,5715.919,7,2,5,0.42884915424108316
43110,703-004-5392,4603.5747,4,2,2,0.7635055356063939
43156,703-004-5380,9074.673,5,3,2,2.224055771724837
43254,703-004-5393,1732.7291,4,1,3,0.8075399392167735
43329,703-004-5394,7996.8677,2,2,0,0.9611929702329295
43405,703-004-5390,3868.3337,3,2,1,1.9838966944693157
43711,703-004-5398,4518.6777,4,1,3,0.5165268771580819
43976,703-004-5398,5500.1934,6,3,3,1.0817962505122434
44223,703-004-5389,9610.109,4,1,3,0.3313303485615256
44456,703-004-5380,8941.221,4,2,2,0.79578452334308
44590,703-004-5398,6964.662,3,2,1,1.2464380996731133
44784,703-004-5383,2643.6199,3,2,1,2.0641607812937974
45292,703-004-5397,8282.027,4,1,3,0.3919322182760311
45366,703-004-5391,6688.5107,4,2,2,0.7278623655539748
45517,703-004-5392,7800.3115,3,2,1,1.7411265797284632
45696,703-004-5392,2228.0396,3,1,2,0.33853450732658075
46228,703-004-5397,4264.5103,1,1,0,0.6147950132757647
46248,703-004-5384,5560.8833,4,1,3,0.4394869310570175
46297,703-004-5388,7455.02,5,2,3,0.9877567948213665
46330,703-004-5387,2090.5393,5,3,2,2.896677937210721
46400,703-004-5386,6271.546,3,2,1,2.6845359554473633
46521,703-004-5386,5708.374,2,0,2,0.27920371738274696
46806,703-004-5395,1102.0673,6,4,2,2.717076106974597
46866,703-004-5381,6011.2744,4,3,1,1.4168122149480669
47016,703-004-5388,9883.894,3,1,2,0.6846307819989441
47020,703-004-5380,7712.541,6,4,2,4.384717210214778
47319,207-008-2398,6498.4478,3,2,1,0.6538922693486758
47551,207-008-2399,7963.0454,5,0,5,0.27920371738274696
47562,207-008-2399,2395.1382,6,3,3,0.973852121795792
47580,703-004-5396,3394.3296,2,1,1,0.8792766170626455
47909,207-008-2399,1147.4556,3,2,1,1.113022293356735
48014,703-004-5396,6743.6616,7,1,6,0.903343899549767
48197,703-004-5384,5169.9624,5,3,2,1.0980513021215437
48381,207-008-2399,3457.6428,3,1,2,0.4180377658513179
48415,207-008-2399,2557.5972,5,3,2,1.0367747699777217
48790,703-004-5386,4329.0815,3,2,1,0.5074100664385304
4895,703-004-5386,9369.232,2,2,0,0.8709559039081592
49272,703-004-5395,5341.7007,9,4,5,2.417122101926532
49466,703-004-5383,4237.411,3,2,1,1.0041704055641378
49617,703-004-5393,6639.0454,2,1,1,0.3511274674921594
49646,703-004-5388,5475.401,4,2,2,1.537249599730863
49955,703-004-5380,4565.3506,1,1,0,0.4456519924100328
5043,703-004-5382,7228.749,6,5,1,1.8298873563811489
5167,207-008-2398,3498.302,7,3,4,1.0708312080181615
5216,703-004-5387,4542.8115,2,1,1,0.4419645549736673
5691,703-004-5390,9434.668,3,1,2,0.49985089198365
5794,703-004-5381,8261.699,3,1,2,0.4164371026555221
5828,703-004-5393,2033.8893,3,2,1,1.129709778962267
5991,703-004-5397,8644.473,3,2,1,1.9465388909845007
6026,703-004-5388,6195.384,2,1,1,0.33853450732658075
6741,703-004-5381,5292.982,2,1,1,0.6941846559749225
688,703-004-5396,7419.28,2,0,2,0.27920371738274696
6995,703-004-5394,3914.0059,2,1,1,0.38988695410046725
7096,703-004-5394,8369.451,3,3,0,4.26162383442765
7139,703-004-5386,9834.928,4,2,2,0.7741719726136537
744,703-004-5391,8480.483,4,3,1,1.3859197181866652
7566,703-004-5385,8929.373,4,1,3,0.4096359356548706
7600,703-004-5396,5219.079,3,0,3,0.27920371738274696
7836,703-004-5395,5823.762,4,3,1,1.097208803993205
7900,703-004-5399,7865.3086,4,2,2,0.9734832769209193
8143,703-004-5396,6012.8174,5,2,3,0.7038586270925391
8398,703-004-5385,6112.9365,3,3,0,1.997678154701436
8451,703-004-5395,2680.3296,7,5,2,1.4293503801159155
8769,703-004-5398,4550.9795,1,0,1,0.27920371738274696
8880,703-004-5398,5758.1113,5,3,2,1.3561338195643684
9075,703-004-5396,4154.9634,2,1,1,0.6601150663084308
9126,703-004-5387,9606.643,4,3,1,1.8231131138804777
914,703-004-5398,3053.9023,3,1,2,0.8636543332583612
9377,703-004-5392,4360.872,3,3,0,1.8066169907701894
9557,207-008-2398,3659.0166,3,2,1,1.1506760977035315
9565,703-004-5386,7062.0405,2,2,0,0.6282213012665943
9957,703-004-5392,599.89215,4,3,1,1.9245215133477525
10183,703-004-5386,5483.772,5,3,2,1.3678546638736464
10292,703-004-5392,72.15977,6,5,1,1.6653194313396003
10815,703-004-5394,8322.588,4,2,2,0.7755003345606328
10878,703-004-5388,7836.025,4,3,1,1.3028729452065644
10886,703-004-5396,8323.112,6,1,5,0.7254643833517468
10957,207-008-2398,7335.214,3,2,1,1.4748074246706997
10962,703-004-5396,9065.731,2,2,0,1.4644162468253947
10995,703-004-5390,9409.5205,1,1,0,0.6460672558162562
1116,703-004-5386,8622.302,1,0,1,0.27920371738274696
115,703-004-5383,713.9784,6,3,3,1.1387381256812275
11613,703-004-5385,4558.8555,5,3,2,0.6050703463480877
11859,703-004-5380,4613.1553,4,1,3,0.6505261753977831
12101,703-004-5391,3677.476,2,2,0,0.6647326834003353
1245,703-004-5383,9140.995,2,2,0,0.5946960809011207
12538,703-004-5386,7330.5205,8,2,6,1.0879914963236659
12818,703-004-5384,7244.8833,3,2,1,0.9751796562971818
13185,703-004-5384,8000.244,3,0,3,0.27920371738274696
13197,703-004-5398,1763.8575,6,2,4,0.44672925531651453
13205,703-004-5381,104.338524,4,2,2,0.8021564702507424
13254,703-004-5388,7049.6978,3,1,2,0.40544548749861364
1326,703-004-5396,3574.7295,4,3,1,1.1418616544482145
13391,207-008-2398,3640.2856,8,4,4,1.6477476676309815
13643,703-004-5395,8031.0483,3,1,2,0.5860254805418413
14007,703-004-5388,6080.776,4,4,0,1.313685725930206
14174,703-004-5393,6952.919,2,1,1,0.683355994053901
14273,703-004-5382,9964.51,3,0,3,0.27920371738274696
1442,703-004-5398,2652.296,1,0,1,0.27920371738274696
1499,703-004-5383,2108.935,5,4,1,1.661748827852782
15190,703-004-5380,8354.304,6,4,2,1.9583128238336087
15278,703-004-5391,5105.458,3,2,1,0.41212811659618387
15296,703-004-5388,9224.626,2,1,1,0.46316835601536926
15520,703-004-5388,9497.302,5,1,4,1.3737956263098319
1567,703-004-5398,8310.291,4,3,1,0.8625885789081359
15699,703-004-5384,8740.238,3,2,1,0.5738652618979344
15757,703-004-5386,4474.093,5,3,2,1.3590698855066732
16152,703-004-5391,9960.504,1,1,0,1.6391510465602808
16213,703-004-5392,6414.3223,3,3,0,1.052498217847831
17307,703-004-5390,4819.4727,2,2,0,0.7880590816138208
17312,703-004-5390,6361.183,2,0,2,0.27920371738274696
17372,703-004-5380,3522.334,5,3,2,1.0648810631263677
17902,703-004-5397,6036.318,2,1,1,0.3326390986750188
17964,703-004-5399,1294.8317,1,0,1,0.27920371738274696
18253,207-008-2399,5302.6377,7,4,3,1.3792848159725064
18534,703-004-5384,2692.231,"","","",0.27920371738274696
18595,207-008-2399,5399.4,5,3,2,1.325228953755218
18617,703-004-5397,3024.2817,3,2,1,0.9746923391048813
18833,703-004-5388,718.4517,3,1,2,0.6411873344172868
18849,703-004-5397,6835.1426,4,0,4,0.27920371738274696
19029,703-004-5392,4202.4883,5,3,2,1.1471792254924535
19129,703-004-5399,7994.0986,2,1,1,1.2981382112977085
19438,207-008-2398,3010.1794,4,3,1,2.2682483317851556
19816,703-004-5383,6535.3267,1,0,1,0.27920371738274696
19921,703-004-5385,7797.9355,5,3,2,1.1004507982690168
20035,207-008-2399,4284.4243,10,5,5,2.6357830479272537
20050,703-004-5392,565.27496,8,4,4,0.8994202231360954
20105,703-004-5384,2944.6978,6,3,3,0.7790904952110173
20113,703-004-5386,8426.452,6,2,4,0.5526197743739141
20388,703-004-5397,7422.9414,3,2,1,0.806443898083003
20477,703-004-5394,9150.378,8,6,2,1.8785715214283296
20758,703-004-5380,7120.6953,9,5,4,1.5037730494581594
20866,703-004-5386,439.62897,5,1,4,0.35831143730785864
20929,703-004-5387,6539.056,2,0,2,0.27920371738274696
21109,703-004-5395,6049.636,4,1,3,0.4842529194270848
21116,207-008-2399,7073.651,5,2,3,1.2684393509947214
21212,703-004-5381,2881.0637,6,3,3,1.0720481093092136
21313,703-004-5386,3031.6187,3,1,2,0.482128878177922
21504,703-004-5394,9643.156,3,0,3,0.27920371738274696
21697,703-004-5398,9282.176,3,1,2,0.6032946767318629
22140,703-004-5397,9615.871,3,1,2,0.5314760802703759
2215,703-004-5384,2209.648,3,2,1,0.9852288327269312
22171,703-004-5398,2857.1636,9,4,5,1.2826767779756816
22532,207-008-2398,668.7641,9,6,3,2.32714085466371
23038,703-004-5396,8382.259,5,1,4,0.6918463034679458
23069,703-004-5383,502.34555,4,3,1,0.6402966740771373
23079,207-008-2398,7057.9775,"","","",0.27920371738274696
23265,703-004-5396,6654.303,4,1,3,0.564855710043543
23289,703-004-5381,7754.52,3,1,2,0.5899028117259267
23454,703-004-5399,9658.206,5,1,4,0.6243640626304968
23996,703-004-5398,7165.941,4,2,2,1.6256449504724253
241,703-004-5383,8314.502,2,0,2,0.27920371738274696
24308,703-004-5395,4420.5957,3,2,1,0.9099044922554756
24596,703-004-5395,2157.9285,4,4,0,1.699030086130264
24624,703-004-5392,8946.381,4,3,1,1.0025143776562786
24745,703-004-5399,1510.7942,4,1,3,0.43959900884524844
25106,703-004-5392,1265.3076,1,0,1,0.27920371738274696
2513,703-004-5385,1208.1951,9,3,6,1.2742457425123688
25253,703-004-5393,6842.078,2,0,2,0.27920371738274696
25345,703-004-5391,5986.232,2,1,1,0.6606771909741327
25463,703-004-5395,1660.9043,2,1,1,0.43483002748292127
25559,703-004-5396,8001.4985,2,1,1,0.5379873768058173
25662,703-004-5386,9530.934,4,1,3,0.4858440145895691
25799,703-004-5390,2109.3345,5,3,2,2.287557269544034
26381,703-004-5386,638.5529,8,5,3,1.8138894219446926
26465,703-004-5381,8764.728,2,2,0,1.0530445884112742
26604,703-004-5396,9506.086,5,5,0,2.007058838679214
26675,703-004-5394,8752.473,2,0,2,0.27920371738274696
26718,703-004-5399,9146.164,4,3,1,1.0029147546269057
26800,207-008-2398,2913.391,3,1,2,0.37742360437346845
26920,207-008-2398,5986.553,5,3,2,1.8759699304791053
27135,703-004-5380,8258.068,1,0,1,0.27920371738274696
27346,703-004-5392,4510.938,3,2,1,1.0975222566333698
27383,703-004-5391,6759.39,3,3,0,1.5203846048383403
27565,703-004-5389,8177.002,2,1,1,0.4955560809373575
27920,703-004-5385,1857.3999,5,1,4,0.5727674930445897
2806,703-004-5388,3945.638,3,1,2,0.6306892054750085
28130,703-004-5381,9807.328,7,4,3,3.4095777368284512
28382,703-004-5392,6707.897,4,2,2,3.227680277140565
28581,703-004-5381,2060.3096,4,2,2,0.8983214960313308
28763,703-004-5390,2036.8356,1,1,0,0.6237771684465521
28838,703-004-5397,5151.4185,5,3,2,1.094502969097791
29257,703-004-5395,382.123,4,3,1,1.0860780936436016
30279,703-004-5384,3988.5664,3,1,2,0.42555299924420353
30612,207-008-2398,3306.8406,6,2,4,1.0203034254108225
30818,703-004-5388,4983.848,1,1,0,0.7131550524028097
30948,703-004-5384,8755.532,2,0,2,0.27920371738274696
31055,703-004-5390,2677.9956,6,4,2,1.4016270532745547
31351,703-004-5383,2259.9285,4,4,0,1.7121232956596926
31393,703-004-5381,5169.0327,2,1,1,0.35831143730785864
31461,703-004-5381,9246.137,2,1,1,0.46258530063414643
31627,703-004-5389,1074.568,4,1,3,0.7284237170311535
31777,703-004-5395,1334.4741,3,0,3,0.27920371738274696
31866,703-004-5382,2121.941,6,2,4,1.2248646257261193
31902,703-004-5388,8331.356,1,0,1,0.27920371738274696
3204,703-004-5384,2404.806,7,6,1,2.7101454282823965
32206,703-004-5398,3041.46,2,1,1,0.8675938696178637
33205,703-004-5385,1174.2616,6,4,2,0.9787825632356782
33843,703-004-5381,3498.453,9,6,3,1.174764251034076
33883,703-004-5395,8086.455,8,6,2,2.495315320813843
34006,703-004-5382,1461.8575,3,3,0,1.0118309369994414
34171,703-004-5388,7850.7764,5,2,3,1.5125183362503016
34624,703-004-5399,5934.035,6,3,3,1.3925994185156707
3471,703-004-5385,7949.8257,5,3,2,1.326688077908442
35091,703-004-5393,8933.645,1,0,1,0.27920371738274696
35655,703-004-5383,3252.994,6,0,6,0.27920371738274696
35666,703-004-5381,57.116745,3,1,2,0.6280388477125447
36225,703-004-5399,8311.444,"","","",0.27920371738274696
3628,703-004-5395,6617.386,5,3,2,0.9627417956124695
36374,207-008-2399,7985.6777,4,2,2,0.9731343592290582
36521,703-004-5396,9363.038,4,3,1,1.4366666162037738
36641,703-004-5390,2738.4067,5,2,3,0.6648935669610918
37091,703-004-5392,8041.9565,2,1,1,0.7217934860488402
37206,207-008-2398,2673.8787,2,1,1,0.3451498904053182
3766,703-004-5390,2014.3896,5,3,2,1.6111680492094844
3817,703-004-5389,2743.854,5,2,3,1.26027138071181
38412,703-004-5388,2047.3439,4,1,3,0.37568354994277614
38603,703-004-5391,3630.5713,3,1,2,0.5429064295503256
38679,703-004-5385,6191.7163,7,4,3,2.430371604536042
38774,703-004-5380,4037.2734,4,1,3,0.5631757107514211
39264,703-004-5388,9426.9375,5,1,4,0.393553487047163
39276,703-004-5383,6198.3184,4,2,2,0.8047981527171534
39749,703-004-5381,8906.886,3,3,0,4.48545823651424
40091,703-004-5383,8636.913,2,1,1,0.8069675811214593
40251,703-004-5388,5576.1157,4,3,1,0.6606269335305491
40294,703-004-5388,4230.2417,3,2,1,0.6584573799829012
40718,703-004-5388,2647.354,2,2,0,0.5589203688507501
40865,703-004-5380,3905.1099,5,2,3,0.9485457384815158
40943,207-008-2399,1898.4396,4,3,1,0.9744325008958535
41068,703-004-5383,4910.9155,8,4,4,1.2708329545233528
41133,703-004-5386,8384.548,5,5,0,1.1780636430265405
41139,703-004-5390,3023.63,4,3,1,2.6161143048577533
41330,703-004-5397,9761.615,6,3,3,1.0804514502548885
41576,703-004-5396,1276.6475,3,2,1,0.9484134286532351
41685,703-004-5386,1374.0211,6,4,2,1.4086778474246555
42010,703-004-5382,1138.0613,3,0,3,0.27920371738274696
42115,703-004-5395,533.5248,1,1,0,0.4987270871853826
42142,703-004-5389,413.62823,4,1,3,1.8096315101379257
42160,703-004-5380,3085.3623,5,3,2,1.7262191496163415
42283,703-004-5395,5200.8813,4,4,0,4.006192298912235
42985,703-004-5385,3417.8455,5,1,4,0.4753401199213634
42993,703-004-5383,7093.5947,4,1,3,0.46631819616811254
43210,703-004-5385,7759.5615,5,4,1,1.8559466982566792
43274,703-004-5399,4015.6274,4,1,3,0.7240286320842519
43327,703-004-5382,8191.5283,4,1,3,0.39669409408629347
43417,703-004-5386,1628.1897,6,3,3,3.399263387162526
43470,703-004-5397,2541.08,3,2,1,0.7133017480943816
43642,703-004-5386,3006.546,2,1,1,0.441185704556129
43855,703-004-5398,4370.6226,4,2,2,2.566880662269829
43939,703-004-5381,5130.716,8,4,4,1.5675149347738742
4400,703-004-5382,8725.297,5,3,2,2.4165033229639046
44009,207-008-2399,8677.205,7,5,2,1.9562106168493145
44254,703-004-5389,6706.8774,5,2,3,0.7370258596571259
44514,703-004-5380,5299.114,2,0,2,0.27920371738274696
4452,703-004-5388,773.53955,3,2,1,1.429453962434593
44546,703-004-5393,4692.7554,4,2,2,0.5002859187202068
4483,703-004-5387,9086.404,6,2,4,0.6944990776111474
44838,703-004-5396,5259.737,7,4,3,3.0093790584542517
45279,703-004-5381,2310.856,4,2,2,0.9384227905383623
45347,703-004-5389,6300.192,3,1,2,0.9899660808988787
45348,703-004-5381,9224.32,6,4,2,1.4919826710404738
45398,703-004-5385,6922.324,5,3,2,0.8133807253369506
45413,703-004-5394,9838.265,2,1,1,0.41628117235057854
45979,703-004-5388,9040.24,7,4,3,1.8410960366275348
46148,703-004-5394,1293.4423,6,2,4,1.1054043761009889
46171,703-004-5391,5725.311,5,3,2,1.2911897050657384
46710,703-004-5386,1119.0248,3,2,1,0.648047332074025
47012,703-004-5382,693.86005,3,1,2,0.8990640158059622
47116,703-004-5387,9024.839,2,1,1,0.49431379371652756
47244,703-004-5398,9592.828,4,1,3,0.5343213409963484
47381,703-004-5383,2962.3484,10,6,4,2.717642024670342
48115,703-004-5392,660.8951,5,2,3,0.4682861984705496
48407,703-004-5385,8789.21,3,0,3,0.27920371738274696
48656,703-004-5380,6503.891,6,3,3,0.8413453647048332
48932,703-004-5387,7019.601,4,2,2,0.9120421621859297
48984,207-008-2398,5722.4727,3,2,1,0.8316418489576999
49004,703-004-5387,2986.5771,7,2,5,0.4842113735686738
49171,703-004-5392,3402.5627,2,0,2,0.27920371738274696
49431,207-008-2398,7549.368,5,2,3,0.7420703043463084
49821,703-004-5385,4245.8145,4,2,2,0.674287706455656
5021,207-008-2398,9696.489,6,4,2,1.6435896513201609
5073,703-004-5396,649.4856,2,1,1,0.49413502200151
5410,703-004-5395,1575.8622,1,0,1,0.27920371738274696
5514,703-004-5388,801.80945,6,2,4,0.7077490273661792
5694,207-008-2399,3926.0798,5,0,5,0.27920371738274696
5938,703-004-5380,583.7715,3,2,1,0.6017461949166092
6283,703-004-5385,6299.11,4,2,2,0.5417630797633206
6337,703-004-5398,1541.5675,5,1,4,0.9760948743876438
728,703-004-5385,2166.1746,4,1,3,0.3383696995767367
7427,703-004-5395,3031.295,2,0,2,0.27920371738274696
7435,703-004-5389,1293.478,5,3,2,1.4408442273785989
7585,703-004-5388,7349.503,3,1,2,1.2653698581897457
8080,703-004-5391,636.73676,6,2,4,0.6954150447929657
8114,703-004-5385,1462.3099,4,2,2,0.9267817545480553
82,703-004-5383,3496.4973,6,1,5,1.0622882154367828
8280,703-004-5381,6605.3325,5,3,2,0.6014867298402382
8285,703-004-5393,9779.365,3,0,3,0.27920371738274696
8470,207-008-2399,5887.4746,"","","",0.27920371738274696
8638,703-004-5397,3862.403,3,1,2,0.7339502604765523
9122,703-004-5396,3430.2188,5,2,3,0.5609307224660645
9252,703-004-5385,6957.9697,2,2,0,1.0990597498823067
9393,703-004-5396,8641.627,5,3,2,1.3014334368266707
9405,703-004-5396,3024.938,1,0,1,0.27920371738274696
9690,703-004-5386,4139.1265,6,3,3,0.9291260916082854
9904,703-004-5392,3138.696,2,0,2,0.27920371738274696
10097,703-004-5391,2859.3718,1,1,0,0.495759118083547
10173,703-004-5391,5200.665,2,2,0,0.5213300338369453
1033,703-004-5390,7445.859,5,4,1,3.054748667116489
1063,703-004-5391,7996.5054,4,2,2,0.711028057230209
10661,703-004-5393,8795.533,5,1,4,0.33853450732658075
10762,207-008-2399,6144.968,5,1,4,0.47100804972823196
10916,703-004-5382,644.4526,4,2,2,0.5345602892620707
10938,703-004-5397,5471.2515,6,4,2,2.4968027790162077
1120,703-004-5399,93.72413,10,7,3,2.7933175185126404
11424,207-008-2398,5150.6104,2,1,1,0.32666834933781397
11557,703-004-5392,8012.652,2,1,1,0.5165268771580819
11891,703-004-5385,8111.74,1,1,0,0.921813525169693
1199,703-004-5399,6020.5073,5,2,3,0.3667166325499017
12214,703-004-5399,2047.1018,8,3,5,0.7554247049398822
12298,703-004-5397,4882.415,4,2,2,0.8481943779138187
12328,703-004-5394,9855.04,3,0,3,0.27920371738274696
12662,703-004-5388,3162.1772,3,2,1,1.8129470259883926
12812,703-004-5389,6194.7505,2,2,0,1.0341222445755893
12865,703-004-5386,5889.1816,4,4,0,1.7624172282197474
12915,703-004-5388,3720.163,4,3,1,1.3025934598387567
13349,703-004-5383,760.83246,3,1,2,0.32666834933781397
13370,703-004-5384,2027.005,2,1,1,0.6320113045042735
13561,703-004-5398,2264.6206,6,1,5,0.9018145024790984
13669,703-004-5394,6201.9297,2,1,1,0.6689640594378422
13741,207-008-2399,3927.6277,6,1,5,0.8352681365370822
1393,703-004-5398,5813.861,1,0,1,0.27920371738274696
1400,703-004-5396,6013.797,2,2,0,0.6375004044654773
14035,207-008-2399,8991.5,4,4,0,1.3440337273076828
14055,703-004-5385,6760.5337,3,2,1,0.8929031208025022
14062,703-004-5394,9518.117,5,2,3,1.7150485869605092
14336,703-004-5383,3367.1409,2,0,2,0.27920371738274696
14356,703-004-5399,7723.094,4,2,2,0.4147201120176782
14564,703-004-5395,2951.5027,6,4,2,2.4005934442750863
14585,703-004-5399,9080.658,4,2,2,1.2499444192885971
14616,703-004-5383,4451.661,7,3,4,1.1809638318969793
15062,703-004-5392,5268.9224,5,3,2,0.6608098173598181
1523,703-004-5389,1587.8391,4,1,3,0.5381620574750895
15577,703-004-5388,1485.5605,"","","",0.27920371738274696
15743,703-004-5390,3018.0466,3,1,2,0.5143089283097984
15843,703-004-5382,9509.612,1,0,1,0.27920371738274696
15855,703-004-5394,3536.3835,"","","",0.27920371738274696
16150,703-004-5388,4548.0044,4,2,2,0.5894323998059156
16197,703-004-5387,7923.1465,3,1,2,0.44227863980892135
16372,703-004-5383,581.4415,5,3,2,0.9319386219584638
16402,703-004-5396,1908.2362,6,4,2,2.3011277594942356
16495,703-004-5383,6579.942,3,2,1,0.8379821176087335
16512,703-004-5394,770.84186,3,1,2,0.35114230018964543
16945,703-004-5397,2436.4597,2,2,0,0.7724327624350666
16993,207-008-2399,7263.819,6,2,4,0.8029077365759874
17022,703-004-5389,5119.1543,4,2,2,0.9855541205667405
17349,703-004-5380,4604.344,3,2,1,1.0462599478252037
17691,703-004-5385,1325.5947,4,1,3,0.5782717778011134
17822,207-008-2398,4669.724,4,1,3,0.5599167018648945
17920,703-004-5388,5286.3765,3,2,1,1.4533940489523098
18149,703-004-5391,1866.2429,5,0,5,0.27920371738274696
1815,703-004-5385,2065.8635,5,3,2,0.647480374823212
18321,703-004-5385,3528.986,4,2,2,1.5966788597441346
18348,703-004-5386,2392.141,4,2,2,1.2666629596329673
18439,703-004-5386,8530.635,"","","",0.27920371738274696
18565,703-004-5388,1665.7073,3,1,2,0.4571759178358126
19086,703-004-5389,2760.2236,5,2,3,1.5797395547482393
19103,703-004-5398,5288.324,4,4,0,1.346421970480578
19150,703-004-5387,1925.8684,3,2,1,0.7071801632125804
19287,703-004-5396,3559.2168,4,3,1,0.6481924966667396
193,703-004-5396,4569.5264,6,3,3,0.8114228775455813
19831,703-004-5394,7195.071,5,2,3,1.0429226563028264
20195,703-004-5395,7363.963,3,0,3,0.27920371738274696
20424,703-004-5387,1451.6085,5,3,2,1.2941884826622703
20708,703-004-5380,3584.2144,5,2,3,0.8885607007996071
20938,703-004-5380,4500.4087,6,5,1,1.6207121399763174
21242,207-008-2398,2952.2705,4,2,2,0.9738441482867577
21633,703-004-5384,6059.165,3,1,2,0.9380118997110014
21677,703-004-5381,9224.791,8,3,5,0.7472790861600653
21781,703-004-5397,2252.5347,5,1,4,0.6585387445389508
21959,703-004-5388,3998.143,8,3,5,0.7801652713350208
22058,703-004-5394,3448.8647,4,1,3,0.5165268771580819
22079,703-004-5398,8197.785,4,2,2,0.6012439438712088
22093,703-004-5386,2564.2383,2,2,0,0.44618824798666884
2223,703-004-5390,9855.312,5,3,2,0.7257060430805063
22582,703-004-5395,5880.226,4,3,1,1.0702937970366124
22635,703-004-5392,2385.708,1,0,1,0.27920371738274696
22656,703-004-5393,9472.725,4,2,2,0.8102608323395862
23056,703-004-5389,1565.0284,3,2,1,0.8706610254652256
23074,703-004-5399,1270.4902,6,3,3,0.9126817344357906
23226,207-008-2398,3822.1252,2,1,1,0.5688353504291676
23288,703-004-5386,18.13054,2,2,0,0.4680042065736253
23802,703-004-5388,5419.901,3,3,0,2.7654100146624274
23858,207-008-2398,8962.065,3,2,1,0.8057986162825566
24004,703-004-5390,9300.495,3,3,0,0.6776858639107766
24104,703-004-5394,790.3415,5,3,2,0.7094198328204234
24489,207-008-2399,6354.6655,7,4,3,1.32214054165424
24556,703-004-5386,2056.117,"","","",0.27920371738274696
24585,703-004-5381,2716.459,2,1,1,0.6715425752428991
24632,703-004-5399,1788.2407,5,4,1,1.4892890642801495
24646,703-004-5386,209.44417,2,2,0,0.5941793789870189
24817,703-004-5398,446.7386,6,3,3,1.7711657438675288
2506,207-008-2398,9531.298,4,3,1,1.404711763943667
25388,703-004-5394,3440.4456,2,0,2,0.27920371738274696
25428,703-004-5384,9057.46,2,1,1,3.0609883604342984
25451,703-004-5395,7515.345,4,3,1,0.533378469579629
25672,703-004-5393,509.64832,4,3,1,1.032598270107987
25788,703-004-5397,2202.8374,6,4,2,3.309566376765742
26108,703-004-5393,1171.8577,5,2,3,1.418010608626641
2619,207-008-2399,2160.154,2,1,1,0.6544623718258962
26308,703-004-5392,2251.4707,2,0,2,0.27920371738274696
2674,703-004-5397,4709.255,3,3,0,1.078227599343367
26847,703-004-5381,5117.5312,1,1,0,0.4777311270500935
26850,703-004-5380,6817.743,2,2,0,0.5198408570281678
26872,703-004-5389,2390.3298,2,1,1,0.39744229071248155
26880,703-004-5391,4412.235,1,1,0,0.3978652972704144
2692,703-004-5395,6146.937,6,4,2,2.3451320178291186
27038,703-004-5388,1281.1494,4,1,3,0.33853450732658075
2713,703-004-5388,1706.9834,3,1,2,0.9746818735713192
27186,703-004-5394,9718.821,5,3,2,0.8159484662853727
27329,703-004-5398,3476.0332,5,1,4,0.6330772933535352
27485,703-004-5380,7744.3535,3,2,1,0.707596200428525
27830,703-004-5380,4794.2812,3,1,2,0.6152229261173523
27857,703-004-5390,7137.9966,2,1,1,0.47835794814723664
28023,703-004-5390,7205.568,4,2,2,0.6062573992826025
2824,703-004-5394,968.20654,2,0,2,0.27920371738274696
283,703-004-5385,6928.0493,5,2,3,1.0678107306592606
28462,703-004-5383,312.58762,8,2,6,0.5649180433978086
28605,703-004-5391,9292.995,4,2,2,0.9224848458300988
28716,703-004-5384,8120.222,5,2,3,1.0476328141701052
28826,703-004-5386,9448.136,3,1,2,0.7525447595546525
29151,703-004-5398,845.04065,3,2,1,0.9531222645254209
29162,703-004-5386,9730.156,4,2,2,1.653283319913887
29419,207-008-2398,2230.0352,3,1,2,0.7134438611702745
2955,703-004-5381,5829.065,5,4,1,1.0153957414320471
29660,207-008-2399,435.555,3,0,3,0.27920371738274696
29913,703-004-5397,9403.675,5,2,3,0.9590396383576153
2992,703-004-5397,5625.0127,1,1,0,0.5842055293389731
29948,703-004-5398,5774.3545,"","","",0.27920371738274696
31188,703-004-5397,9226.28,5,2,3,0.791964946719936
31463,703-004-5388,6746.793,5,3,2,1.971047956529145
3147,703-004-5394,5825.2754,3,1,2,0.35831143730785864
31901,703-004-5399,9913.59,8,5,3,2.1905874552398137
32101,703-004-5388,9120.125,4,3,1,0.7624106998109393
32298,703-004-5383,4602.7144,3,3,0,1.1879950952583975
3238,703-004-5390,652.2721,3,3,0,0.9893067915851558
32651,207-008-2399,9705.616,5,3,2,2.1217190291735384
32746,703-004-5382,9407.362,2,1,1,0.4104730901334791
32856,703-004-5397,7772.522,3,1,2,0.9422094677691699
33055,207-008-2398,4185.4287,5,4,1,1.0666977805526718
33404,703-004-5389,6529.235,5,2,3,1.5622738621468788
33858,703-004-5390,7858.184,5,3,2,1.800199188685148
34110,703-004-5394,3932.9612,7,3,4,1.0698380793150182
34250,703-004-5388,356.13953,1,0,1,0.27920371738274696
35170,703-004-5398,3630.7424,6,3,3,1.348695032795506
3520,703-004-5392,9621.457,5,2,3,0.9071738236351687
35373,207-008-2399,2564.8206,3,3,0,0.8642164480853375
36151,703-004-5393,8003.505,6,5,1,3.779823052071464
36227,703-004-5397,59.288742,4,0,4,0.27920371738274696
36439,703-004-5382,3923.3691,3,2,1,1.0508051278328279
36628,703-004-5390,6328.5024,2,1,1,0.8793959822246915
3681,703-004-5389,8072.467,2,0,2,0.27920371738274696
37123,703-004-5385,982.6249,3,0,3,0.27920371738274696
37407,703-004-5390,7937.794,5,3,2,3.5978427078377684
37434,703-004-5390,2048.018,4,2,2,0.8011809594376903
37610,703-004-5392,4728.019,2,2,0,1.1304503522000253
37714,703-004-5383,4150.0264,4,2,2,0.5035677409702457
37994,703-004-5386,6703.7104,5,2,3,0.9332992710723899
38000,703-004-5388,556.9553,2,0,2,0.27920371738274696
38021,703-004-5386,3213.5117,2,2,0,0.7227287172444862
38280,703-004-5382,2356.047,5,5,0,1.085840447270784
38442,703-004-5383,1262.8854,3,1,2,1.2689501096772353
38477,703-004-5389,82.36885,5,1,4,1.1532920013171812
39017,703-004-5389,4396.0356,7,5,2,3.2156987806709387
39321,703-004-5382,273.23483,1,1,0,2.8174597472109397
39754,703-004-5396,5522.077,5,2,3,1.3704605432187302
39764,703-004-5389,1360.7925,2,1,1,0.3637500930527101
40062,703-004-5393,6411.6504,2,0,2,0.27920371738274696
40307,703-004-5399,5389.912,4,1,3,0.4955798148045949
40567,703-004-5388,2820.6765,5,2,3,0.8864921732765798
40654,703-004-5381,6910.5083,4,2,2,1.1253893298606108
40983,703-004-5398,3301.8262,3,2,1,0.487850328685229
41224,207-008-2398,9379.986,4,2,2,0.6197067893845413
41839,703-004-5380,8385.609,2,1,1,0.5374897965771509
41970,207-008-2399,8299.322,5,4,1,2.298119588810411
42653,703-004-5386,2203.1433,4,2,2,0.8611088348846022
43052,703-004-5380,9014.766,1,1,0,0.41513418539082786
43098,703-004-5390,4968.282,4,1,3,0.5568718143198889
43356,703-004-5397,8611.484,1,0,1,0.27920371738274696
43514,207-008-2399,6479.0435,7,4,3,0.8751284660912941
43823,207-008-2398,901.5727,5,3,2,2.567811248750059
43947,703-004-5392,780.2564,6,4,2,2.3475499690346453
44176,703-004-5392,8103.008,2,1,1,0.5405319994039322
44321,703-004-5393,1463.2523,2,0,2,0.27920371738274696
44405,703-004-5399,4237.183,2,0,2,0.27920371738274696
44439,703-004-5395,4641.673,7,3,4,0.7263885377073264
44732,703-004-5380,8046.634,6,1,5,0.6946528749322218
44837,703-004-5383,3392.6702,4,3,1,1.2531293776665546
44940,703-004-5397,6832.4365,2,2,0,0.8668478330761568
45102,703-004-5385,7531.1587,2,0,2,0.27920371738274696
45131,703-004-5393,9155.305,8,4,4,2.1632912514369136
45280,703-004-5389,1822.4955,3,2,1,0.49505402799532916
45390,703-004-5386,8601.453,3,1,2,0.5006224016070033
45461,207-008-2399,5738.393,2,1,1,0.7479150707391861
45849,703-004-5395,8097.799,4,2,2,0.8849187795446476
45864,703-004-5396,2878.7124,4,1,3,0.5924171019917186
46288,703-004-5387,2549.3127,1,1,0,0.678393076479943
46986,703-004-5393,3307.5261,3,2,1,0.9770780527905487
47483,703-004-5398,4630.9624,5,3,2,2.0143748551819654
4764,703-004-5391,5005.067,3,0,3,0.27920371738274696
47817,703-004-5387,3605.3794,"","","",0.27920371738274696
47897,703-004-5389,9270.483,5,4,1,0.9776707247445318
48187,703-004-5381,7673.909,3,2,1,0.8625043399486811
48280,703-004-5384,4815.7056,6,1,5,0.5165268771580819
48567,703-004-5398,1333.9866,1,0,1,0.27920371738274696
48589,703-004-5389,4107.63,4,2,2,1.833663531036715
49035,207-008-2398,890.58813,4,3,1,2.219736207868974
49202,703-004-5391,947.78955,5,2,3,0.9398019764760008
49285,703-004-5384,9125.704,5,3,2,1.4476945303978446
49486,703-004-5381,2523.703,3,2,1,0.8697282514775633
4982,703-004-5389,1423.9072,4,2,2,1.4894790801097317
5177,703-004-5398,9475.731,4,1,3,0.44488027874799047
5294,207-008-2398,4286.9653,6,0,6,0.27920371738274696
5616,703-004-5393,4323.4585,1,1,0,0.758183937690378
5763,207-008-2398,9713.255,5,4,1,0.8260046157303418
5808,703-004-5399,4647.1147,11,5,6,5.202528324178438
6258,703-004-5385,6981.337,3,2,1,1.2804289980879608
638,703-004-5391,2724.229,5,3,2,1.9158401551855937
6603,207-008-2398,1087.7496,5,1,4,0.8834444630243349
6683,703-004-5381,8214.72,4,1,3,0.45925482785172156
6967,703-004-5392,1422.1394,5,2,3,0.8462832946025514
7067,703-004-5384,2152.961,1,0,1,0.27920371738274696
7151,703-004-5389,3269.5293,3,1,2,0.35534489781066697
725,703-004-5393,5695.246,1,1,0,0.3978652972704144
7276,703-004-5395,8521.766,2,0,2,0.27920371738274696
7474,703-004-5397,4716.0244,7,4,3,2.709980302427396
755,703-004-5397,5217.051,2,0,2,0.27920371738274696
7552,703-004-5382,5889.874,3,2,1,0.766474275184121
7736,703-004-5386,7126.1606,3,2,1,0.6674559766789406
8047,703-004-5388,446.62238,5,3,2,0.8346559346917404
8140,703-004-5391,9145.35,6,4,2,1.8702557278663057
8253,703-004-5393,7004.5195,3,2,1,0.9228505992772298
8473,703-004-5392,4656.5396,6,3,3,0.883017912450254
8535,703-004-5389,6933.574,2,1,1,0.3672522577368947
857,703-004-5380,1908.1783,3,1,2,0.35534489781066697
8949,703-004-5392,6814.001,7,4,3,4.743466756980317
9590,703-004-5399,4505.0317,7,2,5,1.1945789286214727
9723,703-004-5382,2432.7456,3,2,1,1.0891569064946127
998,703-004-5382,6591.3726,4,2,2,1.4696163826732016
10033,703-004-5399,6873.771,3,1,2,0.6614715231158028
10290,703-004-5381,1467.0312,4,1,3,0.5415941359093517
10333,703-004-5396,2302.8982,5,1,4,0.4423633897282897
10510,703-004-5392,2100.5786,5,4,1,0.9775831329851938
10560,703-004-5398,9117.629,2,2,0,1.269607037918009
10655,703-004-5394,1449.998,3,2,1,1.8938818833541728
10785,703-004-5382,5734.907,3,3,0,0.6250016279423063
10786,703-004-5396,4924.1777,7,4,3,0.8302253198612055
10813,703-004-5399,3682.9143,5,1,4,0.4499692613474475
10913,703-004-5380,2682.3884,3,3,0,0.7830591869045765
10987,703-004-5392,6751.6772,2,1,1,0.6101190374402713
11511,703-004-5390,6480.3936,4,2,2,0.43445261773577853
11649,207-008-2398,6727.6562,5,4,1,1.8446519187543995
11742,703-004-5384,2207.97,5,2,3,0.8063596644297659
12243,703-004-5381,7710.9937,3,3,0,1.201966919932692
12658,703-004-5386,2946.1182,4,2,2,1.5454505149680544
12706,703-004-5389,8427.857,7,2,5,1.137801768498737
12770,703-004-5390,3280.5837,6,4,2,0.8183098464891152
12902,207-008-2398,7438.134,7,6,1,1.6406870798602153
13281,703-004-5383,5173.3867,2,1,1,0.7671169407694655
13301,703-004-5382,6413.684,4,1,3,0.48596822671960194
13409,703-004-5382,7476.128,2,1,1,0.6310839864577291
13516,703-004-5398,4491.412,3,1,2,0.5054683984349729
13545,703-004-5395,986.0766,6,3,3,1.870884715578799
13549,703-004-5390,2953.7607,2,2,0,0.5778353601000434
13641,703-004-5399,1230.3137,4,2,2,0.5746626830169717
14162,207-008-2399,7655.64,3,2,1,1.309176513860226
14193,207-008-2398,1682.278,3,2,1,0.8543963346906606
14364,703-004-5385,3830.9307,5,1,4,0.7287247944961303
15403,703-004-5392,2839.2334,4,0,4,0.27920371738274696
15534,703-004-5399,8466.301,3,1,2,0.4230808829965438
16507,703-004-5391,1438.5653,2,1,1,0.9055931527324382
16565,703-004-5389,9066.393,3,1,2,0.5281634954989682
17065,703-004-5395,3022.0627,2,2,0,0.9683235552294742
1710,703-004-5393,3424.738,2,1,1,0.8370455422090631
17161,207-008-2398,2807.296,1,1,0,0.5245465613220291
18328,703-004-5386,8064.095,2,2,0,0.5609542498680881
18418,703-004-5397,8368.333,3,2,1,0.5890803964781393
18452,703-004-5393,2753.7698,9,5,4,1.774973280631588
18590,703-004-5393,6830.5205,8,5,3,1.8265262138708211
18645,703-004-5384,2620.5332,5,2,3,1.0470337107462675
18958,703-004-5391,1031.2789,4,3,1,1.5048198036296065
18999,703-004-5385,2146.6143,2,2,0,1.344214879107264
19370,207-008-2399,8569.023,2,1,1,0.37137220427136947
19564,703-004-5380,5437.859,5,2,3,1.115794583091184
19693,703-004-5386,1695.1578,4,2,2,0.40795153156086617
19808,703-004-5387,3488.9639,4,1,3,0.4230808829965438
1994,703-004-5397,2559.374,6,4,2,1.3826524224998251
19956,703-004-5394,4080.562,5,2,3,1.2606142435354621
19988,703-004-5381,9564.495,2,2,0,0.7378555832247686
20079,703-004-5392,6625.9893,2,1,1,0.8009733035217225
2025,703-004-5380,768.2305,3,2,1,0.7823947691088234
20738,703-004-5389,380.54764,7,5,2,0.9104806299015473
21217,703-004-5395,4528.7554,5,3,2,1.2083520791986473
2134,703-004-5396,9312.683,3,1,2,1.1314518717033069
21418,703-004-5389,6967.6636,5,2,3,0.41764222725169237
2151,703-004-5381,5826.8457,4,1,3,0.8137303087808031
21721,703-004-5394,4049.7273,3,2,1,0.6126575091067593
2177,703-004-5389,4848.0083,3,2,1,0.675358049675447
2181,207-008-2399,2518.4255,3,1,2,0.4746663289993578
21943,703-004-5398,5314.7334,3,1,2,0.4903549875135948
22037,703-004-5397,163.697,3,1,2,0.48439918023986245
22094,703-004-5380,2752.4084,"","","",0.27920371738274696
22848,703-004-5392,3657.2087,8,3,5,1.2806771542388888
22904,207-008-2399,9945.409,5,4,1,1.1129126546300991
23120,703-004-5387,5475.7666,8,5,3,1.708088259395857
23126,703-004-5387,376.65964,4,2,2,0.8263546849187043
23239,703-004-5393,2.0587444,4,1,3,0.8355723935257353
23315,703-004-5390,3245.833,4,3,1,0.8063970958526798
23899,703-004-5393,4448.127,1,1,0,0.43227541848502465
23972,207-008-2399,4195.1865,6,3,3,1.7421836688709935
2400,703-004-5398,315.54224,6,4,2,1.7897161839636047
24484,207-008-2398,5523.6167,3,1,2,0.8655386086775503
2460,703-004-5385,9191.796,5,3,2,4.739025790439326
24691,703-004-5397,5362.3486,5,2,3,0.535148349313802
24848,703-004-5385,7598.101,8,4,4,1.2553014875825237
2488,703-004-5399,931.11694,3,2,1,2.157749294075975
24970,207-008-2399,4818.719,"","","",0.27920371738274696
25077,207-008-2398,1639.7,6,2,4,1.7549124804735128
25323,703-004-5396,8866.824,4,2,2,0.7612991074142057
2533,703-004-5382,5736.51,3,3,0,1.1947812921531595
25379,207-008-2398,1814.785,2,1,1,0.8090978921349374
25382,703-004-5387,668.2175,2,0,2,0.27920371738274696
25586,703-004-5385,5806.661,8,4,4,2.728744667171992
25953,703-004-5395,9134.381,3,2,1,0.4725486089441833
26030,207-008-2398,2688.293,4,2,2,0.5524547648835076
26077,207-008-2398,4129.445,2,2,0,0.7093449936828072
26298,703-004-5390,3602.1685,4,0,4,0.27920371738274696
26857,703-004-5380,8835.054,"","","",0.27920371738274696
26983,703-004-5383,1590.8206,3,1,2,0.8915725875692899
27222,703-004-5383,6272.929,1,0,1,0.27920371738274696
27307,703-004-5389,9108.867,3,2,1,0.6602237689482109
27508,703-004-5383,8253.552,2,0,2,0.27920371738274696
27650,703-004-5393,4780.184,5,2,3,0.41764222725169237
2819,703-004-5388,5749.237,4,3,1,1.452876733579521
28403,207-008-2399,4452.763,4,1,3,0.47049561270104523
28630,703-004-5382,135.2924,2,0,2,0.27920371738274696
28683,703-004-5381,3051.5713,2,1,1,0.6098245443447605
28754,703-004-5389,9420.937,4,2,2,2.023276418523898
29121,207-008-2399,4841.071,6,5,1,1.4640658592212479
29172,703-004-5391,2172.091,3,2,1,1.2182093373151885
29185,207-008-2398,7586.5396,3,1,2,0.4241351892106117
29299,703-004-5391,669.2201,9,5,4,2.119933874981199
29485,703-004-5389,4455.2456,5,2,3,1.1245463165549316
29731,703-004-5397,1725.4752,8,4,4,0.9261961679994126
29857,703-004-5390,4198.782,3,2,1,2.343430166923328
30107,703-004-5398,9330.144,4,1,3,0.6184131824755498
30403,703-004-5388,8961.327,3,1,2,0.7561225709960154
30535,703-004-5398,7026.1123,3,1,2,0.40097060489297476
30709,207-008-2399,9590.625,3,0,3,0.27920371738274696
31166,703-004-5393,7812.54,1,0,1,0.27920371738274696
31198,703-004-5395,2921.3096,2,0,2,0.27920371738274696
31336,703-004-5396,9369.304,4,2,2,0.7029975368353409
31579,703-004-5394,8259.272,3,2,1,0.6659371415830632
31603,703-004-5384,4796.521,4,4,0,0.7268609079539845
32026,703-004-5399,2713.8555,3,2,1,0.5007570745801198
32089,703-004-5387,1792.23,3,2,1,1.238010819222671
32531,703-004-5389,5660.451,6,3,3,0.6798600668852486
32796,703-004-5397,9147.405,4,3,1,0.9246022493514768
32841,207-008-2399,7532.999,5,3,2,1.250997950587517
32901,703-004-5394,998.8791,4,3,1,0.8558781450760589
32981,703-004-5380,2897.6243,5,2,3,2.2269424659217454
33091,703-004-5387,6636.8975,3,2,1,0.4805663313903418
33260,703-004-5385,4176.416,6,2,4,0.8399906059333285
3334,703-004-5383,6013.5913,6,4,2,0.9007691396138718
33443,703-004-5380,8937.78,4,2,2,0.9841663952241348
33513,703-004-5392,2443.788,4,3,1,1.1214510017910222
33693,703-004-5382,6293.0693,7,1,6,0.7082379634061702
33789,703-004-5381,2659.6123,6,2,4,1.1654774352733788
33798,703-004-5380,2252.0654,4,2,2,2.413516668554956
33815,207-008-2399,2457.658,4,0,4,0.27920371738274696
34177,703-004-5396,8499.928,6,2,4,1.8878318269805536
34422,207-008-2398,3123.7627,3,1,2,1.3615043095879067
34494,703-004-5395,4710.679,7,6,1,1.9939416657136222
34814,703-004-5392,6765.083,6,3,3,1.444216316832457
3493,703-004-5391,2712.1335,4,4,0,1.0937478714776383
34999,703-004-5386,5544.8955,1,0,1,0.27920371738274696
35055,703-004-5385,4035.3018,8,5,3,2.26527644935393
35064,703-004-5396,347.22568,6,4,2,1.3872097138109272
3519,703-004-5390,7971.084,3,2,1,1.261019017523658
35261,703-004-5390,5613.67,1,1,0,0.42803994818934926
35266,703-004-5391,1657.393,1,0,1,0.27920371738274696
3545,703-004-5395,4017.6375,5,2,3,0.7153286614719382
35618,703-004-5388,2531.9128,3,2,1,1.5480518116597788
36487,703-004-5392,1069.2793,1,0,1,0.27920371738274696
36840,703-004-5399,3427.3018,2,1,1,0.6489142509449103
37201,703-004-5386,3356.6565,2,0,2,0.27920371738274696
37627,703-004-5391,7873.9824,5,2,3,0.8240312408635482
37791,703-004-5393,5870.038,2,2,0,1.9139567030509914
37877,703-004-5386,4346.3384,4,3,1,1.4275475634607275
38094,703-004-5391,9478.864,6,5,1,2.480498749838512
38140,703-004-5393,8247.966,2,1,1,0.42517299732931846
38167,703-004-5398,777.05743,2,1,1,1.4523556808940186
38483,703-004-5387,6744.6167,6,4,2,1.0207326559566097
38760,703-004-5391,8482.554,3,2,1,1.467851501444869
38913,703-004-5398,8013.808,5,3,2,1.1235832832066883
39128,703-004-5393,9891.413,3,1,2,0.4039104118864428
39139,703-004-5394,934.1973,3,1,2,0.6653411174665438
3971,703-004-5394,1079.3877,10,3,7,1.7486836037226738
3973,703-004-5391,7362.719,5,3,2,1.3686807091349975
40012,703-004-5391,4579.9517,3,0,3,0.27920371738274696
40402,207-008-2399,9556.189,5,3,2,1.5061856644438187
40480,703-004-5384,6418.665,3,2,1,1.1504507756790305
41164,703-004-5385,5268.3516,3,1,2,1.2674173494504313
41420,207-008-2398,1621.9377,2,2,0,1.1761093028489127
41500,703-004-5388,8348.368,5,2,3,0.8078299856497724
41966,703-004-5392,3384.4197,5,5,0,4.096971488288969
42389,703-004-5393,9049.199,4,2,2,1.1647655804932628
42395,703-004-5385,2617.1523,4,2,2,0.8559324672955128
42435,703-004-5384,2435.8809,2,1,1,0.5165268771580819
42456,703-004-5395,8126.8833,4,2,2,1.3833551713034438
42461,703-004-5382,6328.6,2,1,1,0.42719922141932803
4253,703-004-5396,6317.9956,4,2,2,1.6002290903471696
43400,703-004-5399,570.83307,4,1,3,0.9864378158103008
43911,703-004-5385,3662.7246,3,1,2,0.39907663423176776
4412,703-004-5382,7311.836,5,1,4,0.4831723115529983
44148,703-004-5380,4552.081,2,1,1,0.3695543473226321
44454,703-004-5395,632.01544,10,4,6,0.8633443523170742
4462,207-008-2398,2477.2632,5,3,2,1.397574088780323
44633,703-004-5397,7739.334,6,5,1,1.3053593666955405
44636,703-004-5394,7496.941,9,4,5,1.978038431380242
44826,703-004-5387,9234.585,6,3,3,2.505535573395627
45193,703-004-5387,5221.4067,4,1,3,0.5165268771580819
45199,703-004-5396,6213.9966,6,3,3,1.0865862767236563
45625,703-004-5381,8284.6045,8,6,2,2.9026409843678187
45855,703-004-5384,6120.2007,"","","",0.27920371738274696
46010,703-004-5395,9508.302,8,4,4,1.357921109070973
46321,703-004-5387,5113.6177,7,2,5,0.5571432332355865
46531,703-004-5393,840.3373,5,4,1,1.5657691758919738
46587,703-004-5389,1503.5057,3,1,2,0.570528575281649
46632,703-004-5396,7057.3647,4,2,2,0.5821195835463726
46637,703-004-5389,4028.1672,4,1,3,0.8933651352765918
46666,703-004-5396,9847.823,1,0,1,0.27920371738274696
4668,703-004-5392,7219.123,3,2,1,0.48488787995182814
46697,703-004-5395,8835.557,2,1,1,1.7177453931874298
47245,703-004-5385,1066.8898,5,2,3,0.43253436527410527
47460,703-004-5390,7600.362,5,1,4,0.4031391452654219
4778,703-004-5385,8771.948,3,1,2,0.42582271210472183
47865,703-004-5392,1422.4332,5,3,2,0.8486147760262982
48125,703-004-5380,1573.6234,5,2,3,0.8113433666004475
48551,703-004-5396,7723.9067,2,2,0,1.6775675581436251
48606,703-004-5387,6221.6797,4,2,2,0.8115741037424751
48610,703-004-5390,2431.1155,5,2,3,1.0493352147649284
49183,703-004-5389,4010.8186,6,4,2,2.688997794367515
49205,703-004-5380,4126.309,4,1,3,0.35534489781066697
49583,703-004-5394,3429.8235,4,1,3,0.5431875034180744
49845,207-008-2398,5804.0723,4,1,3,0.4053538023002138
53,703-004-5394,3130.386,2,0,2,0.27920371738274696
5360,703-004-5398,7397.685,5,3,2,1.5165298998777994
5568,703-004-5393,3608.622,5,3,2,1.4694649257332677
5717,703-004-5382,8504.122,5,3,2,1.1148406913805216
5971,703-004-5390,6195.5093,4,1,3,0.4475320808795612
6117,703-004-5380,5457.251,2,1,1,0.6649114534952496
6379,703-004-5392,4900.7075,3,0,3,0.27920371738274696
6834,703-004-5395,8105.9873,1,0,1,0.27920371738274696
6990,703-004-5385,7297.2256,1,1,0,0.4082236635875704
7111,703-004-5384,3557.449,3,1,2,0.5165268771580819
7113,703-004-5389,7235.1406,6,2,4,0.8021108010939224
7342,703-004-5382,2376.2744,7,3,4,1.399068161647446
7826,703-004-5397,6373.6587,4,3,1,1.1672774246431818
8073,703-004-5389,4857.891,4,2,2,0.7248084598956283
8326,703-004-5396,7949.9424,5,2,3,1.1016469823950839
8709,703-004-5396,3428.93,2,1,1,0.9432530858080513
8870,703-004-5383,2885.6157,4,2,2,0.9386077077718422
8875,703-004-5392,3592.3816,1,0,1,0.27920371738274696
9000,703-004-5385,5593.0557,5,4,1,2.1894564491576345
9144,703-004-5389,7540.256,3,0,3,0.27920371738274696
9608,703-004-5384,6006.8696,2,2,0,1.0652615969269221
9681,207-008-2399,1746.6002,7,2,5,1.7053436077353268
9873,703-004-5396,8349.654,3,2,1,0.5488374365149947
9966,703-004-5394,3292.3865,2,0,2,0.27920371738274696
10044,703-004-5398,6299.131,3,1,2,0.32666834933781397
10069,703-004-5389,6602.38,5,1,4,0.6189811218960154
10237,703-004-5381,3542.6616,3,1,2,0.6420604966424844
10283,703-004-5395,8138.783,5,3,2,1.106378176905973
10313,703-004-5382,4314.8794,4,3,1,1.0718817997205627
10602,703-004-5383,9625.878,4,0,4,0.27920371738274696
10606,703-004-5395,4861.8804,5,3,2,0.7775904418348246
10657,703-004-5383,5880.4863,3,1,2,0.3941836098587212
10712,703-004-5393,3214.4153,5,0,5,0.27920371738274696
11066,703-004-5380,787.7451,6,3,3,1.5807506651663308
11755,703-004-5387,9179.889,9,6,3,2.3667323623719034
12010,703-004-5393,5442.2607,6,1,5,0.48367869098164246
12095,703-004-5380,9976.32,6,2,4,1.8639964227559829
12210,207-008-2399,5562.9087,4,2,2,0.7314740489594588
12520,703-004-5383,6644.306,7,5,2,1.654613759437185
12556,703-004-5389,4558.365,2,1,1,1.3189734040059067
12663,703-004-5391,7932.733,4,3,1,0.9602774506699426
12851,703-004-5390,8583.256,6,3,3,0.552570332048961
12882,703-004-5395,1937.7709,2,2,0,1.2106321215950404
1291,703-004-5389,6958.5767,6,2,4,0.6978257919743092
12995,703-004-5393,9805.94,5,2,3,1.408175574085522
13005,703-004-5399,9753.926,3,1,2,0.6672770359060425
13241,703-004-5384,3475.6648,6,1,5,0.709210504255504
13259,703-004-5398,6669.824,3,2,1,0.5956345970831934
13360,703-004-5399,9192.076,3,1,2,0.8890235320861553
13803,703-004-5399,6255.355,6,3,3,2.103406603632258
13940,703-004-5384,4551.4326,2,1,1,0.35831143730785864
14057,703-004-5388,5711.349,3,2,1,1.1663875120512917
14245,703-004-5389,883.6287,6,5,1,2.05719766007664
14330,207-008-2399,5333.7866,2,0,2,0.27920371738274696
14365,703-004-5399,8926.107,5,2,3,1.5038191901781397
14377,703-004-5389,9425.192,6,3,3,0.9994476989072397
14850,703-004-5383,4022.3218,7,3,4,1.2541433771453632
14968,703-004-5393,5130.9385,3,3,0,1.9649592488593397
1583,703-004-5388,4296.7837,6,3,3,0.9932604319480741
15881,703-004-5398,993.9355,8,3,5,1.1410030432350524
15914,703-004-5385,6215.6123,2,2,0,1.821041800876011
16163,703-004-5383,9987.474,8,5,3,3.3489740716110767
16414,703-004-5387,9331.146,8,6,2,1.3070233535481837
16588,703-004-5389,5390.392,6,2,4,2.753824480181398
16908,703-004-5389,18.327236,4,0,4,0.27920371738274696
16947,703-004-5391,5239.158,3,2,1,0.9730008905352997
17062,703-004-5392,9899.905,5,2,3,0.6483183083792374
1708,703-004-5381,5897.0244,3,1,2,1.1321202967357724
17131,703-004-5387,6120.663,2,1,1,0.5063966326815051
1755,703-004-5399,3157.983,1,0,1,0.27920371738274696
18170,703-004-5396,4641.777,3,1,2,1.0945972063569003
18415,703-004-5396,5486.3423,5,4,1,1.3605811002830164
18825,703-004-5395,2896.673,3,0,3,0.27920371738274696
18875,703-004-5389,7263.6978,5,1,4,0.35534489781066697
19187,703-004-5382,7080.169,4,3,1,1.9595391051609625
19326,703-004-5393,8913.926,4,3,1,0.9698778246787909
19414,703-004-5386,8927.512,4,0,4,0.27920371738274696
19534,703-004-5381,5689.36,5,1,4,0.4903224449328886
19619,703-004-5394,7354.737,4,1,3,0.37175974969512765
1973,703-004-5383,9131.671,3,2,1,1.1206934660871508
19736,703-004-5394,9767.424,5,2,3,0.8969603914421636
19959,703-004-5389,2338.1162,3,2,1,0.7683613593071794
20057,703-004-5387,5756.114,2,2,0,0.7023727333902394
20408,703-004-5386,2593.6902,6,3,3,2.354997559194245
20469,207-008-2398,1743.5455,3,1,2,0.3978652972704144
20491,703-004-5382,8092.4546,6,4,2,1.1103752028340435
21089,207-008-2399,6340.0557,4,3,1,3.029795864672222
2109,703-004-5387,8482.569,3,1,2,0.35831143730785864
21113,703-004-5392,8693.404,"","","",0.27920371738274696
21442,703-004-5397,2504.7666,4,3,1,0.9247980035232763
21585,703-004-5399,7194.038,4,2,2,0.5405485680763831
22023,703-004-5380,2418.028,1,1,0,0.6702419174405467
22252,703-004-5397,4982.961,2,0,2,0.27920371738274696
22502,703-004-5382,6262.46,1,1,0,0.5894800409658268
22561,703-004-5382,1667.5669,5,3,2,1.4332087316416238
23181,703-004-5397,6375.0806,5,2,3,0.6148705312440471
23204,703-004-5380,6115.992,5,2,3,1.0588225080653113
23215,703-004-5382,4075.8718,4,2,2,0.66077648402468
23282,703-004-5385,3888.5498,3,1,2,0.6506899701860435
23285,703-004-5392,3203.5203,2,0,2,0.27920371738274696
23301,703-004-5397,9479.586,6,3,3,1.7310233485140984
24091,703-004-5386,7949.418,2,1,1,1.0995696023188999
24472,703-004-5395,5841.3706,9,5,4,2.1103116011321505
24827,703-004-5391,5429.0938,5,3,2,0.954309688354688
24860,207-008-2398,6228.7407,3,0,3,0.27920371738274696
2511,703-004-5399,8561.082,2,2,0,2.539359986670297
25136,703-004-5395,47.243835,"","","",0.27920371738274696
25452,703-004-5388,4443.7754,4,3,1,1.279567117593886
25492,703-004-5391,8035.87,7,5,2,1.817059711461905
2609,703-004-5383,3710.0237,3,2,1,1.4787447825862332
261,703-004-5388,5331.7446,4,1,3,0.3317114664830398
26279,703-004-5394,2872.1772,2,2,0,0.8301926405663663
26451,703-004-5383,4962.757,4,3,1,0.533337267642168
26482,703-004-5394,2378.8386,2,2,0,0.8136737503501237
26509,703-004-5387,6526.365,5,2,3,1.0120756419832602
2653,703-004-5381,3591.708,4,1,3,1.0296896083444245
26653,207-008-2399,4893.7207,4,1,3,0.4230808829965438
2670,703-004-5384,8211.265,4,2,2,0.7804462831977549
26720,207-008-2398,5047.3516,5,2,3,0.831310872016051
26818,703-004-5385,6214.5205,4,3,1,1.143666868071493
27589,703-004-5385,1441.8214,2,1,1,0.42687753787258087
27739,207-008-2399,9084.1875,3,0,3,0.27920371738274696
27803,703-004-5396,6809.3125,6,5,1,2.8264446978567315
281,703-004-5383,4966.925,7,7,0,3.460837395799375
28240,703-004-5391,2336.0354,5,2,3,1.1424647238158399
28279,703-004-5387,6295.8296,4,2,2,1.1127593311270974
2834,207-008-2398,2361.6384,3,1,2,0.3978652972704144
28406,703-004-5391,484.0183,4,2,2,0.6107908833425045
28437,703-004-5399,2804.6602,3,3,0,1.644842490335706
28769,703-004-5395,8937.0,3,3,0,1.0241624307129031
28908,703-004-5386,1747.2773,4,4,0,1.1955431279456434
28992,703-004-5386,3806.4377,6,4,2,1.1300961873552626
28993,703-004-5397,8994.248,4,1,3,0.4756507529209138
29119,703-004-5386,5486.415,4,2,2,1.2435956969435418
29178,703-004-5387,1110.8678,3,2,1,0.7678774961702703
29391,703-004-5384,5189.978,2,2,0,0.5524564956737492
29457,703-004-5380,2210.6594,6,3,3,1.0402241042923197
29483,703-004-5398,3790.53,5,5,0,1.163536057287046
29736,703-004-5380,7898.638,6,5,1,2.21513079241441
30062,703-004-5384,3783.8691,2,0,2,0.27920371738274696
30081,703-004-5392,5541.8037,2,0,2,0.27920371738274696
30942,703-004-5381,6270.679,2,1,1,0.623898742383947
31059,703-004-5388,2107.3896,2,2,0,1.207304535747135
31194,703-004-5380,1588.3857,1,1,0,0.9082005670483232
31312,703-004-5381,1321.075,4,4,0,1.0996910637407444
3135,703-004-5382,4755.598,2,0,2,0.27920371738274696
31415,207-008-2398,9458.982,1,1,0,0.5669580486103406
31706,703-004-5380,709.0026,2,0,2,0.27920371738274696
3178,703-004-5381,7518.2407,6,4,2,2.6672874865273926
32094,207-008-2398,9009.221,1,0,1,0.27920371738274696
32151,703-004-5390,6152.583,1,0,1,0.27920371738274696
32348,703-004-5391,330.17218,6,4,2,1.656047003963471
32728,703-004-5395,8950.254,8,3,5,0.9785297679408422
32734,703-004-5380,7845.319,4,2,2,0.936529797610336
32759,703-004-5398,1200.6963,5,3,2,1.1660584135529044
32884,703-004-5385,2015.1466,1,1,0,0.43440416425732453
32945,703-004-5393,9803.053,4,3,1,1.406661337198175
33003,703-004-5389,1350.5197,6,2,4,1.6304816017658597
33005,703-004-5387,1015.7281,5,1,4,0.7872534302240317
33307,703-004-5395,1933.4376,5,1,4,0.36721723609005286
33375,207-008-2399,3056.944,5,2,3,1.7345574610659094
33429,703-004-5395,3448.7617,4,3,1,1.3621302637564208
33743,703-004-5391,1637.001,4,2,2,1.7044580100881348
33988,703-004-5383,1712.4689,"","","",0.27920371738274696
34005,703-004-5388,822.08276,4,3,1,1.443068322579807
34059,703-004-5387,8250.467,5,2,3,0.7578973614624014
34418,703-004-5398,477.25082,3,1,2,0.5728413535730214
34419,703-004-5381,5885.095,4,2,2,2.002145985811768
34715,703-004-5392,6699.9976,2,0,2,0.27920371738274696
34748,703-004-5390,7865.9927,2,1,1,0.5002720948006572
34802,207-008-2398,2907.7578,1,0,1,0.27920371738274696
34806,703-004-5397,7037.146,5,2,3,0.6949641580907309
35153,703-004-5387,9421.138,8,3,5,1.10576564671356
3531,703-004-5396,1338.4324,3,2,1,1.5286678935706333
35650,703-004-5390,7382.659,7,2,5,0.7667476245136499
35848,703-004-5396,746.032,6,4,2,1.1539523912931278
36042,703-004-5384,7050.28,7,3,4,2.1842461223086462
36253,207-008-2398,2217.7463,4,1,3,0.3978652972704144
3678,703-004-5392,4880.832,6,3,3,1.3325489005195932
36842,703-004-5390,1358.0579,3,2,1,0.9414177370308533
36888,703-004-5398,5173.205,3,1,2,0.35831143730785864
37137,703-004-5391,3361.0112,2,1,1,0.35831143730785864
37307,703-004-5380,1854.4418,6,3,3,0.7755228558817023
37367,703-004-5389,8597.507,1,1,0,0.5567442415357037
37482,703-004-5384,191.99014,3,1,2,1.1059207075842115
37621,703-004-5393,4823.4463,7,5,2,1.994335051311341
37628,703-004-5395,864.41516,3,3,0,2.234797219879619
37785,703-004-5391,3556.8547,5,3,2,1.0049657054134777
38270,703-004-5383,212.63301,4,0,4,0.27920371738274696
38646,703-004-5382,6858.9253,4,3,1,0.6100549608254053
38899,703-004-5390,6189.0884,4,3,1,2.735406727626428
39045,703-004-5386,2485.0203,5,1,4,0.5715809059934642
39088,703-004-5383,5655.455,4,1,3,0.39592890511647005
39201,703-004-5397,8279.495,1,1,0,0.6118893299706346
39542,703-004-5390,1750.3047,6,3,3,0.8420386549193546
39722,703-004-5382,855.4804,2,1,1,0.3525563506833067
39747,703-004-5394,717.83545,1,0,1,0.27920371738274696
39798,703-004-5397,771.08325,3,1,2,0.5535050219322947
4002,703-004-5393,7481.241,5,2,3,0.7244080435656901
40266,703-004-5389,9703.414,8,5,3,2.0921343490679876
40310,703-004-5399,9430.889,1,0,1,0.27920371738274696
40391,703-004-5396,3586.2297,3,1,2,0.6304911734507384
40595,703-004-5389,7375.136,4,2,2,1.404841229039371
40628,207-008-2398,7932.1714,1,1,0,0.5484649450161188
40701,703-004-5384,5658.544,1,1,0,0.46725724893406434
4089,703-004-5388,3615.6218,7,4,3,2.6987729335156394
40900,703-004-5396,4672.32,2,0,2,0.27920371738274696
40990,703-004-5385,4222.684,3,2,1,0.5550996231412565
41119,703-004-5393,529.9127,2,0,2,0.27920371738274696
4122,207-008-2398,7942.9854,5,3,2,1.3837457767888037
41243,703-004-5389,9341.526,2,2,0,1.3485867745268414
41287,703-004-5383,32.59003,1,1,0,1.1810947037067108
41409,703-004-5391,817.5433,5,1,4,1.451783292873408
41589,703-004-5393,6262.3423,3,2,1,0.5355568160131919
41620,703-004-5393,1012.5226,3,2,1,1.0718166201368062
41791,703-004-5395,3195.377,1,1,0,0.34532788277514964
41826,703-004-5393,3974.4514,1,1,0,0.3638057774711886
4194,703-004-5388,2217.536,5,3,2,1.1006147012808296
42229,703-004-5382,9993.21,2,2,0,0.7812795427860512
42355,703-004-5390,9494.794,5,2,3,0.8759944730528432
42696,703-004-5396,21.159054,4,2,2,0.6818932412888704
42762,703-004-5388,1741.9678,"","","",0.27920371738274696
42766,703-004-5398,6426.2,3,1,2,0.3690557427011291
42795,703-004-5397,9995.11,1,0,1,0.27920371738274696
42826,703-004-5392,5679.6177,6,3,3,0.8105780231465262
43045,703-004-5389,752.418,3,1,2,0.5303197589901282
43241,703-004-5380,1256.3485,3,1,2,0.7431479663227173
4344,703-004-5388,3251.9365,4,3,1,1.692826751736154
43482,703-004-5394,162.11688,5,3,2,1.1944052176033464
43487,703-004-5382,825.65784,5,2,3,1.325780440118572
43532,703-004-5391,5778.8823,4,3,1,0.9880986085411732
44004,703-004-5393,1206.6388,3,1,2,1.3112302677720877
44081,703-004-5396,8072.3335,4,1,3,0.432468714045152
44209,703-004-5398,3279.67,1,1,0,0.33853450732658075
44577,207-008-2398,2764.9534,2,1,1,0.33853450732658075
44669,703-004-5381,3523.83,3,2,1,2.2576093883389268
44859,703-004-5384,3770.752,4,3,1,0.8963798991922389
45097,703-004-5396,5861.295,4,2,2,1.0600490392559463
45165,703-004-5380,3192.7747,6,2,4,0.6367539227842377
45227,703-004-5380,816.52344,5,3,2,0.9863116023653762
45243,703-004-5385,6853.0527,3,2,1,0.5955010341359241
45318,703-004-5393,5414.1294,5,2,3,1.382284788332535
45383,703-004-5391,829.98517,3,3,0,4.071871576104485
45489,703-004-5388,4335.5234,8,3,5,1.510266918110409
45854,703-004-5380,3623.7358,2,1,1,0.33853450732658075
461,703-004-5397,2197.671,3,3,0,2.3635138154534516
46126,703-004-5383,4203.653,5,3,2,1.078730724199466
46224,703-004-5393,2579.2043,3,2,1,0.838656239998517
46260,703-004-5391,2899.7725,1,0,1,0.27920371738274696
46271,703-004-5396,3278.7544,5,4,1,2.8208922964955048
46327,703-004-5387,1115.3912,5,3,2,1.0406155216619466
46466,703-004-5388,4129.1436,6,4,2,1.7142168550431256
46483,703-004-5390,8484.395,7,2,5,1.4686823982563069
47604,703-004-5395,6430.5327,3,1,2,0.5837920824572373
47720,703-004-5383,6984.666,8,3,5,2.54907447274777
4783,703-004-5385,6538.6333,5,4,1,2.7210324896652542
48129,703-004-5381,696.07495,6,3,3,1.1190351089494264
48169,703-004-5386,8700.822,4,1,3,0.5165268771580819
48291,703-004-5389,9271.719,3,0,3,0.27920371738274696
48425,703-004-5388,8353.693,4,2,2,0.7395846984411028
48600,703-004-5396,3464.142,6,1,5,0.5165268771580819
48684,703-004-5387,7934.8,3,3,0,1.0566894811321315
4897,703-004-5390,3273.949,9,3,6,1.333845653183039
49059,703-004-5397,5677.379,4,0,4,0.27920371738274696
49319,703-004-5384,7325.0454,2,2,0,1.0043546761420543
49805,703-004-5387,2454.8704,3,2,1,1.6214592968589927
5138,703-004-5397,4545.2886,5,2,3,1.3362116143127332
5174,703-004-5382,4386.694,6,4,2,1.1461917113674185
5779,703-004-5386,2090.2783,7,2,5,0.6060439113304531
58,703-004-5384,6592.4536,7,5,2,1.3038205986394389
5814,703-004-5396,2074.7495,3,1,2,0.6308465441795159
5882,703-004-5382,2602.3691,4,3,1,0.8214760330392227
6226,703-004-5383,7279.8765,6,2,4,1.564439447902891
6642,703-004-5382,641.9623,5,3,2,1.4672746475566392
6804,703-004-5396,7681.8896,4,2,2,1.334417770499599
6890,703-004-5384,3111.8374,"","","",0.27920371738274696
6933,703-004-5396,9976.069,6,4,2,2.622248835459168
6981,703-004-5387,8860.211,6,2,4,0.8408533989666933
7184,703-004-5392,9627.455,1,1,0,0.32666834933781397
7459,703-004-5394,1111.5044,8,3,5,1.3348922931133196
7522,703-004-5399,2709.076,7,4,3,1.7795970508549734
7588,703-004-5389,633.4275,1,1,0,0.7806688633210442
8122,207-008-2398,3294.8596,3,0,3,0.27920371738274696
816,703-004-5384,1443.6191,4,2,2,1.1049923436653337
821,703-004-5394,4221.518,4,3,1,1.060369162516767
8226,703-004-5383,7298.5894,5,3,2,0.7688108074528162
8293,703-004-5395,3501.5696,2,1,1,0.5426875290883584
8415,703-004-5392,3224.4194,2,1,1,0.4923309407354442
8463,703-004-5383,9967.376,2,1,1,0.35831143730785864
8978,703-004-5386,7118.967,1,1,0,0.618444867079005
9103,703-004-5399,2406.0732,6,4,2,1.9595197924324481
9123,703-004-5395,3626.4778,7,3,4,1.2567102787367892
9190,703-004-5388,1794.5897,5,0,5,0.27920371738274696
9215,703-004-5389,1292.0303,6,1,5,0.4180377658513179
929,207-008-2399,4734.787,3,1,2,0.5676696230574498
9404,703-004-5383,1955.5944,5,2,3,0.9537423492352606
949,703-004-5395,8377.8545,3,1,2,0.571184282847706
1005,703-004-5380,2598.0227,2,2,0,1.197130066630913
10175,703-004-5389,8511.944,6,2,4,0.6967733290460364
1035,703-004-5391,6986.3516,7,4,3,1.3126182010114291
1037,703-004-5386,279.66022,4,1,3,0.5362210590226182
1123,703-004-5388,4952.8247,6,4,2,1.7136082783097248
11406,703-004-5399,5265.4375,3,3,0,0.7745247034233416
11530,703-004-5384,1401.98,3,2,1,0.6364182895984412
1163,703-004-5380,5576.433,5,4,1,2.5101171063707253
11753,703-004-5390,6815.7563,2,1,1,0.8511034032270832
11766,703-004-5389,415.7561,4,3,1,0.9936228049684109
1181,703-004-5396,9847.644,10,4,6,1.7039811423487954
11814,703-004-5399,187.69383,5,3,2,1.1951006906190778
12370,703-004-5383,9911.305,3,1,2,0.3918388272177862
12417,703-004-5391,6259.196,4,1,3,0.5100567747144984
12452,703-004-5380,8263.173,4,1,3,0.4891265419049676
12469,703-004-5383,8871.631,2,1,1,1.102402298904785
12646,207-008-2399,4680.7886,2,1,1,0.7801307831673978
1268,703-004-5397,2632.9148,2,1,1,0.4423633897282897
1293,703-004-5398,9121.301,5,1,4,0.5165268771580819
13067,703-004-5396,8266.711,3,2,1,1.5992387994361597
13068,703-004-5398,3688.8367,4,4,0,1.898181635978116
13331,703-004-5387,8825.891,3,2,1,0.5814828991622274
13461,703-004-5392,2653.7441,4,1,3,0.769683626910168
13639,703-004-5384,8596.166,4,3,1,2.0156030404559013
13811,703-004-5381,8339.181,8,3,5,0.6793633329186836
13949,703-004-5391,5540.9946,8,1,7,0.4230808829965438
14144,703-004-5388,689.6776,2,1,1,0.5837684390944268
14624,703-004-5388,4274.6196,"","","",0.27920371738274696
14699,207-008-2399,1634.7415,2,1,1,0.8181530558223564
14743,207-008-2399,8015.3276,6,2,4,0.5536094855986404
14761,703-004-5399,9607.627,3,2,1,0.6984710055566642
14898,703-004-5380,2153.5444,6,5,1,2.9889298327198697
14971,703-004-5382,1590.1095,6,4,2,2.151981126037323
15338,703-004-5391,1514.4241,1,1,0,1.0744780028090506
15372,207-008-2398,3940.5818,3,1,2,0.6793906367037986
15466,703-004-5382,6363.505,3,0,3,0.27920371738274696
1560,703-004-5397,3381.145,3,1,2,1.2297127094155493
15799,703-004-5382,6365.5337,3,2,1,1.8663948827081775
15825,703-004-5395,4742.512,2,2,0,1.554135073018098
15906,703-004-5386,9529.229,4,2,2,0.5783698302302276
15996,703-004-5383,9107.711,5,3,2,1.7819795969675096
16183,703-004-5382,147.72713,1,1,0,2.0452481594905194
16217,703-004-5382,4248.6714,4,2,2,0.5147327866885952
16229,703-004-5399,7801.5054,3,1,2,0.5315564672855796
16671,703-004-5382,2751.4194,4,1,3,0.5085831697508554
16681,207-008-2398,2626.4329,1,1,0,0.5128303801256664
1702,703-004-5391,458.31143,4,2,2,1.8965557818673402
17243,207-008-2399,4809.597,3,1,2,0.5909530785344572
17425,207-008-2399,9745.01,1,0,1,0.27920371738274696
1763,703-004-5393,4434.0835,"","","",0.27920371738274696
17816,703-004-5391,6405.8833,3,2,1,1.0659024521855098
17863,703-004-5388,6283.6655,5,3,2,1.7020354183209423
18173,703-004-5381,4417.364,3,3,0,0.8536479520283944
18215,703-004-5386,4348.554,6,4,2,1.301906012923453
18441,703-004-5384,4651.68,8,7,1,2.3511671753175887
18471,207-008-2398,1443.6674,5,1,4,0.6820680657312982
19025,703-004-5387,3018.0723,6,1,5,0.6293498128920266
19441,703-004-5392,400.89966,3,2,1,0.896012545529835
19676,703-004-5383,9429.584,9,5,4,3.0297545405245527
1983,703-004-5383,5694.802,3,2,1,0.6044956053890985
20116,703-004-5383,8755.097,6,4,2,0.8496940230951252
20343,207-008-2398,9944.436,2,1,1,0.3668247134722495
20676,207-008-2398,9592.148,5,2,3,0.8034786775809128
20982,703-004-5395,1368.4934,3,1,2,0.35831143730785864
21680,703-004-5393,2772.0427,3,1,2,0.7394762454993663
21707,703-004-5399,2958.5369,5,1,4,0.403199163355185
21921,703-004-5387,6602.307,6,5,1,2.4229006682489715
22016,703-004-5380,3796.078,7,4,3,0.9466747945261863
22218,703-004-5393,3762.7363,3,1,2,0.7172473316996292
22412,703-004-5392,3196.484,5,3,2,0.733770255416997
22428,703-004-5399,3916.518,2,1,1,0.5485701402093466
22631,703-004-5391,638.49927,3,2,1,0.8635120736530508
2289,703-004-5383,6138.4873,2,1,1,0.5853897600056296
2384,703-004-5382,2169.0994,"","","",0.27920371738274696
2405,703-004-5389,2696.8677,2,1,1,0.6243917610597903
2425,703-004-5383,2757.7114,7,3,4,0.9282496670526112
2452,703-004-5381,3166.083,2,1,1,0.4819172496908456
24653,703-004-5395,846.93787,4,3,1,1.1720196018773812
24699,703-004-5388,1648.2091,4,4,0,1.4992677148529572
24888,207-008-2399,4957.106,7,3,4,0.9551495136512809
24944,703-004-5383,1395.8573,3,1,2,0.5976738249202016
25124,703-004-5387,4203.7397,7,4,3,1.568871823944057
25747,703-004-5389,6757.881,3,1,2,0.32666834933781397
2577,703-004-5391,6918.8286,3,2,1,1.6028701779134646
25822,703-004-5397,646.9888,4,2,2,1.0159643745725964
2614,703-004-5380,7911.3716,6,2,4,1.3604633419785666
26649,703-004-5390,4892.8247,6,2,4,1.3079645942510891
26833,703-004-5389,5512.771,5,4,1,1.463282327999872
27291,703-004-5381,651.4895,6,4,2,1.0416357615507708
27444,703-004-5388,54.22056,4,3,1,1.660624748270922
27471,703-004-5392,9214.697,5,4,1,1.1984210801796595
28096,207-008-2399,7175.911,2,1,1,0.47442419180630446
28372,703-004-5393,8439.435,3,1,2,0.3797357237536708
28729,703-004-5397,9521.653,4,2,2,1.2168571000250166
28788,703-004-5387,1296.7157,7,3,4,1.0990978217032277
28987,207-008-2398,8780.985,6,3,3,1.183369565998192
29364,703-004-5386,8909.441,11,6,5,1.303272252847703
29516,703-004-5397,3138.2673,1,1,0,0.6770086930368193
29528,703-004-5388,5273.233,3,3,0,1.4818152809055407
29544,703-004-5385,2175.2244,5,2,3,1.4326329986596191
29742,207-008-2399,3524.0627,10,5,5,1.3093224124883895
29783,703-004-5387,5732.822,6,3,3,1.453995298731604
2985,703-004-5398,7296.5396,4,2,2,0.45974854037296725
30000,703-004-5381,9228.28,3,1,2,0.35831143730785864
30167,703-004-5380,9601.721,7,3,4,0.7403009857618926
30445,207-008-2399,4942.838,4,3,1,0.8505760300827155
30446,703-004-5388,3738.044,5,1,4,0.6343092395342648
30747,703-004-5390,1696.9568,4,0,4,0.27920371738274696
30836,703-004-5397,1217.773,4,0,4,0.27920371738274696
30925,207-008-2399,5269.278,2,0,2,0.27920371738274696
30979,703-004-5394,5629.7305,2,2,0,0.4825909160833105
31162,703-004-5388,9647.738,3,1,2,0.85633763083813
31200,703-004-5386,7167.7666,2,2,0,1.3948607114133842
31503,207-008-2398,4718.671,4,4,0,1.703141820167094
31516,703-004-5397,2881.8618,2,1,1,1.0857247340431133
31909,703-004-5396,6629.3667,7,1,6,0.5501476581262543
31962,703-004-5391,5672.2256,3,1,2,0.5507000578758696
32442,703-004-5390,290.08508,1,0,1,0.27920371738274696
32503,703-004-5383,2419.204,3,2,1,0.8257997199114564
32642,703-004-5386,971.52234,3,2,1,1.631665910972187
32845,703-004-5391,7021.517,2,1,1,0.35831143730785864
32946,703-004-5380,5846.573,3,1,2,0.3733950545929546
33135,703-004-5396,6316.018,4,2,2,1.2199646012069407
33405,703-004-5387,6091.0513,3,2,1,2.091683142460351
33512,703-004-5390,5104.9263,5,2,3,1.192369295744451
33580,703-004-5380,7735.638,6,3,3,1.4953815857783053
3359,703-004-5390,6272.0396,2,1,1,1.5616400985833854
33830,703-004-5380,9309.172,5,2,3,0.5222277781960185
34024,703-004-5380,7780.4673,1,0,1,0.27920371738274696
34273,703-004-5381,9345.306,4,2,2,1.589933610882427
34685,703-004-5393,2819.7205,4,1,3,0.423017723407834
34820,703-004-5391,4942.036,1,1,0,0.7346299376374891
35166,207-008-2399,7472.032,8,3,5,1.5142663947517794
35718,703-004-5387,6494.4707,7,3,4,0.7461830278894066
35926,703-004-5381,9682.716,5,2,3,0.7123915123983159
35978,703-004-5395,7799.5957,3,2,1,0.6073770334938898
36099,703-004-5393,6630.3022,3,3,0,1.0790452936746273
36116,703-004-5383,3466.2515,5,3,2,1.07870150220666
3612,207-008-2399,3553.908,6,3,3,1.2036185837932019
36296,703-004-5389,1021.7607,4,3,1,1.961320087982744
36330,703-004-5391,660.8939,2,1,1,0.46409130112463254
36558,703-004-5382,9402.398,4,1,3,1.782389106898937
3657,703-004-5399,137.51924,5,2,3,1.4927297585867934
36752,703-004-5383,2063.1511,2,1,1,0.4742713062415103
37412,703-004-5388,5175.338,5,2,3,1.0776831329016223
37535,703-004-5399,4360.9663,3,0,3,0.27920371738274696
37587,207-008-2399,1849.3724,"","","",0.27920371738274696
37752,703-004-5388,5795.086,4,2,2,0.5138938665301541
37786,703-004-5389,268.63873,5,1,4,1.450347698150506
37887,703-004-5393,8807.283,2,1,1,0.9111347264314552
3799,703-004-5385,9734.647,3,1,2,0.39369360110248863
38478,703-004-5399,4054.548,3,2,1,0.7248539458419616
38636,703-004-5399,3334.3948,4,4,0,1.4164525630146292
38972,703-004-5383,7045.393,5,2,3,0.4930574787428125
39108,207-008-2398,1973.6755,4,2,2,1.1784368268306076
39550,703-004-5387,3701.306,1,0,1,0.27920371738274696
39942,703-004-5389,6072.9243,5,2,3,0.6513170780189372
39989,703-004-5380,2436.59,2,1,1,1.9633431864769895
40068,703-004-5393,8842.585,3,2,1,0.8388356389205814
40106,703-004-5389,6884.66,1,1,0,0.35831143730785864
40139,703-004-5385,2744.3826,5,1,4,0.43443049524889177
40280,703-004-5389,9802.322,4,2,2,0.6369551126459166
40458,207-008-2399,5628.0547,5,2,3,0.7528805533764222
40743,703-004-5387,2324.5818,4,1,3,0.6732601302081248
4077,703-004-5399,3456.6462,4,2,2,0.703681140146826
40804,703-004-5380,254.02606,5,4,1,1.4630164248666544
4081,703-004-5385,9.38952,1,0,1,0.27920371738274696
41260,703-004-5384,1472.6937,3,1,2,0.6095645847232666
41332,703-004-5386,5846.2383,4,2,2,0.8716465445550411
41721,703-004-5381,2862.8086,3,2,1,0.4827529698579476
41928,703-004-5398,8478.006,7,5,2,1.7204245881253077
4214,703-004-5397,1431.6892,8,5,3,1.5235498414766315
42200,703-004-5386,942.31903,2,1,1,0.4815428375983237
42455,703-004-5398,7214.3994,4,0,4,0.27920371738274696
42689,703-004-5386,3341.7158,1,1,0,1.7974935463727066
42695,703-004-5389,1752.7986,6,3,3,0.7202130551526743
42814,703-004-5395,3489.6982,1,0,1,0.27920371738274696
42945,703-004-5387,4742.65,7,3,4,4.379364564140228
43291,703-004-5386,802.1927,6,2,4,0.6301304296192587
43305,703-004-5396,9386.159,2,1,1,0.5165268771580819
43409,703-004-5387,3480.4011,5,4,1,2.4676905195540084
43455,207-008-2399,2685.0278,1,0,1,0.27920371738274696
43459,703-004-5381,6995.503,2,2,0,0.5877245436263157
43533,703-004-5388,1650.3536,3,3,0,1.5842153958312606
43879,703-004-5381,4402.0176,4,2,2,1.7383683275700443
44331,703-004-5388,1224.1721,3,1,2,0.6041743660034314
44474,703-004-5380,213.75835,4,2,2,1.1288853535994816
44613,207-008-2399,9152.808,4,1,3,0.6878979015973522
44778,703-004-5399,9574.28,4,2,2,1.0832129956713632
4487,207-008-2398,3956.9312,4,2,2,1.002635851072381
44985,703-004-5383,1676.33,4,2,2,0.5344449995849799
45018,703-004-5399,6101.9575,7,5,2,3.0230253358917367
45086,703-004-5382,5147.7827,4,2,2,0.7928011373204373
45592,703-004-5383,2528.8057,2,0,2,0.27920371738274696
45989,703-004-5383,8829.928,3,2,1,0.5436154051513962
4612,703-004-5398,7598.969,6,4,2,0.7919675378455973
46357,703-004-5394,1382.3777,2,1,1,0.8145584768325631
46479,207-008-2398,4584.931,4,4,0,1.1443049458203751
46527,703-004-5388,8374.498,4,2,2,1.1095565148247972
46581,703-004-5389,1780.0074,5,2,3,0.5321836133932603
46804,703-004-5393,6805.926,4,2,2,0.7803720351105203
47387,703-004-5392,6140.7334,4,4,0,0.9063089431905283
48035,703-004-5383,4960.259,7,2,5,0.4965556252529086
48253,703-004-5382,3602.7043,2,2,0,1.091333922823555
48477,703-004-5397,7452.2163,4,1,3,0.3807252912866403
48845,703-004-5394,4258.9707,4,3,1,1.1971858695298372
48871,703-004-5399,6797.9004,1,0,1,0.27920371738274696
49343,703-004-5392,9258.774,5,2,3,1.9136346714732806
49399,703-004-5391,8492.071,5,3,2,1.2802260114987294
49445,207-008-2399,9382.602,3,0,3,0.27920371738274696
49645,703-004-5387,5336.8784,6,3,3,0.7330072864896889
49676,703-004-5387,5610.761,9,4,5,1.6727265898669383
49730,703-004-5396,6874.7695,4,2,2,0.598968566538468
49813,207-008-2399,6291.792,3,2,1,0.676882554824914
5524,207-008-2399,2433.5576,7,4,3,1.4737227724877642
5560,703-004-5380,2009.9706,4,2,2,1.0920440264106404
5765,703-004-5380,2347.901,6,3,3,2.8697098927537428
5780,703-004-5381,4975.9243,2,0,2,0.27920371738274696
6341,703-004-5380,1481.3966,4,2,2,2.8215754027100517
6698,207-008-2398,4495.663,4,1,3,0.41118369875891214
7082,207-008-2398,6861.958,4,2,2,0.9884630854911658
7210,703-004-5382,836.49457,3,1,2,0.5874026032397295
7225,703-004-5393,4297.5557,2,0,2,0.27920371738274696
7359,703-004-5382,2397.288,2,1,1,0.6846307819989441
7538,703-004-5382,3822.813,1,1,0,0.7355606548406979
81,703-004-5398,4198.6406,4,2,2,0.723461780372667
8146,703-004-5385,2690.158,5,2,3,1.2359394749387917
832,703-004-5393,5602.142,7,3,4,2.072172776752991
8384,703-004-5381,3904.7378,1,1,0,0.4710797787821933
8499,703-004-5395,9586.836,5,3,2,2.6513915967210675
8549,207-008-2398,8433.002,2,0,2,0.27920371738274696
8774,703-004-5389,805.4209,4,4,0,1.0459975314980405
896,703-004-5397,8116.761,4,1,3,0.69964576964072
9065,703-004-5389,6144.087,8,4,4,1.8606007947090246
9206,703-004-5393,9349.95,4,1,3,0.36330026154103034
9491,703-004-5382,2005.7142,4,2,2,1.2706237096489288
9694,703-004-5390,5621.8467,3,1,2,0.549462634695568
10056,703-004-5383,5306.1597,3,1,2,1.6481041856703855
10298,703-004-5399,2137.627,3,2,1,0.4948546580535982
10915,703-004-5394,5249.776,5,2,3,0.5927546895465211
10982,703-004-5390,883.4988,2,1,1,1.1592991188835915
1162,703-004-5397,1577.4858,2,1,1,0.45517270641771834
11712,703-004-5399,8790.02,4,3,1,1.1830707450484457
1183,703-004-5389,4327.1064,6,2,4,0.8340144350382072
11909,703-004-5396,2628.5476,2,1,1,0.37175974969512765
12121,703-004-5394,4534.724,5,3,2,1.2612853589103132
12247,207-008-2399,5786.64,5,3,2,2.3173088491815323
12388,703-004-5382,7167.666,2,0,2,0.27920371738274696
12540,703-004-5385,1801.9944,3,1,2,0.8963894067526988
12601,703-004-5398,4094.5935,3,2,1,0.5076684307145303
12817,703-004-5395,5513.429,4,1,3,0.5356267954866918
13040,703-004-5380,8765.617,3,0,3,0.27920371738274696
13351,703-004-5386,7317.6616,5,4,1,0.6222757006571199
13383,207-008-2399,2544.3708,3,2,1,0.7680377968542959
13826,703-004-5397,6773.3813,6,4,2,2.1117776380005897
13857,207-008-2398,2777.9358,6,3,3,2.8448535960561268
1410,703-004-5387,7215.014,4,2,2,0.5632778925176789
14169,703-004-5386,8291.945,2,1,1,0.3429990943339376
14282,703-004-5390,111.75096,4,3,1,1.3892017891603705
14323,703-004-5381,3345.3584,3,2,1,0.7201920131907502
14517,703-004-5387,7004.3804,6,4,2,1.494348220080159
14524,703-004-5387,2099.6326,5,3,2,0.97409177283667
14591,703-004-5386,6366.242,5,3,2,1.1467728719032213
14621,703-004-5390,6744.622,3,2,1,1.2316762611634604
14748,703-004-5393,3346.9587,"","","",0.27920371738274696
1479,703-004-5398,3967.7417,3,2,1,1.022887472232812
15202,703-004-5399,3961.211,3,3,0,1.6304625985167625
15447,703-004-5388,8415.812,4,4,0,1.2768535932618368
15717,207-008-2398,7744.1597,5,4,1,1.206426140368279
15786,703-004-5382,193.90941,4,2,2,1.1625463668672198
15849,703-004-5388,9778.398,1,0,1,0.27920371738274696
15926,207-008-2398,4547.07,3,2,1,0.7606673556434429
16173,703-004-5395,1720.8815,5,1,4,1.8625228030218632
16245,703-004-5395,8520.557,4,2,2,1.1228104238134522
16350,703-004-5380,3120.3657,5,2,3,1.6989774237630975
16635,703-004-5386,3201.4358,4,0,4,0.27920371738274696
16809,703-004-5382,7133.2065,1,1,0,0.4731206927334937
16828,703-004-5389,933.3521,2,1,1,0.47932220388537905
17258,703-004-5397,8400.31,3,2,1,1.1502329003831229
17621,703-004-5390,8384.777,1,0,1,0.27920371738274696
17955,703-004-5381,2230.2288,2,1,1,0.6934346966000844
18148,703-004-5395,8903.253,6,3,3,0.6110051858627052
18331,703-004-5387,9256.217,1,1,0,1.1830611367185606
18585,703-004-5399,7094.3574,3,3,0,1.7669731182372233
18997,703-004-5380,8583.313,4,2,2,1.3551150627130897
19196,703-004-5389,6034.7485,2,1,1,0.5165268771580819
19236,703-004-5381,8168.53,5,3,2,0.7998643996390872
19737,703-004-5396,7146.1177,6,4,2,1.4846898296312074
19838,207-008-2398,3328.2285,7,2,5,0.5682256285743147
20314,703-004-5396,9081.793,6,4,2,1.5577412851589096
20323,703-004-5385,2571.4756,3,2,1,0.8689873766649763
20334,703-004-5382,5018.521,4,2,2,0.9336979352694881
20419,703-004-5393,2523.712,4,1,3,0.3919322182760311
20548,703-004-5390,8803.241,6,2,4,1.030319010766038
20906,703-004-5395,2787.8713,3,1,2,0.3858384517255498
21088,703-004-5383,2143.2507,2,2,0,1.040351697980824
21172,703-004-5387,2749.4485,6,1,5,0.4239533579369963
21666,703-004-5387,1654.6947,2,0,2,0.27920371738274696
21755,703-004-5383,361.34064,4,3,1,1.2236871757409085
21820,703-004-5393,3481.7852,5,2,3,0.8040341576315003
22288,703-004-5398,1496.7013,6,1,5,0.6118672611931708
22538,703-004-5386,1314.7957,4,1,3,0.46779164331076767
22673,703-004-5391,1160.7433,5,1,4,0.43558361091908293
22824,703-004-5393,8174.693,2,1,1,0.3655591877227474
22981,703-004-5395,5343.6357,6,2,4,1.5815646885065167
22998,703-004-5380,6897.44,4,1,3,0.41903591729561857
23440,703-004-5399,759.7679,2,2,0,0.7286487304943227
23449,703-004-5388,9503.655,3,2,1,0.40627049251245756
23717,703-004-5398,9221.061,5,2,3,0.9085942141818408
23951,703-004-5386,6667.589,4,3,1,0.5639915091131489
24056,703-004-5390,703.50525,5,2,3,0.9270355230427281
24106,703-004-5386,9463.228,3,2,1,0.615220041897815
24121,703-004-5386,5836.6274,5,1,4,0.40013676253353453
24346,703-004-5395,3010.9536,4,3,1,1.2982705012585996
24466,703-004-5390,6586.336,3,2,1,1.0814255236465107
24755,703-004-5384,4592.96,3,2,1,0.6124652345019963
24968,703-004-5393,4825.4375,3,2,1,1.2562715945736276
25356,703-004-5386,7856.7217,4,3,1,1.8814655530948943
25458,703-004-5387,6850.9155,3,0,3,0.27920371738274696
2553,703-004-5399,7480.0366,4,2,2,0.7417902964535059
25682,703-004-5381,4082.6177,3,2,1,0.7115862336169693
26103,703-004-5396,7447.3794,4,3,1,0.6779922211136374
26266,207-008-2399,311.85626,6,3,3,1.1202451812930114
26357,703-004-5388,692.3574,2,2,0,0.9636221693615575
2680,207-008-2399,9646.387,5,0,5,0.27920371738274696
26836,703-004-5380,9859.6875,2,0,2,0.27920371738274696
26838,703-004-5388,3024.4463,6,5,1,4.506601565381931
27092,207-008-2398,90.438126,5,1,4,0.6002618639121433
2736,703-004-5388,4016.0095,4,2,2,1.188804435844417
28077,703-004-5381,1628.1062,3,2,1,1.4054327512596316
28154,703-004-5398,2.208352,3,1,2,0.3781236832355317
28378,703-004-5393,4868.0615,4,3,1,1.076646957944004
2861,703-004-5383,8362.391,8,6,2,3.1165950947934298
28735,207-008-2398,2608.2866,5,1,4,0.7141472986360777
29393,703-004-5394,2410.7307,4,3,1,1.3585269186269027
29434,207-008-2399,2938.7068,6,3,3,1.6085287369758283
2944,703-004-5385,2305.1821,"","","",0.27920371738274696
29653,703-004-5380,4607.0386,6,4,2,3.4818964405389505
29905,703-004-5392,8841.403,1,0,1,0.27920371738274696
29953,703-004-5390,8895.923,3,3,0,0.9268727321137692
29991,703-004-5380,8460.654,4,3,1,0.5108763257348596
30087,703-004-5383,1485.2649,1,1,0,0.5528394636282113
3017,703-004-5384,8122.0776,6,4,2,1.236950717260671
30323,703-004-5399,7728.449,6,3,3,2.326617371111993
30360,703-004-5385,6602.038,3,2,1,0.9674913926911398
30927,703-004-5389,4388.8066,"","","",0.27920371738274696
31034,703-004-5383,3945.3154,6,1,5,0.7826675992466757
31123,703-004-5388,4771.849,7,2,5,0.8916820522396863
31411,703-004-5384,8190.8486,7,5,2,1.7714204153558621
31531,703-004-5380,8722.671,7,4,3,1.3201297297997263
31577,703-004-5382,9268.872,7,3,4,0.9142576847370586
31650,703-004-5389,5654.602,3,2,1,1.0090356266494331
3169,703-004-5396,8518.667,4,1,3,0.6798423802306897
31784,703-004-5391,5704.445,7,4,3,1.512660732376347
32025,703-004-5381,7777.532,1,0,1,0.27920371738274696
32029,703-004-5381,9058.521,6,3,3,0.942479735106776
32087,703-004-5380,7845.743,4,1,3,0.3899429675267125
32315,703-004-5398,7637.734,3,0,3,0.27920371738274696
32883,703-004-5394,3718.068,6,3,3,1.3565415213527026
3306,703-004-5383,4381.603,2,0,2,0.27920371738274696
33160,703-004-5380,7693.5874,4,3,1,0.6582301438766267
3319,703-004-5381,1775.052,4,3,1,1.6935598685333426
33253,703-004-5384,1340.1705,4,4,0,1.3971142389770215
33303,703-004-5390,5054.2617,3,2,1,1.5103549148393811
33374,703-004-5399,5626.643,6,3,3,0.6576023110245309
33392,703-004-5395,4986.138,4,1,3,0.7977237540321124
33453,703-004-5384,2104.742,5,1,4,0.3918926644160685
33679,703-004-5392,2943.415,5,1,4,0.46422899733658574
34420,703-004-5396,4546.5835,5,4,1,1.6269939496253119
34470,703-004-5393,2878.0823,5,2,3,0.7459952995758526
34533,703-004-5393,6144.2705,3,2,1,0.8761266424371476
34541,703-004-5380,5843.226,10,5,5,1.6967374213215762
34719,703-004-5383,3979.0576,6,2,4,0.648071723003128
34741,207-008-2399,508.44012,4,4,0,1.690029707049298
34768,703-004-5381,962.13934,7,3,4,1.6161472157422732
35000,703-004-5398,3465.8413,4,1,3,0.4143460722548127
3533,703-004-5385,1081.5913,4,2,2,0.6999801209364352
35376,703-004-5391,8691.904,5,1,4,0.4443496707008324
35402,703-004-5393,3749.1387,3,3,0,1.354755093866485
35499,703-004-5394,2403.6802,5,3,2,1.0547125997564764
35580,703-004-5390,6706.2476,2,0,2,0.27920371738274696
35632,703-004-5383,3504.1487,4,2,2,1.1388104183387588
36076,703-004-5390,453.2993,3,3,0,1.4816619523381094
36552,703-004-5383,2073.8667,3,1,2,0.33853450732658075
3673,703-004-5392,1513.9073,4,3,1,0.9911328162825851
36823,703-004-5399,4898.828,7,3,4,0.9595817031013467
36993,703-004-5385,5448.274,8,4,4,2.6177025179712077
37221,703-004-5385,2364.527,8,5,3,1.6431359633555433
37225,703-004-5380,7442.9946,2,2,0,1.5116689326474388
3735,703-004-5399,589.1252,5,2,3,0.8883184048214815
37437,703-004-5391,1586.6202,1,0,1,0.27920371738274696
37446,703-004-5388,269.64426,4,3,1,0.47962280221199227
37690,703-004-5392,9451.007,3,2,1,1.3093340470109376
37691,703-004-5397,4787.633,4,1,3,0.48144438595595174
37865,703-004-5396,5899.7773,3,1,2,0.46719260648072014
38589,703-004-5385,3938.5598,"","","",0.27920371738274696
38608,703-004-5390,545.1614,3,2,1,0.5327268159461678
38629,703-004-5386,9795.791,2,1,1,0.6393045879086031
38637,703-004-5382,8455.662,3,1,2,0.8406753992436802
38750,207-008-2398,7481.142,6,2,4,0.5856847854463181
38909,703-004-5390,1848.2614,5,4,1,1.7886187238257094
39310,703-004-5380,7063.813,4,3,1,1.4518552534167948
3965,207-008-2399,8961.222,6,4,2,1.0336433213197727
39855,703-004-5388,1175.735,7,5,2,1.4045848093770075
39918,703-004-5386,1986.1733,11,5,6,2.3775779459919972
39944,703-004-5385,5626.1777,3,2,1,1.0200038357300563
40025,703-004-5381,7394.2515,5,4,1,1.5756372591992927
40137,703-004-5396,5005.9404,6,2,4,1.2125115312538441
40143,703-004-5399,4176.168,4,1,3,0.40048191458402593
4017,703-004-5391,3083.628,6,3,3,0.9586220174674746
40303,703-004-5396,1640.0444,3,1,2,0.4813594160320801
40414,703-004-5395,2939.7947,5,3,2,0.6955252513915372
40436,703-004-5399,3207.6902,2,0,2,0.27920371738274696
40556,703-004-5380,4833.882,4,4,0,1.8484157539100567
41318,703-004-5384,3354.8337,4,1,3,1.544717430230927
41527,703-004-5386,9044.04,3,2,1,0.809221736895487
41649,703-004-5393,5849.12,3,2,1,0.7883616000951335
4185,703-004-5384,3501.1936,8,4,4,1.7743109946051219
42105,703-004-5381,3821.631,"","","",0.27920371738274696
42139,703-004-5398,3949.2344,2,0,2,0.27920371738274696
42210,207-008-2398,2275.1921,2,0,2,0.27920371738274696
42532,703-004-5396,640.27783,7,3,4,1.8607636334348523
42535,703-004-5382,1671.142,5,2,3,1.1999123060072772
42952,703-004-5384,1818.8632,5,1,4,0.606548427934778
42991,703-004-5398,4608.786,1,0,1,0.27920371738274696
43900,703-004-5391,6297.635,6,3,3,0.8699067350011738
43926,703-004-5391,7791.921,5,2,3,0.6508108678191895
43993,703-004-5396,7380.3433,3,0,3,0.27920371738274696
44050,703-004-5397,7630.286,5,2,3,0.6184570980251269
44072,703-004-5397,2466.1506,5,4,1,2.701653020201347
44102,703-004-5394,3639.8394,8,4,4,1.3606560984148746
4424,703-004-5384,8205.218,4,3,1,1.6242113259476816
44291,703-004-5382,596.8195,3,1,2,0.8608968313090756
4454,703-004-5399,7733.118,4,1,3,0.5239432259010611
44830,207-008-2399,3035.9995,4,3,1,1.0574233042600134
45010,207-008-2399,9570.512,3,0,3,0.27920371738274696
45016,703-004-5397,3088.5488,4,2,2,0.5633530827945026
45089,703-004-5380,7305.6914,1,1,0,1.304840301458
45380,703-004-5383,8523.548,4,1,3,0.46036576247654626
45663,703-004-5397,8490.686,5,1,4,1.5095689954037097
46036,703-004-5382,4382.0396,2,1,1,0.33853450732658075
46603,703-004-5393,3971.6226,2,1,1,0.677703617982756
46882,703-004-5387,7224.913,10,4,6,1.5671356787938415
47044,703-004-5395,5460.108,5,1,4,1.5654312917057436
47046,703-004-5384,2443.6443,6,3,3,1.2068264221008806
47166,703-004-5398,4752.133,2,2,0,0.5868300863972575
4727,703-004-5396,5592.767,4,2,2,0.8705913034175323
4771,703-004-5398,6931.482,4,3,1,1.0796368626798682
47713,207-008-2398,4605.0107,1,0,1,0.27920371738274696
47715,207-008-2399,6122.0063,4,1,3,0.35831143730785864
4772,703-004-5398,6058.6606,7,3,4,1.2358754382760282
47998,703-004-5387,7099.127,2,2,0,1.3932792558610931
48135,703-004-5380,1142.5209,5,1,4,0.7033787460614012
48343,703-004-5382,4706.9473,4,1,3,2.4098773836981433
48469,703-004-5383,6717.079,6,3,3,1.1121744127903535
48500,703-004-5395,7685.245,3,2,1,0.5758576671019155
48553,703-004-5380,42.792557,2,1,1,0.6995059206414208
48723,703-004-5382,5482.064,5,1,4,0.3468408179187174
48950,703-004-5397,6595.7754,"","","",0.27920371738274696
49242,703-004-5382,4434.502,1,1,0,0.6847210818430677
4927,703-004-5384,3198.25,3,2,1,0.8752715442898767
4947,703-004-5385,692.89386,3,2,1,0.6591324832420761
49657,703-004-5393,8422.776,4,1,3,0.35831143730785864
5330,703-004-5392,7772.303,3,1,2,0.35831143730785864
5357,703-004-5388,8326.59,6,3,3,1.0593256869426835
5438,703-004-5389,8623.275,5,2,3,0.7547836862630952
555,703-004-5389,454.74112,1,0,1,0.27920371738274696
5610,703-004-5397,2780.724,2,1,1,1.0044512127834486
592,703-004-5390,7337.3403,4,2,2,0.808444374379464
5970,703-004-5392,3409.052,5,1,4,0.6479652105284694
6146,703-004-5390,6231.748,3,2,1,0.7375480006861527
6394,703-004-5395,9058.22,3,2,1,1.8041137416772022
6412,703-004-5399,2494.7327,4,1,3,0.9111450355526618
6480,703-004-5397,9314.287,5,1,4,0.4230808829965438
6516,703-004-5384,9940.957,6,3,3,0.9763236280314876
6551,703-004-5396,1277.7526,1,1,0,0.5578994059387561
6673,703-004-5399,4944.244,2,0,2,0.27920371738274696
6697,703-004-5393,2556.147,2,0,2,0.27920371738274696
679,703-004-5399,7491.182,5,1,4,0.6355042422352992
6836,703-004-5386,745.0289,3,2,1,0.486090604923453
7060,703-004-5393,5383.8574,5,2,3,1.5367846097324702
7178,703-004-5380,393.4443,12,3,9,0.47842920346856094
739,703-004-5394,3459.7134,3,0,3,0.27920371738274696
7757,207-008-2398,5534.5205,4,1,3,0.4057167384729818
7997,703-004-5392,6800.0337,6,5,1,3.6162236601672326
8027,703-004-5399,7089.6333,2,1,1,0.4003987141366781
8050,703-004-5383,5212.8804,3,1,2,0.5614303966805735
8096,703-004-5390,1677.0607,3,3,0,0.9895439900089815
8100,703-004-5385,7971.2646,5,2,3,1.689390498581299
8192,207-008-2398,2764.3406,2,2,0,1.0974758771226596
8561,703-004-5387,4278.303,5,2,3,1.3408075710277865
8770,703-004-5399,3447.6692,3,3,0,1.0143496696477543
9046,703-004-5388,9287.469,5,4,1,1.6897524693470223
9411,703-004-5393,2276.1702,4,3,1,1.9487764085151438
958,207-008-2399,908.1232,6,4,2,1.2023680770189473
9793,703-004-5393,6030.3027,2,1,1,0.9207551080515717
10024,703-004-5383,7787.8013,4,1,3,0.40573287857051776
10086,703-004-5387,9459.046,2,1,1,0.45245771687471364
10213,703-004-5388,781.81445,3,1,2,0.6028202149763912
10287,703-004-5384,1417.2709,5,2,3,1.3693705165146597
11295,703-004-5396,5424.912,2,1,1,2.469709945552184
11319,703-004-5395,3925.467,2,1,1,0.5165268771580819
11476,207-008-2398,2075.4397,5,2,3,0.5948800290036057
1186,703-004-5380,6793.9927,6,5,1,1.930575384876495
11994,703-004-5385,3834.4783,1,0,1,0.27920371738274696
12056,703-004-5396,7711.468,5,3,2,2.682937529907061
12102,703-004-5386,2568.746,3,2,1,0.7342575904993559
12630,207-008-2399,3496.5354,2,2,0,0.6110831620606905
12748,207-008-2398,5143.103,2,1,1,0.3797357237536708
12794,703-004-5381,1957.2377,1,1,0,0.35831143730785864
12815,703-004-5387,5317.9897,4,3,1,5.5087418491937985
13179,207-008-2399,8085.6035,2,1,1,0.4827577692150499
1319,703-004-5394,9839.145,4,1,3,1.0062087789610106
13562,703-004-5380,5507.975,5,3,2,0.7298281301954431
13715,703-004-5391,7804.122,5,2,3,0.47769273830356707
13720,703-004-5393,7628.539,4,4,0,0.7737028973243224
13894,703-004-5386,1643.0491,1,0,1,0.27920371738274696
13908,703-004-5391,4475.1357,5,2,3,0.75372572336042
13982,703-004-5383,3929.0696,1,0,1,0.27920371738274696
14475,703-004-5391,7714.7437,3,2,1,0.8096999223927955
14556,703-004-5381,1363.6368,2,0,2,0.27920371738274696
14595,703-004-5395,7214.0366,4,1,3,0.45602516749212313
14709,703-004-5399,5656.5894,4,2,2,0.6422510864566638
14785,703-004-5397,695.3883,5,0,5,0.27920371738274696
14793,703-004-5387,2589.9792,9,2,7,1.4816646092411858
15044,703-004-5383,100.42548,3,1,2,0.7457155384204923
153,703-004-5384,6296.652,4,3,1,1.0657584256770922
15689,703-004-5383,1546.5874,5,0,5,0.27920371738274696
15745,207-008-2398,2474.888,4,4,0,1.414137385811985
16073,703-004-5381,5266.168,5,1,4,0.48788891004036816
16112,703-004-5394,9426.817,4,3,1,1.4690950534567384
16259,703-004-5384,3211.9875,2,1,1,0.594484445333343
16364,207-008-2399,5770.61,1,0,1,0.27920371738274696
16466,703-004-5393,8188.122,4,2,2,1.5127795940439617
16564,703-004-5396,1387.4995,4,0,4,0.27920371738274696
16728,703-004-5381,9250.501,6,1,5,0.6243963195541858
16879,703-004-5390,7807.4463,6,3,3,0.976424649149505
17411,703-004-5387,479.5426,4,2,2,0.9082851662412165
17557,703-004-5398,8033.902,2,0,2,0.27920371738274696
17662,703-004-5396,8214.303,7,5,2,1.739933462810888
17950,703-004-5392,9450.031,2,0,2,0.27920371738274696
17998,703-004-5395,8814.43,4,1,3,0.43335167687941356
18042,703-004-5397,2589.0476,2,0,2,0.27920371738274696
18206,703-004-5394,8464.443,5,1,4,0.7354779640274562
18323,703-004-5387,315.20187,2,2,0,0.9980573954682694
18380,703-004-5386,4851.897,4,2,2,0.4139892667934017
18412,703-004-5397,7852.8364,7,2,5,1.8933236710934596
1914,703-004-5397,4952.875,6,3,3,2.819110469520862
19228,703-004-5390,2739.1487,7,3,4,1.0772799216831799
19522,703-004-5396,462.69952,5,2,3,0.8199394290359412
19567,703-004-5383,2416.5273,8,5,3,1.9338080701553637
19623,703-004-5386,9716.903,5,3,2,1.1417925728770144
19876,703-004-5390,5135.886,8,2,6,0.6914951007608393
20042,703-004-5386,7024.4336,1,1,0,4.354834654222226
20046,703-004-5389,3407.0032,4,3,1,1.4541857684137478
20181,703-004-5393,6441.6836,2,2,0,0.8417869812311944
20264,703-004-5388,1211.9365,4,2,2,1.4789820772650077
20527,207-008-2398,9427.447,7,5,2,1.8495188098743491
2083,703-004-5386,8228.003,4,3,1,2.1136405674805356
20841,703-004-5390,7662.069,1,0,1,0.27920371738274696
20851,703-004-5392,7503.7085,4,1,3,0.5242268215707221
20932,703-004-5384,6415.0063,5,2,3,1.0981290383100841
21162,703-004-5381,1724.031,5,4,1,1.7333052764901336
2132,703-004-5393,1939.1674,3,2,1,1.0288344044720994
21447,703-004-5397,4462.149,5,4,1,2.125092852609068
21494,703-004-5385,4432.688,5,4,1,0.8123087300594201
21554,703-004-5386,8996.149,2,1,1,0.816959024094893
21623,703-004-5380,6935.5063,4,2,2,1.3890566381685066
21909,207-008-2399,1262.6708,6,3,3,1.131256425100915
22333,703-004-5392,3620.292,3,1,2,2.6763262718582537
22876,703-004-5382,7195.161,5,2,3,0.9097519558616272
22882,703-004-5387,2140.4207,5,3,2,1.265190964299922
22916,703-004-5399,4178.95,4,4,0,1.0374775612253524
23353,703-004-5395,9203.702,9,4,5,3.1532478796012215
23386,703-004-5398,341.4154,4,3,1,1.0775007301604826
23553,703-004-5380,536.8781,4,0,4,0.27920371738274696
23665,703-004-5390,4288.9976,3,0,3,0.27920371738274696
23685,703-004-5384,5038.2524,1,1,0,0.6024045472749158
24335,703-004-5385,4615.235,4,2,2,0.6123843562583764
24344,703-004-5398,8615.886,3,3,0,1.2526591337693336
24364,703-004-5396,2873.2585,1,0,1,0.27920371738274696
24859,703-004-5396,3010.3838,6,4,2,0.9860183354607702
24862,703-004-5382,4144.042,3,0,3,0.27920371738274696
24884,703-004-5384,2422.1748,4,2,2,0.6142402363336646
25149,703-004-5381,4568.1626,3,0,3,0.27920371738274696
25226,703-004-5398,5399.9067,5,2,3,0.5799400274536356
25623,703-004-5396,8615.793,9,3,6,1.6404671761378051
25782,703-004-5396,9656.988,4,2,2,0.5596735460672365
259,703-004-5380,7124.964,5,0,5,0.27920371738274696
26097,703-004-5396,9289.961,3,1,2,0.3978652972704144
26141,703-004-5390,4868.7666,8,6,2,2.356427479938043
26216,703-004-5386,3886.9023,1,0,1,0.27920371738274696
26339,703-004-5399,5356.8267,3,1,2,0.7352995532028299
26477,703-004-5387,3481.162,5,2,3,0.5396665649207909
26537,703-004-5388,2196.6143,6,3,3,1.0888748953993395
26611,207-008-2399,1943.1752,4,2,2,1.2722917408595689
26699,703-004-5397,9472.51,3,2,1,0.9103138905973226
27188,703-004-5399,7217.0938,4,2,2,0.7476599437519381
27261,703-004-5390,7257.822,6,4,2,2.727060846744937
27370,703-004-5399,2112.1145,4,2,2,0.43741915723297026
27400,703-004-5394,5683.8037,2,1,1,0.4088955005130789
27416,703-004-5382,2060.8408,3,1,2,0.32666834933781397
27447,703-004-5385,2574.9177,3,2,1,1.3724601077016447
27542,703-004-5393,8072.7896,3,3,0,0.8346304108485629
27933,703-004-5389,8651.74,3,0,3,0.27920371738274696
28770,207-008-2398,8029.8696,3,3,0,1.6639735291172015
28778,703-004-5383,509.54343,3,1,2,0.9037059672150207
28894,703-004-5390,39.022564,3,2,1,0.6908034944867195
28931,703-004-5397,3616.6824,4,2,2,0.9470921543820503
29003,703-004-5385,3985.6035,2,0,2,0.27920371738274696
29868,703-004-5382,2396.7605,7,2,5,1.1805933004934912
30190,703-004-5387,1009.72235,3,0,3,0.27920371738274696
30218,703-004-5380,723.69037,7,3,4,1.000903798178694
30444,703-004-5385,7644.245,2,1,1,0.5141701126753744
30481,703-004-5391,2387.0146,4,1,3,0.32666834933781397
30483,703-004-5397,8883.405,2,1,1,0.32666834933781397
30552,703-004-5388,9583.708,7,5,2,1.0768987821044438
30637,703-004-5398,2778.7966,"","","",0.27920371738274696
30731,703-004-5398,8698.083,3,2,1,1.8776378477940605
30785,703-004-5398,2741.244,7,4,3,1.3437139449391966
31250,703-004-5393,1349.2,4,0,4,0.27920371738274696
31317,703-004-5383,4641.809,4,2,2,1.4263516382227603
31548,703-004-5383,1557.8914,8,4,4,1.3550117261527796
31584,703-004-5397,6731.9893,5,2,3,0.8262507928072965
32191,703-004-5387,6811.642,2,1,1,0.7069756382161494
3269,703-004-5380,2030.0049,2,0,2,0.27920371738274696
32809,703-004-5384,5829.3433,6,3,3,1.4865952427889428
32828,703-004-5393,6111.601,4,1,3,0.7322209971829553
32833,703-004-5388,5746.497,2,1,1,0.5244719591770303
33014,703-004-5385,2403.4124,3,3,0,1.1369983181822796
33027,703-004-5387,1257.993,2,1,1,0.5160465477228625
33273,207-008-2398,4716.543,4,1,3,0.40323068225573316
33577,703-004-5384,3551.3276,3,2,1,0.9268099939443554
33738,703-004-5389,3566.4363,5,4,1,1.5422778886693829
34163,703-004-5381,2516.8884,3,2,1,0.7272881449052313
34236,703-004-5390,6068.445,3,1,2,0.7041893734136642
34247,703-004-5396,1523.6807,4,3,1,1.6847961847030808
34255,703-004-5380,1014.36975,8,4,4,1.587834832280278
34323,207-008-2398,5181.0874,3,0,3,0.27920371738274696
34370,207-008-2398,1730.5052,5,0,5,0.27920371738274696
34833,207-008-2398,5015.946,5,3,2,0.9192172701690633
35015,703-004-5387,5791.447,4,2,2,0.5853866607683219
35284,703-004-5395,930.01245,6,1,5,0.5052994960581642
35625,703-004-5397,8593.393,1,0,1,0.27920371738274696
35642,207-008-2399,9375.703,2,1,1,0.9664045346502461
35782,703-004-5383,7904.6953,4,2,2,2.1492176058468377
35881,703-004-5380,738.96765,4,1,3,0.3716194735788479
35950,703-004-5397,7794.336,7,3,4,0.8538095707132051
36132,703-004-5399,4033.5447,5,3,2,1.61258318341409
36215,703-004-5394,9773.428,5,0,5,0.27920371738274696
36863,207-008-2399,3726.9956,3,2,1,0.5506117549515223
36899,703-004-5390,7234.6904,6,3,3,2.0574729146499027
36970,703-004-5391,8635.052,2,1,1,0.885556949804838
37058,703-004-5390,2036.4297,5,3,2,0.8989996478753485
37296,703-004-5383,2877.4678,1,1,0,0.33853450732658075
37402,703-004-5398,388.36002,5,4,1,1.8810922819922207
37502,207-008-2399,1963.2876,5,4,1,1.9641897556028993
37557,703-004-5387,8.257031,5,2,3,0.8072024045857776
37650,703-004-5397,1350.2806,3,1,2,0.5865030670910293
37830,207-008-2398,9503.829,6,1,5,0.4271826182746608
37903,703-004-5381,6150.472,3,2,1,0.983864481671293
37917,703-004-5382,6870.0195,5,1,4,1.1567227349793145
37936,703-004-5396,6091.3037,6,2,4,0.9818490560976767
38146,703-004-5380,6427.913,2,2,0,0.8259787075023305
38285,703-004-5399,4044.4392,8,5,3,1.6705282353168185
3835,207-008-2399,3683.6462,1,1,0,0.35114230018964543
3862,703-004-5396,9844.395,2,1,1,0.3624893137664036
38796,207-008-2399,5559.5835,5,0,5,0.27920371738274696
38861,703-004-5391,6283.3066,6,6,0,2.7413175705755584
38908,703-004-5386,8791.098,6,2,4,1.2051803055303303
39400,703-004-5380,6085.041,2,2,0,2.254220949224524
39567,207-008-2399,4987.466,7,4,3,1.7159306977810176
39615,703-004-5387,2088.3845,7,3,4,1.2613193019887825
40045,703-004-5384,2994.6458,7,3,4,2.6031727368915543
40374,207-008-2398,1504.6823,7,2,5,0.7538500369334169
40919,703-004-5386,3695.671,2,1,1,0.44305852085286834
41251,703-004-5395,554.20996,4,1,3,0.4042031775578559
42119,703-004-5384,222.2842,9,4,5,1.8741818424437884
42324,703-004-5381,8742.347,8,4,4,1.4502525853498225
42471,207-008-2398,2097.2188,5,1,4,0.756247281917066
42492,703-004-5393,3454.5583,5,2,3,0.48790333223097665
42510,703-004-5389,2744.186,"","","",0.27920371738274696
42838,207-008-2399,4243.3374,3,1,2,0.4669356657754182
42943,703-004-5397,8513.592,5,4,1,1.4870522084689106
43345,703-004-5398,1913.3729,5,2,3,1.3998578443201974
43478,703-004-5391,4089.4265,1,0,1,0.27920371738274696
4367,703-004-5397,6235.3706,2,1,1,0.4266426768825102
43675,703-004-5391,88.89139,1,1,0,0.6190142244760609
44085,703-004-5392,5137.0215,3,0,3,0.27920371738274696
44485,703-004-5391,9848.325,1,0,1,0.27920371738274696
44593,207-008-2399,3308.4387,4,1,3,0.7731444922270264
44648,703-004-5399,9738.194,4,2,2,1.8571865081028383
44695,703-004-5399,3246.361,6,3,3,1.211350140130456
44994,703-004-5389,3912.5293,6,4,2,1.6857398494199523
45020,703-004-5397,3480.0464,10,5,5,1.8056425114800545
45043,703-004-5394,5643.848,1,1,0,3.529565871425462
45251,703-004-5393,4357.7666,1,0,1,0.27920371738274696
45263,207-008-2398,90.453026,3,2,1,1.1906570886358765
45303,703-004-5396,5166.375,"","","",0.27920371738274696
45372,703-004-5393,1995.9879,3,2,1,0.697789991861353
45558,703-004-5384,4604.843,4,4,0,0.8279361639474102
45732,703-004-5388,5008.299,5,2,3,2.607313942695973
4574,703-004-5399,2516.424,5,1,4,0.7172383903668035
45844,703-004-5393,56.961178,4,3,1,0.8502167504259414
46052,703-004-5386,8365.69,4,3,1,1.0038838476743748
46190,703-004-5387,8240.16,6,1,5,0.3978652972704144
47009,703-004-5399,8714.017,3,2,1,0.9548861224530456
47235,703-004-5391,1867.5405,3,2,1,0.7960316498127588
47428,703-004-5387,3383.2312,6,3,3,1.4985782385772342
47466,207-008-2399,4742.539,4,2,2,0.9918745754987244
47590,703-004-5398,7458.723,8,3,5,1.518932007103861
47815,703-004-5386,5631.3438,4,3,1,1.3335734042947085
47920,703-004-5396,830.8631,5,2,3,1.1869485423379085
48,703-004-5387,2632.8533,9,4,5,1.1702992223543882
48141,703-004-5393,5466.284,5,2,3,1.589667175672875
48276,207-008-2398,4339.08,2,0,2,0.27920371738274696
48410,703-004-5392,4164.8735,7,4,3,1.348999156602855
48581,703-004-5384,4464.5737,2,0,2,0.27920371738274696
48879,703-004-5397,5829.679,3,1,2,0.623162601851972
48923,703-004-5396,4688.3633,4,0,4,0.27920371738274696
49023,703-004-5382,973.5221,3,0,3,0.27920371738274696
49461,703-004-5392,4173.16,6,4,2,2.503186646816512
4957,703-004-5386,3280.0298,3,0,3,0.27920371738274696
49655,703-004-5391,1837.7864,5,4,1,1.3294145922319116
49699,703-004-5395,413.5734,4,1,3,0.35831143730785864
49983,703-004-5394,8544.695,3,1,2,0.4686974334387502
5009,703-004-5394,6126.08,3,2,1,0.7386512696312795
5024,703-004-5398,6307.513,2,2,0,0.6144690345829302
5033,703-004-5381,4307.6436,1,0,1,0.27920371738274696
5090,703-004-5386,1532.8151,3,2,1,0.5090691149944303
5915,703-004-5391,9751.415,2,1,1,1.0128271019641044
6031,703-004-5385,7227.911,1,1,0,0.5165268771580819
6215,703-004-5386,4412.8506,3,1,2,0.5669580486103406
6229,703-004-5391,4400.6475,3,3,0,0.8084382353763044
6370,207-008-2398,7468.9453,2,1,1,0.6162830770493672
6815,703-004-5385,4426.1416,6,3,3,1.347511823463384
6973,703-004-5380,2167.9841,9,5,4,2.1225741209944124
7036,703-004-5387,1037.5172,5,3,2,1.1265833005805153
7061,703-004-5383,2952.2812,4,0,4,0.27920371738274696
7393,703-004-5386,5389.5693,4,2,2,1.430924149656251
7456,703-004-5385,5873.603,4,3,1,0.9569426561142416
7706,703-004-5385,1784.2894,5,5,0,1.0892427470871906
7759,703-004-5390,7634.7197,5,2,3,0.5877942136748379
7776,703-004-5399,6044.813,5,4,1,1.928841572618698
7965,703-004-5386,7173.908,5,2,3,1.205522308883003
7982,703-004-5396,7399.2886,1,1,0,0.7519896371215801
8171,703-004-5394,8029.2583,3,3,0,0.9145473255151156
8385,703-004-5380,3703.6938,6,2,4,0.8453291651378861
8392,703-004-5397,1917.0648,2,2,0,0.7422452800584763
8406,703-004-5396,8232.593,4,3,1,1.507879657972339
8452,703-004-5387,6631.896,2,1,1,0.5128489723563867
9203,703-004-5386,2984.823,2,1,1,0.38654135677863444
9435,703-004-5399,6535.803,4,2,2,0.7785356690691336
9854,703-004-5395,2290.9749,6,2,4,1.0095383307187797
9907,207-008-2398,7339.311,2,2,0,0.9540011605072891
9924,703-004-5381,75.988174,3,3,0,1.9026892663667567
10026,703-004-5381,2867.285,6,0,6,0.27920371738274696
10640,703-004-5396,4014.3096,5,3,2,0.7404208442375456
10747,207-008-2399,9150.272,5,2,3,0.5191027725787688
10781,703-004-5399,3834.843,4,3,1,0.8523613937673048
11123,703-004-5399,112.97107,2,0,2,0.27920371738274696
11425,703-004-5386,6720.1562,4,3,1,1.0947740555078544
11564,703-004-5393,766.32855,4,1,3,0.4032545106903127
11662,207-008-2398,7490.7334,4,2,2,1.2677913964593694
1225,703-004-5380,9691.722,3,2,1,1.5984333304206642
12421,703-004-5388,7202.276,7,5,2,1.362335595918329
12593,703-004-5385,7621.536,5,3,2,1.6930009708714788
12616,703-004-5384,4222.3037,3,1,2,0.4505378541205513
12739,703-004-5384,7984.56,3,1,2,0.5117668085235929
13049,703-004-5386,1831.938,4,1,3,0.4388242947175104
13050,703-004-5397,1541.4602,1,0,1,0.27920371738274696
13173,703-004-5397,6137.449,2,1,1,0.5232253656200736
13234,703-004-5389,4674.699,2,1,1,0.3980880894556764
13723,703-004-5394,8592.75,2,1,1,0.8603117238604796
1390,207-008-2398,7596.195,"","","",0.27920371738274696
13943,703-004-5384,8420.573,1,1,0,0.546619164857285
14209,703-004-5388,6402.374,4,3,1,1.8735237221527665
1430,703-004-5388,2204.1987,4,1,3,0.47122093831240885
14447,703-004-5390,5239.8877,2,0,2,0.27920371738274696
14466,703-004-5398,5885.1753,7,4,3,2.001710863117593
14512,703-004-5386,8640.685,7,2,5,0.7152850234699248
14864,703-004-5397,9760.689,3,1,2,0.5680650990546869
15491,207-008-2398,6563.021,3,0,3,0.27920371738274696
1581,207-008-2399,2294.7627,5,3,2,2.562989104998335
15835,703-004-5398,3833.908,4,2,2,1.127117974715235
15981,207-008-2398,6376.92,4,2,2,0.4664860386695502
1640,703-004-5397,1365.5961,5,0,5,0.27920371738274696
16418,207-008-2399,7190.951,7,5,2,1.206491026360544
16685,703-004-5399,2805.015,7,3,4,1.0397555356398454
16824,207-008-2399,5582.402,2,1,1,0.5723559891852239
16852,703-004-5384,4400.1133,6,3,3,1.7304684497144427
16919,207-008-2398,7434.2573,3,2,1,0.779394055423756
17316,703-004-5380,3522.2573,6,4,2,2.68874335150732
17407,703-004-5390,2801.258,3,2,1,1.2935419704938982
1768,703-004-5381,5006.336,8,5,3,1.3826928627065858
17726,703-004-5380,9275.431,2,1,1,0.3750751322628224
17742,703-004-5389,5812.74,3,3,0,1.5990601657221752
17915,703-004-5380,7359.182,3,1,2,0.35403686578808374
18186,703-004-5394,6200.137,5,3,2,1.4909799852538412
18256,703-004-5392,7427.784,2,0,2,0.27920371738274696
18651,703-004-5397,7084.0835,4,2,2,0.6541934084391402
18796,703-004-5393,3981.7144,7,2,5,0.9929174777979933
1881,703-004-5391,3953.008,5,4,1,1.7657646196965529
19324,703-004-5387,777.1343,3,2,1,0.647991761740641
19466,703-004-5388,2802.526,3,2,1,0.6627716219052616
19531,703-004-5389,7345.7373,2,1,1,0.4314860782385869
19585,703-004-5387,7059.4424,3,1,2,0.5273325459308983
19637,703-004-5384,6797.9473,9,4,5,1.1641656759235959
19719,703-004-5383,6755.5244,3,3,0,3.3880377539672737
19735,703-004-5384,4567.09,3,2,1,0.7390140382828777
1980,703-004-5394,1327.2345,6,3,3,1.2567151271630974
19912,703-004-5399,4568.1685,2,1,1,0.9379566573993611
19993,703-004-5380,2399.5178,7,2,5,0.5034932638697361
20120,703-004-5391,5075.957,7,4,3,1.975515292357811
20392,703-004-5396,1824.6537,5,2,3,1.081555629696214
20570,703-004-5388,4724.9756,3,1,2,0.45489651640166084
20630,703-004-5383,3913.824,5,2,3,0.7979986440935444
20793,703-004-5399,3003.965,3,0,3,0.27920371738274696
21215,703-004-5381,4220.5737,3,1,2,0.7771477669887165
21685,703-004-5385,4098.3057,4,1,3,0.9225479316063482
217,703-004-5394,5567.8486,1,1,0,0.589891767495719
21899,703-004-5396,5851.0,4,2,2,0.7172307591087299
22007,703-004-5387,3569.849,2,2,0,2.1536077757177825
22017,703-004-5392,7723.34,7,4,3,1.3394131428311324
22369,703-004-5396,8188.9756,3,2,1,0.7858760943038862
22387,703-004-5398,6431.271,1,1,0,0.5854777353583708
22783,703-004-5397,5030.04,3,3,0,2.1586983967102302
23009,703-004-5394,3120.3062,7,2,5,1.2808175318659831
2302,703-004-5380,3174.7622,3,1,2,0.3978652972704144
23091,703-004-5394,3434.2563,5,4,1,1.6065775837336338
23453,703-004-5398,6880.121,1,0,1,0.27920371738274696
23573,703-004-5386,1268.2843,2,1,1,0.7182515629671166
23880,703-004-5381,3609.4583,4,0,4,0.27920371738274696
24069,207-008-2399,9473.845,7,4,3,1.446496372393376
24203,703-004-5397,5253.628,4,1,3,0.4653390842532737
24209,703-004-5399,1054.0908,4,3,1,1.0362773382685253
24291,703-004-5388,755.167,2,1,1,1.0907279600215267
24468,703-004-5396,7676.4517,6,3,3,1.171744481386638
24605,703-004-5399,2998.5981,4,0,4,0.27920371738274696
24682,703-004-5392,9007.375,3,2,1,0.8585555243767408
24683,703-004-5383,3747.0967,3,1,2,0.9952910504757129
24796,703-004-5398,8636.832,2,2,0,1.1386013913464175
24952,703-004-5399,7525.257,5,2,3,0.7777486648720549
24954,703-004-5386,3831.6184,6,2,4,2.586955646592597
25629,703-004-5398,8914.591,1,0,1,0.27920371738274696
25651,703-004-5384,6982.0303,5,2,3,1.2517034510488103
25810,703-004-5395,4637.734,1,1,0,0.4979399020573739
26193,703-004-5391,5781.7793,4,1,3,1.1624943458298966
2624,207-008-2399,8129.698,5,2,3,0.6114240354994276
26503,703-004-5399,2008.8857,4,2,2,1.2306377199720173
26655,703-004-5382,6938.695,5,2,3,0.616453945375738
26667,207-008-2398,9040.524,1,1,0,1.0139280104924682
26882,703-004-5387,63.762665,4,2,2,0.5962501594451989
27301,703-004-5382,2055.2861,2,1,1,0.7579114767166969
27425,207-008-2399,1705.9272,1,1,0,1.894092669221703
27454,703-004-5384,3620.3503,3,1,2,0.32666834933781397
27460,703-004-5382,2246.3762,9,8,1,2.086937121539469
27684,703-004-5381,1164.85,6,3,3,1.3282798475905098
27846,703-004-5393,1629.8336,3,2,1,2.2592760487033416
27851,703-004-5398,3226.521,3,3,0,2.386700780037244
28487,703-004-5390,2292.9817,4,2,2,0.6784585515595988
28549,703-004-5381,3868.7712,5,1,4,0.8425071985737592
28915,703-004-5389,4126.637,5,2,3,0.8914743789319518
28943,703-004-5385,4452.3823,6,3,3,1.6026010927849157
2912,703-004-5399,5036.308,2,2,0,0.7062814894107305
29265,703-004-5383,760.1666,5,4,1,0.9278636304009719
29372,703-004-5390,5667.854,4,2,2,0.8599884866825261
30053,703-004-5387,2737.2097,4,3,1,1.1908499387930547
30204,703-004-5396,3812.678,3,0,3,0.27920371738274696
30325,703-004-5385,5163.9985,3,1,2,0.39487996712109236
30337,703-004-5397,7975.192,5,3,2,0.9903778171119678
3062,207-008-2399,133.47566,3,2,1,0.8366339159609018
30821,703-004-5389,5940.6533,5,3,2,0.7778293227439984
31082,703-004-5393,1640.538,5,2,3,2.2721911066179405
31252,207-008-2398,1418.6096,4,2,2,0.7687624466314544
31342,703-004-5386,3063.525,5,1,4,0.47794976332433803
31450,703-004-5392,875.36993,6,3,3,0.9537122200309447
32562,207-008-2399,6430.7563,"","","",0.27920371738274696
32570,703-004-5380,6900.638,6,3,3,1.1606733447455908
32816,703-004-5382,8223.725,3,2,1,1.1976280684817489
33131,703-004-5391,8285.364,3,2,1,1.1604803026147625
33188,703-004-5397,2459.274,2,0,2,0.27920371738274696
33192,703-004-5384,9073.617,6,4,2,2.6625992086377006
33518,703-004-5391,94.12408,4,2,2,0.8682415170675766
3362,703-004-5394,1442.9319,6,4,2,0.7996819455729243
33764,703-004-5394,5012.1807,7,4,3,1.8500273811532175
33826,703-004-5387,4403.2305,4,2,2,0.7290472020286051
33952,703-004-5388,3823.8215,8,4,4,0.8417421062013264
33960,703-004-5398,2073.1694,6,4,2,1.3979914754100549
34220,703-004-5392,8297.053,3,3,0,1.747313029387478
34301,207-008-2399,5268.8896,"","","",0.27920371738274696
34462,703-004-5397,4238.7666,4,1,3,0.3587761951624187
34507,703-004-5398,7466.796,3,0,3,0.27920371738274696
35161,703-004-5398,9123.302,2,1,1,0.43315269660888417
35466,703-004-5391,7555.474,4,3,1,1.7022299680980482
35734,703-004-5387,4468.2954,7,3,4,1.0146747361346646
3598,703-004-5380,679.5079,6,2,4,0.6271413556310708
36058,703-004-5381,2584.1384,8,4,4,2.111913218605875
36123,703-004-5394,6245.5503,4,3,1,1.4644440425653884
36232,207-008-2399,1217.6979,2,0,2,0.27920371738274696
36446,703-004-5386,7906.583,5,3,2,1.6472819787819593
36739,703-004-5381,8713.164,1,1,0,0.5366812593257505
36789,703-004-5395,7571.5024,5,3,2,1.690432901018124
36829,703-004-5383,7427.967,3,3,0,3.706562161320555
36886,703-004-5399,5441.5645,7,3,4,1.0525311463938742
37087,703-004-5392,4142.943,5,2,3,0.4942936620223567
37300,703-004-5384,7592.196,4,2,2,2.3063091421667066
37478,703-004-5380,205.87683,5,4,1,0.9088074318621644
37759,703-004-5399,1002.53644,4,3,1,0.7612192131717774
3792,703-004-5399,8669.13,6,3,3,1.1918547742651804
3820,703-004-5392,1606.9764,5,2,3,1.3268087464291807
38208,703-004-5395,1150.8185,5,1,4,0.6224440375435054
3869,207-008-2399,7933.2427,4,1,3,0.33853450732658075
38941,703-004-5395,5459.509,3,2,1,0.5618957558924563
39235,703-004-5392,7794.724,5,1,4,0.39977706716860467
39455,703-004-5384,3054.698,2,1,1,0.8248202912070378
39561,703-004-5391,1744.3263,4,1,3,0.3978652972704144
40016,703-004-5384,1587.658,8,5,3,1.388089008410308
40334,703-004-5392,8058.9263,4,2,2,0.8613200695135057
40667,703-004-5393,2022.7498,3,2,1,0.7261625214946252
40697,703-004-5397,1136.108,5,4,1,1.5165246630057418
40817,703-004-5398,6880.987,6,3,3,0.79841913177452
41003,207-008-2398,3997.637,1,1,0,1.0648444055226725
41250,703-004-5396,1388.4711,4,2,2,0.7093148595002408
41263,703-004-5397,6638.4404,5,3,2,1.3998101244016217
41292,703-004-5382,5149.2666,5,4,1,1.6735814025260032
41783,703-004-5388,2540.3064,3,3,0,0.8990102641533042
41954,703-004-5387,9123.739,1,0,1,0.27920371738274696
41987,703-004-5391,9085.263,6,2,4,0.7821879382209193
42193,703-004-5382,789.79315,"","","",0.27920371738274696
42574,703-004-5391,5623.665,2,0,2,0.27920371738274696
42690,207-008-2399,5960.9453,3,1,2,0.9751265142753854
43090,703-004-5396,1488.4781,3,3,0,1.5996098906588267
43337,703-004-5391,7779.7554,11,6,5,2.0335471570104042
43627,703-004-5392,8958.587,2,0,2,0.27920371738274696
44428,703-004-5384,9050.935,5,2,3,0.6870006046547089
44749,703-004-5382,5380.283,1,1,0,0.6681491291346684
44981,207-008-2398,6409.5913,6,2,4,1.0391299027357144
45107,703-004-5389,5363.822,4,3,1,0.8336055445280527
45143,207-008-2398,4590.851,5,2,3,0.8578253502032352
45212,703-004-5383,9458.523,1,0,1,0.27920371738274696
45225,703-004-5383,9090.882,6,5,1,1.2967626488464437
45603,703-004-5394,4776.3325,3,3,0,1.445687065440671
45812,703-004-5382,3896.6597,2,2,0,0.5360393903137405
45857,703-004-5394,3423.9202,1,0,1,0.27920371738274696
45862,703-004-5394,6334.194,5,1,4,0.4253093591848614
45935,703-004-5393,1773.0159,8,3,5,1.4235512103852175
46106,703-004-5382,4241.9795,5,2,3,0.46975332530004826
46138,703-004-5381,550.48706,7,3,4,1.2299603528323098
46179,703-004-5382,7775.0635,3,2,1,1.2293636160657029
46397,703-004-5383,7013.8687,1,0,1,0.27920371738274696
46532,703-004-5383,3508.6567,6,3,3,1.190918667014524
46968,703-004-5382,5431.0938,4,1,3,1.1695060146256826
47086,207-008-2398,6454.1147,3,1,2,0.4751325060481747
4715,703-004-5396,9453.807,3,1,2,0.6072239099831951
47277,703-004-5388,6483.823,3,2,1,0.47103993820114265
48056,703-004-5387,6580.681,3,2,1,1.1575656627067774
48643,703-004-5396,237.54477,3,2,1,0.55873324628488
48645,703-004-5394,9856.477,4,2,2,0.5299241646637898
49668,703-004-5395,459.19955,4,3,1,1.550804666565427
500,703-004-5391,6938.525,5,4,1,1.063834940078125
5225,207-008-2398,1917.4391,5,3,2,1.039350114544649
5736,703-004-5398,2589.3967,1,0,1,0.27920371738274696
5930,703-004-5395,3742.7449,6,3,3,1.120213773869151
6274,207-008-2398,5923.5103,6,4,2,1.5861827470504526
6519,703-004-5380,1938.7233,4,3,1,0.8375231363302461
6598,703-004-5382,9895.156,5,5,0,1.0841043790645586
6828,703-004-5380,2042.8008,3,2,1,0.9900110044889451
6932,703-004-5399,2204.4229,4,2,2,0.5758576671019155
6953,703-004-5399,5847.19,2,2,0,0.5626472664735286
7074,207-008-2399,8562.288,5,2,3,1.0889377264546591
7226,703-004-5398,7549.034,1,1,0,0.44421165297112447
7454,703-004-5390,7170.1177,9,7,2,3.3305669733767793
7571,703-004-5399,3708.3035,4,1,3,0.7170449484555289
7810,703-004-5382,237.27954,1,0,1,0.27920371738274696
7848,703-004-5393,3444.438,6,1,5,0.7619652753732061
8014,703-004-5396,6931.033,4,1,3,0.3868302342462827
8117,207-008-2398,7433.9307,3,1,2,0.45270177987600274
8195,703-004-5383,7648.863,4,3,1,0.9451333801535777
833,703-004-5391,6242.3037,2,0,2,0.27920371738274696
8886,207-008-2399,5101.9697,2,2,0,0.6203505887166395
8981,703-004-5398,3633.8872,4,0,4,0.27920371738274696
8983,703-004-5396,1338.6935,5,4,1,2.014300114057537
9064,703-004-5399,6994.9824,5,2,3,0.5027880244160766
9268,703-004-5388,483.69647,7,3,4,0.9846650762305387
9309,703-004-5380,3669.4438,4,4,0,1.1169953796749128
9327,703-004-5384,7206.853,7,4,3,1.4885096667597444
9463,207-008-2399,1716.6621,3,1,2,0.35955511568793774
950,703-004-5397,6465.8047,7,3,4,1.00535922656538
9584,703-004-5390,1281.423,3,2,1,1.0713269410229105
9801,703-004-5380,6153.889,3,2,1,0.8958093468763838
9803,703-004-5394,1803.9125,4,3,1,0.9311348691793254
9879,703-004-5384,9021.372,3,2,1,0.6542838245775475
9885,703-004-5380,6362.1934,6,2,4,0.9149576673846834
10081,703-004-5393,2275.6548,5,1,4,0.6142076417111215
10439,703-004-5386,1552.0054,5,3,2,1.8965627468848703
10536,703-004-5389,25.256275,3,2,1,0.6479902276409352
10686,703-004-5382,4908.3228,4,1,3,0.5745701234974756
1081,703-004-5381,4215.3174,4,2,2,1.1146845450401819
10909,703-004-5391,5331.715,3,2,1,0.5589885358042459
10963,703-004-5390,5373.722,9,4,5,1.7917067225143979
11397,703-004-5387,6112.328,6,4,2,1.3305075024046227
11882,703-004-5388,3550.8914,3,2,1,0.4915495037524283
12150,703-004-5395,1724.183,4,3,1,2.3221172054119394
1221,207-008-2399,2948.4724,3,0,3,0.27920371738274696
12358,703-004-5392,9965.93,5,2,3,0.9094355689065268
12393,703-004-5384,830.19434,2,2,0,0.6144938054099496
12554,207-008-2399,4986.1323,2,0,2,0.27920371738274696
1332,703-004-5382,3065.2363,2,2,0,0.7501728629932414
13692,703-004-5387,2997.4937,1,0,1,0.27920371738274696
13970,703-004-5394,6342.2173,5,1,4,0.3815528334856319
1411,703-004-5380,163.95807,2,1,1,0.3978652972704144
14181,703-004-5384,3277.353,5,2,3,2.1970913951532682
14207,703-004-5395,7860.2344,3,2,1,0.8670308802888353
14399,703-004-5389,9272.466,1,1,0,0.3131070259220805
14436,703-004-5393,419.63458,3,1,2,0.36892969366608885
14457,703-004-5386,2971.7666,4,2,2,2.565840634659123
15106,703-004-5385,8418.103,2,1,1,1.0405702947141997
15130,703-004-5384,8253.057,3,1,2,1.005133766108695
15175,703-004-5397,6907.5103,4,1,3,1.5607246834106472
15437,703-004-5390,5304.1245,3,1,2,0.3978652972704144
15504,703-004-5395,8208.758,4,4,0,1.7198255410834078
15564,703-004-5391,3696.9673,2,2,0,0.7675353644390828
1575,207-008-2398,4631.8013,7,6,1,2.7808548908091266
1602,703-004-5383,4510.3135,5,2,3,0.6076836698827323
16279,703-004-5392,9975.244,3,3,0,1.0930316959184836
16404,703-004-5398,8748.167,5,1,4,0.36593428997378474
17027,703-004-5382,5732.1104,2,0,2,0.27920371738274696
1724,703-004-5382,1150.7213,4,2,2,0.39666419212353066
17398,703-004-5382,6266.3706,1,1,0,0.5367614642461369
17708,703-004-5391,2816.9614,7,2,5,0.4855131432475464
17738,703-004-5390,4782.14,5,2,3,0.5919796191125621
17788,207-008-2399,8184.218,2,2,0,1.1850542939602422
18090,703-004-5386,2586.7666,3,1,2,0.4642357900341236
18271,703-004-5383,4871.245,3,1,2,0.48520085299048454
18341,703-004-5386,6319.961,4,2,2,1.1994754909118281
18434,703-004-5385,4025.8079,2,2,0,0.7936152123188698
18566,703-004-5394,5220.99,2,1,1,0.43065382155693077
18568,703-004-5389,1474.7769,6,3,3,1.271573725985495
18652,703-004-5390,8354.337,1,1,0,0.35831143730785864
18697,703-004-5380,3914.826,7,2,5,0.5342511129057521
18957,703-004-5380,4966.542,3,2,1,1.7761637926359863
1907,703-004-5390,6902.0947,5,3,2,0.769203186195305
19291,703-004-5399,8009.4414,4,3,1,2.0628030262109065
19392,703-004-5394,7696.322,5,4,1,3.3684110322077228
19431,703-004-5394,5708.5483,8,5,3,1.573934895601681
19632,703-004-5394,8146.4077,4,1,3,1.0144051999590098
20335,703-004-5399,4382.615,4,3,1,0.5433741420115415
20430,703-004-5398,8517.913,3,1,2,0.6924048153817374
20446,703-004-5393,5595.347,6,2,4,0.7258122570618633
20476,703-004-5395,8957.361,4,1,3,0.36010784178115807
2052,703-004-5387,7487.066,3,1,2,0.34693970256862383
20659,703-004-5382,9542.961,2,1,1,1.2414175624998807
20681,703-004-5397,9118.702,2,2,0,0.5728106310453072
21563,703-004-5397,2926.6333,6,4,2,1.0309177530209064
21682,703-004-5382,3269.3816,7,6,1,2.0300808588125805
21727,703-004-5387,4506.25,6,5,1,2.872177435156608
22240,703-004-5380,1751.1755,2,1,1,1.162591410852385
22987,703-004-5380,2922.0813,4,2,2,1.5712807624934515
23524,703-004-5394,4512.3643,5,1,4,0.5781507056482826
23611,703-004-5384,1075.9926,4,4,0,1.8351325382763992
23620,703-004-5388,894.56024,4,2,2,0.7235654833484695
23634,703-004-5388,4775.7603,4,2,2,0.5956345970831934
23655,207-008-2399,4701.3887,3,0,3,0.27920371738274696
24141,703-004-5392,4185.8164,6,4,2,1.0558851641310938
24289,703-004-5383,642.6734,6,4,2,1.2347177921500352
24397,703-004-5399,9237.118,6,4,2,1.8654481892651076
24617,703-004-5386,4697.3525,3,3,0,0.7697307720907929
24904,703-004-5395,2760.2148,4,2,2,0.9395956767160791
25236,703-004-5382,2503.5762,2,2,0,0.5317244049455775
25406,207-008-2398,9445.541,1,0,1,0.27920371738274696
25506,703-004-5381,8722.238,6,4,2,1.2790698142015204
25625,703-004-5396,1423.4155,5,3,2,1.2730333266557168
25768,703-004-5394,6747.9087,4,3,1,1.1739762474826285
26045,703-004-5383,3360.8545,3,2,1,2.3328702440227094
26054,703-004-5393,8410.456,2,0,2,0.27920371738274696
26057,703-004-5386,388.50723,3,0,3,0.27920371738274696
26249,703-004-5385,7301.355,7,3,4,0.6995272962889036
26633,703-004-5385,8763.169,5,2,3,0.5114040358622474
26759,703-004-5382,1841.8175,1,0,1,0.27920371738274696
26962,207-008-2399,12.542009,4,3,1,4.893874439625739
27152,703-004-5388,1583.327,7,3,4,1.1185292920224814
27172,703-004-5385,3792.578,1,1,0,0.46724258803091884
27539,703-004-5387,7951.012,5,2,3,1.9135266560568327
27724,703-004-5399,1318.7336,5,3,2,1.1774052773829853
27733,703-004-5393,4487.5664,5,3,2,1.2659637288119368
27756,703-004-5399,7001.5244,5,1,4,0.40944862182850106
28376,703-004-5389,8157.949,2,1,1,0.3843277781829389
28384,703-004-5396,9880.3,3,2,1,1.5001228881570012
28432,703-004-5387,2355.1064,4,2,2,0.9394404135870719
2858,703-004-5395,771.53625,4,1,3,0.4337975069301488
28815,703-004-5395,8822.634,6,1,5,0.9090826703546697
28984,703-004-5394,4898.1743,6,1,5,0.4819172496908456
29103,703-004-5393,1153.2957,5,1,4,0.33853450732658075
29762,703-004-5389,2626.3994,3,1,2,1.1019129230742517
29904,703-004-5394,8764.676,5,2,3,2.5954467705207778
30121,703-004-5395,7718.023,5,0,5,0.27920371738274696
30152,703-004-5380,1237.2064,5,1,4,0.40358742234499756
30178,703-004-5381,1602.8165,7,2,5,0.6124449875672797
3028,703-004-5392,2056.042,8,3,5,1.693432996787912
30335,703-004-5388,6144.774,4,2,2,1.5166447119019912
304,207-008-2398,6741.27,6,3,3,1.227742533325091
30442,703-004-5399,3280.734,2,1,1,1.638550769516246
30462,207-008-2398,6600.402,3,1,2,0.46265891680404425
30598,703-004-5386,8846.297,4,2,2,0.8152586036793238
30868,703-004-5388,9353.89,2,1,1,0.8740591335287929
3101,207-008-2398,4138.5127,4,2,2,0.5318365942698309
31243,703-004-5382,1258.5521,8,4,4,1.3200831353444096
31414,703-004-5392,5246.547,2,1,1,0.3978652972704144
31449,207-008-2399,8214.269,3,2,1,0.9050131241060765
316,703-004-5388,735.66614,4,1,3,0.5114678943166849
31875,703-004-5389,459.13757,3,2,1,1.8286520833047486
31915,703-004-5393,3035.8105,5,3,2,0.921124021105137
31951,703-004-5386,7908.314,3,2,1,0.8511805012237733
32208,207-008-2399,4197.622,6,4,2,1.978601478708725
32271,703-004-5389,2164.1248,3,2,1,1.9586858117265922
32312,703-004-5382,5914.0747,7,3,4,1.3871634198761003
3234,703-004-5386,3160.8975,4,3,1,1.3301450802567265
32581,703-004-5388,8548.161,3,0,3,0.27920371738274696
32583,703-004-5382,5192.7847,1,1,0,0.5343878737787008
32835,703-004-5399,3336.1895,2,2,0,1.0462684634439408
32860,703-004-5385,5791.061,3,2,1,0.5103515307714279
33369,703-004-5396,6412.8643,5,3,2,1.1433386552497224
33394,207-008-2399,6551.864,8,3,5,1.2546788229173211
33395,703-004-5391,463.3045,3,2,1,0.7069198832187442
33409,703-004-5380,6556.7446,6,4,2,1.4781282598697154
33900,703-004-5395,8893.852,3,0,3,0.27920371738274696
3392,703-004-5389,4252.385,4,2,2,0.7097341204479601
33983,703-004-5399,2716.6628,5,1,4,0.9427145097040841
33987,703-004-5389,1916.7167,5,3,2,1.6947919808044174
34114,703-004-5385,932.6732,6,5,1,3.1767053235270213
34191,703-004-5383,8479.067,5,3,2,1.7877567159488572
34503,703-004-5395,1445.3965,4,1,3,0.4105526104831779
34545,207-008-2398,2967.282,2,1,1,0.35534489781066697
34566,703-004-5387,1859.104,3,1,2,0.43786697040114747
34675,703-004-5380,3472.0564,2,0,2,0.27920371738274696
34965,703-004-5396,7151.351,5,4,1,1.920175865040159
35204,703-004-5399,2020.7173,6,2,4,1.3424052206990003
35649,703-004-5389,5461.619,3,3,0,0.6750109907185505
35728,703-004-5396,569.57245,1,0,1,0.27920371738274696
35775,703-004-5398,943.02057,4,3,1,1.3886394591576157
35832,703-004-5387,5374.034,3,1,2,0.36010784178115807
35957,703-004-5391,9503.565,4,2,2,0.5006369052270316
36023,703-004-5388,414.6439,2,2,0,0.5360738647776664
36381,703-004-5397,8422.3545,3,2,1,0.7155105016249848
36484,703-004-5381,186.58041,2,1,1,0.9797586029272898
36498,703-004-5382,640.9496,"","","",0.27920371738274696
37027,703-004-5381,8343.915,6,2,4,0.917360372776321
37308,703-004-5394,6622.676,2,1,1,0.4171842408497167
37457,703-004-5388,5211.2124,3,2,1,0.6342462472539692
37793,703-004-5386,2999.863,2,1,1,1.7998094611125819
37923,703-004-5387,8642.807,7,3,4,0.8969427608387847
38116,703-004-5382,6982.6577,5,4,1,0.9945349492744228
3822,703-004-5381,1226.139,4,3,1,0.822468322482129
38403,703-004-5392,1488.3286,1,0,1,0.27920371738274696
38459,703-004-5389,484.4588,7,1,6,0.5705909212908779
38824,703-004-5389,152.03654,6,3,3,1.7499929639584826
38955,703-004-5384,9597.433,5,3,2,0.8730830389842239
39036,703-004-5394,3992.0354,2,1,1,0.44889223285844576
39089,703-004-5385,935.5229,1,0,1,0.27920371738274696
39387,703-004-5399,3134.7107,3,1,2,1.1946406653132098
39461,703-004-5384,1157.5865,5,2,3,0.8677638067944504
39482,703-004-5384,6063.402,7,4,3,1.0589898843159231
39772,703-004-5388,4063.4106,2,1,1,0.9109623991042474
39960,703-004-5397,6428.441,"","","",0.27920371738274696
40017,703-004-5399,2196.7454,6,3,3,1.2298448511655722
40131,703-004-5389,1343.0042,3,1,2,0.33816665642892896
40193,703-004-5388,6559.0317,5,2,3,0.9325264839766259
40230,703-004-5399,2349.3594,3,2,1,0.6026304964580154
4042,703-004-5385,797.9929,4,3,1,0.9370404325446416
4068,703-004-5399,7447.008,5,2,3,1.6486970434131887
40936,703-004-5397,734.3191,2,0,2,0.27920371738274696
41034,703-004-5386,8582.487,3,2,1,1.4653635728991743
41035,703-004-5398,9181.418,5,1,4,0.5948891846124662
41121,703-004-5392,5429.4844,6,1,5,0.46229061261105336
41372,207-008-2399,796.60175,4,1,3,1.9459284266157044
41373,703-004-5385,608.7673,6,5,1,3.819063372033639
41455,703-004-5396,9951.752,3,0,3,0.27920371738274696
41489,703-004-5385,9244.779,5,2,3,0.5308566093486035
41604,703-004-5388,9737.794,3,0,3,0.27920371738274696
41759,703-004-5393,4148.651,8,5,3,2.4039802074564034
42431,207-008-2398,7245.6475,6,3,3,1.3120443050930715
42515,703-004-5398,4654.5566,7,3,4,0.880357443589624
42617,703-004-5393,7347.697,2,0,2,0.27920371738274696
427,703-004-5384,8174.4463,4,1,3,0.4042515454564179
42726,703-004-5385,2046.4724,5,3,2,1.0141238879458074
42736,703-004-5395,5336.886,4,2,2,0.6793611321961518
42832,703-004-5388,8689.951,5,2,3,1.13309907731709
42914,703-004-5386,325.28342,2,2,0,0.8843091141042939
4304,703-004-5395,4625.2275,9,3,6,0.5728911276047238
43198,703-004-5380,629.6098,4,2,2,1.3452467501137089
43490,703-004-5392,6595.375,4,2,2,0.4664567994857314
43676,703-004-5397,9787.452,2,0,2,0.27920371738274696
43795,703-004-5391,3205.5742,4,2,2,0.6361931397509245
43812,703-004-5398,6044.558,7,4,3,1.0900542570701157
43825,703-004-5387,2207.821,4,1,3,0.37175974969512765
44140,703-004-5388,2448.4158,6,2,4,0.6612331189217611
44298,703-004-5397,8862.077,7,1,6,0.643706885444478
44333,703-004-5392,437.02542,3,0,3,0.27920371738274696
44443,703-004-5393,6119.4414,3,2,1,0.5402225985784302
44536,703-004-5386,609.52545,4,1,3,0.7770917999361775
44839,703-004-5393,4675.106,2,1,1,0.5113608363948808
45470,703-004-5394,6417.8823,1,1,0,0.6433428956532268
45700,703-004-5384,5309.261,7,2,5,0.8513308399027206
46093,703-004-5393,6929.281,6,3,3,1.6269286350425909
46256,703-004-5398,4934.498,4,2,2,1.1567882344463154
46687,703-004-5396,2160.136,4,4,0,1.0722251258934679
46772,207-008-2398,7407.861,5,1,4,0.33853450732658075
46995,703-004-5382,5814.3296,7,2,5,1.0658258593348433
47018,703-004-5390,4509.12,5,0,5,0.27920371738274696
47074,703-004-5397,9948.466,5,3,2,2.092064248908719
47296,703-004-5394,3704.8696,1,1,0,0.5961325967409775
47350,703-004-5389,3315.9893,7,6,1,1.6131948791508879
47356,703-004-5393,2295.9937,5,2,3,0.7507527006220247
47438,703-004-5392,92.3574,2,1,1,0.5165268771580819
47606,703-004-5391,4411.8535,3,3,0,1.280001359434909
47679,703-004-5387,5020.72,2,2,0,1.0321260264556567
47836,703-004-5395,7493.588,5,4,1,2.373666771657389
48029,703-004-5385,2270.8547,3,2,1,0.7735296138747793
48162,703-004-5385,6724.209,5,2,3,1.1112949294944456
4820,703-004-5390,6912.3135,4,4,0,1.4930567310093457
48372,703-004-5392,8344.0,4,1,3,0.7528299815413624
48373,703-004-5389,265.38074,5,2,3,0.7139768815001717
48577,703-004-5397,6340.288,2,0,2,0.27920371738274696
48748,703-004-5389,4443.305,5,2,3,0.4562904657917049
4903,703-004-5389,9370.035,5,3,2,1.4177987697074912
49120,703-004-5381,1832.8744,5,3,2,2.1256345785586026
49149,703-004-5391,3785.9202,2,0,2,0.27920371738274696
49234,703-004-5396,7558.983,3,1,2,0.33853450732658075
49384,703-004-5390,1373.6254,5,2,3,2.1388637597444164
5109,703-004-5390,4797.099,6,4,2,1.0250720935590838
5208,703-004-5385,2030.7904,6,1,5,0.36010784178115807
5511,207-008-2399,184.54135,7,3,4,1.4087916069638673
5541,207-008-2398,6303.8647,3,1,2,0.9877836146238204
5652,703-004-5394,287.43982,5,2,3,0.6523751147207777
5798,703-004-5394,6382.9814,4,2,2,0.6243569725210232
5843,703-004-5383,6971.19,6,3,3,1.3810605606369621
5854,703-004-5396,9882.611,"","","",0.27920371738274696
589,703-004-5388,661.82794,5,2,3,1.0362488439941213
5954,703-004-5381,2374.096,3,1,2,0.5505275332204848
5962,703-004-5397,6098.2256,4,1,3,0.5201608880421418
5987,703-004-5395,6849.411,4,2,2,1.861637544456846
6174,703-004-5386,9060.692,5,1,4,2.580606641525074
642,703-004-5399,1210.0458,6,0,6,0.27920371738274696
6432,703-004-5387,7191.8438,2,2,0,0.7539145317385367
6592,207-008-2398,6340.805,4,2,2,2.1747181344178372
6644,703-004-5380,5074.2695,5,4,1,1.1402195566733058
6824,703-004-5399,6568.597,1,0,1,0.27920371738274696
7200,703-004-5393,4689.711,6,3,3,2.962863372077137
7389,703-004-5385,3143.801,2,1,1,0.38345697974030424
8064,703-004-5391,2564.5166,3,2,1,0.5020539603168548
812,703-004-5393,1068.5271,6,4,2,2.4691754388258187
8211,703-004-5387,3085.3396,4,3,1,0.6950097148531187
8234,703-004-5382,9859.876,2,0,2,0.27920371738274696
8329,703-004-5391,8957.433,4,1,3,1.5494133291391297
8395,703-004-5388,1053.8495,2,1,1,0.35534489781066697
8465,703-004-5383,8203.49,5,2,3,0.7753324910836041
8711,703-004-5387,7562.8394,8,4,4,1.1410128647299362
8982,703-004-5383,7736.7886,4,1,3,0.3623001968734576
9068,703-004-5390,7453.7026,8,4,4,1.6536991590333139
9140,703-004-5388,2335.1084,5,3,2,0.9211238628349482
9426,207-008-2399,5548.9946,6,3,3,1.623168024624626
10113,703-004-5398,9115.822,7,3,4,1.3501358204629064
10144,703-004-5381,6433.334,6,1,5,0.42384097797586556
1015,703-004-5380,3783.698,3,2,1,0.4583230444424551
10406,703-004-5391,8383.25,2,1,1,0.391224583646428
10446,703-004-5393,6673.4004,2,0,2,0.27920371738274696
10726,207-008-2398,3882.699,3,2,1,0.5733210559403374
10875,703-004-5395,7153.1743,4,1,3,1.0697739357315277
11241,703-004-5382,7009.0015,5,4,1,3.4710277597810437
11307,703-004-5383,1933.7374,9,6,3,3.1100378586378743
11359,703-004-5380,5934.366,"","","",0.27920371738274696
11363,703-004-5390,4936.9365,1,0,1,0.27920371738274696
11768,703-004-5385,8605.673,6,5,1,1.8460180676137061
11955,207-008-2398,9207.062,4,1,3,0.758017439966613
12084,703-004-5382,16.22379,5,2,3,0.8539801411522187
12165,703-004-5397,779.7265,3,0,3,0.27920371738274696
12231,703-004-5388,4872.764,5,5,0,1.8008543653452171
12410,703-004-5398,685.5565,5,2,3,1.8086486490002653
12980,207-008-2398,2961.936,4,3,1,1.4498120631509557
13289,703-004-5380,60.075523,3,3,0,1.2411570083961476
134,703-004-5395,8645.778,3,1,2,0.49519069246511693
14011,703-004-5387,374.58838,4,4,0,2.0649204676370756
14143,703-004-5394,6982.584,3,1,2,0.7918802953877885
14326,703-004-5380,5967.305,2,1,1,0.694412767428135
14762,703-004-5392,1900.1526,3,2,1,0.4779924904681026
1484,703-004-5389,7226.5005,3,1,2,0.5543851920472472
1555,703-004-5380,1049.0,2,1,1,0.384455497309775
15760,703-004-5388,9974.747,4,3,1,1.259016881232263
15897,703-004-5392,32.295586,1,1,0,0.8384793236657504
16006,207-008-2398,8433.947,7,5,2,2.305884036140136
16351,703-004-5383,3319.8254,3,1,2,0.4629635905300687
16528,703-004-5386,3006.2998,9,3,6,1.0321371319877282
16742,703-004-5384,6772.291,4,0,4,0.27920371738274696
16911,703-004-5380,3584.9243,3,2,1,2.1036275406572695
17015,703-004-5394,2495.4402,3,1,2,1.9452164475328575
17152,703-004-5398,1585.2571,2,0,2,0.27920371738274696
17469,703-004-5397,3236.1448,3,2,1,0.6551587511637228
1754,703-004-5382,4791.39,6,5,1,1.560900040385449
17666,703-004-5387,8626.305,4,2,2,0.7020427669805577
1774,207-008-2398,169.58118,6,2,4,1.1575161750353327
17785,703-004-5394,6357.485,6,4,2,3.005101608994983
18336,703-004-5397,2264.2344,9,3,6,0.7201127317358624
18427,703-004-5382,7409.0254,5,4,1,1.2868456173706484
18579,703-004-5396,2455.8206,1,1,0,0.6775729905415983
18666,703-004-5384,3077.1667,5,4,1,1.234269638421899
19539,703-004-5390,9774.516,4,2,2,0.43741915723297026
19796,703-004-5380,766.15393,3,1,2,0.33853450732658075
19864,703-004-5387,7810.925,3,0,3,0.27920371738274696
19927,703-004-5380,6957.7637,3,1,2,0.7157835191367723
20053,703-004-5388,4151.7427,5,4,1,1.761129437721368
20263,703-004-5395,9672.785,5,5,0,1.354740847866092
20378,703-004-5399,4251.7,8,5,3,1.4082286077296986
20771,703-004-5385,5997.5244,3,1,2,0.9250567230004203
20884,703-004-5393,5380.2236,3,2,1,1.0830744731769462
20887,703-004-5389,283.02908,3,1,2,1.008053053021681
21070,703-004-5390,2267.0525,2,0,2,0.27920371738274696
21202,703-004-5390,3578.0537,4,2,2,0.880788262018249
21369,703-004-5380,7914.5747,3,3,0,0.6851584716155117
21463,703-004-5390,9743.852,4,0,4,0.27920371738274696
21752,703-004-5396,2632.668,3,2,1,0.7481148320037371
22166,703-004-5395,2542.6824,1,0,1,0.27920371738274696
23030,703-004-5384,9416.803,2,1,1,0.5152416152367244
23110,703-004-5397,4274.719,4,3,1,1.5396253751475912
2327,703-004-5381,2249.2063,3,1,2,0.3978652972704144
23308,703-004-5391,118.98816,4,3,1,1.0994716429930587
23591,703-004-5399,1359.9199,3,3,0,1.302465530175458
23606,703-004-5394,7634.348,2,1,1,0.5244682073607914
23632,703-004-5392,7855.24,5,2,3,0.9561903802933515
23756,703-004-5387,9824.074,5,1,4,0.33556796782938897
23923,703-004-5389,6588.647,7,3,4,1.0605313019938145
24229,207-008-2398,5851.8315,3,1,2,0.7164819177623742
24576,703-004-5388,8359.562,4,2,2,0.7261708168420313
24648,703-004-5386,7152.961,4,1,3,0.3978652972704144
24809,207-008-2398,898.55316,2,1,1,0.6692133851237464
24825,703-004-5389,5230.5693,1,1,0,0.4686062770951132
25010,703-004-5398,9990.43,3,0,3,0.27920371738274696
25181,703-004-5387,7587.2104,9,4,5,1.6797616294431197
25411,207-008-2398,9126.059,4,1,3,0.7140976897879204
25608,703-004-5395,584.93915,1,1,0,1.833864378499828
25709,703-004-5393,542.33136,7,3,4,1.2663104785455717
25723,703-004-5384,9434.393,5,3,2,1.4975187917427617
25789,703-004-5386,7209.1274,1,1,0,0.5295350353417972
25811,703-004-5384,3120.867,2,0,2,0.27920371738274696
25854,703-004-5384,4953.5596,2,2,0,0.7077175870059207
25952,703-004-5394,1822.8394,8,4,4,2.0521117946962018
25995,703-004-5398,7911.3047,2,1,1,1.1087404278268518
26262,703-004-5381,7424.0317,5,4,1,1.6852065579111661
26282,703-004-5399,1712.8557,1,0,1,0.27920371738274696
26700,703-004-5392,9050.585,6,3,3,1.2834009313353223
26754,703-004-5381,5995.271,3,2,1,0.8198997596695122
27091,703-004-5380,6974.7085,2,0,2,0.27920371738274696
27144,703-004-5399,2719.3218,1,0,1,0.27920371738274696
27185,703-004-5389,5915.6353,4,1,3,1.3954202627598893
27293,703-004-5382,7891.2363,6,4,2,1.1096620399935044
27547,703-004-5389,9048.669,4,1,3,0.5669580486103406
27691,703-004-5387,2694.4167,7,4,3,1.1965574928351224
27710,703-004-5384,7176.926,4,4,0,1.2251039991313595
27798,703-004-5397,9234.063,5,2,3,0.5896910245904431
28190,703-004-5381,6274.762,2,0,2,0.27920371738274696
28280,703-004-5399,507.44415,3,0,3,0.27920371738274696
28613,703-004-5385,745.4747,3,1,2,0.39907663423176776
28730,703-004-5398,3929.86,10,6,4,2.147392841021058
28809,703-004-5382,8571.035,2,1,1,0.8498200366816149
2887,703-004-5392,2161.3013,8,4,4,1.919788375582354
28890,703-004-5391,2411.3804,3,2,1,1.523274601264234
29075,703-004-5384,6184.0093,4,1,3,0.7015926951896202
29115,703-004-5386,4666.904,5,3,2,1.0007435479601026
29396,703-004-5395,5051.3057,2,1,1,0.6790719235963376
29479,703-004-5386,9748.906,3,1,2,0.44385494462136815
29842,703-004-5392,5197.1426,4,1,3,0.33853450732658075
29861,703-004-5393,2604.413,1,0,1,0.27920371738274696
3029,207-008-2398,732.07916,1,1,0,0.4409419228858854
30583,703-004-5393,6602.001,4,1,3,0.5445537692039335
30620,703-004-5398,5092.48,3,2,1,1.5983652476161343
30757,703-004-5389,8807.917,3,1,2,0.476348807842992
30975,703-004-5390,6694.3525,6,4,2,1.8467842151139338
30983,703-004-5388,857.563,4,1,3,1.684079755171608
30986,703-004-5384,3287.4036,6,4,2,1.8283597220483043
31003,703-004-5393,8297.092,6,2,4,1.96263244436881
3146,207-008-2398,1778.3976,4,1,3,0.6515027782819108
31498,703-004-5380,6820.4995,3,2,1,0.86904139534704
31681,703-004-5382,848.43756,4,1,3,0.3896447485111028
32020,703-004-5386,2053.759,5,1,4,0.8141408320200918
3206,703-004-5392,8987.438,2,1,1,0.5165268771580819
32363,703-004-5396,1739.0417,6,3,3,1.4724692256886056
32407,703-004-5389,544.8532,"","","",0.27920371738274696
32420,703-004-5390,1033.0397,5,1,4,0.488233753915241
32539,703-004-5383,5635.0005,5,1,4,0.5165268771580819
32617,703-004-5380,2975.2612,5,1,4,0.5759683460766204
33283,703-004-5391,343.55283,4,3,1,1.251402530893486
33304,703-004-5382,7632.43,7,4,3,1.3596560503920503
3331,207-008-2398,6896.187,5,2,3,0.7889927529696268
33328,703-004-5390,1915.6128,4,1,3,0.5861569815916532
33390,703-004-5398,8325.226,9,2,7,0.7221655069619832
33489,703-004-5398,5439.052,3,2,1,0.5947568902161827
33651,703-004-5389,9273.471,8,1,7,1.0004049312948944
33730,703-004-5394,2726.0984,5,3,2,0.9069476363811951
33751,703-004-5382,4514.589,"","","",0.27920371738274696
34120,703-004-5389,5525.5483,4,3,1,0.657267210815288
34510,703-004-5397,5303.9473,3,2,1,0.7226252979856245
34527,703-004-5391,9347.006,2,2,0,0.6693535378666721
34561,703-004-5386,155.96687,3,0,3,0.27920371738274696
34684,703-004-5381,29.845238,3,2,1,1.0337592320381066
35164,207-008-2399,5973.192,7,4,3,1.0740440801285924
35473,703-004-5383,3054.8877,2,1,1,0.5362549111006996
35623,703-004-5383,8689.5625,2,1,1,0.5724173170781235
358,703-004-5396,1640.538,2,2,0,0.6129972726887324
35854,703-004-5396,9183.083,9,3,6,3.2787226330720785
35872,703-004-5395,7644.6963,7,2,5,1.0164947029738745
35996,207-008-2399,3823.955,3,1,2,0.5878734246225262
3695,703-004-5397,8689.468,5,4,1,1.2524271966153298
37161,703-004-5398,8141.3066,3,0,3,0.27920371738274696
37297,703-004-5394,6536.8647,6,5,1,2.5880624922115394
37351,703-004-5384,1548.3505,3,1,2,0.4172687728905459
37616,703-004-5397,60.330627,6,2,4,0.8157950898091507
37622,703-004-5384,7096.442,1,1,0,0.4832288018662962
37864,703-004-5383,6902.2812,4,2,2,1.1374108576330635
38173,703-004-5382,7263.506,3,3,0,1.0460150487003461
38319,703-004-5399,4326.7983,4,2,2,1.066214813603783
38348,703-004-5392,86.383224,5,3,2,0.7632789954822633
38537,703-004-5386,3448.2563,4,2,2,1.6049825763317411
38607,703-004-5389,8271.734,5,4,1,2.7347379882504246
38724,703-004-5388,3904.311,8,3,5,0.5928228939882539
38856,703-004-5396,4108.722,2,1,1,0.3187575773453028
39018,703-004-5387,8314.092,3,2,1,0.693231703385143
39081,703-004-5399,82.33607,6,2,4,0.8791538980696688
39418,703-004-5394,9040.707,6,5,1,1.7126436235390812
39472,703-004-5393,923.51794,2,2,0,1.5937243218669632
39624,703-004-5392,3962.9775,2,2,0,1.0484455010968015
39876,703-004-5385,8682.612,2,1,1,0.527777040984247
40118,703-004-5398,7743.3403,6,3,3,2.6055223840200217
4034,703-004-5382,4674.1587,4,1,3,0.7216763774078664
40452,703-004-5386,2786.3206,4,2,2,0.7164742140705296
40530,703-004-5398,9976.687,2,1,1,0.3805394705486912
40665,703-004-5380,7099.768,3,2,1,1.0261765095251238
40809,703-004-5391,4633.9863,3,3,0,0.6655539388111404
40896,703-004-5383,6865.8857,5,3,2,1.295048821364601
41023,703-004-5389,5609.6255,4,1,3,0.6324484023986496
41480,703-004-5395,7048.2393,3,0,3,0.27920371738274696
41638,703-004-5395,4838.9976,3,0,3,0.27920371738274696
41876,703-004-5395,5368.4683,3,2,1,0.5811822917527164
42159,703-004-5388,2339.744,2,0,2,0.27920371738274696
42252,703-004-5398,95.73221,6,3,3,0.9614377802868143
4265,703-004-5391,4303.2847,3,2,1,2.009932853509523
43048,703-004-5383,8671.147,3,1,2,0.8098109669686937
43049,703-004-5380,1712.3597,2,1,1,0.5320162868635785
43245,703-004-5382,1878.8701,2,0,2,0.27920371738274696
43448,703-004-5394,8023.7837,6,3,3,1.1221769943022228
43504,703-004-5390,9728.535,5,3,2,1.7445074176173174
43672,703-004-5388,803.2471,6,3,3,2.226197946258263
43716,703-004-5380,6091.2944,3,3,0,1.5911432154426455
43780,703-004-5386,8513.302,5,5,0,1.43529089816383
44282,703-004-5394,3584.9631,6,5,1,1.8196636706212546
44545,703-004-5383,1750.1616,5,3,2,0.7002060320552146
44632,703-004-5390,6968.2896,5,1,4,0.35831143730785864
44642,703-004-5384,4680.6807,3,1,2,0.42687753787258087
44712,703-004-5383,3716.3699,3,0,3,0.27920371738274696
44773,703-004-5392,1276.4305,4,1,3,0.44829646872267315
44781,703-004-5398,341.5817,1,1,0,0.5165268771580819
4515,703-004-5383,3264.7031,3,3,0,1.4137310898446638
45569,703-004-5389,8287.436,3,2,1,2.1395313259813014
45618,703-004-5390,9735.448,5,2,3,1.2982080420590498
45672,703-004-5390,9445.8545,1,0,1,0.27920371738274696
45677,703-004-5381,3404.4648,2,1,1,0.46742635266430166
45734,703-004-5387,2764.0076,2,2,0,0.5018523951119737
46005,703-004-5384,7033.9863,2,1,1,0.34445651043902575
46200,703-004-5388,3219.2166,9,4,5,1.0942593419315303
46389,703-004-5384,4033.916,7,6,1,5.2496121363820745
46798,703-004-5399,899.9789,3,1,2,0.549105226539755
46809,703-004-5393,5339.6587,6,3,3,1.851457789368598
46997,703-004-5398,875.58386,4,3,1,0.7265532358691726
47658,703-004-5385,8197.136,2,0,2,0.27920371738274696
47756,703-004-5387,2707.5935,4,2,2,0.9274984086998458
48081,207-008-2398,3847.586,5,1,4,0.5087560887480944
49335,703-004-5386,61.796307,8,3,5,1.9964818658256878
49355,703-004-5399,492.47803,1,0,1,0.27920371738274696
49377,703-004-5392,385.0436,5,1,4,0.3618219126680011
49652,703-004-5398,1530.9257,2,2,0,0.46935889915273415
49946,703-004-5383,4673.831,3,1,2,0.4587598064326467
49947,703-004-5384,5551.6704,10,5,5,1.0572468219404312
49963,703-004-5382,1750.6742,3,0,3,0.27920371738274696
538,703-004-5383,9630.957,6,3,3,1.6678668917466701
5424,703-004-5390,7435.794,5,3,2,1.0100991696479442
5534,703-004-5394,3731.947,4,2,2,0.6008331457315522
5822,703-004-5388,5780.494,5,1,4,0.9573766419005709
6135,703-004-5392,3824.9338,3,2,1,1.223205671053566
6499,703-004-5395,3169.5366,5,1,4,0.4220786276159599
6691,703-004-5387,6675.3237,6,4,2,2.1735519348704146
6818,703-004-5398,9602.608,3,1,2,0.6428606043861537
6960,703-004-5395,6796.2534,5,5,0,1.9542479687909495
7001,703-004-5396,8556.371,4,2,2,0.8724425712588304
7023,703-004-5385,2234.4338,4,2,2,0.6335718021516451
7118,703-004-5390,6619.5356,5,3,2,2.4131567601132673
7465,703-004-5384,6253.5244,4,2,2,0.7958657089745115
7551,703-004-5386,8452.781,4,1,3,2.5207390971094803
7693,703-004-5390,574.9285,5,3,2,1.1697594475039297
7809,703-004-5391,1485.0021,7,4,3,1.073711350634401
803,703-004-5385,3979.0916,3,2,1,0.9503718504862864
806,703-004-5392,8138.9453,4,2,2,0.9844319835714178
8217,703-004-5386,1095.5155,5,3,2,0.8918302873062999
88,703-004-5397,7809.9834,4,1,3,0.6708081694521548
8863,703-004-5383,2878.734,3,3,0,1.4454091125696573
9004,703-004-5384,9302.2295,3,2,1,1.3788386814745246
945,703-004-5385,9183.669,4,0,4,0.27920371738274696
9467,703-004-5384,2668.6042,2,0,2,0.27920371738274696
9501,703-004-5380,8131.494,5,2,3,0.9748772490367975
9506,703-004-5390,88.79125,6,4,2,1.3290549354714452
9846,703-004-5381,4207.9463,6,2,4,0.7897873041309743
9938,703-004-5399,1749.6007,6,1,5,0.3618589241232504
1,703-004-5384,3566.9165,9,5,4,1.941302040650351
1024,703-004-5397,7533.3164,4,3,1,2.711358764721597
10312,703-004-5388,7793.986,2,1,1,0.49287185526500316
10520,703-004-5392,5340.912,"","","",0.27920371738274696
1085,703-004-5385,9685.159,5,1,4,0.35831143730785864
11007,703-004-5387,1897.3857,3,1,2,0.3553938045104331
11250,703-004-5385,3611.5593,5,0,5,0.27920371738274696
1150,207-008-2398,6478.934,7,3,4,1.5359951102279077
11783,703-004-5399,7818.449,1,1,0,0.38817711461164883
12028,703-004-5396,59.152245,5,2,3,0.7983978445200828
12049,703-004-5397,5767.724,2,2,0,1.476749922138208
12077,703-004-5384,687.76013,3,1,2,0.4943022605879134
12173,703-004-5391,8576.7705,2,2,0,0.912234967102356
12230,703-004-5389,7502.6226,1,0,1,0.27920371738274696
12575,703-004-5389,8989.701,3,1,2,0.6576480039731752
12577,703-004-5387,7623.4487,8,6,2,2.083711461842914
12604,703-004-5392,6479.0996,4,1,3,0.6798015354824273
12679,703-004-5382,3063.0762,6,3,3,1.381698956472417
13220,703-004-5381,3120.1172,4,1,3,0.35831143730785864
13380,207-008-2399,7317.279,9,2,7,0.9461896266440251
13486,703-004-5395,9457.645,2,0,2,0.27920371738274696
13560,703-004-5384,5317.0156,4,3,1,1.4159174215529917
13696,703-004-5391,6422.1606,1,0,1,0.27920371738274696
13708,207-008-2399,1576.8248,4,2,2,0.5555429694328968
13750,703-004-5387,1236.5175,5,2,3,2.132250389212281
13897,703-004-5381,8009.5864,5,0,5,0.27920371738274696
14025,703-004-5385,2639.4927,4,2,2,0.878798789607149
14102,703-004-5381,6818.126,5,3,2,1.446657429885454
14213,703-004-5380,1339.0625,7,5,2,1.1436125274577393
14474,703-004-5388,5634.059,1,0,1,0.27920371738274696
14546,703-004-5384,1261.7379,6,2,4,0.9301115566891746
14612,703-004-5397,2131.312,2,1,1,3.460877688951883
14670,703-004-5392,4334.657,3,2,1,0.6959927595061715
149,703-004-5388,6383.7373,5,3,2,1.1976228321781914
14927,703-004-5390,2801.7468,5,3,2,1.0414560411861509
15286,703-004-5391,1220.6459,6,0,6,0.27920371738274696
15399,703-004-5381,1651.907,4,3,1,1.3304849814686637
15599,703-004-5384,6998.2773,1,0,1,0.27920371738274696
15680,703-004-5399,1118.1188,4,3,1,2.431886131613588
15736,703-004-5392,7441.668,4,3,1,0.9009265763433383
15779,703-004-5387,6218.7983,3,1,2,0.6386337045723766
15842,207-008-2399,9313.754,1,0,1,0.27920371738274696
16013,703-004-5390,2762.1162,2,0,2,0.27920371738274696
16199,703-004-5383,4449.923,5,2,3,0.4957803787258292
16662,703-004-5398,6893.301,7,6,1,1.9666728978877128
16665,703-004-5396,5724.7056,3,3,0,1.5974963573588552
16717,703-004-5393,7254.2734,5,3,2,1.914558552775408
16737,703-004-5397,6503.4707,1,1,0,0.36712161433822693
16893,703-004-5384,9236.288,3,1,2,0.3863359665390255
17374,703-004-5391,5652.1436,7,3,4,1.294760824571748
17579,703-004-5398,8929.129,5,4,1,1.3125706586724286
1778,207-008-2399,379.75192,3,2,1,1.2398770723103396
18041,703-004-5381,4473.874,2,0,2,0.27920371738274696
18045,703-004-5382,4501.5835,6,3,3,1.7618338882655964
18420,207-008-2399,2429.8984,5,3,2,1.0037581635839685
18486,703-004-5399,4516.439,2,2,0,0.9598030395264595
18508,703-004-5390,4134.605,3,3,0,1.0146301498377492
18704,703-004-5397,3401.6377,5,4,1,0.9266678008567164
18785,703-004-5393,8984.8545,4,2,2,0.7885464169689091
18877,703-004-5392,861.5255,6,3,3,1.3865870793570034
1937,703-004-5398,8210.114,1,0,1,0.27920371738274696
19388,703-004-5385,2655.459,4,1,3,0.3614868706279776
19418,703-004-5388,6354.2534,2,2,0,1.5534405227380972
19591,703-004-5383,6097.4473,2,1,1,0.62765274689012
19826,703-004-5393,3849.976,"","","",0.27920371738274696
20358,703-004-5390,1338.092,4,1,3,0.4860073389990234
20553,703-004-5391,7615.977,3,1,2,0.5272858585777646
20574,703-004-5399,7199.089,5,2,3,0.6280070583993613
20957,703-004-5382,6648.702,5,3,2,1.3371099367139643
21155,703-004-5384,2850.3955,4,2,2,1.3783883177005636
21520,703-004-5391,7093.145,4,0,4,0.27920371738274696
21888,703-004-5389,5063.8394,2,2,0,0.5202451810375057
22027,703-004-5381,6398.688,5,2,3,0.5009816848680948
2228,703-004-5396,8393.643,2,0,2,0.27920371738274696
22448,703-004-5383,405.5798,5,4,1,2.2434242965442173
22931,703-004-5380,7548.29,1,0,1,0.27920371738274696
22948,703-004-5388,2398.9917,2,1,1,0.5235678294458198
23294,703-004-5384,5029.134,4,2,2,0.604951524130136
2331,703-004-5394,3964.501,6,4,2,2.1586746410641138
23370,703-004-5398,5093.3584,9,5,4,2.617904665106132
24195,703-004-5391,8535.733,3,2,1,0.5181207801173764
24567,703-004-5388,5440.3745,3,1,2,1.478935334859464
24717,207-008-2399,349.2266,2,1,1,0.8588230968712283
24731,703-004-5381,8663.234,3,1,2,0.3672522577368947
24768,703-004-5397,8649.447,3,3,0,1.1212040869939177
24813,703-004-5396,7813.188,6,4,2,2.170180249390756
25119,703-004-5390,2472.7202,6,4,2,1.1922808465009886
25170,703-004-5394,6590.5166,2,2,0,1.242927071037111
25219,703-004-5395,3286.2295,1,1,0,1.3364318632495844
25335,703-004-5384,5072.548,3,0,3,0.27920371738274696
25504,703-004-5383,9550.047,1,1,0,0.6597516278014508
25727,703-004-5392,5728.566,1,0,1,0.27920371738274696
25762,703-004-5380,4962.4536,2,1,1,0.5947072810359352
26022,207-008-2399,6843.9473,7,6,1,3.1137057867003626
26516,703-004-5390,8590.581,3,2,1,0.5513924981424965
26902,703-004-5381,2501.2935,6,2,4,0.7336475788413344
2697,703-004-5394,2263.7583,5,3,2,1.4974571129100755
26995,703-004-5384,3845.3542,8,6,2,1.7400681735898647
27064,703-004-5389,1997.2194,4,1,3,0.7076098073272915
27319,703-004-5387,5993.06,1,0,1,0.27920371738274696
27586,703-004-5392,7422.2056,4,1,3,0.7601544938706312
27694,703-004-5386,5573.2847,4,2,2,1.0234932845865041
2777,703-004-5399,1992.8539,4,2,2,1.405272714712052
28067,703-004-5398,1743.437,5,3,2,0.5799451158509901
28121,703-004-5385,2134.7815,2,0,2,0.27920371738274696
28201,703-004-5397,2013.576,5,4,1,1.4881513687094647
28410,703-004-5383,1867.578,3,1,2,0.3565006121564479
28495,703-004-5382,8843.595,3,3,0,0.8642721889899407
28615,703-004-5380,7909.33,6,3,3,1.9317923293535066
29255,703-004-5380,7794.44,6,2,4,0.5670205805146009
29321,703-004-5399,8934.454,5,2,3,0.8797421205471829
29625,703-004-5396,7899.21,8,3,5,1.4026498669499836
29719,703-004-5387,718.9649,"","","",0.27920371738274696
29814,703-004-5395,620.4003,4,2,2,0.723423834872573
29817,703-004-5391,5098.957,9,5,4,3.4376590880511277
29881,703-004-5388,5193.271,3,2,1,0.7952168934753249
30137,207-008-2399,7940.706,6,3,3,1.2275292719398925
30222,703-004-5389,3806.4302,3,1,2,0.3486207416170325
30286,703-004-5397,166.83638,4,1,3,0.39655507565915477
30575,703-004-5383,7548.3726,3,1,2,1.0761887943930324
30737,703-004-5386,6464.8647,7,3,4,2.0796506155493315
30842,703-004-5383,7678.9736,4,4,0,3.1325511852279924
30892,703-004-5384,3194.8394,4,3,1,1.4539883708942098
31268,703-004-5399,4755.5586,"","","",0.27920371738274696
31530,703-004-5398,2005.6862,3,3,0,1.481837442919655
31763,703-004-5399,9626.08,4,2,2,1.1073691365078904
318,703-004-5385,4568.1826,6,4,2,2.5644065029937053
32158,703-004-5399,1200.3702,5,1,4,0.5608312930419322
3219,703-004-5394,9570.702,4,3,1,1.3672698648841375
32333,703-004-5396,2005.592,4,3,1,0.7264197697507481
32485,703-004-5390,8692.51,2,1,1,0.7441579469297931
32602,703-004-5387,3768.2075,6,5,1,1.4680400821465283
32614,703-004-5383,7636.5483,3,3,0,2.554382112072237
32738,703-004-5385,5183.307,3,2,1,0.7552207388686755
32852,703-004-5396,4850.77,3,3,0,1.128853925290717
33008,703-004-5380,5776.3813,2,0,2,0.27920371738274696
3341,703-004-5383,5330.673,3,1,2,0.6105812435460113
33504,703-004-5387,9276.845,"","","",0.27920371738274696
33606,703-004-5391,1838.6888,4,0,4,0.27920371738274696
33765,703-004-5390,7766.243,6,2,4,0.8950425306455456
34126,703-004-5397,6134.008,3,2,1,0.8251264928356034
34142,703-004-5389,7960.686,4,2,2,0.6151308037429132
34408,703-004-5380,545.9118,4,3,1,0.7931114445519137
34468,703-004-5394,3616.3335,6,4,2,2.4703779265745442
34531,703-004-5380,2163.4019,7,2,5,0.8297571866588767
3467,703-004-5395,6970.4604,2,1,1,1.2218890893184533
34839,703-004-5385,8743.374,8,5,3,3.306271335741778
35409,703-004-5385,8619.583,3,1,2,0.4419924367838552
35522,207-008-2399,1676.5815,7,1,6,0.43675992623359433
35574,703-004-5399,9999.453,6,2,4,1.6122567987051506
35607,703-004-5392,1071.8208,5,3,2,0.986527828865008
35879,703-004-5390,7903.296,7,4,3,3.034500983418862
36226,703-004-5398,6659.975,5,1,4,0.7428731292178192
36290,703-004-5391,735.09094,5,2,3,0.3859991392816477
36434,207-008-2399,5473.0986,7,1,6,0.7251814084503794
36715,703-004-5391,5629.621,4,2,2,1.550393562561754
36972,703-004-5385,4599.8994,3,0,3,0.27920371738274696
37165,703-004-5392,7814.306,5,3,2,1.9736700898802153
37251,703-004-5392,584.7621,3,2,1,0.5191376259453645
3730,703-004-5395,7328.009,4,2,2,1.1996349066136103
37951,703-004-5396,75.32895,5,2,3,0.5758576671019155
38009,703-004-5388,7355.046,4,2,2,1.7103654771934231
38231,703-004-5381,8287.279,3,1,2,3.3965722716460256
38613,703-004-5386,1116.603,3,0,3,0.27920371738274696
38743,703-004-5386,1039.2737,6,3,3,1.1024660754437055
38936,207-008-2399,2.6923418,"","","",0.27920371738274696
39010,703-004-5396,6841.321,2,1,1,0.573335540963862
391,703-004-5388,8919.385,2,1,1,0.4361947572586287
39170,703-004-5392,302.37497,3,2,1,0.4057760692629256
39751,703-004-5398,861.944,2,1,1,0.34192483818051406
4025,207-008-2399,7748.7075,3,1,2,1.326697068140939
40365,703-004-5392,5675.2603,7,2,5,0.6753774988746216
40609,703-004-5388,502.49695,2,1,1,0.7734370458961782
40771,703-004-5385,3096.161,3,2,1,1.0675254239112741
40885,207-008-2399,4393.872,4,2,2,1.046500071428479
40975,703-004-5380,4649.9116,4,2,2,0.9871582492652774
40987,703-004-5381,3287.3188,6,2,4,1.2466626242173076
41078,703-004-5393,6451.9243,7,1,6,0.35831143730785864
41085,207-008-2399,459.96426,3,3,0,0.5774551692221221
41088,703-004-5398,6325.3057,3,1,2,0.7052241382381503
41155,703-004-5385,3877.418,2,1,1,0.3978652972704144
41220,703-004-5392,4978.5596,4,3,1,1.8859704840545515
41387,703-004-5395,4049.4622,7,5,2,1.6896395381505223
41624,703-004-5398,7387.8354,2,1,1,0.9336415351007187
4170,703-004-5391,8952.79,1,0,1,0.27920371738274696
41852,703-004-5387,1299.1298,1,0,1,0.27920371738274696
41999,703-004-5396,3476.1113,3,2,1,1.161750415618824
42136,703-004-5385,6789.7725,6,1,5,0.6733796902988594
42279,703-004-5397,1695.6472,2,2,0,0.6621483453958931
42286,703-004-5390,7962.432,5,4,1,1.3790740966034292
4230,703-004-5389,9430.913,5,3,2,1.1195684688610354
42437,703-004-5380,2662.2593,5,4,1,1.2452199329007627
42728,703-004-5397,5969.498,2,2,0,0.8596697988963137
42770,703-004-5394,131.76799,7,0,7,0.27920371738274696
42894,703-004-5382,3387.8667,2,0,2,0.27920371738274696
42936,703-004-5393,9435.077,1,1,0,0.9763684437259255
42970,207-008-2399,7428.658,5,3,2,0.8824360125538092
43123,703-004-5391,4764.143,3,2,1,1.688087345342445
43148,703-004-5383,6525.2773,5,2,3,0.584970479959107
43278,703-004-5395,2838.378,4,2,2,0.7693121258121567
4328,207-008-2399,872.96545,4,3,1,2.6271692949523198
43352,703-004-5387,894.3832,3,2,1,0.7979624983648571
43541,207-008-2398,1764.3177,9,9,0,3.148872073382911
43863,703-004-5393,677.8705,5,3,2,1.6036232244032174
44045,703-004-5389,6929.2695,4,1,3,0.39143290023632876
44313,703-004-5382,1979.4119,2,1,1,0.33853450732658075
44533,703-004-5397,8133.176,3,1,2,0.429416587323796
44630,703-004-5382,8948.38,7,4,3,1.6834424033909159
45000,703-004-5387,2296.6975,3,2,1,0.8756963742716659
45206,703-004-5380,518.89417,4,2,2,0.5803371635562304
45272,703-004-5380,6624.3965,5,2,3,1.0826572929240856
45578,703-004-5396,8636.535,5,3,2,1.2671334247764474
45595,703-004-5384,1475.3002,3,2,1,1.0521990258881364
45822,703-004-5381,3476.0928,8,6,2,1.7312827285978103
4585,703-004-5385,2563.433,3,2,1,1.1330799096323059
46404,703-004-5399,218.12141,1,1,0,0.9969408229007035
46433,703-004-5381,8625.098,3,3,0,1.363979568615274
46523,703-004-5389,4195.374,2,2,0,0.7827114444386059
46890,703-004-5388,9124.393,4,2,2,0.3859991392816477
46975,703-004-5395,1265.2695,3,2,1,0.7678721383535358
4700,703-004-5389,5743.517,3,2,1,1.5443661737901013
47080,703-004-5385,1934.6571,2,0,2,0.27920371738274696
47089,207-008-2399,9117.668,9,6,3,1.0699222653484284
47274,703-004-5384,3867.892,4,1,3,0.3889656787788394
47542,703-004-5380,5727.746,7,4,3,2.1437281703165088
47814,703-004-5387,7844.3975,"","","",0.27920371738274696
47849,207-008-2398,6256.736,3,2,1,0.9801875044578171
47928,703-004-5396,2152.0542,4,2,2,0.6992397936649928
48094,703-004-5388,4836.452,5,3,2,1.2568599456889316
48107,703-004-5391,2185.4556,7,5,2,1.5853062083896923
48808,207-008-2398,2400.7725,2,1,1,0.5224861810650763
48972,703-004-5385,5573.408,4,1,3,0.40195197747830314
49094,703-004-5395,9752.442,5,3,2,0.7770127553721665
4910,703-004-5395,2976.6714,4,3,1,1.762256048136085
49331,703-004-5381,7007.014,6,2,4,0.6106664537952753
49546,703-004-5397,639.0971,3,0,3,0.27920371738274696
49771,703-004-5380,1249.6161,6,4,2,1.533565778264253
49863,703-004-5392,9541.548,6,2,4,0.3978652972704144
5031,703-004-5396,2729.984,4,2,2,1.0800898353547883
5122,703-004-5396,5656.817,8,6,2,2.0820988862358902
5253,703-004-5398,4637.648,3,3,0,1.2068756923010717
5368,703-004-5390,333.7413,4,1,3,0.6726401120236282
5422,703-004-5382,4307.9106,6,3,3,1.6060965274233674
5889,703-004-5396,7288.146,1,0,1,0.27920371738274696
6242,703-004-5391,8999.263,2,1,1,0.35831143730785864
6362,703-004-5398,1369.5812,7,4,3,3.053160023890752
6660,703-004-5387,8742.991,5,3,2,1.162169478805897
6793,703-004-5384,1560.2029,7,3,4,0.7323591063537614
6885,703-004-5382,3364.3418,"","","",0.27920371738274696
7310,703-004-5387,2478.9238,6,1,5,1.0397342595748813
7573,703-004-5390,9386.022,5,0,5,0.27920371738274696
7710,703-004-5389,897.4105,8,3,5,1.1691966919534693
7768,703-004-5391,3457.6196,4,0,4,0.27920371738274696
7883,703-004-5394,5273.939,6,2,4,0.7146421315322676
793,703-004-5386,5220.627,5,2,3,1.0286098711503449
7993,703-004-5390,8549.743,6,1,5,0.46812222299984235
8193,703-004-5396,7886.907,3,2,1,0.8310377602092558
8488,703-004-5384,8636.547,1,1,0,0.34104123320170765
8572,703-004-5391,5879.884,3,2,1,0.5519399524018377
8645,703-004-5382,5570.586,1,1,0,0.3710484291463167
8665,703-004-5384,9114.036,3,2,1,0.5851150910862931
8895,703-004-5391,4723.2144,5,2,3,0.7733155030439914
8919,703-004-5384,5753.4707,7,3,4,1.1142883854398555
899,703-004-5397,7285.8047,1,0,1,0.27920371738274696
9189,207-008-2399,7157.338,4,2,2,0.5508686920318218
9400,703-004-5388,6962.721,3,1,2,0.35831143730785864
9627,703-004-5382,5578.6724,6,3,3,1.0615122234648915
9662,703-004-5381,7960.735,5,1,4,0.35831143730785864
10264,207-008-2398,7113.158,6,2,4,0.9875773394640442
10279,703-004-5388,2456.2598,5,3,2,1.4067414265760787
10383,703-004-5387,5924.1724,4,1,3,0.4722092491862857
10493,207-008-2398,2896.881,3,1,2,1.1714369307020192
10590,703-004-5393,2926.6846,1,0,1,0.27920371738274696
10648,207-008-2399,8720.292,2,2,0,0.5021886029216555
1065,703-004-5389,5256.9194,4,1,3,0.5022128871375853
10659,703-004-5380,4341.868,3,3,0,1.741434538065548
10715,703-004-5394,4912.804,4,4,0,1.0465399134698061
11122,703-004-5394,5223.4243,3,0,3,0.27920371738274696
11559,703-004-5381,2813.1897,5,2,3,0.7408426160885294
11585,207-008-2399,616.6393,"","","",0.27920371738274696
11640,703-004-5388,5899.1025,1,1,0,0.3187575773453028
11821,207-008-2398,8586.056,4,0,4,0.27920371738274696
11873,703-004-5382,3720.5063,3,1,2,0.7714193374869732
1220,703-004-5396,9939.703,5,1,4,1.5665263245893228
12201,703-004-5387,6737.0015,5,1,4,0.7698135543327094
12473,703-004-5392,9435.888,4,2,2,0.4445820028153332
12671,703-004-5386,6535.2656,5,2,3,0.9932411170641354
12773,703-004-5393,5982.5073,4,2,2,0.7750757305032854
1281,703-004-5394,8091.8833,3,0,3,0.27920371738274696
13062,703-004-5387,5984.99,4,3,1,0.7781797224572035
13119,703-004-5397,7842.72,6,4,2,0.9614383673824725
1376,703-004-5388,5895.061,5,2,3,0.7049073680586901
13788,703-004-5388,7925.4116,3,2,1,2.1017679974369545
14230,703-004-5382,58.51507,1,0,1,0.27920371738274696
14260,703-004-5386,9200.086,6,2,4,0.86545905814844
14283,703-004-5391,4643.515,6,3,3,0.7411113120041294
14287,703-004-5384,7638.855,"","","",0.27920371738274696
14508,703-004-5398,4275.4185,5,3,2,1.862342964621741
14626,703-004-5390,9273.59,7,7,0,1.9578290942031673
14860,703-004-5382,6567.1675,8,2,6,0.5744869808639864
15188,703-004-5390,2578.0208,6,1,5,0.47522715788535846
15196,703-004-5398,2689.5732,5,3,2,1.599472999299618
15261,703-004-5383,9144.027,6,4,2,1.6513770890000996
15302,703-004-5385,644.4991,3,2,1,0.6027279791103418
15329,703-004-5396,9349.626,3,3,0,1.9953661425207168
15624,703-004-5398,1605.2246,2,2,0,0.5992537467882402
15828,703-004-5397,6260.2744,1,0,1,0.27920371738274696
16053,703-004-5399,1671.595,3,2,1,0.4639324508552534
16873,703-004-5395,5435.005,5,2,3,4.19188968139125
17028,703-004-5398,2868.1172,4,2,2,0.7867951612032801
17224,703-004-5386,2092.067,6,2,4,1.9700817711846847
17306,703-004-5384,5614.332,2,1,1,0.3978652972704144
17336,703-004-5381,3023.2532,3,1,2,0.6249157444926899
17581,703-004-5385,5282.4014,6,3,3,1.5279584380879707
17590,703-004-5398,1127.2145,4,2,2,0.7239763906642596
18567,703-004-5390,9416.353,4,2,2,0.8819225335882146
18985,703-004-5381,3466.33,2,1,1,0.623882754187108
19011,703-004-5386,7672.198,5,1,4,1.379540102599891
19101,703-004-5385,1594.3873,7,4,3,1.0346933384866783
19361,703-004-5393,3156.6501,2,0,2,0.27920371738274696
19433,703-004-5386,1322.9084,4,2,2,1.4522802851517436
1948,703-004-5389,1670.7069,4,3,1,0.6139664469347265
19528,703-004-5395,6564.43,5,2,3,0.6262888385541743
19554,703-004-5380,4409.296,7,3,4,2.6463148523764732
19687,703-004-5381,4282.3174,2,2,0,1.2660612917415484
19790,703-004-5397,8932.693,5,2,3,0.6351884570457493
19960,703-004-5397,3966.4602,4,0,4,0.27920371738274696
20,703-004-5399,4698.0693,2,1,1,1.2477774659266745
20004,703-004-5387,6955.0376,6,2,4,0.6936330004494796
20524,207-008-2399,4274.516,6,4,2,1.6206324204510094
20584,703-004-5393,5891.6777,3,0,3,0.27920371738274696
21461,703-004-5395,2838.0442,3,1,2,0.6767970252269093
21595,703-004-5387,6085.541,4,0,4,0.27920371738274696
22390,703-004-5391,2475.4382,3,1,2,0.9622759129040153
22750,703-004-5390,3122.3296,10,6,4,3.133553917073126
2285,703-004-5391,546.1502,3,2,1,1.15956090619691
22851,703-004-5393,8092.313,3,2,1,0.5884453054486721
22944,703-004-5397,4413.714,6,2,4,0.749858792293708
23436,703-004-5397,6885.5767,3,2,1,0.829998867926083
2345,703-004-5399,5820.688,5,2,3,0.487850328685229
23483,703-004-5384,487.9141,2,1,1,0.3978652972704144
23603,703-004-5380,9905.855,3,2,1,0.8725893868877774
23618,703-004-5394,7035.535,5,3,2,0.6308791145876682
23760,703-004-5382,2134.193,1,1,0,0.4006692038855996
24380,703-004-5395,8730.716,4,3,1,1.2718112743883767
24555,703-004-5396,8373.844,6,3,3,1.2168366339058163
24737,703-004-5390,5992.119,2,1,1,0.5014799862501207
24949,703-004-5390,5906.6694,4,1,3,0.44026787367913217
26188,703-004-5395,276.91483,1,1,0,0.3978652972704144
26467,703-004-5385,6778.391,3,0,3,0.27920371738274696
26539,207-008-2399,7904.8545,3,3,0,0.6867162447537661
27039,703-004-5389,4912.8604,5,2,3,0.4805658261421249
27361,703-004-5390,3508.472,5,2,3,0.8472036093287103
27382,703-004-5385,7784.713,10,3,7,3.8323079253968704
27475,703-004-5381,4129.646,1,0,1,0.27920371738274696
27481,207-008-2398,7673.431,4,3,1,1.0095046478231402
27483,703-004-5395,9668.529,4,2,2,0.777443661232343
27583,703-004-5386,1250.4452,5,1,4,0.7395866750370168
27610,703-004-5381,7922.4717,7,3,4,1.0915708542365279
27647,703-004-5384,8967.17,5,4,1,2.32521621443755
2830,703-004-5394,9766.124,"","","",0.27920371738274696
28533,703-004-5397,6807.7397,2,0,2,0.27920371738274696
28776,703-004-5388,5112.9897,3,1,2,0.45996997160211445
28901,703-004-5391,8535.94,4,3,1,0.8219649492337335
28937,703-004-5391,9257.33,4,1,3,0.35831143730785864
29156,703-004-5394,7484.917,4,2,2,0.7707066216670594
29295,703-004-5399,6626.195,4,1,3,0.5206988397641173
29402,703-004-5396,6010.937,4,1,3,0.4247800444357455
29895,703-004-5383,6266.06,4,1,3,0.5610999834655963
29939,703-004-5391,5903.782,5,3,2,1.1774513965759215
2995,207-008-2399,1949.9951,1,0,1,0.27920371738274696
30111,703-004-5389,7863.135,5,3,2,1.7797176314558956
30322,703-004-5390,5897.584,3,3,0,1.1102751120557022
30744,703-004-5393,9020.586,2,1,1,0.7083968906544127
30772,207-008-2398,2347.185,7,4,3,1.798239380236965
31349,703-004-5396,3844.0715,3,2,1,1.4314362690305347
31407,703-004-5382,3625.413,6,3,3,1.7959920784986623
31464,703-004-5395,3673.2173,5,2,3,1.621817566085055
31561,703-004-5389,7332.5205,3,1,2,6.439186003610353
31704,703-004-5385,4224.1304,4,2,2,1.1258024887692073
31793,703-004-5384,7727.331,4,1,3,0.5608312930419322
31975,703-004-5393,8678.31,2,1,1,0.4181039019107019
32046,703-004-5393,3872.7427,3,2,1,1.2068612615507965
32120,703-004-5382,9593.2295,"","","",0.27920371738274696
32182,703-004-5395,9162.211,2,0,2,0.27920371738274696
32511,703-004-5387,5632.529,"","","",0.27920371738274696
32792,703-004-5381,6742.429,3,1,2,0.69964576964072
33155,703-004-5384,1279.9883,3,2,1,0.8094597330787129
33235,703-004-5388,8763.809,2,0,2,0.27920371738274696
33441,703-004-5380,5950.9097,1,0,1,0.27920371738274696
33566,703-004-5398,5249.934,7,4,3,1.508878230374075
33807,703-004-5387,1249.4529,1,1,0,0.3271627725873459
34058,703-004-5384,5698.485,3,1,2,0.35831143730785864
34176,703-004-5392,3316.288,7,3,4,0.7783821483930802
34315,703-004-5389,2928.8042,6,1,5,0.8366261145932543
34604,703-004-5389,2904.4683,3,1,2,2.0342328006461963
34658,703-004-5383,821.9117,6,0,6,0.27920371738274696
35183,703-004-5391,5180.476,3,1,2,0.3978652972704144
35424,703-004-5387,3961.0808,3,2,1,0.6209621206065323
35471,703-004-5383,486.7047,4,2,2,0.7130957114124411
36400,703-004-5387,2918.7422,1,1,0,0.703942365137888
36581,703-004-5390,6833.107,6,2,4,0.6694815505750028
36713,703-004-5392,2447.4346,3,3,0,1.1744901912019143
36802,207-008-2399,3709.314,3,0,3,0.27920371738274696
36809,703-004-5397,4042.502,3,0,3,0.27920371738274696
36940,703-004-5392,4052.2385,2,1,1,0.6173892200625992
36949,703-004-5380,2396.7922,2,1,1,0.39753897792572335
37029,207-008-2399,3652.063,2,1,1,0.335311180285758
37386,703-004-5391,2375.158,1,0,1,0.27920371738274696
37559,703-004-5381,4638.0605,4,2,2,1.0183930294250465
37761,703-004-5387,3086.0347,3,3,0,2.5722537338290232
37974,703-004-5394,6086.0645,4,3,1,1.6258343519312164
37992,703-004-5396,7318.644,3,2,1,1.1845034150355476
38112,703-004-5395,225.68106,5,3,2,1.050929625874715
39209,703-004-5385,8534.955,4,3,1,1.5109994604530264
39503,703-004-5399,3487.693,1,1,0,0.7792038315637101
39553,207-008-2398,2797.947,5,1,4,0.818811770648962
39619,703-004-5391,8285.699,5,1,4,0.393510119491447
40252,703-004-5396,7980.418,1,1,0,0.9763855442034817
4048,207-008-2399,6944.705,3,1,2,0.35831143730785864
40655,207-008-2399,3998.2646,6,3,3,0.6036936682604626
40683,703-004-5387,4202.4155,3,2,1,1.0117850961770272
40796,703-004-5387,9320.542,3,1,2,0.35831143730785864
41415,703-004-5390,5868.697,2,0,2,0.27920371738274696
41539,703-004-5380,301.92615,8,2,6,1.013503057909648
41812,703-004-5395,9417.361,9,3,6,1.500517432539715
41834,703-004-5385,6655.9624,2,1,1,0.7579011232926379
41886,207-008-2398,906.75653,3,1,2,0.48220157491416465
41912,703-004-5383,8134.191,4,2,2,1.6226991760219065
42042,703-004-5393,2533.272,8,8,0,3.367457100309351
4218,703-004-5390,1588.3463,3,0,3,0.27920371738274696
42236,703-004-5387,2053.824,"","","",0.27920371738274696
42259,207-008-2399,6868.7886,4,1,3,0.3978652972704144
42271,703-004-5392,7122.236,4,2,2,0.47697301719552604
42475,703-004-5395,8764.944,3,3,0,0.6449170680719052
42543,703-004-5393,7611.658,4,2,2,0.7753069052699251
42781,703-004-5380,9576.542,1,1,0,0.9333330613016372
4293,703-004-5385,7853.5884,6,3,3,0.8933799932603865
43371,703-004-5394,1211.1628,3,1,2,0.7435738597275668
43876,703-004-5396,3798.389,2,0,2,0.27920371738274696
43919,207-008-2398,2707.1362,4,3,1,0.8891512047864452
44283,703-004-5387,9689.016,4,2,2,0.7273480364463372
44458,703-004-5380,8505.681,2,0,2,0.27920371738274696
44567,703-004-5398,9323.807,7,3,4,2.4511919195304737
44655,703-004-5388,3925.153,5,1,4,0.3131070259220805
44705,207-008-2399,8318.454,6,2,4,1.1333942305672102
44907,703-004-5393,2993.5378,4,4,0,0.7322480533983249
45049,703-004-5384,8291.356,4,2,2,1.2072424215859137
4518,703-004-5382,6264.3276,2,0,2,0.27920371738274696
45475,703-004-5390,2536.0261,5,1,4,0.35831143730785864
45551,703-004-5396,2435.1108,4,1,3,0.7959898999381328
46000,703-004-5393,404.80734,3,2,1,0.9069602936128766
46188,703-004-5387,7440.0244,3,2,1,1.1697669455954733
46269,703-004-5384,6733.411,4,1,3,0.6155815208441436
46461,703-004-5385,8728.831,8,3,5,0.9515502009311236
46813,207-008-2398,3050.2427,1,1,0,0.43863912738783994
47232,703-004-5397,4061.6245,5,2,3,0.81236379361476
47366,703-004-5388,5891.2764,6,3,3,0.680450847237622
47462,207-008-2399,3307.4893,6,2,4,0.9015293173361144
47734,703-004-5398,6539.769,3,2,1,1.2010077052467898
47792,703-004-5396,4081.896,3,3,0,1.3120239117595913
48004,703-004-5391,8217.143,6,3,3,2.080672262056836
48146,703-004-5396,5658.437,3,1,2,0.4821238774072124
48267,703-004-5397,5111.2344,4,0,4,0.27920371738274696
48284,703-004-5384,5415.472,2,1,1,0.5518196079013644
48424,703-004-5399,3693.5771,4,1,3,0.8624899588510458
48706,703-004-5385,4866.933,4,2,2,0.6504021006205185
48760,703-004-5396,7103.6377,3,1,2,0.4814745108646583
48774,703-004-5392,6508.128,2,2,0,1.671689022451749
49061,703-004-5398,5391.4487,5,2,3,0.8419759027146799
49382,703-004-5398,1979.962,2,2,0,1.3381778188058457
49472,703-004-5386,9709.096,3,2,1,2.5425326861115187
49474,703-004-5389,7970.5317,2,2,0,0.9330625464315112
49563,703-004-5396,1897.4579,2,2,0,0.9028937658243839
5202,703-004-5383,405.79797,5,1,4,0.40955511096684816
5448,703-004-5397,4861.9204,4,2,2,0.7549879000784662
561,703-004-5390,6517.6826,8,3,5,1.097778184441687
5707,703-004-5380,605.8258,2,1,1,0.6171608873084674
5999,703-004-5384,1914.543,3,1,2,0.6086169746987089
600,207-008-2398,3532.037,2,1,1,0.7150964225489487
6022,703-004-5383,8971.938,5,3,2,0.7234715100598753
6043,703-004-5390,8160.1274,3,0,3,0.27920371738274696
6084,207-008-2399,5325.365,4,1,3,0.3401166617250829
6132,703-004-5384,2757.9497,6,3,3,1.5290522275142
6416,703-004-5399,9353.548,4,2,2,1.0505635650884129
6530,703-004-5380,9322.52,6,3,3,0.8762865510029602
6569,703-004-5385,976.1381,2,2,0,0.5370701631761343
680,703-004-5398,8925.242,1,1,0,1.2364304225983662
7443,703-004-5399,3266.8054,3,0,3,0.27920371738274696
7503,703-004-5397,4728.562,3,1,2,0.7182515629671166
7603,703-004-5384,7933.466,3,0,3,0.27920371738274696
7837,703-004-5399,6313.858,1,1,0,0.40501323647221704
8015,207-008-2398,4456.9165,1,1,0,0.571202538369976
8028,703-004-5398,2570.1504,5,2,3,3.1627558187998788
8156,703-004-5387,8744.964,2,1,1,0.5321179706973056
8270,703-004-5394,7064.284,3,1,2,0.614342782548703
8294,703-004-5393,3332.684,"","","",0.27920371738274696
8537,703-004-5382,2777.4065,2,1,1,0.6184062852907382
8602,703-004-5385,8299.965,3,0,3,0.27920371738274696
9370,703-004-5399,4942.459,1,0,1,0.27920371738274696
9819,703-004-5386,8403.044,3,3,0,2.0487195827227067
10343,703-004-5387,1480.2736,6,6,0,1.691148608270537
10361,703-004-5387,8705.724,3,1,2,0.44829646872267315
10599,703-004-5382,8599.025,3,2,1,1.0893636768064472
10674,703-004-5393,4211.3545,5,2,3,1.1716234574366349
1072,703-004-5395,4516.7197,2,0,2,0.27920371738274696
10783,703-004-5387,8083.225,4,2,2,1.1874597103509352
11907,207-008-2399,9346.333,5,1,4,0.3187575773453028
11996,703-004-5391,2455.8186,5,4,1,3.220062693542701
12249,703-004-5384,4072.6072,2,0,2,0.27920371738274696
12340,703-004-5397,2045.8048,3,1,2,0.8670218896744936
12878,703-004-5391,3167.883,5,4,1,1.15824850601762
13207,703-004-5383,9263.955,4,2,2,0.7818781578219219
13226,703-004-5397,1954.0697,3,0,3,0.27920371738274696
13231,703-004-5389,7580.677,7,5,2,1.3770357656105443
13311,703-004-5383,7129.902,2,0,2,0.27920371738274696
13585,703-004-5385,6366.319,5,4,1,3.208057546727772
13646,703-004-5395,755.3935,7,5,2,0.903232423096305
13732,703-004-5381,1750.747,5,1,4,0.3975356817707265
13734,703-004-5388,9453.797,3,1,2,0.4381012006905436
13790,703-004-5387,8013.535,3,1,2,0.3468408179187174
13818,703-004-5397,3023.2644,3,0,3,0.27920371738274696
14316,703-004-5388,4433.8755,3,1,2,0.35534489781066697
14584,703-004-5389,8675.913,2,1,1,0.48128300729257484
14719,703-004-5389,1823.5051,5,4,1,1.2080794746177672
14857,703-004-5389,3328.1355,4,1,3,0.4740690096025948
15011,703-004-5396,3397.2334,5,4,1,2.33744494193683
15183,703-004-5387,7211.977,2,2,0,0.6492285923405643
1587,703-004-5395,5086.6807,1,0,1,0.27920371738274696
16057,703-004-5388,6292.0566,4,2,2,0.6148530521673956
16115,703-004-5396,6320.8584,7,1,6,1.0419317714511063
16254,703-004-5391,8392.392,7,4,3,1.8033936972294808
16344,703-004-5395,7610.771,6,2,4,1.1901847214802754
16438,703-004-5390,9163.937,3,2,1,0.5016145505021948
1650,703-004-5383,1599.4329,6,3,3,0.6823780798022434
16623,703-004-5396,4405.3726,6,3,3,0.7548312612947535
16963,703-004-5386,9845.202,3,3,0,0.8869716926436838
16990,207-008-2399,2561.0823,3,1,2,0.5754501585311356
1701,703-004-5396,8226.154,4,2,2,0.9474156981019904
17108,703-004-5395,1119.6155,6,4,2,2.4885263482153297
17205,703-004-5391,9914.039,3,2,1,0.7049349546331256
17406,703-004-5395,792.8425,6,4,2,2.7065969111351866
17624,703-004-5380,9605.111,6,2,4,1.0823139226054588
17880,703-004-5388,7538.308,3,2,1,0.6453923094721458
17973,703-004-5386,1931.4003,2,1,1,0.52147723758966
18016,703-004-5383,4677.9985,5,1,4,0.8355233857908357
18024,703-004-5385,6458.333,3,2,1,1.0114654450220373
18073,207-008-2398,3521.3994,3,1,2,0.35831143730785864
18198,703-004-5390,8783.707,5,2,3,1.0521006540227096
18409,703-004-5398,3965.54,3,2,1,1.1028240008254875
18457,703-004-5390,4808.158,3,3,0,1.1641873982569437
18733,703-004-5399,7527.4956,3,1,2,0.35114230018964543
19161,703-004-5382,5652.3203,2,0,2,0.27920371738274696
19288,703-004-5382,694.0508,2,0,2,0.27920371738274696
19427,703-004-5395,1570.465,8,3,5,1.2676298910131145
19476,703-004-5399,509.39322,5,1,4,0.36951836429724944
19616,703-004-5389,8320.214,4,2,2,1.1136524233698566
19758,703-004-5390,2933.849,"","","",0.27920371738274696
19836,703-004-5380,1603.9753,3,1,2,0.3649094745402494
1986,703-004-5385,2904.3914,4,0,4,0.27920371738274696
19888,703-004-5399,8758.974,6,4,2,1.0509768163369801
20483,703-004-5397,1795.6328,4,2,2,0.6789427063514023
20501,703-004-5398,1825.7677,2,1,1,0.33853450732658075
20791,703-004-5397,2505.3066,3,2,1,0.7732218923035024
2120,703-004-5384,3858.0989,1,1,0,0.4474442264842623
21244,703-004-5385,2468.605,"","","",0.27920371738274696
21266,703-004-5388,7222.128,1,1,0,0.6676767322104049
21427,703-004-5380,1808.5039,2,2,0,0.8904805700285029
21445,703-004-5389,8270.16,1,0,1,0.27920371738274696
21577,703-004-5383,2180.9102,5,2,3,1.1234454626777106
21661,703-004-5387,2804.4058,9,5,4,2.44249783896663
21878,703-004-5383,4027.942,7,2,5,0.5829419300839206
22117,207-008-2398,6320.0786,7,6,1,1.693393174286007
22259,703-004-5380,489.5079,2,0,2,0.27920371738274696
22353,207-008-2399,2767.6707,3,1,2,1.7871273301370263
22539,703-004-5394,9860.371,2,1,1,0.32666834933781397
23201,703-004-5399,2879.3704,2,1,1,0.3488507255148782
23411,703-004-5397,3256.305,9,5,4,1.3414486293146597
23417,703-004-5383,5954.341,1,0,1,0.27920371738274696
23447,703-004-5389,2626.6802,4,1,3,0.8005296394276701
23485,703-004-5388,8486.277,4,2,2,0.4068405675289348
23490,703-004-5399,8192.415,3,1,2,0.33853450732658075
23920,703-004-5388,5755.3887,6,4,2,0.87567637567648
23940,703-004-5393,6748.1626,"","","",0.27920371738274696
24077,703-004-5398,4542.643,3,2,1,0.5806924661293217
24236,703-004-5399,7553.9736,5,3,2,2.2177535724515343
24572,703-004-5384,5524.063,3,2,1,1.5926074936318564
24714,703-004-5390,2993.067,6,2,4,0.7503703497211585
24842,207-008-2399,2226.4766,6,3,3,1.6829742229040894
24963,703-004-5395,3396.0366,4,2,2,0.5106546499913948
25089,703-004-5382,7012.7974,7,5,2,3.7030227916151004
25113,703-004-5387,6103.8613,2,0,2,0.27920371738274696
2514,703-004-5384,7878.405,5,3,2,0.9091359861471545
25422,703-004-5398,2166.3904,5,4,1,0.641010081750519
25743,703-004-5386,2332.403,8,3,5,0.8776699720032635
25758,703-004-5387,2196.5234,1,1,0,0.32666834933781397
26090,703-004-5395,426.56778,6,4,2,1.1741874425400418
2634,703-004-5382,2850.6816,4,0,4,0.27920371738274696
26620,703-004-5387,1077.4905,3,1,2,0.47400546049116826
26936,703-004-5384,4593.9194,6,3,3,1.712241866757143
27055,703-004-5389,8461.184,2,1,1,0.5346331423417869
27084,703-004-5395,5404.3164,"","","",0.27920371738274696
27115,703-004-5399,8257.746,8,6,2,2.9169029850178303
27348,703-004-5383,4110.3984,5,3,2,0.8797467572418708
27379,207-008-2399,6905.213,8,3,5,1.1096324150427141
2742,703-004-5399,6765.9287,5,4,1,1.4593385805517258
27682,703-004-5388,3034.5059,8,3,5,1.0418053880888865
27818,703-004-5385,926.9893,5,1,4,0.6791561143880585
27867,703-004-5382,4530.459,7,2,5,0.6912745985347234
28124,703-004-5387,9603.338,1,1,0,1.2376690286633927
28973,703-004-5383,6883.148,3,3,0,0.9685282656805375
29052,703-004-5391,794.6068,7,2,5,1.177243613931378
29831,703-004-5395,9673.64,5,1,4,0.526438734474938
30602,703-004-5390,7843.257,4,3,1,0.5034257837982811
30647,703-004-5387,9800.805,7,4,3,0.875801861122903
30648,703-004-5396,9526.337,6,3,3,0.9046875611098247
30791,703-004-5394,261.19232,4,1,3,0.5220539956278838
31230,703-004-5390,8037.079,2,0,2,0.27920371738274696
3124,703-004-5398,4680.405,6,4,2,1.0563335337863915
31355,703-004-5384,7575.0435,2,1,1,0.37170689188200606
31398,703-004-5399,4239.9126,7,4,3,0.7739872584751597
31657,703-004-5393,1623.7795,4,2,2,0.8922440448566902
3180,703-004-5382,424.28552,2,0,2,0.27920371738274696
31861,703-004-5383,2809.4648,1,1,0,0.43444993285250233
32190,703-004-5394,1997.4846,7,3,4,0.9413388059138795
32307,703-004-5385,3371.3252,10,7,3,3.1473120669594947
32375,207-008-2398,6610.134,3,3,0,3.3591407540130946
32399,703-004-5387,1675.2935,4,2,2,1.8152497272202122
3265,703-004-5382,4657.026,4,4,0,1.305532821184888
32898,703-004-5391,9004.584,4,1,3,0.7019898753464755
32995,703-004-5393,8484.903,1,0,1,0.27920371738274696
33749,703-004-5386,2851.8015,5,3,2,1.3153769251277243
33882,703-004-5390,2434.252,6,0,6,0.27920371738274696
34130,703-004-5380,7071.471,5,4,1,1.2480700342909377
342,703-004-5399,3721.6414,3,2,1,0.4659968210559169
34721,703-004-5386,4810.6235,5,3,2,0.8839344948452033
34774,703-004-5383,7069.2393,4,4,0,2.750582084039524
34788,703-004-5391,5325.2153,3,2,1,2.743425621078473
34858,703-004-5380,5251.316,5,4,1,3.0685634558716157
35205,703-004-5393,6219.7437,5,1,4,0.5740184126136567
35260,703-004-5390,6431.0854,3,1,2,0.39175924443767807
35610,207-008-2398,1644.8528,4,3,1,0.8622920324503832
35673,703-004-5391,2905.5596,2,0,2,0.27920371738274696
35897,703-004-5395,1528.9891,2,2,0,0.4518167081015827
35930,703-004-5392,380.53632,6,3,3,1.2130285225050328
36223,703-004-5384,8984.536,4,2,2,0.6557591904211403
36238,703-004-5385,3215.586,2,2,0,0.6382505539649406
3714,703-004-5386,2099.9216,6,2,4,1.2500258074520054
38103,703-004-5383,5631.574,4,2,2,1.23289678543172
38617,703-004-5396,6484.8022,2,0,2,0.27920371738274696
39051,207-008-2399,4627.3315,6,3,3,0.7610997601724637
39677,703-004-5387,9611.889,5,4,1,0.9591590399803118
39953,703-004-5385,3548.0286,3,1,2,0.5671648824181036
40159,703-004-5390,643.74506,3,2,1,0.5306013495383076
40245,703-004-5384,6509.631,2,1,1,0.44750585504521845
40818,703-004-5383,8447.752,4,1,3,0.4384940505908422
40966,207-008-2398,7009.861,4,3,1,1.2852398987845204
41061,703-004-5395,892.4502,6,2,4,0.8242775850361128
41076,703-004-5385,7037.967,6,1,5,0.5165268771580819
41322,703-004-5382,3080.5278,3,3,0,1.1110038831649665
41345,703-004-5385,1914.7104,4,1,3,0.38528840586044555
41433,703-004-5387,779.1978,7,6,1,3.2950441710554825
41559,703-004-5383,7491.3975,6,4,2,1.0444520344317803
41676,207-008-2399,6116.712,7,4,3,1.3356490198306377
41857,703-004-5397,9559.747,3,0,3,0.27920371738274696
41879,703-004-5399,191.58482,5,3,2,2.5424603182198795
41930,703-004-5384,1587.8213,4,2,2,0.8124739811574863
41950,207-008-2399,2696.309,4,2,2,1.8826128858004378
42075,703-004-5395,4879.385,4,1,3,0.33853450732658075
42216,703-004-5388,3457.9724,3,1,2,0.5206152891755371
42235,703-004-5386,3035.2456,4,2,2,0.6140223284789034
42388,703-004-5394,3380.531,9,7,2,1.6243282547364368
42630,703-004-5395,7968.367,5,3,2,1.0587207291176073
42778,703-004-5398,4170.352,3,2,1,1.0573923855134142
42829,703-004-5391,6630.7046,2,0,2,0.27920371738274696
42915,207-008-2399,5309.1997,3,3,0,0.7660471884850768
43011,703-004-5392,3220.371,8,6,2,2.2073915825872867
4303,703-004-5381,5250.118,7,2,5,0.5417424628842112
43412,703-004-5398,8938.913,5,3,2,1.2777306204611285
43460,703-004-5392,8942.076,3,0,3,0.27920371738274696
43579,703-004-5385,361.91464,3,1,2,0.49473517243496123
43772,703-004-5391,6379.6963,3,0,3,0.27920371738274696
43862,703-004-5395,3485.8357,6,1,5,0.567335419593398
44265,703-004-5397,2265.011,1,0,1,0.27920371738274696
44371,703-004-5394,754.3635,3,2,1,1.3306267231804254
44905,703-004-5396,8350.498,4,0,4,0.27920371738274696
45092,703-004-5386,2815.4111,1,1,0,1.2125570257906306
45213,703-004-5386,3473.2937,5,2,3,1.0235844936560545
454,703-004-5397,7969.8525,6,4,2,1.6794020829653418
45487,703-004-5387,2890.5935,3,2,1,0.5709974442723229
45580,703-004-5398,8783.557,4,3,1,3.4427878457242054
45707,703-004-5398,5169.5806,5,2,3,1.2417078749141508
4586,703-004-5383,247.78545,3,1,2,0.33872490147958795
45960,703-004-5382,6469.2847,1,0,1,0.27920371738274696
46080,703-004-5396,9891.637,4,2,2,0.6503318031121916
46110,703-004-5392,2103.309,4,2,2,0.7686400855071298
46310,703-004-5392,8137.7573,6,3,3,2.089157253054643
46476,207-008-2399,3383.5256,6,4,2,1.509732192786322
46709,703-004-5380,3706.8325,9,5,4,3.2297235477872106
46732,703-004-5389,5074.181,4,3,1,0.9574377429268011
4705,703-004-5384,4910.095,6,4,2,1.1314504636192613
47112,703-004-5384,5593.3325,7,1,6,0.469729716589883
47181,703-004-5386,4076.6377,4,1,3,0.5379873768058173
472,703-004-5399,5489.141,2,2,0,1.2450260485444231
4726,703-004-5381,9704.126,1,1,0,0.3971434393260978
47261,703-004-5399,1462.5609,2,1,1,0.36287606681374174
47518,207-008-2398,7899.908,10,4,6,1.414501091727681
47530,703-004-5389,7153.7144,3,3,0,0.9823418791021099
47651,703-004-5387,6585.6523,2,0,2,0.27920371738274696
48072,207-008-2399,36.494137,2,1,1,1.3080217514669923
48095,703-004-5399,7469.5117,4,1,3,0.5721068742334396
48296,207-008-2399,7.132292,3,2,1,1.5930177963016545
48499,703-004-5385,8698.426,5,2,3,1.0454681787310653
48588,703-004-5392,3465.2292,7,3,4,1.3235764662462715
48626,703-004-5380,7201.0386,3,2,1,1.8709984345217363
48658,703-004-5380,5784.644,4,2,2,1.0867686727715402
48941,703-004-5394,6097.952,1,1,0,0.8020732699327169
49109,703-004-5392,2953.4692,5,2,3,2.601159956052506
49411,703-004-5394,5330.4395,2,0,2,0.27920371738274696
49609,703-004-5395,783.1639,3,1,2,0.515737686042041
49705,703-004-5393,4426.6387,3,2,1,0.5105937981636984
5124,703-004-5383,6617.8286,4,1,3,0.4180377658513179
5160,703-004-5398,8679.757,3,3,0,1.233846936384958
5356,703-004-5396,2338.2969,4,2,2,1.3472869051879899
6073,703-004-5391,3133.157,6,3,3,0.9617162562579632
6199,703-004-5396,9800.58,6,5,1,2.502842967598284
6225,703-004-5393,7790.9546,3,2,1,0.6084439556207819
6322,703-004-5386,2446.868,3,3,0,0.9222623460975661
6409,703-004-5389,5375.5786,2,1,1,1.1238468885101636
6450,703-004-5388,9168.24,2,2,0,1.251463593958262
6554,703-004-5394,9881.502,7,4,3,1.1243811488949589
681,703-004-5398,5773.802,2,1,1,0.6575882819446234
7526,703-004-5396,3260.8442,3,0,3,0.27920371738274696
769,703-004-5386,7840.476,4,2,2,0.6160692354572062
7851,703-004-5387,2522.1675,6,3,3,0.8354511232111053
8435,703-004-5389,716.8126,4,2,2,1.5935771233173952
859,703-004-5387,4057.5386,2,1,1,0.36815297947202014
8748,703-004-5389,9062.909,"","","",0.27920371738274696
9236,703-004-5383,8180.8975,8,4,4,1.9196729574899893
9277,703-004-5382,4507.918,5,3,2,1.0749345169225102
9287,703-004-5390,5346.8037,6,5,1,2.061663964813086
9651,703-004-5397,1762.1243,7,4,3,1.0682565546433906
9826,703-004-5394,1608.0665,4,1,3,0.3978652972704144
9877,703-004-5394,4219.3516,6,4,2,1.646846331943456
9889,703-004-5398,9939.625,4,1,3,0.7696483796907827
10020,703-004-5381,742.4605,2,1,1,0.6936237910754444
10032,703-004-5391,3262.3523,2,1,1,0.5247151613668668
10053,703-004-5398,1864.2002,4,1,3,0.4398418311556768
10222,703-004-5397,2488.4165,4,4,0,1.668263305078279
10550,703-004-5383,414.55508,4,1,3,0.40071141380489195
10816,703-004-5385,7373.339,6,3,3,1.6964391026014438
11277,207-008-2399,7512.57,4,3,1,0.8747275360616945
11301,703-004-5381,8115.0557,1,0,1,0.27920371738274696
11630,703-004-5389,9382.8545,1,1,0,0.6581868174907854
11791,703-004-5394,3114.646,1,1,0,0.32666834933781397
11923,703-004-5380,4102.4517,4,0,4,0.27920371738274696
11997,703-004-5397,9103.711,3,2,1,0.4985230305577329
12004,703-004-5388,7423.909,1,0,1,0.27920371738274696
12260,703-004-5381,5261.8066,1,0,1,0.27920371738274696
12352,703-004-5382,637.7423,2,1,1,0.3978652972704144
13206,703-004-5390,3003.8726,6,2,4,0.6533520671716454
13218,703-004-5380,9067.567,3,0,3,0.27920371738274696
13355,207-008-2398,450.09793,2,2,0,0.7596701388270465
14128,703-004-5389,723.9169,3,2,1,0.6163524385491299
14131,207-008-2399,3736.0137,2,2,0,0.5133445397590125
14494,703-004-5381,473.95706,3,1,2,0.5790272370504237
14752,703-004-5394,2431.287,6,3,3,1.76945287205284
14826,207-008-2398,3430.3577,5,3,2,1.459301289995185
14900,703-004-5388,6909.2095,2,1,1,0.6412267762380979
15088,703-004-5398,3335.6167,3,2,1,0.9369558614122138
15480,703-004-5391,961.32574,3,2,1,1.021790526894634
15725,703-004-5388,5433.652,7,3,4,1.7378126932347664
15742,207-008-2398,2255.2258,5,3,2,1.810941936668302
15794,703-004-5392,696.8558,6,2,4,0.7429329928861894
15924,703-004-5395,4069.1382,5,4,1,1.924257715589285
15957,703-004-5387,7530.2485,1,1,0,0.4336261064892285
16171,703-004-5386,9243.881,7,5,2,1.3731691203131446
16285,703-004-5393,4159.7305,3,2,1,0.7497534844463606
1660,703-004-5381,7738.9253,5,3,2,0.7168111901118209
16760,703-004-5382,8380.084,1,1,0,0.9639007146300157
16948,703-004-5389,6375.454,5,3,2,0.7610254961860553
16979,703-004-5390,9214.349,3,3,0,1.800486677714482
17136,703-004-5395,560.4881,5,4,1,1.6263277637196667
17429,703-004-5391,2806.4941,10,6,4,2.9197116002843853
17449,703-004-5384,8572.776,2,0,2,0.27920371738274696
17554,703-004-5392,9337.467,"","","",0.27920371738274696
17566,703-004-5388,3511.7607,3,2,1,0.5685317035334375
17728,703-004-5383,6672.17,8,6,2,4.415646341557731
17939,703-004-5399,5716.5684,7,3,4,1.2444082918423554
18000,703-004-5394,8796.277,5,3,2,1.7187786996735912
18183,703-004-5383,3365.686,6,3,3,1.2619459335643792
18268,703-004-5380,3283.863,7,3,4,1.2824856928246937
18274,703-004-5380,4357.2603,5,1,4,0.3978652972704144
18363,703-004-5382,3451.8003,3,3,0,1.3859434642935622
18819,703-004-5381,3956.4067,4,2,2,0.8989592792881688
18824,703-004-5396,2107.113,1,0,1,0.27920371738274696
18916,703-004-5392,212.50963,1,1,0,0.33853450732658075
19154,703-004-5394,3178.5137,3,3,0,1.9347985596200545
19158,703-004-5388,7724.642,1,1,0,0.32666834933781397
19318,703-004-5397,7805.527,6,2,4,0.7878331874804533
19359,703-004-5398,4039.1826,2,1,1,0.8521566598007856
19448,703-004-5393,1276.7655,3,2,1,1.2059041510318067
19639,703-004-5397,9930.6455,3,1,2,0.7377710381587756
19645,703-004-5396,9995.169,5,1,4,0.3870758832472951
19703,703-004-5395,1336.9852,2,2,0,0.6583477778226079
19742,703-004-5387,1321.0315,6,4,2,1.3832340622192292
19850,703-004-5394,7662.88,6,1,5,0.7182515629671166
20559,703-004-5392,2726.808,2,0,2,0.27920371738274696
2063,703-004-5383,6091.9453,2,2,0,0.8410405164029577
20634,703-004-5399,4878.797,4,2,2,0.47024673027312575
20691,703-004-5397,7126.3086,2,1,1,0.4408998969096752
20700,703-004-5399,9722.673,5,1,4,0.3978652972704144
20857,703-004-5394,7561.777,4,2,2,0.814412308008114
20885,703-004-5395,6684.8164,4,1,3,0.531694356866686
21038,703-004-5396,2706.8179,3,1,2,0.7426538152377011
2104,703-004-5397,4741.6157,4,3,1,1.8759662915217972
21165,703-004-5386,5374.8906,3,0,3,0.27920371738274696
21167,703-004-5388,2659.341,5,2,3,1.0022306052851913
21281,703-004-5398,5877.427,3,1,2,2.151053812058002
21304,703-004-5388,809.6886,3,2,1,0.8844103085774238
21374,703-004-5383,9643.405,2,1,1,0.4206824740278613
2150,703-004-5391,9730.74,2,1,1,1.006464608752529
21574,703-004-5384,4594.9014,1,1,0,0.511060094186223
21759,703-004-5389,6182.5513,4,0,4,0.27920371738274696
22120,207-008-2398,64.49163,3,2,1,0.4978376577248056
22170,703-004-5385,4827.416,4,3,1,0.9452585837622541
22178,703-004-5389,8679.976,4,1,3,0.33853450732658075
22189,703-004-5390,1686.1617,4,2,2,0.839084757188555
22430,703-004-5388,65.63068,4,2,2,0.5783933167371402
22622,703-004-5388,162.91261,4,3,1,3.381678798898761
22814,703-004-5384,6265.976,4,1,3,0.38965254254427256
22877,703-004-5383,9927.393,3,2,1,0.5057814118682543
23048,703-004-5380,6698.2446,6,4,2,2.167165705073593
2332,703-004-5397,9697.454,7,4,3,1.3861236375489492
23325,703-004-5386,9039.316,4,2,2,1.9364363635860247
23341,703-004-5391,4363.762,9,7,2,2.0489543384855455
23505,703-004-5385,6193.7915,1,1,0,0.5585400572297138
23538,207-008-2398,9292.005,3,1,2,1.0647166775462815
24182,703-004-5383,1516.7487,1,0,1,0.27920371738274696
24272,703-004-5380,102.549194,2,2,0,0.8935947250193422
24502,703-004-5386,5769.6987,"","","",0.27920371738274696
24595,703-004-5389,4609.2827,1,1,0,0.4841291614799076
24791,703-004-5396,9053.148,4,2,2,0.5258105275068022
25048,703-004-5383,3676.657,"","","",0.27920371738274696
25303,703-004-5398,1766.3646,4,2,2,0.6770622787720202
25495,207-008-2399,1675.6714,2,0,2,0.27920371738274696
26087,703-004-5394,8427.723,4,2,2,0.5320760469343984
2615,703-004-5399,8976.974,4,1,3,0.36925762470301704
26170,703-004-5388,5522.5835,4,2,2,0.9166383919077707
26404,703-004-5384,536.16583,2,2,0,0.5496530670778151
26405,703-004-5396,590.46564,2,1,1,0.8750834023949983
26441,703-004-5390,7557.4736,3,3,0,2.2722858316463594
26476,703-004-5380,2071.362,3,0,3,0.27920371738274696
26553,703-004-5391,9035.89,4,3,1,0.7258158710373969
26562,703-004-5399,3044.688,3,3,0,1.5925649842980285
26623,703-004-5381,487.51474,3,2,1,1.1984629663543895
26641,703-004-5386,6611.833,4,3,1,2.1292802081734017
26991,703-004-5398,2277.2104,5,1,4,0.7671916820680745
27182,703-004-5393,4828.7505,4,1,3,0.5894215286584196
2721,703-004-5384,8616.318,5,1,4,0.3978652972704144
27564,703-004-5387,6947.1533,4,2,2,1.26189401506299
28207,703-004-5399,9025.3,4,1,3,0.3978652972704144
28365,703-004-5396,3543.2446,"","","",0.27920371738274696
28705,703-004-5397,7202.6616,2,2,0,1.0596674971242122
28764,703-004-5396,1932.1812,6,3,3,0.7744744248913971
28798,703-004-5389,6550.6226,2,1,1,0.5679200452430955
2893,703-004-5385,4726.9277,5,3,2,1.67075906061663
28930,703-004-5383,3827.4812,4,2,2,0.6141062585607086
29256,703-004-5393,6262.1016,2,0,2,0.27920371738274696
29318,207-008-2398,4339.938,5,3,2,4.800907273354227
2941,703-004-5398,3755.4353,3,2,1,0.454182852187934
29489,703-004-5392,351.87424,7,4,3,3.1090797764372553
29568,703-004-5386,1159.3336,4,2,2,0.6123461029173733
29576,703-004-5397,638.98444,3,1,2,0.4155753320589615
29753,703-004-5381,7506.4062,1,0,1,0.27920371738274696
29786,703-004-5383,9257.08,4,1,3,0.5545988570647513
29962,703-004-5385,6529.7324,6,3,3,1.203993699576298
30246,703-004-5380,656.54517,5,4,1,1.081886501928544
30539,703-004-5399,5514.5215,4,3,1,1.158018020669177
30972,703-004-5392,6058.2827,6,2,4,1.0202794425554669
31084,703-004-5388,4359.263,1,0,1,0.27920371738274696
31697,703-004-5380,7951.0957,2,0,2,0.27920371738274696
31865,703-004-5386,5310.051,2,2,0,2.250401364374526
31872,703-004-5383,2787.0244,5,1,4,0.4878322545322421
31911,703-004-5390,1338.5845,3,1,2,0.42011278225422183
31916,703-004-5390,5760.6655,2,1,1,0.4248978884385737
32204,703-004-5395,782.6364,4,2,2,0.91963695082116
32214,703-004-5389,5682.2417,1,1,0,3.0145833502250454
32379,703-004-5380,4612.789,7,3,4,0.6555336773138967
32737,703-004-5388,751.8637,4,1,3,0.3637500930527101
33013,703-004-5385,289.27386,4,1,3,0.5669966032690986
33095,703-004-5389,8676.202,2,1,1,0.7213859172743339
33141,703-004-5398,8145.1006,3,3,0,1.0302569543205375
33422,703-004-5396,8519.702,9,4,5,1.2867865474492843
34161,703-004-5398,3352.5999,2,2,0,0.7627936329244938
34185,703-004-5394,2302.2014,5,4,1,1.339388730002893
34386,703-004-5383,7425.187,6,3,3,0.7339584007582475
34390,703-004-5389,9653.603,5,1,4,0.6494052510049758
3450,703-004-5380,629.21704,7,4,3,2.116464921845495
34584,703-004-5382,7739.195,2,0,2,0.27920371738274696
34608,703-004-5382,3206.0986,3,2,1,0.8785164353483768
34790,207-008-2399,4139.181,3,3,0,0.6218170594052841
35042,703-004-5389,5853.3765,2,1,1,0.35831143730785864
35112,703-004-5382,8963.479,6,5,1,2.3894354888530667
35156,703-004-5397,5779.5386,3,2,1,0.8406036855554767
35196,703-004-5383,4318.1016,5,0,5,0.27920371738274696
35224,703-004-5391,6268.9023,2,1,1,0.5146966381780614
35301,703-004-5384,3907.1738,1,1,0,0.3852316707925617
35577,703-004-5384,6065.077,4,3,1,1.0732663058805485
35842,703-004-5387,98.87517,8,3,5,0.7988753327292132
35863,703-004-5381,2796.75,5,0,5,0.27920371738274696
35890,703-004-5387,8189.5957,2,2,0,1.369804502111342
36083,703-004-5381,3348.0435,6,3,3,1.1265062791848954
36144,703-004-5391,3265.2961,2,0,2,0.27920371738274696
36153,703-004-5386,3286.8403,3,1,2,0.3781593139485323
36164,703-004-5393,4672.903,4,3,1,0.8950993788976404
36170,703-004-5383,5683.4526,"","","",0.27920371738274696
36391,703-004-5382,775.3545,4,3,1,1.056667136128835
3647,703-004-5385,9512.795,4,0,4,0.27920371738274696
36585,703-004-5392,3000.427,3,1,2,0.42421679105046867
36620,703-004-5397,1568.1189,2,1,1,0.5629095220819005
3664,703-004-5384,388.3463,2,1,1,0.7463481770188305
37,703-004-5397,7122.755,7,4,3,1.971814089761723
37299,703-004-5391,4067.7004,8,3,5,0.6074346764347086
37687,703-004-5391,4077.1223,2,2,0,1.463515088562267
37904,703-004-5390,8961.1455,5,4,1,1.2900292565635758
38019,703-004-5383,2536.4644,4,1,3,0.7101196475601432
38054,703-004-5392,3630.4038,3,1,2,1.2848138506739257
38093,703-004-5385,9686.041,3,2,1,1.2267313987659811
38175,207-008-2399,2165.4053,3,2,1,0.41764222725169237
38349,703-004-5398,2127.695,4,2,2,0.45719608721424815
38512,703-004-5394,4335.443,4,1,3,0.3565006121564479
38612,703-004-5383,7759.2114,1,1,0,0.3841264445284092
38652,703-004-5380,3546.734,2,2,0,0.5319034402185254
39151,703-004-5380,462.2048,3,3,0,0.648679783274729
39244,703-004-5389,339.24936,4,2,2,0.6224328255409133
3950,703-004-5384,4179.2104,3,2,1,1.042475256051426
39540,703-004-5387,2290.6428,5,3,2,0.6338596945626322
39630,703-004-5386,6863.3525,2,1,1,1.4296143178189362
3990,703-004-5395,6591.6133,2,0,2,0.27920371738274696
40601,703-004-5396,11.018515,2,0,2,0.27920371738274696
40639,207-008-2398,3681.6733,7,2,5,1.5148431730241225
40767,703-004-5388,1055.3241,6,1,5,0.4590130926562781
41144,703-004-5386,2433.2632,5,4,1,1.56820408512734
41295,703-004-5398,8008.206,3,2,1,0.7782249798177538
41708,703-004-5381,922.0749,4,1,3,1.1682938043488234
41849,703-004-5396,148.49663,6,2,4,0.7303119985609924
42100,703-004-5397,4721.803,3,3,0,1.0481880763222662
42494,207-008-2398,4220.0405,6,4,2,2.1629154948330167
4250,703-004-5399,3690.6057,2,1,1,0.3468408179187174
42521,703-004-5388,8021.056,4,2,2,1.3846746078375887
42621,703-004-5399,2582.723,2,2,0,0.7553812003425066
42902,703-004-5380,5682.4746,3,1,2,0.35318614495832257
43191,207-008-2399,8971.442,4,2,2,0.7902540633102446
4334,703-004-5384,7316.776,5,2,3,1.0773740944002232
43991,703-004-5398,276.1537,2,2,0,1.470174491565844
44012,703-004-5394,371.79172,5,2,3,1.121028240380973
44320,703-004-5398,5566.974,4,1,3,0.35831143730785864
44599,703-004-5381,1628.7845,8,4,4,1.026419248584561
44771,703-004-5398,4009.4192,4,2,2,0.498554937618846
45459,703-004-5388,5811.4185,1,1,0,0.8628004053428028
45552,703-004-5381,7676.646,5,4,1,1.111333231176253
45962,703-004-5397,9999.147,5,3,2,1.6722404350973534
45991,703-004-5384,8494.85,6,3,3,1.3495695126901432
45992,703-004-5387,5714.748,2,0,2,0.27920371738274696
4603,703-004-5382,8000.706,2,2,0,0.5645226531248568
46049,703-004-5384,3040.6594,4,4,0,1.2041404256860369
46101,207-008-2398,5740.0537,5,1,4,0.49899940815442445
46113,703-004-5396,8071.173,2,1,1,0.33853450732658075
46247,703-004-5384,7621.3135,1,1,0,0.36795269067373165
46336,703-004-5391,6509.5483,6,4,2,1.3521936946792743
46341,703-004-5395,9708.157,1,1,0,0.7133660295677012
46522,207-008-2398,9134.794,5,3,2,1.5418800767627487
46528,703-004-5381,3361.0142,5,1,4,0.4902804189566785
46619,703-004-5392,5298.5933,3,1,2,0.8122490228201943
47189,703-004-5391,9654.193,3,1,2,0.6798756878315679
47407,703-004-5394,6652.727,7,7,0,1.5704351933755782
47435,703-004-5385,3531.6753,4,2,2,0.9151828330447148
4755,207-008-2398,4390.061,6,5,1,2.4588650732548736
48202,703-004-5390,921.08844,7,6,1,1.1345157717867864
48206,703-004-5383,8342.629,4,1,3,0.8915048997659578
48309,703-004-5396,8454.649,4,0,4,0.27920371738274696
49690,703-004-5392,8690.093,3,1,2,0.40197331355499777
4978,207-008-2399,227.38695,5,2,3,0.7973897790454522
49993,207-008-2399,2871.43,6,1,5,0.980447097217268
5374,703-004-5399,7369.712,4,2,2,2.4679614276921895
546,207-008-2399,9523.857,4,2,2,0.8756780819840084
5605,703-004-5396,4036.488,4,1,3,0.5201608880421418
5609,703-004-5398,7701.8076,6,2,4,0.6413535936617063
563,703-004-5393,8238.748,2,1,1,0.3187575773453028
603,703-004-5399,2221.1218,8,6,2,3.0472278916141082
6092,703-004-5380,8728.696,2,2,0,1.4929586209156473
6158,703-004-5381,9752.755,4,3,1,5.2785991608776675
6330,703-004-5393,8546.674,5,3,2,1.0738883624203668
6585,703-004-5395,2743.993,5,3,2,1.5023249827623117
6710,703-004-5386,9953.253,7,4,3,0.8328504687852794
6760,703-004-5394,8874.993,7,6,1,2.2375974990114984
6770,703-004-5390,308.73895,5,3,2,2.5682279827844217
7033,207-008-2398,7334.697,7,3,4,0.9168325935748706
7165,207-008-2399,4764.7036,5,2,3,0.5506190427232377
7209,703-004-5387,5553.981,3,1,2,0.5116411036934071
7501,703-004-5380,2837.5166,4,2,2,1.4673818098304974
7516,703-004-5381,3150.9321,2,1,1,0.35831143730785864
7520,703-004-5389,4150.7246,3,1,2,0.9018009888344035
7532,703-004-5382,5048.099,6,2,4,1.1649823803579287
7709,703-004-5399,1484.0227,2,2,0,0.5284548380530402
7783,703-004-5380,3352.2158,2,1,1,0.5719314852609562
7996,703-004-5383,6481.771,3,2,1,0.7983039803067297
8123,703-004-5394,8716.1875,4,2,2,1.053653521691828
8608,703-004-5381,5690.1763,4,1,3,0.5765482333015652
8609,703-004-5391,3910.857,2,2,0,1.1939722739689984
8622,703-004-5380,8457.845,2,1,1,0.7483054468460929
9212,703-004-5391,5366.2563,4,3,1,2.597840154548416
9234,703-004-5387,2215.0076,2,2,0,0.9819417879990876
9363,703-004-5383,9509.304,6,2,4,0.8812165772482466
9473,703-004-5390,6578.4116,3,0,3,0.27920371738274696
9516,703-004-5396,8888.583,2,1,1,0.6339363496132463
9563,703-004-5399,4864.226,4,1,3,0.3187575773453028
9664,703-004-5399,216.77614,9,4,5,1.0605202903192705
10090,703-004-5384,7800.4937,9,4,5,1.0089643356709133
10196,207-008-2399,9214.024,3,0,3,0.27920371738274696
10384,703-004-5391,3908.6902,2,1,1,0.45670166396471623
10492,703-004-5384,4329.439,3,1,2,0.3978652972704144
10767,703-004-5384,589.05066,3,0,3,0.27920371738274696
10787,703-004-5382,8323.974,6,2,4,0.6151658042835189
10824,703-004-5396,5646.9717,6,4,2,2.111654858760129
10851,703-004-5382,2199.0557,4,0,4,0.27920371738274696
10935,703-004-5389,7116.1323,4,1,3,0.4376551303132253
11453,703-004-5399,5460.845,7,3,4,1.0439785525813707
11519,703-004-5385,148.89061,5,1,4,0.36951836429724944
11639,703-004-5387,3061.2314,5,2,3,0.8791519562359686
11879,703-004-5385,9363.796,4,3,1,1.196021682068228
11922,703-004-5380,5787.7515,7,3,4,1.6478954123248384
11970,703-004-5389,3320.9985,7,4,3,1.7891774890344478
12018,703-004-5385,7340.295,3,0,3,0.27920371738274696
12108,703-004-5386,5789.4644,4,0,4,0.27920371738274696
12316,703-004-5386,9397.685,3,1,2,0.9377975040746805
12353,703-004-5386,1656.0322,3,2,1,0.8138598615878672
12653,703-004-5398,3850.7693,3,1,2,0.8671350320589378
12727,703-004-5398,3718.0298,1,0,1,0.27920371738274696
12731,703-004-5385,7144.2617,1,1,0,0.3978652972704144
13933,703-004-5387,626.359,4,3,1,1.0819949705171183
13958,703-004-5397,1503.7358,8,5,3,1.3935254165007518
14069,703-004-5395,3105.114,2,2,0,0.4834017530390345
14328,703-004-5398,5608.0723,5,3,2,1.2136718034068568
14550,703-004-5387,2245.9846,2,1,1,0.5961420047985176
14646,207-008-2399,2986.805,6,4,2,0.7909933475198022
14768,703-004-5384,1990.7325,8,3,5,1.6847784418432536
14959,703-004-5383,4970.906,7,4,3,1.3376999458760295
14960,703-004-5385,1120.6156,8,3,5,0.774372309963364
1521,703-004-5391,1394.6068,4,1,3,0.9580267677605766
15322,703-004-5398,2058.7952,4,3,1,0.9600247548831338
15340,703-004-5386,1621.2333,5,3,2,1.156564333907767
15582,207-008-2398,9912.444,3,1,2,0.44829646872267315
15614,703-004-5389,6655.9287,5,2,3,0.6430996217522065
15644,703-004-5389,8735.515,3,1,2,1.322884960012286
15687,703-004-5390,8319.849,6,3,3,1.7973433424070198
15844,703-004-5382,9774.119,5,2,3,0.5817963101720933
15872,703-004-5386,5579.9526,2,1,1,0.6063978885217305
16119,703-004-5395,2116.1836,1,0,1,0.27920371738274696
16128,703-004-5380,4501.4614,1,1,0,0.34448232013380015
16628,207-008-2398,2360.0286,2,1,1,0.3978652972704144
1675,703-004-5391,522.0193,4,1,3,0.49720261912970876
16910,703-004-5391,6912.277,5,3,2,3.8418188172061853
17056,703-004-5399,4117.235,5,3,2,1.1252665812219176
17226,703-004-5399,3015.0288,3,3,0,2.169956533285079
17603,703-004-5391,1849.5238,4,1,3,0.3978652972704144
17771,703-004-5384,4564.492,3,1,2,0.4755523738030865
17856,703-004-5393,9250.988,4,0,4,0.27920371738274696
17906,703-004-5386,7671.157,5,2,3,0.6616908668308585
18499,703-004-5387,3233.5867,2,0,2,0.27920371738274696
18740,703-004-5391,7190.4097,1,1,0,0.41594630807021743
18832,207-008-2399,3620.5059,8,5,3,1.4441371220384762
18955,703-004-5394,5749.036,6,3,3,1.2328578729359525
19279,207-008-2399,8079.4053,2,1,1,0.5165268771580819
19634,703-004-5384,3772.21,3,2,1,1.156017412656803
1979,703-004-5396,3564.5742,5,4,1,1.0315670149335638
19830,703-004-5395,5106.1733,3,2,1,0.63867619790707
20021,703-004-5380,7467.792,5,2,3,0.8236988406855252
20133,703-004-5384,3766.3066,2,1,1,0.9598454734251503
20290,703-004-5387,952.65985,5,2,3,0.958091397977098
2030,703-004-5385,3081.2437,1,0,1,0.27920371738274696
20354,703-004-5392,4743.4194,4,3,1,0.8952992006687331
20495,703-004-5385,8621.154,5,2,3,0.7564116672528398
20872,703-004-5395,7266.0996,5,2,3,0.9982129889882277
20953,703-004-5389,8623.313,3,2,1,1.018227224506988
20994,703-004-5399,1078.2415,3,1,2,0.5165268771580819
21018,703-004-5383,9570.093,2,1,1,0.5226541635818853
21036,703-004-5388,6629.1523,4,2,2,0.612905308493556
21084,703-004-5381,3105.9248,4,3,1,2.3063848701172547
2124,703-004-5392,6822.741,5,3,2,0.9475985231949401
21394,703-004-5380,3497.585,8,7,1,3.3304252102582743
21398,703-004-5381,1311.6658,7,5,2,2.1825414312293856
21425,703-004-5397,4421.9224,4,1,3,1.9123943092482512
21869,703-004-5394,5269.155,2,2,0,0.5457569210133848
22008,703-004-5384,8069.9927,4,2,2,1.0055047723806307
22128,703-004-5391,92.48197,3,2,1,1.474900117035156
22578,703-004-5380,8590.589,4,1,3,0.3978652972704144
22908,703-004-5398,8173.5493,3,1,2,1.715710361719615
2291,703-004-5382,6555.133,5,3,2,1.004535246585919
22982,703-004-5380,7737.51,3,0,3,0.27920371738274696
23127,703-004-5390,9901.3125,6,2,4,1.391486341712965
23212,703-004-5383,7809.637,8,3,5,0.8777032322286614
23557,207-008-2398,1853.7355,8,2,6,1.1056847252198214
23772,703-004-5390,8726.446,3,2,1,1.8316927875266964
23822,703-004-5398,6685.3267,5,3,2,1.2972844385612983
24340,703-004-5381,2075.215,3,2,1,1.549797919533937
24637,703-004-5382,8358.607,6,4,2,1.5661071376501408
24650,207-008-2399,5919.667,5,3,2,0.9717913462590831
24800,703-004-5383,481.07623,2,2,0,0.6226127257136213
24871,703-004-5383,724.5767,5,3,2,1.9018723949102923
24926,703-004-5390,8587.9375,3,2,1,0.7630426671779607
25019,703-004-5395,8100.9536,3,1,2,0.44286045678745484
25083,703-004-5383,9064.419,3,2,1,0.7054100283297314
25085,703-004-5380,5782.0244,3,3,0,1.2533529939058623
25221,207-008-2399,9442.578,3,1,2,1.0439841437291866
25277,703-004-5393,9134.9375,5,3,2,1.2728149021011161
2568,703-004-5386,3631.488,3,1,2,0.7650905890569337
25715,703-004-5386,5814.582,4,3,1,1.0980829775221446
25760,703-004-5380,3178.6174,3,3,0,1.4568797713518307
2583,703-004-5399,3102.0837,4,1,3,0.7117968525993688
25931,207-008-2399,4650.6035,4,1,3,0.5475427650707916
25980,703-004-5387,8076.3477,"","","",0.27920371738274696
25984,703-004-5387,7093.66,3,3,0,0.9478032680363228
26309,703-004-5380,5214.93,3,1,2,0.44299176410762475
26634,207-008-2398,9828.747,4,1,3,0.737132822674712
26939,703-004-5394,6338.715,7,5,2,2.1669144930190605
27048,703-004-5394,9673.642,3,2,1,0.47697301719552604
2733,703-004-5395,4623.3267,4,3,1,0.9678735395413692
28138,703-004-5392,6253.05,2,1,1,1.2060794857422734
28186,703-004-5380,7966.3096,1,1,0,0.47705530296097065
28422,703-004-5398,4798.1123,2,2,0,1.2663028293673069
2853,703-004-5395,9712.171,5,1,4,1.1733233736781228
28552,207-008-2399,9445.694,2,0,2,0.27920371738274696
28731,703-004-5385,4349.838,5,4,1,2.0349490792804064
28889,703-004-5386,6789.559,1,1,0,0.6439041063559401
29122,703-004-5394,9702.282,4,2,2,0.43718655169503423
2920,703-004-5389,9481.092,6,3,3,0.5396671730981072
29205,703-004-5386,4327.6084,9,4,5,2.832282720183779
29229,703-004-5380,594.5522,1,0,1,0.27920371738274696
29750,207-008-2399,8176.057,1,1,0,0.47276191568555953
2978,703-004-5392,8479.509,8,4,4,1.3808332189923151
29891,703-004-5380,9057.707,3,2,1,2.997081056283188
29997,703-004-5383,2185.2178,7,2,5,0.4818734097592655
3014,207-008-2399,5663.1265,"","","",0.27920371738274696
30153,703-004-5399,2493.8672,7,3,4,1.6199667057399774
30341,703-004-5386,8827.535,4,1,3,0.4373697149080171
30630,703-004-5398,8423.456,4,0,4,0.27920371738274696
31259,703-004-5393,198.60745,3,2,1,0.4777820296693812
31635,703-004-5393,94.13957,3,1,2,1.4115963414347321
31669,703-004-5396,2246.2637,3,2,1,1.0631254098693064
31705,703-004-5385,5497.3237,1,0,1,0.27920371738274696
31783,703-004-5388,1865.6665,4,2,2,0.6878031162311347
31843,703-004-5381,9573.668,3,3,0,2.561021554781169
31908,703-004-5390,7254.2817,3,1,2,0.4867483947391429
32036,703-004-5397,3219.7063,"","","",0.27920371738274696
3209,703-004-5380,4736.51,5,1,4,1.0043281972472413
32184,207-008-2398,6328.882,4,1,3,0.5165268771580819
32953,703-004-5396,1680.4277,3,1,2,0.6748735427792392
32961,207-008-2399,3063.9,4,2,2,0.8666287964688558
32998,207-008-2398,1155.0903,4,1,3,0.3978652972704144
33056,703-004-5396,7961.0312,3,1,2,0.6290287209687515
33196,703-004-5390,6098.009,5,1,4,0.5451842154760143
33549,703-004-5383,1345.3507,3,1,2,1.0640637338857488
33773,703-004-5393,1903.4922,5,1,4,0.9863601867915842
33949,703-004-5393,6700.813,1,0,1,0.27920371738274696
34030,703-004-5391,26.126503,4,3,1,1.0421277498307833
34300,703-004-5397,5156.944,3,2,1,0.6461115065041357
34789,703-004-5387,8097.3447,9,3,6,0.808934043925481
35010,703-004-5394,3790.6248,4,3,1,0.47944513344318584
35390,703-004-5391,1192.4202,6,2,4,1.5922024786124702
35756,703-004-5380,4758.9756,4,3,1,1.3764971167630806
35837,703-004-5393,930.55786,6,2,4,0.93181520002353
36107,703-004-5390,8548.893,2,1,1,0.4545201076251748
36519,703-004-5380,4169.0493,4,1,3,0.45981603826528866
36710,703-004-5383,105.44061,3,3,0,3.925440674558743
36826,703-004-5384,2675.9124,2,1,1,1.2488907169948953
36846,703-004-5389,9347.183,2,0,2,0.27920371738274696
36941,703-004-5383,5981.2275,7,2,5,0.8911717418948939
37261,703-004-5396,578.2258,2,1,1,1.1378283183418152
37560,703-004-5388,1342.951,5,4,1,1.0706802675101728
37986,703-004-5398,6778.7446,4,1,3,0.33853450732658075
38521,703-004-5392,3861.8618,6,3,3,0.6355369209210882
39072,703-004-5393,2827.9866,6,2,4,0.4814942073370827
39075,703-004-5399,9760.705,3,1,2,0.7204345752202852
39373,703-004-5397,5425.648,9,6,3,1.6634479064484466
3941,703-004-5390,9447.504,3,3,0,0.6885861679951997
39733,703-004-5394,1731.0715,5,4,1,1.827777911140233
39857,703-004-5383,8931.828,4,2,2,0.9292948214192778
40098,703-004-5397,4379.152,4,1,3,0.4335042138007228
40200,703-004-5399,599.606,3,2,1,0.9134061002476743
40614,703-004-5382,7408.3716,1,0,1,0.27920371738274696
40686,703-004-5385,9992.774,3,1,2,0.4104730901334791
40852,703-004-5395,2218.3252,4,2,2,0.5990039063738327
41001,207-008-2398,3312.691,4,3,1,1.2453822360071776
41055,703-004-5388,3777.1743,9,5,4,2.186653622124145
41130,703-004-5386,7506.8687,5,3,2,0.7384992239079144
41340,703-004-5381,5994.7144,6,4,2,1.6391293233356092
4136,703-004-5392,667.35803,3,1,2,0.9751265142753854
41384,703-004-5387,1066.6686,2,0,2,0.27920371738274696
42223,703-004-5398,1653.272,2,1,1,0.5309853466647426
42397,703-004-5396,2168.457,3,2,1,1.1164062503767511
42553,703-004-5395,9020.564,5,3,2,1.0913986837252234
42612,703-004-5385,3002.1262,4,3,1,0.8948767882539318
42843,703-004-5390,3322.7944,2,1,1,0.4031391452654219
42959,703-004-5384,2888.1584,9,7,2,2.951328229605788
43003,703-004-5381,5112.566,3,1,2,0.5016786516919428
431,703-004-5398,8179.615,4,2,2,1.1689067301741358
43169,703-004-5399,6434.6724,5,2,3,0.8230151988984831
43349,703-004-5399,8183.1987,6,3,3,1.1655456841589709
43612,703-004-5387,1653.7922,5,4,1,1.5549811042722836
43681,703-004-5398,5444.9336,1,0,1,0.27920371738274696
44063,703-004-5381,2418.372,1,1,0,0.45617749386572864
44181,703-004-5386,1288.0469,5,4,1,1.5442332292396357
44522,703-004-5381,896.32214,3,1,2,0.4152617317229347
44547,703-004-5390,166.00906,7,3,4,1.63940500569807
44565,703-004-5398,289.85382,"","","",0.27920371738274696
45002,703-004-5395,2360.2104,3,2,1,0.9639313272422787
45075,703-004-5388,5326.6167,3,3,0,1.6176709456940164
45156,703-004-5391,712.5562,7,4,3,1.1497952555996813
45259,703-004-5382,2183.8706,2,2,0,0.9484809968281693
45281,703-004-5385,2617.1077,5,1,4,0.5858133769668936
45282,703-004-5396,7977.179,6,2,4,0.6671344734895891
45526,703-004-5389,583.44366,5,3,2,0.8010222331384877
45761,703-004-5399,8677.245,3,1,2,1.4053952580310498
45798,703-004-5384,9372.131,7,0,7,0.27920371738274696
46704,703-004-5382,5906.8853,8,3,5,0.6708884937878908
46839,703-004-5391,9126.917,3,1,2,0.9257495604125218
46847,703-004-5390,2389.7273,2,0,2,0.27920371738274696
47386,703-004-5395,790.81177,3,2,1,0.7423846716809671
47458,703-004-5387,2439.9119,2,1,1,0.477356369319281
47929,703-004-5388,8919.307,2,1,1,0.8296404586334968
48037,703-004-5393,4781.047,4,0,4,0.27920371738274696
48361,207-008-2399,3946.0164,3,0,3,0.27920371738274696
4844,207-008-2399,8248.584,4,1,3,0.3602312185107687
48740,703-004-5380,7132.5283,5,3,2,1.4693569327332345
48874,207-008-2398,2934.4666,7,5,2,0.9639403229225945
48922,703-004-5386,2430.5796,2,2,0,1.1260169687918034
49,703-004-5382,5880.8965,3,3,0,1.4225514646974011
49309,703-004-5385,6277.69,6,1,5,0.5837684390944268
49365,703-004-5385,7176.7676,1,0,1,0.27920371738274696
49368,703-004-5384,5149.6084,2,1,1,1.2946187374272162
49460,703-004-5384,2416.0117,2,1,1,0.728530452950097
49556,703-004-5385,7843.2515,3,3,0,0.9661150772073361
49788,703-004-5397,7219.9644,9,4,5,1.619491527953539
49841,703-004-5381,8576.518,2,0,2,0.27920371738274696
5007,703-004-5390,105.49426,1,1,0,0.43753968342140503
5495,703-004-5380,9931.402,8,3,5,1.5663219466257619
5704,207-008-2399,9712.475,2,0,2,0.27920371738274696
5823,207-008-2399,6859.6636,4,1,3,0.3573557415801328
6110,703-004-5390,5328.3223,3,2,1,1.9601477275053365
6153,207-008-2398,506.50775,2,1,1,0.35831143730785864
6255,207-008-2399,9366.196,5,4,1,2.458523341831133
6316,703-004-5383,7856.695,7,4,3,2.8617175904225767
6428,703-004-5397,6041.382,9,7,2,2.0588911749395824
6783,703-004-5398,194.13173,4,2,2,0.5895613399825539
6985,703-004-5381,2710.632,5,2,3,1.1987182949419488
7032,703-004-5394,3255.191,4,1,3,0.3978652972704144
7876,703-004-5398,8956.517,6,0,6,0.27920371738274696
7920,703-004-5399,1433.9412,4,2,2,1.0086965321923749
8026,703-004-5383,4881.579,3,1,2,0.5666398163046807
8244,703-004-5392,5869.3516,4,2,2,1.1151640440955743
8341,703-004-5382,6160.0874,2,1,1,0.510425667245757
8532,207-008-2399,1470.1254,3,1,2,0.35831143730785864
8538,703-004-5388,4944.974,2,2,0,1.212151716831139
8787,703-004-5384,791.0943,2,0,2,0.27920371738274696
9180,703-004-5397,2353.7766,1,1,0,0.7011019269597037
9267,207-008-2399,7309.687,2,1,1,1.3582806276264674
9386,703-004-5394,7163.037,2,1,1,0.3978652972704144
9401,703-004-5381,9267.114,8,3,5,1.4420310896908382
9487,703-004-5395,6928.4106,3,0,3,0.27920371738274696
9554,703-004-5385,1033.569,2,2,0,0.7761079580596837
9777,703-004-5395,6965.998,7,3,4,0.7071067338894356
9786,703-004-5399,2395.6113,4,2,2,0.8156550615800665
9925,703-004-5397,3783.4817,2,1,1,1.156593837800032
10018,703-004-5397,4565.1597,5,2,3,0.999828072197136
10125,703-004-5394,3378.7202,6,2,4,0.8107763915043972
10188,703-004-5383,1071.186,5,4,1,0.7395167618654022
10418,703-004-5394,3850.3938,5,2,3,1.832670837896998
10566,703-004-5389,9442.207,10,5,5,3.5879205264799334
10642,703-004-5381,4714.1235,6,4,2,0.9644743412340266
11087,703-004-5383,4794.817,2,1,1,0.459566005113014
11101,703-004-5385,6376.331,4,3,1,1.1292403282759242
11478,703-004-5396,9028.511,6,3,3,3.441018681265811
11538,703-004-5392,3359.1653,4,3,1,1.1300706323591816
11772,703-004-5393,9171.067,5,4,1,1.6111363058691326
11825,703-004-5396,4932.175,6,3,3,1.4988215891031447
11832,703-004-5386,7582.856,7,2,5,0.7895979570968702
12065,703-004-5398,7951.707,7,1,6,0.7130839101678123
12720,703-004-5399,4424.088,11,6,5,2.9047382030593503
12940,703-004-5393,9002.328,4,0,4,0.27920371738274696
13694,703-004-5399,3368.787,5,2,3,0.732598955832186
13879,703-004-5393,2472.2964,2,2,0,1.2663833881703845
14014,703-004-5392,8412.633,2,0,2,0.27920371738274696
14064,703-004-5393,3310.8843,3,1,2,0.37126491245441406
1415,703-004-5388,6953.8804,1,0,1,0.27920371738274696
14238,703-004-5389,2842.679,4,0,4,0.27920371738274696
14332,703-004-5388,5262.373,7,6,1,3.0724590818505746
14347,703-004-5397,2222.2131,5,3,2,1.1440769227733183
14402,703-004-5389,9244.178,3,2,1,1.6027898046525064
14416,703-004-5384,4180.014,6,4,2,1.9354694856181156
14875,703-004-5381,3234.8884,6,4,2,1.9193083676786433
15023,703-004-5380,8600.409,4,3,1,2.061920292068505
15142,703-004-5380,835.7376,7,4,3,1.3650207734948878
1524,703-004-5390,9551.598,4,1,3,0.412079965694458
15461,703-004-5380,2670.5693,1,1,0,1.0114845601217193
15985,703-004-5395,3898.8047,5,4,1,1.7145360933177534
16033,703-004-5382,164.28113,4,3,1,0.6581364804262207
16669,703-004-5385,9620.484,1,0,1,0.27920371738274696
16766,703-004-5383,4834.27,5,3,2,0.9252276452656196
16776,207-008-2398,6651.2124,1,1,0,0.39226842608571283
1736,703-004-5387,6742.973,2,2,0,0.7818124108870261
17392,703-004-5395,5876.483,3,3,0,2.132007859074091
1756,703-004-5396,8158.275,3,1,2,1.325212156438524
17829,703-004-5399,5144.316,2,1,1,0.366430649901985
18143,703-004-5387,9864.509,6,4,2,1.417262619613885
18460,703-004-5380,7153.226,4,2,2,0.9355243572490338
18818,703-004-5383,9513.702,5,5,0,1.843596286689007
19119,703-004-5386,4391.147,4,1,3,0.5123985139727981
19232,703-004-5385,5973.1426,7,4,3,2.0197255759660133
19416,207-008-2399,7403.9395,7,3,4,0.8867705530628623
19770,207-008-2399,5040.1777,6,4,2,1.4114146756510617
19776,703-004-5380,2193.8574,1,1,0,0.4234219423508295
20124,703-004-5387,4273.3877,2,0,2,0.27920371738274696
20254,703-004-5388,8220.821,2,0,2,0.27920371738274696
20277,703-004-5385,2345.0596,6,4,2,0.8285248262359134
20299,703-004-5394,7340.456,3,2,1,0.627534145254016
20330,703-004-5396,3548.6816,4,3,1,1.0060912633946053
20447,703-004-5391,6993.2837,2,0,2,0.27920371738274696
20470,703-004-5389,8395.8955,1,0,1,0.27920371738274696
20503,703-004-5396,2227.9917,2,1,1,0.4752771454496315
20794,703-004-5398,6069.721,2,2,0,1.9244542912397806
20898,703-004-5383,5410.679,6,4,2,2.095571279074597
21014,703-004-5388,7541.8315,2,0,2,0.27920371738274696
21062,703-004-5388,1843.149,5,3,2,1.3408086962732138
21549,703-004-5396,3347.7444,5,1,4,0.48514969238201827
21579,703-004-5389,4578.125,5,3,2,1.9439496338147395
21904,703-004-5399,1341.3167,3,2,1,1.0692848145793878
21962,703-004-5382,4977.1694,8,6,2,1.7764051557141953
21988,703-004-5385,8883.295,2,0,2,0.27920371738274696
22204,703-004-5397,2493.0625,4,2,2,0.7232482927981315
22501,703-004-5399,374.6742,3,1,2,1.189765086576868
22665,703-004-5381,877.67664,3,3,0,3.2309110464624804
22674,207-008-2399,6250.108,5,4,1,0.969225413827617
22906,207-008-2399,145.54561,5,4,1,3.6558902059583835
23893,703-004-5388,5534.7725,5,3,2,1.1232007940118873
24117,703-004-5388,8547.313,3,3,0,0.8847866402482781
24161,703-004-5398,7602.4365,7,3,4,1.7471161847133276
24222,703-004-5398,8557.622,3,2,1,0.45422483892420384
24357,703-004-5388,6364.9917,1,0,1,0.27920371738274696
24645,207-008-2398,2505.9211,5,1,4,0.47843879092985936
25028,703-004-5397,5314.4717,7,6,1,2.7864091384479424
25168,703-004-5397,7661.706,4,3,1,0.6929019661373774
25911,703-004-5389,7538.1685,7,4,3,0.7504176257668108
26018,703-004-5383,7108.199,5,3,2,0.9536440838958958
26052,703-004-5394,5702.2617,3,0,3,0.27920371738274696
26123,703-004-5381,8120.6323,3,1,2,0.4180377658513179
26146,703-004-5388,750.9369,6,1,5,0.6787899023634825
26213,703-004-5389,4400.662,5,4,1,1.9341599846340432
26316,207-008-2398,3051.2314,"","","",0.27920371738274696
26495,703-004-5381,8593.628,6,4,2,2.214312732579439
265,703-004-5397,975.3263,4,3,1,0.9140900581907251
26525,703-004-5398,1689.1866,3,3,0,1.1806880547738767
26823,703-004-5381,8383.103,5,2,3,1.1119725266653482
26867,703-004-5383,4212.358,2,0,2,0.27920371738274696
26959,703-004-5392,4091.773,2,1,1,0.33853450732658075
27235,703-004-5396,3335.786,6,5,1,1.0529417930030498
27353,703-004-5383,8058.4424,7,3,4,1.225586123968372
2760,703-004-5388,8270.773,5,1,4,0.33853450732658075
27677,703-004-5392,5320.753,2,1,1,0.32666834933781397
2781,703-004-5382,8259.714,6,2,4,1.5187142035821033
27850,703-004-5383,1464.8843,3,2,1,0.41319241800590484
27869,703-004-5381,5904.7886,6,5,1,2.1949323917485963
28044,703-004-5396,7073.7964,5,3,2,0.7013121627899508
28069,703-004-5391,5596.147,7,3,4,0.5795586830934263
28428,703-004-5384,3996.064,4,1,3,0.3978652972704144
28535,703-004-5391,3346.3008,2,1,1,0.6952773626388654
29345,703-004-5389,4934.498,3,1,2,0.33853450732658075
29384,703-004-5399,237.88393,4,3,1,1.413447154474238
29456,703-004-5388,4246.0015,7,3,4,1.3022622924563303
29608,703-004-5393,6802.4766,3,2,1,1.802200957837733
29623,703-004-5387,9046.757,1,1,0,0.3978652972704144
29675,703-004-5393,9795.498,2,1,1,1.6940755531500107
29864,703-004-5398,5500.7344,1,0,1,0.27920371738274696
2993,703-004-5384,272.02786,6,3,3,1.434770729172267
30145,703-004-5381,2461.016,7,3,4,0.7063185075543443
30283,703-004-5390,8857.73,5,2,3,1.7307858860749348
30288,703-004-5391,4136.868,6,1,5,0.7890663003924981
30431,703-004-5391,703.8182,6,1,5,0.529291592917376
30600,703-004-5389,8033.7705,2,1,1,0.35534489781066697
30645,703-004-5398,557.723,3,1,2,0.4803491438067964
30667,703-004-5398,7451.848,6,4,2,1.9236218668345528
30761,703-004-5388,7685.8784,3,1,2,0.4013064830871568
31137,703-004-5381,8162.1655,3,1,2,0.7030805891353696
31294,703-004-5398,5545.4805,3,1,2,0.4571392888144298
31372,703-004-5386,9898.101,5,4,1,1.4045195889913635
31581,703-004-5397,6151.6724,2,1,1,0.6618429086114899
31671,703-004-5385,8030.511,3,1,2,0.47452067787784763
31739,703-004-5399,560.4887,3,0,3,0.27920371738274696
31879,703-004-5382,6398.598,5,3,2,1.088285213761104
31989,703-004-5383,2397.613,8,3,5,1.1602049507145515
31996,703-004-5384,8492.714,4,1,3,0.35831143730785864
3205,703-004-5381,5023.396,5,2,3,1.1759715904569468
3212,703-004-5399,2926.42,4,0,4,0.27920371738274696
32323,703-004-5383,613.12256,5,2,3,0.3978652972704144
32376,703-004-5396,4990.3496,5,1,4,0.8704018546367892
32640,703-004-5385,8315.502,5,4,1,3.318396446134837
32683,703-004-5393,9220.972,2,1,1,0.3637500930527101
32790,703-004-5382,54.447056,4,2,2,0.5309153386680833
331,703-004-5381,1143.3971,5,3,2,0.6872172982681316
33183,703-004-5386,4406.1846,7,3,4,0.97494173731684
33584,703-004-5399,2280.079,4,1,3,1.1929795944221069
33711,703-004-5385,7014.7056,3,2,1,1.1399069712443701
3424,207-008-2399,9384.245,3,1,2,1.6773259250833363
34251,703-004-5394,5748.9546,7,3,4,0.8704113853106864
34593,703-004-5385,3808.2295,3,1,2,0.7088385370372764
34703,703-004-5387,1943.2211,1,1,0,0.8261369134516522
34893,703-004-5388,7153.336,6,3,3,1.6117849052825206
35123,703-004-5393,2230.246,2,2,0,0.5180808802183641
35167,703-004-5385,6317.079,6,4,2,0.799543936964078
35420,703-004-5390,5720.888,2,1,1,0.7182515629671166
35491,703-004-5398,4449.2656,3,1,2,1.697649364836424
35830,703-004-5382,8957.5,2,0,2,0.27920371738274696
35988,703-004-5380,1509.3583,3,2,1,0.7313821804914593
35998,703-004-5387,8831.8,3,1,2,0.8157076800336563
36193,703-004-5392,2322.327,5,3,2,0.6285852764080304
36780,703-004-5389,1221.8446,"","","",0.27920371738274696
3679,703-004-5380,6878.9727,7,5,2,2.3634626370672143
36822,703-004-5383,8145.8105,3,1,2,0.3900473298577316
37274,703-004-5397,8424.028,5,4,1,2.379534149246494
37523,703-004-5389,9664.185,6,3,3,1.515878345693417
37787,703-004-5380,7638.4736,4,1,3,0.4504584717210431
37818,207-008-2398,6075.2393,7,0,7,0.27920371738274696
37963,703-004-5387,2355.2197,2,1,1,0.3852512128714995
38003,703-004-5392,55.464508,4,3,1,1.8075623690907408
3805,703-004-5382,6298.0186,1,0,1,0.27920371738274696
38355,703-004-5394,9923.219,4,2,2,0.5846372103244698
38408,703-004-5397,5877.629,8,7,1,3.33219949147453
38602,703-004-5384,6336.7886,1,0,1,0.27920371738274696
38759,703-004-5388,3633.7244,4,2,2,0.5358172559369041
39067,703-004-5380,7980.4297,4,1,3,0.6381948602450498
39277,703-004-5396,8728.283,2,0,2,0.27920371738274696
39409,703-004-5384,4101.5967,6,3,3,1.2239059471360472
39428,207-008-2399,9969.259,"","","",0.27920371738274696
39616,703-004-5382,9968.393,4,3,1,0.7103526365564905
39650,703-004-5393,2166.866,5,3,2,0.9948837443118391
39716,207-008-2398,1278.2722,7,2,5,1.3392274005286433
39832,703-004-5399,4179.1777,4,4,0,1.1883334622353665
39845,703-004-5385,1436.8873,7,0,7,0.27920371738274696
40158,703-004-5389,853.06647,2,0,2,0.27920371738274696
40371,703-004-5395,4626.141,6,4,2,1.0559086452567952
40386,703-004-5383,4984.355,6,3,3,1.1405721477778654
40490,703-004-5388,6011.2417,2,1,1,0.40535181291288974
40632,703-004-5387,2460.4565,1,1,0,0.5165268771580819
40698,703-004-5391,2266.2478,11,8,3,2.3124048958626937
40752,703-004-5394,5520.8765,3,1,2,0.8774387797168702
41151,207-008-2399,1227.6125,"","","",0.27920371738274696
41214,703-004-5384,8575.326,6,3,3,1.3192319514360697
41239,703-004-5393,1161.3429,4,1,3,0.37982502895311754
41270,207-008-2398,1491.3577,4,0,4,0.27920371738274696
41347,703-004-5392,7816.5083,6,3,3,1.3749529966113376
41644,703-004-5396,2913.2473,7,3,4,1.6502656520808605
41670,703-004-5388,5610.0103,1,0,1,0.27920371738274696
41764,703-004-5397,7391.155,4,1,3,0.44722392784185794
42246,703-004-5396,4437.351,6,3,3,1.1232329983238172
42413,703-004-5389,2301.3235,4,4,0,0.9309704054383
42779,703-004-5380,6854.0537,4,2,2,0.9038992472876402
42807,703-004-5389,1113.9191,5,4,1,2.184424869740857
42810,207-008-2399,4950.931,7,6,1,1.8254259544768545
4282,703-004-5393,7806.731,1,0,1,0.27920371738274696
43212,703-004-5390,831.1081,2,1,1,0.4783698143778757
43230,703-004-5392,2835.496,3,0,3,0.27920371738274696
43250,703-004-5389,2191.2468,5,2,3,0.5669580486103406
43561,703-004-5390,4982.865,7,2,5,1.6450052780040136
43850,703-004-5392,1093.0276,5,3,2,1.1312282189585336
44061,703-004-5391,5009.8823,2,0,2,0.27920371738274696
44461,703-004-5381,6937.3374,3,1,2,0.570791769306467
44587,703-004-5398,2757.1333,4,2,2,1.040658695630922
44660,703-004-5385,9348.196,3,0,3,0.27920371738274696
44960,703-004-5383,2119.3796,3,1,2,0.6957744848190953
45424,207-008-2399,4850.6294,4,1,3,0.47049561270104523
45457,703-004-5392,2746.076,5,2,3,0.5648907184863335
45585,703-004-5380,4862.4463,4,2,2,0.5340661968690016
45740,703-004-5397,5355.027,2,0,2,0.27920371738274696
46358,703-004-5381,9950.013,5,1,4,0.39395778277524635
46435,703-004-5385,6297.7256,3,1,2,0.5642500244894573
4645,703-004-5388,9505.393,3,2,1,0.6430992290382606
46767,703-004-5398,7481.126,4,2,2,3.614562684480958
46783,703-004-5381,2496.0554,5,3,2,0.9385583772628743
47049,703-004-5394,4855.9316,1,0,1,0.27920371738274696
47142,703-004-5385,2790.9094,2,0,2,0.27920371738274696
47346,703-004-5386,493.94608,2,1,1,1.5892661427825088
47456,703-004-5397,6592.3755,4,4,0,1.2820919103818595
47464,703-004-5393,4036.0874,2,1,1,0.4316792450157317
47667,703-004-5392,4950.9023,4,4,0,1.025209987878001
47863,703-004-5385,9018.808,4,3,1,2.015432807638337
4793,703-004-5387,7051.5503,4,4,0,1.5397761517381663
48017,703-004-5399,2114.3704,1,1,0,0.6220052089212229
48028,703-004-5384,6237.8066,6,2,4,0.45549887640538606
4803,703-004-5382,2904.4246,6,5,1,1.2730751270523695
48177,703-004-5395,8866.909,5,2,3,1.375659232684594
48540,703-004-5392,9108.71,2,2,0,0.4956900673701691
48695,703-004-5396,3457.6392,4,2,2,0.5398902739361837
48872,703-004-5398,7400.041,10,7,3,2.4612468916671086
48919,703-004-5386,9952.975,"","","",0.27920371738274696
49021,703-004-5396,9941.687,8,0,8,0.27920371738274696
49554,703-004-5394,885.5432,5,3,2,1.2433748627958814
498,703-004-5382,7141.2817,1,1,0,3.2669738204781846
49817,703-004-5383,6784.49,6,4,2,3.1311546984785457
49874,703-004-5384,9805.148,4,4,0,1.116496355980312
5373,703-004-5398,9515.93,2,1,1,0.35534489781066697
5496,703-004-5389,1472.7568,5,4,1,1.0923954765613948
5559,703-004-5382,3406.7834,6,1,5,0.5454944383487166
5561,703-004-5381,2114.8389,4,2,2,1.4722354657376602
5743,703-004-5386,8833.15,5,5,0,4.252370582623596
5775,703-004-5398,7010.6167,6,3,3,3.065865622070723
5796,703-004-5381,8206.721,2,1,1,1.7690770190377123
580,703-004-5382,6961.375,4,1,3,0.5501476581262543
6299,207-008-2399,1515.2955,2,1,1,0.5845995076167135
6404,703-004-5385,9119.753,2,2,0,1.6659679588680336
6408,703-004-5394,4180.125,6,2,4,0.519108893873006
6878,703-004-5394,9301.52,4,3,1,1.850677360300622
6943,703-004-5395,2272.9724,2,1,1,0.3482416837923913
6997,703-004-5385,2714.4414,4,2,2,1.3115265432683594
7086,703-004-5387,4334.7227,5,3,2,1.1268489328662616
7162,703-004-5389,1973.8799,7,5,2,1.6855048014887237
7177,703-004-5385,2586.459,6,4,2,1.3385905783429748
7381,703-004-5386,8163.658,3,1,2,0.3919322182760311
7469,703-004-5396,9438.116,3,1,2,0.33853450732658075
762,703-004-5384,4692.7305,8,3,5,1.3244057625645418
8399,703-004-5382,5405.959,3,2,1,0.9382275636189256
8458,703-004-5394,3495.8303,3,2,1,0.9456401563143173
8634,703-004-5384,2786.8276,3,1,2,0.9272385442144336
8717,207-008-2398,4466.828,1,1,0,0.50815335597802
8955,703-004-5394,2824.167,1,0,1,0.27920371738274696
9237,703-004-5381,5637.5166,2,1,1,1.570683473384648
9675,703-004-5389,6563.8916,1,1,0,0.3678798879283554
10061,703-004-5398,8115.9253,"","","",0.27920371738274696
10117,703-004-5388,2107.6428,5,1,4,0.5837684390944268
10155,703-004-5392,3858.7737,6,4,2,0.9874879573965696
1019,703-004-5384,366.89697,5,3,2,1.5771402215602641
10605,703-004-5394,5386.827,4,0,4,0.27920371738274696
10746,703-004-5386,9200.297,3,1,2,0.9143644968250366
11158,703-004-5381,4342.9087,4,2,2,0.6576886970685341
11445,207-008-2399,6212.113,5,2,3,0.8079180566549163
11655,703-004-5386,863.1069,4,3,1,0.9125270167028585
11816,703-004-5398,9405.402,4,2,2,1.187773187692075
11890,703-004-5386,5245.1836,3,0,3,0.27920371738274696
12072,703-004-5394,7022.2793,5,4,1,2.135428140515038
121,703-004-5385,3616.9255,9,6,3,1.674314687475337
12105,703-004-5396,2618.0918,4,2,2,0.9713040761035006
12143,703-004-5380,3438.6284,4,2,2,0.5898148112866568
12483,703-004-5388,2702.9329,4,2,2,0.4028095297657339
12522,703-004-5392,3374.486,5,5,0,2.1758844596862223
12606,703-004-5391,3804.9834,4,2,2,0.498225313020397
1270,703-004-5380,1385.5667,4,3,1,1.1546594599849727
12781,703-004-5394,956.74097,7,4,3,3.039936377700046
12846,703-004-5394,7700.3174,4,1,3,0.534141359878399
12901,703-004-5391,598.68036,3,2,1,0.9246847748740148
13131,703-004-5391,5330.0527,"","","",0.27920371738274696
1325,703-004-5392,8503.678,2,1,1,0.617954983093447
13684,207-008-2399,3861.5637,2,2,0,1.4295485029250008
13855,703-004-5390,8969.063,1,0,1,0.27920371738274696
1386,207-008-2398,7314.126,2,1,1,0.6137810582873684
14165,703-004-5384,1714.5079,3,3,0,1.4638955139935454
14500,703-004-5398,9266.034,3,2,1,0.8528488224062626
15355,703-004-5392,1692.1259,6,5,1,1.8144373145408619
15416,703-004-5380,1830.3174,4,2,2,0.7942655534297146
15450,703-004-5399,9490.023,5,3,2,0.7287100941575624
15661,703-004-5394,3802.7126,3,1,2,0.3978652972704144
15715,703-004-5392,2420.9565,7,3,4,1.0364135427932162
1573,703-004-5396,9651.459,2,1,1,0.7087427012139361
1574,703-004-5391,9167.089,2,2,0,0.5501476581262543
15761,207-008-2399,2518.071,2,0,2,0.27920371738274696
16080,703-004-5389,9450.39,3,0,3,0.27920371738274696
1632,703-004-5396,6526.81,6,2,4,0.4955707787218235
16331,703-004-5395,4493.1807,1,0,1,0.27920371738274696
16778,703-004-5394,4381.683,7,5,2,2.712423896689087
16791,703-004-5391,5004.4756,6,5,1,2.3957264513914276
16957,703-004-5388,8425.807,5,2,3,0.7230422109764434
17334,703-004-5380,9499.95,2,1,1,0.35831143730785864
1751,703-004-5386,1826.505,5,3,2,3.0138358579926177
17740,703-004-5381,4298.831,3,1,2,4.138744112133992
17943,703-004-5388,9406.077,5,4,1,2.072117206355141
18060,703-004-5380,7872.0854,1,0,1,0.27920371738274696
18089,703-004-5399,6720.4736,7,4,3,0.5214711096534014
18245,703-004-5398,1746.3976,4,4,0,1.8511364941220032
18317,207-008-2398,4338.44,4,2,2,1.3201012523475306
18660,703-004-5380,257.7609,3,1,2,0.687863590113401
18678,703-004-5380,7612.0347,2,1,1,0.36738513398520634
18872,703-004-5397,9950.13,1,0,1,0.27920371738274696
19056,703-004-5399,3934.7922,4,2,2,0.5076272586665069
19143,703-004-5390,3206.824,7,2,5,2.216406048237647
19293,703-004-5384,3570.3706,6,2,4,0.7338764520488539
19334,703-004-5391,819.1842,6,4,2,1.464299250081868
19471,703-004-5381,2572.5872,5,3,2,1.3993548903243718
19529,207-008-2398,4904.0996,4,2,2,0.7407030137138313
19813,703-004-5391,6328.203,5,3,2,0.8822580036832758
20462,703-004-5383,8354.385,3,1,2,0.35831143730785864
20487,703-004-5389,8571.107,9,7,2,2.5900179576020457
20504,703-004-5387,9678.749,6,3,3,1.0011547962265248
20713,207-008-2398,3771.6895,4,3,1,1.2639298153689653
20911,703-004-5397,1674.6343,2,2,0,0.6025756814775601
21284,703-004-5381,9003.078,7,1,6,0.615320299611652
2135,207-008-2398,449.40472,7,2,5,1.314434406474149
21433,703-004-5392,9124.212,1,0,1,0.27920371738274696
21572,703-004-5393,8449.457,4,2,2,0.526132454438308
21722,703-004-5382,1276.5765,1,0,1,0.27920371738274696
21850,207-008-2399,8760.164,5,2,3,0.49891716908725237
22150,703-004-5392,8975.847,5,2,3,0.7041946494485993
22238,207-008-2398,2271.3096,4,2,2,1.2799517127340496
22551,703-004-5389,3201.5962,4,3,1,1.275017728807167
22811,207-008-2399,4886.471,5,3,2,1.0622852379474277
22938,703-004-5382,7964.6963,4,2,2,0.5030768627221891
23052,703-004-5386,6214.3916,3,0,3,0.27920371738274696
23154,703-004-5397,8435.684,4,3,1,1.8897478086370614
23193,703-004-5398,1915.3064,5,5,0,2.2810971852657786
23305,703-004-5395,140.15257,3,1,2,0.32666834933781397
23403,703-004-5380,2880.0022,5,3,2,1.6890400523179843
24138,207-008-2399,907.3758,4,2,2,1.3125299719873342
24253,703-004-5397,4604.9873,8,1,7,0.32666834933781397
24529,703-004-5388,8282.793,4,1,3,0.5165268771580819
2461,703-004-5380,2509.467,7,3,4,2.2430902968988295
24644,703-004-5383,2551.0752,4,3,1,1.8666744921750518
24981,703-004-5396,8812.36,3,1,2,0.6404795893671089
25052,207-008-2399,329.19824,3,2,1,0.5765394841775976
25147,703-004-5394,6036.3203,4,2,2,0.9900701190293589
25164,703-004-5393,5308.8784,4,3,1,0.7861782637391106
25196,703-004-5390,5662.902,3,2,1,0.5701695758130884
25365,703-004-5396,6941.058,3,2,1,0.47697301719552604
25512,703-004-5393,6109.087,5,1,4,0.5626291210600086
25654,703-004-5388,1805.6089,7,6,1,1.8490514305649208
26254,703-004-5388,9278.696,1,1,0,0.9642943971204845
26789,703-004-5393,5515.167,4,1,3,0.6416910605846935
27007,703-004-5395,9953.934,1,1,0,0.3978652972704144
2706,703-004-5392,8336.296,5,4,1,1.7726639667086066
27096,703-004-5399,9343.813,5,2,3,0.46550239780638497
27320,703-004-5381,7437.293,10,1,9,0.5215984976618071
27413,703-004-5395,4855.4814,4,4,0,0.9830454871338452
27482,703-004-5380,8847.169,3,2,1,1.5926714153354744
27603,703-004-5390,9834.2295,6,1,5,0.5165268771580819
27716,703-004-5390,2945.4417,9,6,3,3.431076946589973
28018,703-004-5387,2171.296,4,0,4,0.27920371738274696
28068,703-004-5389,1943.5757,9,3,6,0.8850839063681497
28579,703-004-5383,7082.305,5,4,1,1.4503731372530142
28627,703-004-5394,2675.4385,3,1,2,0.7026156950569588
2878,703-004-5392,1219.3555,4,3,1,0.6882972326022468
29010,703-004-5390,7243.3726,3,2,1,0.4993868711743077
29048,703-004-5385,4646.576,"","","",0.27920371738274696
29184,703-004-5396,7013.572,4,3,1,0.6918331244452561
29268,703-004-5391,6805.028,2,1,1,0.3978652972704144
29287,703-004-5389,9692.959,8,6,2,3.448556851777107
29351,703-004-5395,9417.045,4,3,1,0.8576807080372568
29403,703-004-5392,9279.21,3,2,1,2.4658164147413837
29552,703-004-5389,2736.0332,6,3,3,1.1694396334765649
29569,703-004-5392,2847.931,3,2,1,0.5752949949030765
29712,703-004-5391,2098.179,6,5,1,1.6988573190864575
29835,703-004-5389,2150.3567,4,2,2,0.6288544367571458
30189,703-004-5385,249.91393,2,2,0,0.8315721082337567
30272,703-004-5382,3415.0308,2,2,0,1.044904584091618
30651,703-004-5397,2608.4702,3,3,0,0.8809108018660723
31171,703-004-5391,7825.881,3,2,1,0.6187594496745703
31301,703-004-5385,6812.803,4,3,1,1.778775553516844
31362,703-004-5387,5938.2935,6,3,3,1.5307278856282753
31435,703-004-5394,563.2639,3,1,2,0.37881366923530785
31808,703-004-5390,9906.958,3,1,2,0.4304577603225629
32058,703-004-5391,19.856094,5,3,2,1.2930228632937564
32065,703-004-5393,9431.889,3,1,2,0.768518469780963
32305,703-004-5395,3929.464,7,1,6,0.8229207783644652
32489,207-008-2398,7421.9463,3,1,2,0.46126100416837335
32795,703-004-5385,1175.3362,3,1,2,0.4840185485013564
32879,207-008-2399,5634.296,4,2,2,1.0736898902069285
33487,703-004-5396,7326.865,5,2,3,3.9672420948448246
33650,703-004-5385,3490.0356,8,4,4,1.1142481268112927
34252,703-004-5383,5829.467,4,1,3,0.9596277561047319
34377,703-004-5393,2976.1768,4,4,0,1.2633787897943267
34738,703-004-5394,3989.9521,1,1,0,0.6526639636360175
34803,703-004-5389,7491.6987,"","","",0.27920371738274696
35227,703-004-5383,8181.539,4,2,2,0.5750879559491142
3575,703-004-5380,3425.5977,6,2,4,1.5815823178380948
35822,703-004-5398,5801.7554,4,2,2,0.951744604943268
3592,703-004-5393,653.6621,9,7,2,4.165728697948443
36066,703-004-5387,4251.804,4,2,2,0.7811311768359458
36087,703-004-5382,8099.2383,5,2,3,1.7743994140406496
36287,703-004-5398,3520.6033,4,2,2,1.0823185844628653
36376,703-004-5383,2514.2168,2,1,1,0.3978652972704144
3638,703-004-5383,7034.504,4,1,3,0.4768644834254133
36555,703-004-5396,41.996838,3,0,3,0.27920371738274696
36636,703-004-5383,6361.0967,2,1,1,0.44432460195143314
36900,703-004-5390,9870.9795,3,3,0,1.3552984055762358
36947,207-008-2398,8305.637,1,0,1,0.27920371738274696
37216,703-004-5399,9117.363,9,6,3,1.7267741848240985
3753,703-004-5389,8742.156,6,1,5,0.5762958630609512
37575,703-004-5388,918.82526,"","","",0.27920371738274696
37615,703-004-5387,7663.577,1,1,0,0.3978652972704144
3775,703-004-5387,1652.2694,3,1,2,0.533797323532915
37869,703-004-5382,4339.757,4,2,2,0.8194335879708912
38029,703-004-5389,1724.503,4,2,2,0.5493593536979813
38308,207-008-2399,1893.1472,2,0,2,0.27920371738274696
38930,703-004-5395,8084.088,6,1,5,1.0413901650128379
39365,703-004-5394,2359.7402,3,2,1,1.119182955077701
39618,703-004-5388,6376.611,4,1,3,0.4230808829965438
39686,703-004-5394,6944.939,5,3,2,1.7170011403430088
39846,703-004-5394,5164.417,7,3,4,1.003580717623843
39973,703-004-5394,2901.01,1,0,1,0.27920371738274696
4,703-004-5390,6429.441,5,3,2,1.1037759350047063
40001,703-004-5393,5409.3345,3,2,1,0.8393693794910428
40279,703-004-5395,6967.842,3,3,0,1.1495925181617819
40502,703-004-5397,5666.9907,2,2,0,0.5653168724364255
40513,703-004-5397,7229.0073,5,2,3,0.44414331342660474
40623,703-004-5397,9481.777,4,2,2,1.1261739740404724
40918,703-004-5397,9170.482,2,1,1,0.9613901213467816
40923,703-004-5389,9225.84,6,2,4,0.7445512235954477
41186,703-004-5391,9803.455,5,2,3,0.5480035478856355
41343,703-004-5380,6990.665,3,0,3,0.27920371738274696
41466,703-004-5396,3545.4165,5,0,5,0.27920371738274696
41560,703-004-5383,181.70357,4,2,2,0.6232022118635866
4168,703-004-5389,7882.798,3,3,0,2.6436205217048743
41692,703-004-5386,1641.1204,3,2,1,1.5339935551680668
41727,207-008-2398,947.66974,7,3,4,1.4732699657613892
42812,703-004-5398,8551.548,2,1,1,0.33853450732658075
43070,703-004-5393,289.4485,2,0,2,0.27920371738274696
43126,703-004-5393,940.99225,4,1,3,0.5973210209247806
43143,703-004-5387,5721.5337,4,1,3,0.44363584289687685
43748,703-004-5398,1511.7639,6,2,4,2.778267966481826
43916,703-004-5393,179.59178,3,1,2,0.6708273662057401
4419,703-004-5384,3393.216,2,0,2,0.27920371738274696
44358,703-004-5399,6399.7036,3,2,1,0.8389797510031894
44384,703-004-5390,144.78802,5,1,4,0.3982589865039096
44448,703-004-5395,4015.24,4,4,0,1.4968279203021932
44507,703-004-5393,3767.3743,3,2,1,0.8658805789402918
44616,703-004-5388,6916.9526,9,3,6,1.034569973141422
45339,703-004-5391,7211.3896,6,4,2,1.2348781828365314
45427,703-004-5396,6462.3477,4,2,2,1.6738245289491898
45737,703-004-5396,2781.0454,5,2,3,0.7971232346541653
45767,703-004-5380,2835.2886,6,4,2,1.3113838633360588
4578,207-008-2398,9102.045,4,3,1,0.905717826526143
45903,703-004-5381,853.30786,4,2,2,1.9074744560838353
46353,703-004-5396,4215.819,5,5,0,2.323114879174747
46370,703-004-5389,6127.1143,6,3,3,1.8736721346301644
4673,703-004-5383,8676.109,"","","",0.27920371738274696
46734,703-004-5382,9452.679,4,1,3,2.2777290874097953
46994,703-004-5383,8252.47,4,2,2,2.896373616377268
47582,703-004-5388,2697.8098,4,4,0,1.2465194760899898
47800,703-004-5383,9789.56,6,3,3,2.63143681478423
47808,703-004-5392,5075.1836,3,2,1,0.47697301719552604
47853,703-004-5395,3931.0222,1,1,0,0.6868305125990304
48079,703-004-5386,1370.5891,9,6,3,1.9771126949730142
4832,703-004-5384,2763.9253,5,3,2,1.4355689634191215
48416,703-004-5397,9001.93,6,2,4,1.199185313102059
48419,703-004-5390,8258.278,3,2,1,1.8431173050635394
48689,703-004-5399,1449.2994,4,1,3,0.585943987519148
48758,703-004-5380,3997.733,4,2,2,0.6635233406841663
48777,703-004-5380,7924.543,7,4,3,0.622160867983657
49050,703-004-5388,4378.3887,1,1,0,0.5726111208302134
49106,703-004-5384,7408.5786,4,2,2,0.9194721554098524
49117,703-004-5383,97.18776,6,1,5,1.0220591026253107
49295,703-004-5397,5283.1685,2,1,1,0.4870900949271513
49523,703-004-5386,8296.82,3,1,2,0.41766216868874745
49553,703-004-5393,9914.115,5,2,3,1.5278469471775473
49828,703-004-5380,2315.7173,5,3,2,0.8393428799667696
49862,703-004-5396,7959.8696,6,2,4,1.1828715611747624
5393,703-004-5383,225.69418,5,1,4,0.32666834933781397
5478,703-004-5396,8337.11,5,1,4,0.5383263064286127
6052,703-004-5383,6793.0283,4,3,1,2.068065956129287
6089,703-004-5393,7917.921,8,7,1,3.0141815491024726
6218,703-004-5382,797.81354,6,1,5,0.36007282013431624
641,703-004-5385,4637.3037,4,0,4,0.27920371738274696
6822,703-004-5382,4933.2617,1,0,1,0.27920371738274696
7405,703-004-5390,3042.5955,5,3,2,1.2806620447730122
7569,703-004-5380,4031.6558,4,1,3,0.3978652972704144
7796,207-008-2398,4562.654,4,3,1,1.1028311022568407
7802,703-004-5392,8123.1333,6,2,4,0.859398797002675
8030,207-008-2399,5983.351,"","","",0.27920371738274696
8296,703-004-5383,8639.628,2,0,2,0.27920371738274696
8360,703-004-5392,9211.822,4,3,1,1.2240084997285618
8695,703-004-5383,3294.9763,4,3,1,1.5362343748361043
9564,207-008-2398,5888.754,2,1,1,0.5628603073283753
9717,703-004-5395,151.28017,5,3,2,1.0705952233477587
10207,703-004-5397,3261.7502,4,0,4,0.27920371738274696
1025,703-004-5397,6020.0938,2,1,1,0.756646449395515
10469,703-004-5380,1848.6422,5,1,4,0.42555299924420353
10796,703-004-5395,3499.0137,5,2,3,2.5400261003342792
10854,703-004-5396,6905.0713,4,1,3,0.3978652972704144
10948,703-004-5382,4263.748,6,2,4,2.4195375470135225
11621,703-004-5395,920.8888,4,1,3,0.6052345471306976
1197,703-004-5390,139.37712,4,1,3,0.7536738722782799
12047,703-004-5398,905.3356,6,2,4,1.1503231270164773
12270,207-008-2399,5373.7827,4,1,3,0.47560782370451604
12539,703-004-5396,51.398277,5,1,4,0.846880691715419
12876,703-004-5387,291.82495,"","","",0.27920371738274696
12931,703-004-5394,4093.654,5,3,2,1.3491360487549575
13055,703-004-5386,2976.4248,"","","",0.27920371738274696
13056,703-004-5381,4628.4185,3,0,3,0.27920371738274696
13484,703-004-5380,7986.097,3,1,2,0.9780287413383212
13890,207-008-2399,4780.585,2,1,1,0.6168838163999214
14151,703-004-5394,3355.6348,5,3,2,0.9966365977519496
1417,703-004-5394,2716.4119,8,3,5,1.1724191968631863
14424,703-004-5389,8865.223,6,3,3,1.6226036510793203
15007,703-004-5383,3912.0037,3,1,2,0.4590130926562781
15233,207-008-2399,3971.2542,1,1,0,0.35831143730785864
15316,703-004-5394,5217.997,4,2,2,0.5922437834161282
15344,207-008-2398,5959.8555,2,0,2,0.27920371738274696
15380,703-004-5393,424.61575,5,2,3,0.8353190900834359
15387,207-008-2398,5787.3784,2,1,1,0.665681628522546
1553,703-004-5386,1929.6873,3,0,3,0.27920371738274696
16111,703-004-5390,9602.7295,9,5,4,1.3157276535544762
16323,703-004-5398,8889.322,5,3,2,0.9577894996750136
16417,703-004-5384,6835.0728,3,1,2,0.6225699759919029
16465,703-004-5387,9414.309,3,1,2,0.5276727535199893
16731,703-004-5398,9536.114,7,3,4,0.664453008994284
1694,703-004-5398,1813.358,4,1,3,0.42555299924420353
17040,703-004-5394,2338.5112,6,3,3,0.8515887154842944
17107,703-004-5381,1230.768,"","","",0.27920371738274696
17248,703-004-5390,5618.3745,5,4,1,0.998699072261403
17262,703-004-5380,5879.64,6,4,2,1.1919284734752063
17711,703-004-5380,3575.1252,3,0,3,0.27920371738274696
17869,703-004-5398,4272.827,5,3,2,1.120591750588419
1807,703-004-5388,9642.241,4,1,3,0.4637546116192895
18072,703-004-5380,4425.81,6,3,3,2.0362451496568155
18189,703-004-5384,4849.759,"","","",0.27920371738274696
18239,703-004-5395,3686.7256,4,1,3,0.35050693770154023
18249,703-004-5396,239.49026,2,2,0,1.2304707157944972
18269,703-004-5381,2000.7062,4,2,2,0.6251553675875137
18369,703-004-5386,7839.9326,5,2,3,1.1234962909510429
18802,703-004-5387,6708.0273,5,3,2,0.6787956142586945
18987,703-004-5387,354.53796,4,3,1,1.1927008199042575
19028,703-004-5394,7010.58,6,3,3,0.7928591510053062
19035,703-004-5387,8573.109,4,3,1,0.6164729596053594
19053,703-004-5386,2428.624,7,2,5,1.6203687010098662
19084,703-004-5390,6547.9326,3,2,1,1.1959410059349196
19285,703-004-5395,7513.862,4,2,2,0.9267223017299797
19495,703-004-5391,6498.639,1,0,1,0.27920371738274696
19546,703-004-5392,7654.988,5,3,2,1.0913749075366757
19620,703-004-5383,6085.729,1,0,1,0.27920371738274696
19633,207-008-2398,1485.0759,3,2,1,0.7354446876901558
19642,703-004-5396,8184.4077,1,1,0,0.6007307109127413
19692,703-004-5392,8222.653,6,1,5,0.6294408622861943
19725,703-004-5387,7326.795,2,1,1,0.33853450732658075
19923,703-004-5382,6241.389,2,2,0,1.0662937721493222
20306,703-004-5391,1231.0618,4,1,3,0.6290498501136591
20317,703-004-5382,4683.701,7,3,4,1.3597701409010032
20507,703-004-5388,4177.0347,5,2,3,1.5330266630283573
20513,703-004-5386,1943.45,7,5,2,1.2548277310340739
20565,703-004-5396,6246.4155,2,1,1,0.6173892200625992
20578,703-004-5397,3314.9636,5,2,3,1.8154391549387894
20800,703-004-5399,2125.0205,3,3,0,0.8270587831382703
2093,703-004-5391,5704.456,5,1,4,0.3689007141460094
20955,703-004-5381,2561.7837,3,1,2,0.5081553274181694
20967,703-004-5399,2922.1343,2,2,0,1.9559206833511003
21243,703-004-5391,1795.4767,3,0,3,0.27920371738274696
21589,703-004-5395,8625.221,7,3,4,1.1162529129235272
21627,703-004-5395,2764.3318,1,0,1,0.27920371738274696
21836,703-004-5387,2446.282,4,2,2,0.9276049616458074
22011,703-004-5393,8062.4453,1,0,1,0.27920371738274696
22138,703-004-5387,202.81732,5,2,3,1.2044667199086605
22272,703-004-5382,9293.567,4,4,0,2.3935268744061973
22505,703-004-5383,8060.197,4,2,2,0.4727205999968977
22521,703-004-5385,9643.376,2,1,1,0.4045517605298771
2286,703-004-5396,7489.4424,6,5,1,1.5977451140736096
23109,703-004-5393,9473.125,2,0,2,0.27920371738274696
2343,703-004-5390,6101.753,6,3,3,0.8569326890087566
23973,703-004-5390,924.8674,3,2,1,0.9280782078590836
2404,703-004-5389,6960.738,9,4,5,2.7710225358658893
24116,703-004-5383,6864.3765,5,3,2,1.0842611195469203
24464,703-004-5389,5917.947,2,0,2,0.27920371738274696
24812,703-004-5381,3779.956,2,0,2,0.27920371738274696
24872,703-004-5383,2900.9236,5,2,3,0.629543397095047
25289,703-004-5382,5814.1245,1,1,0,0.37394040683563273
25421,703-004-5387,7776.421,2,1,1,0.6366805174872534
25505,703-004-5391,2061.6555,6,2,4,1.684175383544708
2551,703-004-5380,5514.4043,5,3,2,1.0110297494341731
25774,703-004-5388,8428.828,6,5,1,1.6929673817193593
25775,703-004-5387,2621.3533,4,1,3,1.374863027910825
25781,703-004-5397,8614.1045,6,6,0,2.7728886608622534
25866,703-004-5381,1944.9806,5,4,1,1.6582540593993558
25884,703-004-5385,750.8355,5,3,2,1.153190784408737
25889,703-004-5398,9301.592,5,1,4,0.4195395764717712
26133,703-004-5384,3389.9707,6,4,2,1.5479949859691342
26697,703-004-5388,1671.0847,2,1,1,0.32951716901368855
26784,703-004-5387,4778.519,7,3,4,0.9368307524670593
27134,703-004-5381,4283.9907,1,0,1,0.27920371738274696
27919,703-004-5385,4337.957,4,2,2,0.9693066381110971
27947,703-004-5393,8942.919,3,1,2,0.6005558100560536
27981,207-008-2398,1213.1268,3,2,1,0.8549407735016525
28179,703-004-5395,4042.679,1,0,1,0.27920371738274696
28193,703-004-5387,9689.844,5,1,4,0.4716706541550569
28265,703-004-5385,8602.906,2,1,1,0.5820457565246615
28848,703-004-5398,6170.706,3,3,0,0.8261092284793221
28898,703-004-5391,2291.5083,4,3,1,0.6157948791882263
29333,703-004-5398,1953.8439,6,2,4,0.628486474272321
29847,703-004-5392,8359.703,1,1,0,0.7398513165311269
29951,703-004-5386,6044.2007,5,2,3,0.6598225562778196
30377,703-004-5385,8797.152,3,3,0,0.7521222234035315
30419,703-004-5390,741.21655,1,1,0,0.35831143730785864
30474,703-004-5399,8528.837,6,5,1,1.6485366613695704
30733,703-004-5387,6184.7036,7,1,6,0.5165268771580819
30866,703-004-5397,223.51921,3,0,3,0.27920371738274696
31571,703-004-5397,8967.745,5,2,3,0.7150266971446657
31609,703-004-5385,9753.669,2,1,1,0.6159876776895732
31803,703-004-5382,5326.6333,5,1,4,0.6014950037166498
31818,703-004-5392,4718.9116,5,5,0,2.6568229541316226
32185,703-004-5389,7440.211,6,3,3,1.8573070329610788
32220,207-008-2399,4410.7354,7,5,2,1.7101834231211215
32476,207-008-2398,3471.049,6,4,2,2.585972372230297
32592,703-004-5391,8730.784,4,3,1,1.7660794824750128
32702,703-004-5383,5618.8853,3,1,2,1.3178702092114256
32739,703-004-5399,7444.047,3,2,1,0.8093230894727775
32881,703-004-5387,4467.5757,5,0,5,0.27920371738274696
3292,703-004-5388,5662.4585,3,0,3,0.27920371738274696
33041,703-004-5386,6439.5547,3,0,3,0.27920371738274696
33297,703-004-5390,8133.8423,4,4,0,1.0037775952929744
33416,703-004-5380,6331.877,3,2,1,0.6463066248911223
33559,703-004-5386,6720.131,6,4,2,1.8295592625379644
33979,703-004-5391,4319.267,3,2,1,0.47103993820114265
34028,703-004-5392,108.78861,5,3,2,2.4371026800668565
3457,703-004-5384,3842.1565,5,3,2,0.9742038024900412
34576,703-004-5382,5711.4385,7,6,1,1.72687598631592
34921,703-004-5383,9991.915,8,7,1,2.426607566098908
35197,703-004-5381,1357.3247,6,4,2,0.9684682645355109
35544,703-004-5383,7209.097,3,1,2,0.6143633497754637
35606,703-004-5382,8557.22,1,1,0,0.4180377658513179
35668,703-004-5393,28.035046,1,1,0,0.4712683703106344
3567,703-004-5387,772.61505,2,1,1,1.0298604928025636
35800,703-004-5383,6109.4546,5,2,3,1.308085425120945
35824,703-004-5398,5599.438,4,1,3,0.4258681940657802
35867,703-004-5383,9816.304,3,1,2,0.45261668502046587
35987,703-004-5385,2204.0796,4,0,4,0.27920371738274696
36025,703-004-5397,518.229,4,1,3,0.6673415347006483
36031,703-004-5383,5151.1406,11,5,6,3.408266040739409
3614,703-004-5398,7994.3906,2,1,1,0.9545605587205304
36233,207-008-2399,4336.829,"","","",0.27920371738274696
36663,703-004-5399,1733.9867,2,1,1,1.1613287869633244
36769,703-004-5380,6363.714,5,1,4,0.4459594667958592
36838,703-004-5380,2362.8342,5,2,3,0.6463709237984315
37196,703-004-5384,1558.2174,4,1,3,0.6195046923395966
37314,703-004-5384,1463.2542,4,2,2,1.3068517543347038
37315,703-004-5391,3382.352,4,2,2,1.8587835844743146
37626,703-004-5382,2998.1309,3,0,3,0.27920371738274696
37847,703-004-5385,1448.0984,5,4,1,1.0138588932037833
38025,703-004-5395,3599.5764,5,2,3,3.3123698488406332
38772,703-004-5389,4597.565,7,1,6,0.43852688917578214
38841,703-004-5394,8412.774,2,0,2,0.27920371738274696
39056,703-004-5384,8789.886,2,0,2,0.27920371738274696
39184,703-004-5398,8067.896,5,2,3,0.6974836429153813
39292,207-008-2398,4468.868,5,1,4,0.9536313149812093
39509,703-004-5385,5448.795,2,1,1,0.35831143730785864
39730,703-004-5381,5324.4883,2,1,1,0.4475320808795612
39883,703-004-5398,3775.2825,3,0,3,0.27920371738274696
39938,703-004-5388,244.80344,3,1,2,3.5609305606849797
40133,703-004-5380,4905.0776,7,4,3,2.687126948636052
40333,703-004-5396,3829.1013,1,1,0,0.4637111847772056
4040,703-004-5384,408.93854,4,3,1,0.636340005117959
4050,703-004-5397,1248.9796,3,1,2,1.033562911209783
40536,703-004-5395,8368.504,5,2,3,2.4015563725915112
40845,703-004-5392,364.9491,4,1,3,0.33853450732658075
40853,703-004-5387,2653.6245,5,4,1,1.430341621631252
41282,703-004-5396,7752.385,3,2,1,0.9920353389070922
41354,703-004-5391,1359.2285,6,2,4,2.2575023394012312
41363,703-004-5384,5010.2056,1,0,1,0.27920371738274696
41748,207-008-2399,7350.049,6,5,1,1.4450196874910395
41761,703-004-5395,3809.3413,6,1,5,0.33853450732658075
41946,703-004-5380,9058.999,6,3,3,1.5893225561305042
42081,703-004-5398,5147.694,2,1,1,0.6289020288295297
42495,703-004-5395,7164.4414,7,2,5,0.5957417163208928
42756,703-004-5389,3445.767,4,2,2,0.6480406397389417
42896,703-004-5389,3604.905,3,1,2,0.3925079080467526
43043,703-004-5386,1782.487,6,3,3,0.48901600212789326
43069,703-004-5383,2278.868,3,2,1,0.9767715394886567
43112,703-004-5380,5033.7505,5,1,4,0.43699141617864873
4321,703-004-5387,1459.0841,2,0,2,0.27920371738274696
43407,703-004-5392,9941.606,6,4,2,1.6410888273033892
43511,703-004-5383,2318.5928,6,2,4,1.5055018506887614
43786,703-004-5394,695.92896,5,3,2,1.6475298372418692
4435,703-004-5398,4756.694,4,2,2,0.6381652530600758
44435,207-008-2398,4239.3794,3,1,2,0.6142966286085715
44605,703-004-5382,5914.821,3,2,1,0.5242029827393099
45028,703-004-5380,5272.8633,2,1,1,0.33853450732658075
45155,703-004-5395,4663.572,5,3,2,0.9320243854167498
45242,703-004-5383,401.0719,5,3,2,0.8362518916341207
45566,703-004-5384,940.62744,2,1,1,0.863465319432148
4592,703-004-5395,6546.5767,4,0,4,0.27920371738274696
45932,703-004-5382,175.03142,3,2,1,0.8433341855314522
46116,703-004-5398,840.3945,5,3,2,1.0821501091875982
46241,703-004-5380,4775.314,3,3,0,1.0355646521432875
46262,703-004-5385,7984.8022,3,2,1,0.5562785064204505
46425,703-004-5393,249.14444,3,1,2,1.175018355162312
46447,703-004-5387,9609.247,4,2,2,2.8065947586179663
46855,703-004-5383,3769.266,5,3,2,1.2897085163477675
46898,703-004-5387,3724.976,7,1,6,0.35534489781066697
46950,703-004-5383,5738.103,7,3,4,1.1265586153989342
47107,703-004-5381,5796.752,2,0,2,0.27920371738274696
4770,703-004-5383,3252.234,7,4,3,2.2181411595620406
47844,703-004-5392,9515.182,5,1,4,1.0747822229821558
48294,703-004-5383,6668.769,8,5,3,2.084159590884746
48323,703-004-5393,6701.0664,3,1,2,0.3919550190720685
48483,703-004-5390,9224.104,3,1,2,0.5435367951304665
48550,703-004-5395,3390.863,3,2,1,0.4378797691425733
48634,703-004-5393,9579.166,2,0,2,0.27920371738274696
48672,703-004-5399,2927.7307,4,2,2,0.5309553836375479
48792,703-004-5384,7184.8027,2,1,1,0.3978652972704144
48971,703-004-5399,8984.071,4,2,2,0.6460295108304865
49212,703-004-5386,2628.7341,1,0,1,0.27920371738274696
49345,703-004-5385,8341.296,5,2,3,0.6597181203916265
49519,703-004-5399,9165.276,2,0,2,0.27920371738274696
4955,703-004-5395,4153.378,2,1,1,0.7637103296994575
49691,703-004-5390,7886.5977,6,4,2,2.294449058541451
49833,703-004-5398,4458.692,9,4,5,0.7781855922464246
49942,207-008-2399,1699.7546,5,2,3,0.6190395514666349
49997,703-004-5380,1428.2805,5,2,3,0.9353416126349686
5537,703-004-5394,1802.2329,8,4,4,1.9520610681142578
5629,703-004-5382,8316.503,4,4,0,1.7321615823990548
5681,703-004-5384,4051.515,2,0,2,0.27920371738274696
5740,703-004-5391,6472.9185,7,5,2,2.0455202376855235
5810,703-004-5391,8423.33,6,3,3,1.9782036021644367
5858,703-004-5388,126.63543,7,5,2,1.4146699771906406
587,703-004-5385,3045.4648,3,2,1,0.45719608721424815
5964,703-004-5384,5497.175,2,0,2,0.27920371738274696
6082,703-004-5398,102.985504,3,2,1,0.86776203709851
6267,703-004-5383,7166.2764,3,1,2,0.33853450732658075
6346,703-004-5389,6388.213,3,3,0,0.9337203757298234
6382,703-004-5388,9392.193,4,2,2,1.3273064265005339
6421,703-004-5388,9313.358,3,1,2,1.6362031933145573
6665,703-004-5393,5431.2207,7,3,4,1.9005181750615905
690,703-004-5395,9712.291,2,0,2,0.27920371738274696
6934,703-004-5388,1679.1772,3,2,1,1.0021739532491818
7206,703-004-5398,5610.5957,1,1,0,0.5165268771580819
7384,703-004-5383,7374.8105,6,4,2,2.1436934114578015
7441,703-004-5393,8039.092,5,2,3,1.3972401781479342
7592,703-004-5390,7855.417,3,1,2,0.5385817768993445
8182,703-004-5389,2150.1594,5,3,2,1.1745111548902305
8218,703-004-5396,7961.6587,5,1,4,0.35831143730785864
8348,703-004-5390,8307.823,3,1,2,0.3792149961018502
8352,703-004-5384,6717.0005,4,2,2,0.8494289132686821
8498,207-008-2398,2733.0857,8,6,2,1.3574578933823518
8632,703-004-5395,3704.9377,5,3,2,1.6141099917278312
8844,703-004-5380,5079.494,5,2,3,1.4392048399696982
9170,703-004-5384,7247.643,7,1,6,0.5874784599474869
9612,703-004-5397,7594.6855,3,0,3,0.27920371738274696
9790,703-004-5390,5599.5864,4,1,3,0.8129405901518976
9888,703-004-5380,1729.523,3,3,0,2.0089896716508564
10005,703-004-5381,1004.67804,2,1,1,0.5165268771580819
10240,703-004-5396,9181.137,2,1,1,0.5738925498572038
10284,703-004-5393,8184.3247,3,2,1,2.231227522989437
10553,703-004-5384,7517.609,6,2,4,0.8629184431901159
10558,703-004-5381,6535.5576,4,2,2,0.9730531542199085
10620,703-004-5383,7416.1377,2,1,1,0.3637500930527101
10731,703-004-5380,589.45416,5,4,1,1.626373545369028
10919,703-004-5391,9953.858,4,1,3,0.33472744830518475
1098,703-004-5396,5955.182,3,1,2,0.51109462406712
11135,703-004-5397,8339.313,6,3,3,0.7999479312434179
1121,703-004-5391,5474.7944,3,1,2,0.4398418311556768
11446,703-004-5381,6393.518,3,2,1,1.6534210113737382
11628,703-004-5393,4964.223,3,2,1,0.5722353987700322
11657,703-004-5398,8039.6133,6,4,2,1.66812289853005
11748,703-004-5388,4851.012,3,2,1,0.5535518727621058
11817,207-008-2398,2114.8413,8,5,3,2.551616779611401
11877,207-008-2399,6001.826,1,0,1,0.27920371738274696
12145,703-004-5394,5167.0986,3,1,2,0.35140860891242454
12609,703-004-5394,2880.6304,1,1,0,0.5472820150665705
12783,207-008-2398,3214.692,6,2,4,1.1534518291588551
12869,703-004-5390,970.37134,6,3,3,1.4521834072981794
12900,703-004-5387,7147.254,4,1,3,0.33853450732658075
12926,207-008-2399,6499.2305,7,2,5,0.9913603145013518
12985,703-004-5395,584.0838,5,0,5,0.27920371738274696
13300,207-008-2398,865.0899,6,4,2,0.7317585061609907
13613,703-004-5385,9927.519,10,4,6,1.0145842028069174
14259,703-004-5385,2284.2295,6,6,0,3.063765049342552
15803,703-004-5391,1505.0125,3,2,1,0.5580584301187655
15807,703-004-5382,1687.0099,4,2,2,0.795546338603464
15822,703-004-5383,5498.748,4,3,1,1.2635491026018162
15867,703-004-5398,9971.773,4,1,3,0.3978652972704144
16142,703-004-5387,2884.2485,4,2,2,0.554023252450423
16226,703-004-5394,2936.4705,4,4,0,2.074964678242356
16585,703-004-5385,295.90546,4,2,2,0.6956936484214352
17075,703-004-5392,5834.118,10,3,7,1.4291798578026496
17104,703-004-5381,2365.1172,2,1,1,0.35831143730785864
17127,703-004-5393,6046.95,4,3,1,1.0685800844771967
17172,703-004-5393,4751.8496,4,2,2,0.5725810494765697
17204,703-004-5388,8244.485,2,1,1,2.4158158635795313
17269,703-004-5383,9887.069,5,3,2,0.7493546085223355
1730,703-004-5380,4631.3145,7,4,3,0.8627573055991455
17335,703-004-5390,5823.1396,3,2,1,1.079867286493769
18054,703-004-5386,8657.776,6,4,2,0.9600124179319267
18104,703-004-5397,5167.129,8,2,6,1.1866407700821788
18394,207-008-2398,8484.698,3,2,1,1.4598318029842972
1846,703-004-5387,1375.494,5,3,2,0.9948925620414799
18497,703-004-5383,3535.4258,2,1,1,1.4474269738882122
18612,703-004-5386,5278.469,5,4,1,1.5736394751513583
18680,703-004-5386,4158.104,2,1,1,0.4988125555933882
18773,703-004-5385,4897.5347,5,3,2,1.0443062068941604
19213,703-004-5398,5169.6987,2,2,0,0.7814709264145687
19406,207-008-2399,737.9323,4,2,2,1.3518941872120493
20110,703-004-5382,2478.811,6,3,3,1.3098117651946248
20174,703-004-5387,9293.841,2,1,1,0.39411406687427813
20831,703-004-5392,6453.9297,5,3,2,0.8554906270891198
20870,703-004-5383,2373.6929,7,6,1,1.2907734459424454
2128,703-004-5398,5026.959,2,1,1,0.5222678388824206
2137,703-004-5380,8975.637,3,2,1,0.6403233317625366
21413,703-004-5395,7315.4897,2,1,1,0.4976696893173773
21509,703-004-5380,4967.825,2,1,1,0.6694140593735505
21648,703-004-5380,9766.902,1,0,1,0.27920371738274696
21823,703-004-5397,476.20355,4,3,1,1.1049628206864668
22052,703-004-5381,4197.8223,3,0,3,0.27920371738274696
22074,703-004-5388,3066.4158,2,1,1,0.6213977426000525
22135,703-004-5381,2725.395,4,2,2,1.3361081494642855
22370,703-004-5385,3142.0427,2,0,2,0.27920371738274696
22566,703-004-5380,1245.6924,7,4,3,1.9791336105824533
22669,703-004-5398,4521.9526,3,2,1,1.6328436983391792
23118,703-004-5394,297.15298,2,0,2,0.27920371738274696
23211,703-004-5393,7502.7544,5,4,1,2.569339506227174
23450,207-008-2399,3879.8167,4,2,2,0.5382011563594387
23480,703-004-5386,5921.4907,3,2,1,1.1398635573318447
23653,703-004-5397,1169.3763,5,3,2,0.6812081668858081
23797,703-004-5383,6978.974,5,2,3,1.3506209995194738
24097,207-008-2398,9507.336,4,3,1,2.6454858323322505
2427,703-004-5382,4002.3118,7,5,2,1.775900113945423
24852,207-008-2398,612.88776,3,2,1,1.356273057952249
25107,703-004-5383,9251.579,2,2,0,1.8523565601385164
25202,703-004-5398,4873.797,5,2,3,0.9256511163218676
25429,703-004-5385,132.65848,4,0,4,0.27920371738274696
25553,703-004-5398,5791.9214,3,1,2,0.8982853520014663
25634,703-004-5391,759.5944,4,2,2,0.9394448752114618
25668,703-004-5380,3914.0361,4,3,1,1.8950752758600196
26084,703-004-5395,7676.732,4,3,1,3.7810325140981584
26172,703-004-5387,1986.6335,9,5,4,1.263538344259975
26246,703-004-5391,1644.0505,4,1,3,0.6925609542133818
264,703-004-5385,7076.397,6,3,3,1.208899785886162
26530,207-008-2399,6076.451,2,2,0,0.7243791848157938
26663,703-004-5388,2859.608,5,2,3,0.8409684988139847
26731,703-004-5395,4015.9207,4,3,1,1.784996006464724
27308,703-004-5396,6807.555,2,0,2,0.27920371738274696
28024,703-004-5384,6078.7314,2,0,2,0.27920371738274696
28122,703-004-5393,1291.9503,5,4,1,1.3248474779479171
28136,703-004-5386,5813.709,5,5,0,3.6730091807912992
28166,703-004-5385,841.81604,5,3,2,3.788031320947927
28298,703-004-5398,7201.841,5,5,0,2.4238077882578635
28306,703-004-5382,7014.1353,3,2,1,0.6618651433379066
28399,703-004-5395,1716.6477,5,1,4,1.0940718571434007
28452,703-004-5390,6035.056,5,2,3,0.5250236931190271
28567,703-004-5391,3242.3235,6,2,4,0.7934448595483967
2857,703-004-5380,24.90461,8,3,5,2.012821942576446
28572,703-004-5386,9591.731,6,3,3,1.355780302331483
2880,703-004-5388,3414.8503,5,5,0,5.111044539770788
29036,703-004-5393,2871.6135,3,2,1,0.6842417326799437
29074,703-004-5399,9132.438,8,6,2,1.8580026033857997
29329,703-004-5399,3076.9985,5,0,5,0.27920371738274696
29379,703-004-5393,7015.281,1,0,1,0.27920371738274696
29432,703-004-5383,6281.327,3,1,2,0.3401166617250829
29600,703-004-5396,6365.334,"","","",0.27920371738274696
29692,207-008-2398,2831.019,"","","",0.27920371738274696
29807,703-004-5397,1654.445,2,2,0,0.7631620877855717
30037,703-004-5392,4175.5073,4,1,3,1.4211828705165557
30265,703-004-5383,3013.1125,4,1,3,1.2063224834010444
30336,703-004-5395,2232.1213,5,3,2,3.076419554035088
30385,703-004-5394,6092.7837,5,3,2,1.694800645381296
31540,703-004-5390,1586.2894,4,2,2,0.6579842390226615
31576,703-004-5389,3538.602,5,3,2,0.9992961777515965
31735,703-004-5381,8939.338,3,1,2,0.40026043593831584
31868,703-004-5385,3900.6047,2,0,2,0.27920371738274696
31890,703-004-5386,1756.0703,1,0,1,0.27920371738274696
32091,703-004-5385,8706.99,3,3,0,0.7968369702792345
3211,703-004-5389,63.495636,8,4,4,1.318361388132386
32122,703-004-5386,9434.763,5,4,1,1.9561885182914798
3218,703-004-5380,1575.228,5,1,4,0.7772730997827527
32338,703-004-5383,7359.3564,5,4,1,1.5829706179667566
32639,703-004-5391,3241.793,3,2,1,1.9570848380169208
32663,703-004-5393,4796.0703,3,1,2,0.8838005203524963
32877,703-004-5395,675.8338,4,1,3,0.5569426461867657
33018,703-004-5396,9363.037,1,1,0,1.9277417966728176
3324,207-008-2399,3994.748,3,3,0,0.9116577774036596
33263,703-004-5389,5990.376,7,3,4,1.0258857133726986
33642,703-004-5394,2270.454,5,3,2,1.4935199471408334
33669,703-004-5384,563.4183,9,4,5,2.345825108999366
33761,703-004-5398,9450.386,6,3,3,0.7172851292000144
34133,703-004-5397,9324.468,4,3,1,0.7242102262230207
34427,207-008-2398,3831.6255,2,1,1,1.1240856068964415
34567,703-004-5387,3407.6667,4,1,3,0.49282668267321744
34903,207-008-2398,4613.1646,6,2,4,1.188800212497499
34938,703-004-5396,3922.339,1,1,0,1.0327687468185047
35624,703-004-5382,2198.7498,4,2,2,1.1557358277703458
35786,703-004-5393,2974.0066,4,2,2,0.9841393339002542
35981,207-008-2398,2757.7043,3,3,0,2.1648300862328274
36301,703-004-5391,1682.4967,3,1,2,0.6104385523182057
36408,703-004-5389,1509.1044,6,3,3,3.911920982204707
36584,703-004-5399,8765.149,3,2,1,1.146455150300354
36617,703-004-5382,3104.3853,2,0,2,0.27920371738274696
37822,703-004-5390,4352.1855,5,3,2,1.0862856106409118
37925,703-004-5395,5909.362,6,3,3,1.1673732717083074
37941,703-004-5387,3203.3306,1,1,0,0.5080524893594243
38011,703-004-5383,4183.0063,4,2,2,0.9826309275721719
38100,703-004-5392,9060.636,4,0,4,0.27920371738274696
38186,703-004-5386,9685.914,2,1,1,0.5113555216233566
38212,703-004-5384,3537.2524,3,2,1,1.086196745529686
38268,703-004-5389,3451.782,2,1,1,0.48338390402482306
39693,207-008-2399,2738.2964,6,5,1,3.407471912628008
39854,703-004-5383,9323.83,3,0,3,0.27920371738274696
40026,703-004-5385,5588.006,6,3,3,1.88649630949816
40290,703-004-5393,1565.4457,3,0,3,0.27920371738274696
40468,703-004-5394,9301.572,7,6,1,2.938728065949552
40687,703-004-5388,718.49884,4,0,4,0.27920371738274696
40765,703-004-5392,7714.093,5,3,2,2.1629994068130514
40788,703-004-5380,771.9493,2,2,0,1.9974480769541656
40808,703-004-5388,4062.141,4,2,2,1.3102049432116483
40945,703-004-5387,3406.4824,3,1,2,0.4230808829965438
4152,703-004-5399,3930.024,2,2,0,1.2989601712394139
41718,703-004-5387,3458.7957,4,1,3,0.47244304731329956
4178,703-004-5392,1588.9657,2,2,0,0.49504356893685686
41969,703-004-5380,6267.513,"","","",0.27920371738274696
42053,703-004-5398,3744.011,3,0,3,0.27920371738274696
42547,703-004-5394,556.55896,5,4,1,2.445975569690626
42798,703-004-5386,2431.572,2,1,1,0.42987488188234124
43266,703-004-5397,3746.466,4,3,1,1.4052888088730844
43434,703-004-5393,5291.171,4,4,0,1.5938521521953695
43512,703-004-5389,8120.7124,1,1,0,0.4087021537944691
43551,703-004-5396,6058.442,1,1,0,0.3959733320767259
43643,703-004-5388,4488.9746,3,1,2,0.3131070259220805
43778,703-004-5396,4650.928,3,2,1,0.7780348101112502
43983,703-004-5382,4452.279,4,0,4,0.27920371738274696
44041,703-004-5393,5044.2495,6,4,2,1.989477187876646
4423,703-004-5393,7773.261,3,3,0,3.4322027259408427
44396,703-004-5398,6919.5293,4,1,3,1.14255931326989
44694,703-004-5387,1644.5046,10,7,3,7.071563499718472
4475,703-004-5390,9695.806,3,1,2,0.7324232104464815
44910,703-004-5388,3801.201,4,3,1,1.8185459557640151
45322,703-004-5380,2303.2266,3,1,2,0.6615952937887197
45497,703-004-5384,9836.448,4,1,3,0.5274103685340991
45731,703-004-5386,3310.616,2,1,1,0.47594079019625735
45843,207-008-2398,9972.322,2,1,1,0.3568601047394626
46078,703-004-5380,4339.4487,3,3,0,1.018322665210424
46945,703-004-5393,7149.042,4,1,3,0.3919322182760311
47143,703-004-5382,7598.9517,5,3,2,0.978600490660922
4718,703-004-5391,8125.568,4,2,2,0.5967477937540704
47316,703-004-5389,1475.752,3,2,1,1.1030899480004228
47967,703-004-5392,3788.299,5,3,2,0.9186061153801977
48027,703-004-5383,3659.5447,4,4,0,1.003685347557278
48675,703-004-5398,5906.4478,5,4,1,1.9695157126150327
48735,703-004-5386,220.72435,9,4,5,2.667660015775737
48935,703-004-5392,2339.6802,5,1,4,0.5669580486103406
49241,703-004-5396,2421.6074,4,1,3,0.49567113652197364
49423,703-004-5394,5353.4824,7,3,4,1.3605219297112703
49503,703-004-5383,6244.578,7,4,3,1.0575171597256825
49565,703-004-5388,2896.5122,3,1,2,0.4406066586006219
49635,703-004-5392,8941.123,4,2,2,1.1880099677798297
49741,703-004-5399,9874.547,3,2,1,1.0570529566726412
49795,703-004-5387,5003.531,4,2,2,2.7167827731648106
49919,703-004-5388,710.4546,"","","",0.27920371738274696
5026,703-004-5398,4617.3926,2,1,1,0.5165268771580819
508,207-008-2398,4324.932,3,0,3,0.27920371738274696
5095,703-004-5394,3041.1143,3,3,0,1.1710689776552066
5540,703-004-5396,5527.8667,9,5,4,1.8468564190981114
5784,703-004-5385,540.70233,2,0,2,0.27920371738274696
5946,703-004-5388,7393.909,4,1,3,0.9608922725975043
6095,703-004-5396,3350.1082,5,2,3,0.5353961490580628
6260,703-004-5380,6066.905,5,3,2,1.3262563171373125
6275,703-004-5394,2592.6978,"","","",0.27920371738274696
6286,703-004-5384,5524.183,4,4,0,2.8202980697578504
651,703-004-5395,1878.7628,4,3,1,0.9383880304443619
66,703-004-5392,1910.3777,3,2,1,0.976820789997105
662,703-004-5390,1075.0276,5,3,2,0.6707811183627586
6676,703-004-5398,3507.9343,5,4,1,2.1069658521155463
6699,703-004-5386,362.09464,"","","",0.27920371738274696
6946,703-004-5386,1251.0764,1,0,1,0.27920371738274696
7122,703-004-5382,1909.6875,3,0,3,0.27920371738274696
7572,207-008-2398,8536.696,4,0,4,0.27920371738274696
7581,703-004-5381,9639.003,1,1,0,0.4638191143493954
7822,207-008-2399,9245.443,5,4,1,2.33015757521259
7850,207-008-2398,3469.8325,4,1,3,0.5950277804855958
8105,703-004-5391,7697.57,9,5,4,0.8204286806451374
8191,207-008-2398,5721.9683,8,4,4,2.41561910035103
8232,703-004-5382,1197.0574,3,2,1,0.5576156912925783
8359,703-004-5385,3284.4485,5,2,3,1.1698767599542026
846,703-004-5384,8392.058,2,1,1,1.6480481801697597
8485,703-004-5391,742.7657,5,4,1,1.2126494790789648
8487,703-004-5396,1595.5782,1,1,0,0.42100854645955216
8563,703-004-5385,8646.083,3,2,1,0.7299796621600334
8985,703-004-5393,8211.112,4,1,3,1.329479944530451
9053,703-004-5390,8097.4766,4,3,1,1.5545288221721714
9276,703-004-5390,7901.547,7,5,2,2.5318095256922803
9452,703-004-5388,9917.703,10,6,4,1.9992540689285596
9522,703-004-5395,3609.1704,"","","",0.27920371738274696
9751,703-004-5396,5350.325,4,1,3,0.4600637420615335
10075,703-004-5381,5765.0415,3,1,2,0.7674110408448571
10950,703-004-5394,1221.494,4,1,3,0.35831143730785864
11163,703-004-5391,3240.7605,2,1,1,1.549108099614735
11339,703-004-5395,120.20827,2,1,1,0.4774975669784875
11603,703-004-5391,739.32886,1,1,0,0.3367545836282657
11829,703-004-5392,9499.788,2,2,0,0.8548133329249492
11842,703-004-5385,274.75058,5,4,1,1.018574831657834
11844,703-004-5397,760.4283,7,4,3,2.2291362054592656
11849,703-004-5391,472.63742,3,1,2,0.4866286884154609
12724,703-004-5380,7570.4243,3,0,3,0.27920371738274696
12814,703-004-5390,4335.178,3,1,2,0.5271673242651452
12886,703-004-5385,2254.266,6,6,0,2.2819802991274574
1292,703-004-5394,4450.039,5,5,0,3.6810721891824327
13297,703-004-5394,6756.2686,4,3,1,0.7099265918248181
13718,703-004-5393,8264.511,2,0,2,0.27920371738274696
14266,703-004-5386,4203.998,4,1,3,0.6653411174665438
14281,703-004-5394,6164.7905,3,2,1,0.7805644844107968
14451,703-004-5387,7214.3228,1,0,1,0.27920371738274696
14471,207-008-2398,9440.314,2,1,1,0.4457749101500602
14570,703-004-5384,1794.3263,1,0,1,0.27920371738274696
14655,703-004-5382,7191.278,3,2,1,1.1306660352378557
14694,703-004-5387,4324.095,7,1,6,0.4260602184603415
14894,703-004-5387,8043.404,1,0,1,0.27920371738274696
151,207-008-2399,8406.423,5,2,3,0.8784164939756576
15155,703-004-5380,9120.118,7,4,3,1.694001131306953
15642,703-004-5394,218.36996,2,2,0,1.051047519073909
15726,703-004-5385,3231.5208,3,0,3,0.27920371738274696
16307,703-004-5387,8068.5317,3,1,2,0.4169320523228548
16385,703-004-5396,3300.3801,4,2,2,1.8232067020685088
16708,703-004-5380,5916.368,3,2,1,1.4563730200367462
17047,703-004-5393,2694.378,7,6,1,1.4469570149325646
17304,703-004-5396,4210.406,6,4,2,0.916055900931908
17760,703-004-5393,9500.247,3,1,2,2.130140532503657
17803,703-004-5382,4082.3125,2,0,2,0.27920371738274696
17892,703-004-5389,9309.0205,6,5,1,1.5742033474745454
1800,703-004-5392,3829.196,5,2,3,0.48003346423441623
1849,703-004-5382,5931.3433,6,6,0,1.93040934844165
18630,703-004-5395,3396.3525,1,0,1,0.27920371738274696
18717,703-004-5387,493.2189,5,1,4,0.7398598740530978
1873,703-004-5394,8007.071,5,4,1,2.2781826578533892
18828,703-004-5391,1348.8083,3,1,2,0.9546994004351161
18943,703-004-5391,9519.712,"","","",0.27920371738274696
19254,703-004-5381,1579.1852,5,3,2,1.2300377131148053
19381,703-004-5385,2766.2407,6,1,5,0.7265814434793197
19470,703-004-5380,4208.028,6,3,3,2.7213615914833915
19507,703-004-5380,5917.305,1,0,1,0.27920371738274696
19828,703-004-5383,2101.2266,8,4,4,1.819115302836614
20005,703-004-5393,2292.452,1,1,0,0.4534487787758835
20056,703-004-5389,7325.715,2,2,0,0.6661020581215493
20287,703-004-5387,9631.321,4,3,1,1.0015060941906089
20355,703-004-5399,9255.807,2,2,0,0.41764222725169237
20693,703-004-5389,3390.984,2,2,0,0.5638415372359883
20737,703-004-5384,8498.965,5,3,2,0.866864647983338
20878,703-004-5396,8553.041,4,2,2,1.1088297040788833
20925,703-004-5395,5174.405,2,2,0,0.5740308051420697
20958,703-004-5397,9954.54,2,1,1,0.44829646872267315
2173,703-004-5393,369.43497,2,0,2,0.27920371738274696
21749,703-004-5397,4014.2036,4,1,3,0.5401711964541659
21818,703-004-5398,8530.005,3,0,3,0.27920371738274696
22030,703-004-5395,847.0654,1,0,1,0.27920371738274696
22174,703-004-5384,7879.789,4,3,1,1.3564180213089807
22217,703-004-5395,5616.9243,3,2,1,0.671334133589792
22773,703-004-5393,4030.8816,3,1,2,0.3978652972704144
22972,703-004-5380,2844.6047,4,1,3,0.44688509635494666
23093,703-004-5395,279.92667,6,1,5,0.8442343211604569
23136,703-004-5398,4867.654,7,5,2,3.510426458973707
23192,703-004-5389,4684.2207,8,4,4,1.6182416145007699
23225,703-004-5381,5509.205,2,2,0,3.5200583504868845
23227,703-004-5389,5648.9985,6,3,3,0.9722198634620306
23568,703-004-5389,3089.8337,3,3,0,1.8532350440352685
23732,703-004-5383,2795.191,5,3,2,0.9528499584408766
24093,703-004-5384,142.2459,4,3,1,1.0534153292174466
24254,703-004-5386,3712.1177,2,2,0,0.6012959238436626
24264,703-004-5397,7999.4136,4,1,3,0.32666834933781397
24427,703-004-5394,7360.564,2,2,0,0.6488922590143422
24933,703-004-5388,4321.5977,3,0,3,0.27920371738274696
25069,703-004-5394,9451.26,3,1,2,0.7047331245681284
25070,703-004-5396,5937.6167,1,0,1,0.27920371738274696
25138,703-004-5394,6451.2046,4,2,2,0.8326367168932802
2542,703-004-5386,4861.5493,4,1,3,0.35831143730785864
25426,703-004-5383,6384.993,4,1,3,0.44436865454794217
25455,703-004-5386,6779.564,8,2,6,0.46893171746513856
25767,703-004-5383,2563.3467,7,4,3,1.0114027777536565
25845,703-004-5381,1794.6327,4,1,3,0.6105104793413115
25910,703-004-5389,1541.9954,3,1,2,0.589036845197784
26046,703-004-5393,4501.226,5,2,3,0.5526730622130303
26397,703-004-5396,2829.601,1,1,0,0.8219218161798217
26459,703-004-5395,331.3297,7,3,4,2.2281384687965895
26613,703-004-5389,4695.3013,2,1,1,0.5376807652883911
26614,703-004-5386,444.58688,1,0,1,0.27920371738274696
26656,703-004-5389,3462.6555,5,2,3,1.938116203999245
26745,703-004-5393,434.95654,5,2,3,1.3681758840316094
26949,207-008-2398,515.911,8,3,5,1.5023850050149348
26964,703-004-5397,8128.9736,9,6,3,2.698062004840286
27021,703-004-5393,2440.0164,5,1,4,0.5184947533967535
27341,703-004-5387,5914.812,2,2,0,0.7757661457316607
27819,703-004-5388,2138.2207,4,2,2,0.5855725601795124
27833,703-004-5395,1804.5532,3,2,1,0.5217859985301225
27906,703-004-5380,1511.82,2,1,1,0.9886761253451813
28014,207-008-2399,2697.3052,6,4,2,3.059053383179461
2848,703-004-5389,3525.0747,2,0,2,0.27920371738274696
28523,703-004-5386,3618.4985,3,2,1,1.7321772094066288
28620,703-004-5393,5346.588,5,5,0,3.3848068932243844
28924,207-008-2399,9960.22,6,3,3,0.9735268392082351
28955,703-004-5393,1379.4458,4,1,3,0.6556010160320689
29031,207-008-2399,73.02046,2,2,0,0.7512005965579011
29043,703-004-5399,1758.2118,2,2,0,2.379432369856109
2916,703-004-5384,2789.6494,3,1,2,0.5785907547318878
29492,703-004-5394,2671.088,3,2,1,0.47697301719552604
29815,703-004-5384,6327.053,3,2,1,1.5985736994087059
30417,703-004-5391,6047.9395,5,3,2,1.0044912257047474
3045,703-004-5396,8293.201,2,1,1,0.35831143730785864
3051,703-004-5380,1612.6758,1,1,0,0.5950277804855958
30714,703-004-5383,1688.7808,5,2,3,0.6930492854271942
3073,703-004-5384,1788.7903,6,3,3,0.7837671496869207
30778,207-008-2398,5032.236,4,1,3,0.4985875535875644
31033,703-004-5399,3809.3281,4,1,3,0.4863184623777371
31044,703-004-5395,7793.7837,8,7,1,3.0620238938701556
31629,703-004-5399,2474.9714,9,6,3,2.983858876148904
31788,703-004-5388,5638.831,"","","",0.27920371738274696
31813,703-004-5391,1295.6655,5,3,2,1.5689839270358867
31857,703-004-5380,2839.862,4,3,1,0.7809449959881616
31950,703-004-5391,8421.159,6,3,3,2.5294354211412067
32137,207-008-2398,8643.223,6,4,2,1.6889719343843987
32832,703-004-5383,9113.1875,2,0,2,0.27920371738274696
32948,703-004-5383,2025.7014,3,0,3,0.27920371738274696
33024,703-004-5388,9460.529,3,2,1,1.122796070620749
33511,703-004-5399,745.4145,4,3,1,2.4100980530882983
33702,703-004-5385,9771.7,3,2,1,0.7597616305872921
33769,703-004-5392,6778.759,3,0,3,0.27920371738274696
33785,207-008-2399,2850.579,2,0,2,0.27920371738274696
33833,703-004-5398,9780.306,8,3,5,0.8469322641927152
34617,703-004-5393,1324.8121,4,2,2,0.8897505826425405
34702,703-004-5383,9310.799,2,0,2,0.27920371738274696
3479,703-004-5388,5405.2495,4,2,2,0.7087365660716032
35006,703-004-5392,5939.7896,2,2,0,1.1743667737976788
35274,703-004-5396,247.93327,4,2,2,0.4676778601043255
35370,703-004-5388,4960.964,4,1,3,0.7606061597594327
35496,703-004-5395,223.59132,5,4,1,1.4324840109336523
355,703-004-5392,6408.371,4,4,0,1.4330201854825122
35514,703-004-5394,5803.2017,4,0,4,0.27920371738274696
35985,703-004-5389,3208.88,4,2,2,0.4453299292254814
3604,703-004-5389,5825.2,5,0,5,0.27920371738274696
36358,703-004-5399,4389.291,5,3,2,1.1611441557263293
36550,207-008-2398,9589.999,5,2,3,0.7538792425147668
36603,703-004-5383,5413.065,10,4,6,2.2082300504517387
36686,703-004-5396,6585.54,3,1,2,2.612046750038201
36903,703-004-5381,2621.764,2,0,2,0.27920371738274696
37258,703-004-5386,5762.8955,4,2,2,0.9513413898494819
37335,703-004-5383,1452.4395,4,3,1,2.1560951827396533
37469,703-004-5387,2654.8296,3,1,2,0.7192504764648455
37488,207-008-2399,524.9077,2,2,0,0.8284462449277289
37510,207-008-2399,2831.518,9,4,5,1.1001369194818966
37572,703-004-5381,5656.1567,2,2,0,0.6990636829225525
37641,703-004-5398,4807.8804,2,1,1,0.66427788428701
3782,703-004-5388,5723.0396,5,1,4,0.8572468656085331
38320,703-004-5389,5089.2104,4,3,1,1.4031357413721293
38566,703-004-5387,2219.0815,8,4,4,2.0668901531551724
38700,703-004-5393,7812.5503,3,0,3,0.27920371738274696
39098,703-004-5383,7272.226,4,3,1,2.638133642783503
39101,703-004-5393,1543.7592,1,1,0,0.7638032987951331
39187,703-004-5389,4459.7256,8,5,3,2.99314981373533
39263,703-004-5397,2144.9734,4,1,3,0.5165268771580819
39564,703-004-5381,4300.4463,4,1,3,0.626247350263248
39872,207-008-2399,8951.977,2,0,2,0.27920371738274696
4079,703-004-5397,8501.133,6,4,2,1.7598468043251227
41477,703-004-5383,1387.5568,3,1,2,1.0349395460373636
41568,703-004-5383,1102.634,2,1,1,0.5312247352460334
41625,703-004-5380,3170.219,5,1,4,0.7890467414065553
41659,703-004-5386,73.592064,7,4,3,1.650258584361754
41836,703-004-5381,6088.2725,4,2,2,0.9585873694749052
42111,703-004-5399,4356.7554,1,0,1,0.27920371738274696
42163,703-004-5394,5677.3823,5,2,3,1.0100076648115466
42221,703-004-5393,1463.1868,5,4,1,2.707632171715614
42243,703-004-5394,323.86185,3,3,0,2.283153417602883
42357,703-004-5391,9232.64,2,0,2,0.27920371738274696
42374,703-004-5390,5745.01,3,0,3,0.27920371738274696
42478,703-004-5383,4169.2114,3,1,2,0.35831143730785864
42558,703-004-5394,354.88724,4,1,3,0.34721788714710256
42834,703-004-5397,6525.025,4,1,3,0.5374170455356257
42857,703-004-5399,1389.3998,"","","",0.27920371738274696
43176,703-004-5395,280.90836,4,2,2,0.6580785467873534
43606,703-004-5393,2493.4946,4,1,3,0.47682450256163866
43618,703-004-5395,5789.855,3,2,1,0.5036179066443014
44257,703-004-5389,5730.6387,5,3,2,2.7797606123197327
4443,703-004-5382,5590.7666,4,2,2,1.4308924077369007
4455,703-004-5384,9145.97,5,2,3,1.2000141559994133
44685,703-004-5392,6061.297,1,1,0,1.172463798255751
44897,207-008-2398,5528.0347,5,3,2,1.2545152728240156
44979,207-008-2399,2042.7412,1,1,0,0.5837684390944268
45076,703-004-5398,4241.7993,3,1,2,0.5535050219322947
4543,703-004-5389,7822.108,4,4,0,3.815302258219628
45654,703-004-5388,4302.159,5,1,4,0.7118557766747993
45669,703-004-5385,6484.04,5,3,2,3.842801392624716
45778,703-004-5384,6025.9355,4,2,2,1.1367459682698835
45827,703-004-5397,8779.447,4,3,1,0.6980740822253088
46021,703-004-5381,2071.197,4,3,1,1.297927222362882
46089,703-004-5381,9106.796,5,2,3,0.5804680798812786
46183,703-004-5391,686.3004,"","","",0.27920371738274696
46220,703-004-5386,2615.6836,3,1,2,0.9207473640946098
46761,207-008-2399,7139.2905,8,5,3,1.0528877108106995
4734,703-004-5383,2936.3,3,1,2,0.5315097944713684
47553,703-004-5381,7129.647,4,3,1,1.3068417492008815
47774,703-004-5382,2574.7048,4,2,2,0.8943692777109227
48200,703-004-5397,4596.041,8,4,4,1.4771335865455464
48423,703-004-5395,9047.211,5,2,3,0.9921725322842606
48543,703-004-5392,4928.7915,1,1,0,0.35831143730785864
489,207-008-2399,7652.43,7,4,3,1.2952129871768112
49122,703-004-5385,804.17993,4,3,1,1.2652590097995167
49229,703-004-5383,607.27057,6,3,3,1.6359164059351663
49458,703-004-5398,8709.069,5,1,4,0.6715621823587137
49870,703-004-5397,8647.406,6,4,2,2.5355053193873895
5169,703-004-5386,3248.977,4,4,0,1.3435119582587207
5260,703-004-5396,7434.5483,3,2,1,1.2226412870365295
5679,703-004-5390,5175.031,1,1,0,0.603597335834067
6230,703-004-5387,167.15407,7,2,5,0.6488851583326051
661,703-004-5385,9854.188,6,3,3,1.210659015982979
6860,703-004-5395,5587.4272,4,2,2,0.4263440764434547
6986,207-008-2398,8942.515,5,4,1,1.0545623927714056
7039,703-004-5382,9661.332,4,1,3,0.35831143730785864
7064,703-004-5389,4117.1104,6,3,3,0.5446101177314966
7172,703-004-5392,8482.858,1,0,1,0.27920371738274696
7216,207-008-2399,5329.885,4,1,3,0.47889484485421574
7246,703-004-5384,3754.937,7,4,3,1.3857151280059707
7374,703-004-5396,63.889027,3,1,2,1.1954110890383172
7431,703-004-5396,7044.7812,2,0,2,0.27920371738274696
7489,207-008-2399,3970.526,4,3,1,1.456494411301206
7660,703-004-5385,8796.005,2,1,1,0.35831143730785864
7944,703-004-5396,6146.072,6,4,2,1.079579354714429
8039,703-004-5397,2351.9534,6,4,2,2.2727369382983404
8350,703-004-5380,5140.6606,7,1,6,0.4392426290121128
8704,703-004-5396,1426.1395,3,1,2,0.532209080810006
8794,703-004-5383,2281.856,5,0,5,0.27920371738274696
8808,703-004-5382,4504.3706,3,1,2,0.7189365265719864
8883,703-004-5391,9247.5625,6,5,1,1.4368211005374687
9183,703-004-5394,6946.3823,4,1,3,0.8397030762840617
9752,703-004-5399,2159.5842,3,1,2,0.6552125986517932
10017,703-004-5382,5820.082,4,2,2,0.41764222725169237
10738,703-004-5398,8868.351,5,3,2,1.0354839030113754
1102,703-004-5392,5719.6973,2,1,1,0.4446070743294141
11054,703-004-5385,2146.982,6,4,2,1.5370214331629812
11185,703-004-5398,3830.7888,4,4,0,1.1493915300592314
11671,703-004-5387,4311.484,2,1,1,0.6501987322274398
11679,703-004-5382,4369.6304,6,3,3,2.599120783346682
1178,703-004-5390,8060.4756,5,2,3,0.4079197472091105
11840,703-004-5385,7617.2515,3,3,0,1.4112447166668485
12166,703-004-5382,7815.695,6,1,5,0.4036247320727664
12264,703-004-5392,2570.463,6,4,2,0.8068286221384195
12526,703-004-5394,3694.4324,6,4,2,1.3212452168067803
12911,703-004-5390,8618.534,5,1,4,0.47826793909310267
13047,703-004-5396,4933.297,8,4,4,1.7034504649341273
13182,207-008-2399,2893.1636,4,2,2,0.7775823529109502
13196,703-004-5391,9585.228,1,1,0,0.6452352792078245
13248,703-004-5385,162.83989,4,1,3,0.7131987513936134
13524,703-004-5398,57.151913,3,1,2,0.7964232193776599
1388,703-004-5383,384.292,1,0,1,0.27920371738274696
13911,703-004-5391,1153.127,4,2,2,0.6666120138459982
14206,703-004-5390,7217.2886,4,2,2,1.6603381221614801
14345,703-004-5381,4521.268,1,0,1,0.27920371738274696
14358,703-004-5396,4938.668,6,2,4,0.9180127267689064
1438,703-004-5392,9282.201,5,5,0,1.7126107628836076
14600,703-004-5380,8944.588,4,3,1,1.066948506365806
14738,703-004-5391,3653.338,3,1,2,0.4245646992136887
14902,703-004-5388,6014.248,5,4,1,1.8141637621188147
14912,703-004-5393,5663.21,2,1,1,0.5413414565736282
14988,703-004-5392,2010.7913,4,1,3,0.5568718143198889
15139,207-008-2398,6487.217,3,0,3,0.27920371738274696
15414,703-004-5397,8015.0566,2,2,0,0.5790928374316537
15442,703-004-5380,3106.495,7,4,3,0.8671284524464669
15485,207-008-2398,3713.9397,3,1,2,0.4860073389990234
15571,703-004-5385,3893.162,1,0,1,0.27920371738274696
15925,703-004-5394,4919.7817,8,5,3,2.857916957331402
16048,703-004-5393,2510.8086,1,1,0,0.6540891842751972
16061,703-004-5386,6650.3857,7,3,4,1.0144520892974287
16147,703-004-5390,4801.9683,6,4,2,1.3267860993782237
16247,703-004-5393,5493.1084,5,3,2,0.7448568386018282
16327,703-004-5398,9857.048,"","","",0.27920371738274696
16360,207-008-2398,8614.543,1,0,1,0.27920371738274696
16412,703-004-5387,164.2704,6,3,3,1.6190227463630453
16477,703-004-5390,55.484177,4,1,3,0.5057947243031805
16568,703-004-5393,8254.09,1,0,1,0.27920371738274696
16627,703-004-5398,552.87244,1,0,1,0.27920371738274696
16711,703-004-5392,7657.6416,6,2,4,0.7212153218721965
16872,703-004-5397,9550.989,3,2,1,0.7164379385364547
1699,703-004-5385,8151.1724,5,3,2,1.4998739366455764
17187,703-004-5388,5861.566,4,3,1,1.2046133082422137
17448,703-004-5394,9702.969,7,4,3,2.0728137935960564
17745,703-004-5384,983.91473,8,0,8,0.27920371738274696
17997,703-004-5390,6861.813,2,2,0,0.691453822842485
18052,703-004-5396,4870.867,3,1,2,0.39041947195399374
18311,703-004-5381,6790.256,3,1,2,0.3457389603911891
18463,703-004-5385,3996.3906,7,4,3,1.0405414347316813
18491,703-004-5391,8778.702,7,3,4,1.3807940292412995
18547,207-008-2399,6608.4995,1,1,0,1.2235783253790973
19118,703-004-5396,8822.097,4,2,2,0.5521955636177687
19317,703-004-5388,4082.957,2,2,0,0.7817981709418507
19398,703-004-5382,4831.6187,4,3,1,0.5865787505173338
19453,703-004-5390,3462.749,3,3,0,1.6693915114458961
19802,703-004-5395,9546.921,3,1,2,0.35831143730785864
19821,703-004-5389,7232.9297,3,0,3,0.27920371738274696
2010,703-004-5392,805.9067,4,2,2,0.8150746601986659
20221,207-008-2399,7042.899,5,2,3,0.5248826300751718
20557,703-004-5383,7125.8677,6,4,2,1.3704056367955073
20710,703-004-5387,5785.045,1,0,1,0.27920371738274696
21064,703-004-5394,3875.4302,3,3,0,1.3053196092074473
21121,703-004-5380,7423.1978,4,1,3,0.35981766242161134
21201,703-004-5383,7203.7964,4,1,3,0.35831143730785864
21253,703-004-5387,2697.3337,6,3,3,1.2104956491227767
21300,703-004-5383,7466.789,6,4,2,1.690322336282637
21448,703-004-5384,496.08945,4,1,3,0.4230808829965438
2159,703-004-5393,3611.9836,5,1,4,0.5165268771580819
21654,703-004-5389,4159.9375,4,4,0,1.3962613258471834
21715,703-004-5399,1132.2844,5,2,3,0.9235542625086616
21735,207-008-2398,8894.423,5,3,2,1.9623337517925588
21870,703-004-5397,4657.7744,3,2,1,2.0625088443740536
21876,703-004-5396,5508.938,1,0,1,0.27920371738274696
22070,207-008-2399,2492.3123,2,1,1,0.4040511947119619
22133,703-004-5392,1421.6792,4,4,0,1.737954069754127
22222,703-004-5382,14.1221285,3,1,2,0.5312759928299046
22377,703-004-5396,167.93608,1,1,0,0.3978652972704144
22442,703-004-5391,7166.5757,"","","",0.27920371738274696
22719,703-004-5389,4570.788,5,3,2,1.6514833325193667
22749,703-004-5395,7989.8994,1,1,0,1.5946329104641985
22760,703-004-5398,2851.3276,5,2,3,0.8632152712545429
22790,703-004-5399,6241.864,7,2,5,0.9807956091725194
23179,703-004-5380,8818.464,7,5,2,1.5928572454016852
24014,703-004-5388,8742.571,3,2,1,1.1378628556866732
24227,703-004-5397,2234.2717,1,1,0,0.8348855830673545
24325,703-004-5391,5427.1235,2,1,1,0.3636450281121845
24493,703-004-5386,798.53235,2,1,1,0.4410713628926129
24823,703-004-5390,8321.212,4,3,1,2.8201441817358894
2518,703-004-5399,2527.0212,5,1,4,0.5265218389558336
25591,207-008-2398,2022.2742,2,1,1,0.4245646992136887
25650,703-004-5399,7944.9946,5,1,4,3.1229467935701223
25823,703-004-5392,6956.828,1,0,1,0.27920371738274696
25826,703-004-5394,258.19778,2,1,1,0.5240181626769171
25920,703-004-5390,6958.1694,3,0,3,0.27920371738274696
26136,703-004-5395,865.58936,2,1,1,0.7400259252368169
26214,703-004-5383,6996.2207,"","","",0.27920371738274696
26232,703-004-5386,6021.1094,3,1,2,0.5501476581262543
26586,703-004-5397,111.45234,4,1,3,0.35831143730785864
26828,703-004-5382,2066.0652,5,3,2,1.1240147128269866
26866,703-004-5396,8137.84,7,5,2,2.4119897336180895
27614,703-004-5391,395.2366,4,3,1,1.3484978099649971
2769,703-004-5388,647.4453,3,1,2,0.5073104412904583
28035,703-004-5398,5983.0947,3,0,3,0.27920371738274696
2852,703-004-5380,5357.537,5,1,4,0.7695661271378987
2907,703-004-5393,1879.1246,1,0,1,0.27920371738274696
29160,703-004-5384,4839.759,2,1,1,0.5742337497415048
29202,207-008-2398,581.7068,3,0,3,0.27920371738274696
29219,703-004-5395,9756.697,3,1,2,0.4462858141745765
29416,703-004-5383,9142.731,5,2,3,1.4661273253925216
29560,207-008-2399,1053.2499,5,2,3,1.1654080319641265
30200,703-004-5397,8628.997,3,1,2,0.35831143730785864
30571,703-004-5382,1816.7842,4,3,1,1.0809446751245286
3070,703-004-5386,1201.7345,3,2,1,1.0878853310398946
30878,703-004-5399,7008.3154,4,3,1,1.6251720079331398
31125,703-004-5396,3022.358,1,1,0,1.8964877965922202
31189,703-004-5399,5368.6685,2,1,1,0.9811686082468739
31434,703-004-5390,9558.721,"","","",0.27920371738274696
31521,703-004-5396,6892.378,5,3,2,1.3328798910717934
31821,703-004-5398,870.3369,3,1,2,0.6028202149763912
321,703-004-5391,878.39606,2,1,1,0.5786017793499253
32264,703-004-5383,7401.0093,2,1,1,0.3870758832472951
32480,703-004-5395,4245.367,4,2,2,1.6698735163181653
32513,703-004-5390,2905.1436,6,3,3,2.1941216272654023
32851,703-004-5387,7215.508,5,1,4,0.5385694211118721
33565,703-004-5398,22.20273,3,1,2,0.4423540902110476
33662,703-004-5398,2432.246,4,2,2,2.325531235075557
33686,703-004-5383,2870.7034,5,3,2,1.5432508186854632
33915,703-004-5398,2603.2437,4,4,0,1.6098694660531105
33961,703-004-5390,5446.4336,4,4,0,1.5412095697021235
34204,703-004-5390,5316.3784,"","","",0.27920371738274696
34374,703-004-5391,3538.1497,5,4,1,1.3723676993936749
34433,703-004-5398,2023.2635,4,1,3,0.7281242276959011
34645,703-004-5381,7871.61,4,0,4,0.27920371738274696
35035,207-008-2399,1629.7704,7,4,3,0.7302313772003018
35127,703-004-5387,496.87982,2,0,2,0.27920371738274696
35151,703-004-5381,9582.499,5,3,2,1.5048103776157087
35165,703-004-5399,8402.731,5,4,1,1.1595465987152223
35353,703-004-5380,6056.3057,2,0,2,0.27920371738274696
35465,207-008-2399,8955.911,2,1,1,0.9589703387677986
35949,703-004-5384,4152.972,5,4,1,2.5283104425707426
36117,207-008-2398,9042.81,4,3,1,1.3714486413920912
36174,703-004-5382,2216.0835,3,2,1,0.7319851293385192
36520,703-004-5391,7604.6763,4,2,2,1.3881096348789617
36609,703-004-5387,8443.884,6,2,4,0.6662642588426368
367,703-004-5396,9453.501,6,3,3,0.7363092645494489
37291,703-004-5398,8745.494,7,4,3,1.55546339826175
37385,703-004-5397,5380.956,2,0,2,0.27920371738274696
37735,703-004-5383,17.162561,2,2,0,0.6135345320093875
37760,703-004-5384,8401.051,3,1,2,0.4170208013907442
37859,703-004-5390,1359.731,6,3,3,1.6330513798784259
38007,703-004-5388,6531.6978,2,1,1,0.5837684390944268
38101,703-004-5387,1019.6209,4,2,2,0.7057348612203813
38155,703-004-5385,2307.39,3,1,2,0.37635788591577474
38362,207-008-2399,4013.5706,4,2,2,0.6559674450189339
38529,703-004-5388,7682.072,5,4,1,1.1783755507070206
39004,703-004-5382,320.39703,4,3,1,1.0072166769893431
39068,703-004-5396,7359.956,4,4,0,1.5984895083538333
3942,207-008-2399,2525.3247,4,1,3,0.4200692036407548
39498,703-004-5386,2538.386,3,2,1,0.590402859328091
39631,703-004-5388,941.81537,3,2,1,1.7455895015421123
39963,703-004-5399,9979.068,6,4,2,1.4871679440624934
40128,703-004-5384,2731.8108,6,2,4,0.823711784571588
40231,207-008-2399,6158.2666,5,2,3,1.5098247885774303
40596,703-004-5388,9888.852,1,0,1,0.27920371738274696
40663,703-004-5388,2245.341,7,4,3,2.5465295509919676
40753,703-004-5398,7851.1626,2,1,1,2.1949311773558358
40806,207-008-2398,5907.1494,2,2,0,1.2609003764728317
41325,703-004-5395,4158.06,7,4,3,1.7003165958565518
41377,703-004-5387,8537.202,5,3,2,1.0092531108411373
41571,703-004-5397,792.7644,3,2,1,2.0603462209692545
42016,703-004-5397,7135.453,3,1,2,0.3925553957810551
42044,703-004-5381,8103.2334,7,3,4,1.8903196088547145
42123,703-004-5389,7063.8247,4,2,2,1.0025263687875856
42918,703-004-5396,7353.111,4,2,2,0.7710048953888968
43018,703-004-5392,965.74963,5,3,2,3.0009484121136976
43027,703-004-5390,9538.017,4,2,2,0.9003200832066378
43177,703-004-5393,1668.2029,2,2,0,0.6582068104165413
43427,703-004-5393,3810.4744,4,3,1,1.064452821368223
43505,703-004-5389,1543.9976,7,3,4,0.9001624224598772
43572,703-004-5394,2531.597,4,2,2,1.925206195275166
44266,703-004-5397,5750.0674,5,2,3,1.114680852822828
4447,703-004-5391,650.2831,7,4,3,2.0586573228292906
44504,703-004-5380,615.82684,2,1,1,0.47450393005209873
44551,703-004-5381,4887.342,9,5,4,1.1794635505507143
44553,703-004-5395,643.89166,5,4,1,1.7815451423256898
44835,703-004-5398,5454.1636,4,4,0,1.3904110958189415
44879,703-004-5391,5264.2407,2,1,1,0.4313940897200444
45449,703-004-5394,7878.768,7,4,3,2.5772510097860066
45454,703-004-5387,4932.6133,4,3,1,0.9358924550659168
45612,703-004-5392,2251.171,1,1,0,0.49558705287932997
45675,703-004-5392,3796.94,2,0,2,0.27920371738274696
45922,703-004-5396,2650.4277,5,4,1,1.6979474182370256
45968,703-004-5396,1455.4209,2,1,1,0.5146966381780614
46015,703-004-5388,8233.235,4,3,1,0.9314749521208386
46205,703-004-5391,6923.2295,2,1,1,0.6337299061328943
46223,703-004-5388,6190.5396,3,3,0,2.323782460333776
46409,703-004-5398,468.92465,8,5,3,2.877580857987886
46558,703-004-5385,4282.2417,2,1,1,0.3778557617512005
46949,703-004-5391,6264.785,5,2,3,0.735666733295503
46978,703-004-5394,9147.179,6,2,4,0.6067057287528409
47283,703-004-5391,3860.199,3,1,2,0.7093437951195725
47626,703-004-5387,3888.2786,3,2,1,0.5872568169213409
47657,703-004-5398,1770.3026,4,2,2,0.4910317196423477
4790,703-004-5387,1065.4962,1,1,0,0.5933239876942215
47917,703-004-5398,2055.5962,3,1,2,0.42102624538020755
47941,703-004-5394,1007.6535,5,3,2,1.2105057992674504
48210,703-004-5395,7226.7925,6,2,4,0.7503396318617399
48237,207-008-2398,2860.4531,1,0,1,0.27920371738274696
48272,703-004-5393,9041.413,5,2,3,0.9386809455682852
48448,703-004-5390,9718.01,4,2,2,0.7348243609391181
487,703-004-5384,7886.9375,2,2,0,0.621950569720488
48770,703-004-5399,3900.3313,4,2,2,0.9083557067434054
48937,703-004-5392,5225.896,1,1,0,0.6341996105466854
49240,703-004-5389,7181.6143,3,1,2,1.9839354883122156
49291,703-004-5389,7779.987,5,5,0,2.371823789506502
49342,703-004-5398,1419.7224,9,2,7,0.7028100074821122
49392,703-004-5384,712.66473,4,2,2,0.7691824161507368
4952,703-004-5384,3241.48,5,2,3,0.5410009397701688
49850,703-004-5383,3894.7463,3,1,2,0.885039732368485
5002,703-004-5384,7153.4585,2,1,1,0.4230808829965438
5047,207-008-2398,2925.4365,3,2,1,0.8180931020132471
5165,703-004-5392,2016.024,3,1,2,0.5669580486103406
5322,703-004-5391,2615.4583,3,2,1,0.4057760692629256
5429,703-004-5399,462.80087,4,1,3,1.018720861964441
5462,703-004-5381,9954.5,4,2,2,0.8747155084558728
5826,207-008-2399,6610.6064,3,2,1,0.5382815001374875
5847,703-004-5396,5611.1074,6,2,4,0.9663233718761047
6039,703-004-5386,1132.0216,5,4,1,1.8198903592420115
6324,703-004-5390,1553.7148,6,2,4,0.9751056288284791
6415,703-004-5380,2913.7683,4,1,3,1.1844585009242787
6718,703-004-5392,4436.187,2,0,2,0.27920371738274696
6817,207-008-2398,2637.3005,3,1,2,0.5903624221219833
6839,703-004-5383,8374.569,9,4,5,1.681100689336395
7003,703-004-5398,1347.1764,5,2,3,1.996862115175933
7007,703-004-5388,2330.436,7,3,4,1.0848034021358661
7075,703-004-5389,9882.417,6,2,4,1.6036576034096734
7433,703-004-5385,923.3737,2,0,2,0.27920371738274696
7591,207-008-2398,3025.6296,6,4,2,2.354735752749227
8038,703-004-5396,8704.114,5,1,4,1.4965266139795472
8046,703-004-5395,595.38245,9,4,5,1.4851901349682686
8103,207-008-2399,8113.991,7,4,3,1.5650015720131747
8152,703-004-5390,1730.6417,4,2,2,0.8957363834869051
8219,703-004-5388,7993.3257,2,1,1,0.6769195042873796
8249,703-004-5387,9520.969,2,1,1,0.5606371987442431
8281,703-004-5383,6568.9946,3,2,1,0.6440151657659915
8786,703-004-5383,19.742847,5,1,4,0.35831143730785864
8820,703-004-5394,2458.7058,2,2,0,0.7527358139921105
8878,703-004-5380,9473.249,2,2,0,0.8530634345441318
8903,703-004-5390,7559.7183,2,1,1,0.443609323956529
925,703-004-5389,6817.9785,3,1,2,0.5010647784785192
9650,207-008-2399,3884.8943,4,3,1,1.356061188001728
9775,703-004-5380,8681.338,4,1,3,0.6695154717257539
10131,703-004-5388,1527.4,2,0,2,0.27920371738274696
10289,703-004-5396,7033.834,6,2,4,0.543237303112364
10327,703-004-5399,8458.197,2,0,2,0.27920371738274696
10632,703-004-5384,3691.8591,5,3,2,2.6275093145527064
10769,703-004-5397,2921.7876,3,2,1,0.7734893586249133
10912,703-004-5383,9622.193,2,0,2,0.27920371738274696
11489,703-004-5380,4711.716,4,2,2,1.0196616894624093
11535,207-008-2399,5226.671,5,0,5,0.27920371738274696
12277,703-004-5399,7515.246,3,1,2,0.5381620574750895
13045,703-004-5389,4579.2026,7,4,3,1.6272596348239285
13210,703-004-5392,3463.5483,2,2,0,1.5359790950708019
13267,703-004-5384,7844.1914,5,3,2,1.060877919792336
13286,703-004-5398,9118.332,7,4,3,0.8313607902074442
13482,703-004-5392,5610.3706,7,2,5,2.2157114497572445
13578,703-004-5390,4099.6646,7,7,0,2.7581888345344736
13583,703-004-5399,6075.9307,3,1,2,0.41191328810455424
13728,703-004-5392,1831.4976,4,2,2,0.6433531332062246
13789,207-008-2398,2099.2368,5,5,0,2.7440064710971344
13792,703-004-5397,5919.861,6,3,3,0.9359727955545198
13837,703-004-5388,816.2731,"","","",0.27920371738274696
14194,703-004-5395,9441.365,5,4,1,1.9858847892785405
14297,703-004-5387,2310.9912,2,2,0,3.084181719081146
14592,703-004-5396,4160.5728,4,2,2,0.797903547774461
14633,703-004-5381,2935.8203,5,1,4,0.5120685506806868
14780,703-004-5383,3639.6433,5,3,2,1.4008983844106957
14837,703-004-5389,536.2344,3,2,1,0.43741915723297026
15110,703-004-5397,5928.0312,6,1,5,0.3666442600459473
15157,207-008-2398,9502.825,2,1,1,0.6578558448319985
15347,703-004-5382,7357.0693,3,1,2,1.4819003789137475
15915,703-004-5387,138.36264,2,0,2,0.27920371738274696
16107,703-004-5380,549.258,4,2,2,1.542524957076444
16393,703-004-5387,3632.6008,1,0,1,0.27920371738274696
1662,703-004-5395,4851.6826,4,2,2,0.6732187582525002
16658,703-004-5396,4120.7915,3,3,0,1.8079844584930835
16877,703-004-5397,5866.656,6,4,2,2.1977963090736323
1717,703-004-5392,5049.063,6,3,3,1.4017109184151146
17267,703-004-5392,5592.8247,4,4,0,1.8401127295384874
17739,703-004-5385,1650.967,6,3,3,1.7051314697580677
18122,703-004-5389,5440.2056,2,1,1,0.3805604835367963
18308,703-004-5381,3315.2688,7,6,1,2.2663911350891373
18609,703-004-5392,8010.958,5,2,3,0.9194689417367463
18765,703-004-5388,1956.3961,5,4,1,0.8611957195059335
18786,703-004-5399,7576.929,11,7,4,2.3682195216694333
19166,703-004-5395,304.9594,5,3,2,3.090877066588794
1928,703-004-5394,6662.8784,4,4,0,1.343530792464047
19902,703-004-5390,2715.3206,"","","",0.27920371738274696
1991,703-004-5385,7248.264,3,2,1,1.0702206114856725
19947,703-004-5389,7554.8916,3,0,3,0.27920371738274696
19980,703-004-5393,5628.914,5,3,2,1.8440983384701413
2003,207-008-2398,7604.168,5,4,1,1.8274823093563746
20160,703-004-5381,8138.1284,5,4,1,0.7915398890259308
20381,703-004-5387,1037.4701,1,0,1,0.27920371738274696
20617,703-004-5389,4517.294,3,2,1,0.6265265624610324
20635,703-004-5386,4865.0806,7,3,4,0.6833769589387441
20639,703-004-5380,618.9853,5,2,3,0.631163979883306
20801,703-004-5382,4614.7295,5,3,2,1.3174398528646887
21557,703-004-5380,8779.143,2,1,1,0.3978652972704144
21675,703-004-5390,1998.9086,3,2,1,0.7706190686596042
21686,703-004-5389,4923.2837,5,2,3,0.45719608721424815
2171,703-004-5387,3177.355,5,4,1,1.0978909934238672
22019,703-004-5384,6783.8613,4,1,3,0.5165268771580819
22164,703-004-5381,7159.555,2,2,0,0.5422998197054416
22180,703-004-5390,349.3625,5,2,3,0.6973825056276499
22303,703-004-5384,2816.3035,3,2,1,0.5911092022607266
22878,703-004-5381,945.6569,3,2,1,0.8367824813383947
22928,703-004-5382,5382.589,1,0,1,0.27920371738274696
23068,703-004-5395,8302.097,3,1,2,0.5594383654082092
23094,703-004-5382,2758.0005,5,4,1,1.6015964035749446
2312,703-004-5390,7104.802,3,1,2,0.6296324375820402
23243,703-004-5397,5193.5947,"","","",0.27920371738274696
23433,703-004-5392,423.28833,1,0,1,0.27920371738274696
23743,207-008-2399,205.7594,1,0,1,0.27920371738274696
2381,703-004-5381,622.35175,3,1,2,0.7935999472083387
23950,703-004-5392,2043.835,8,2,6,0.9568123484670813
24005,703-004-5386,2837.084,2,1,1,0.9136386407938092
2420,703-004-5385,5784.032,1,0,1,0.27920371738274696
24220,703-004-5399,7228.3213,4,0,4,0.27920371738274696
24273,703-004-5397,7689.9717,3,0,3,0.27920371738274696
24320,703-004-5382,3172.6301,6,2,4,0.4716631157061667
2451,207-008-2399,5775.014,2,2,0,0.8836226539578259
24690,703-004-5383,8008.9053,4,3,1,3.4587544906539356
2535,703-004-5398,9906.807,3,1,2,0.3781089682578671
254,703-004-5389,5440.0723,4,0,4,0.27920371738274696
25588,703-004-5381,440.45688,1,1,0,0.5837684390944268
26281,703-004-5389,4692.7256,7,5,2,2.4623412003012866
26375,703-004-5385,67.44921,8,3,5,1.2085699586753424
2639,703-004-5380,3243.3044,5,3,2,1.0692069531239365
26615,703-004-5397,9882.713,2,0,2,0.27920371738274696
26910,703-004-5389,6559.5137,4,1,3,0.606548427934778
27325,703-004-5391,14.823079,9,3,6,1.2310411881317525
27479,703-004-5384,3140.2588,2,2,0,0.5212587784116917
27651,703-004-5390,5971.552,1,1,0,1.22860146399336
28212,207-008-2399,6233.764,3,1,2,0.4377069701645314
2874,703-004-5393,8170.579,4,3,1,1.1444950909388436
28881,207-008-2399,4140.0156,5,4,1,1.3455032953407307
2972,703-004-5390,9469.13,6,4,2,2.089991378063119
29893,703-004-5398,3460.567,7,3,4,2.225409115730144
30328,703-004-5398,5001.1025,2,1,1,0.3954405734532194
30351,703-004-5391,6372.856,4,2,2,0.832893237480308
30560,703-004-5380,5429.8174,6,3,3,1.635576226887962
30698,703-004-5397,5980.2695,2,2,0,0.5688497163414261
30718,703-004-5391,9632.57,5,3,2,1.8394487139354034
30897,703-004-5389,372.80084,1,0,1,0.27920371738274696
31001,703-004-5392,7943.318,4,0,4,0.27920371738274696
31614,703-004-5387,2195.2886,3,1,2,0.837844194620195
32136,703-004-5393,4117.7695,3,3,0,1.1886463616680183
32325,703-004-5387,461.42398,8,5,3,2.442992664629539
32524,703-004-5393,9838.564,2,1,1,0.3908792340943195
32534,703-004-5392,170.60399,1,1,0,1.2344346199461644
32536,703-004-5390,8747.636,4,3,1,1.7634463801944689
32822,703-004-5385,5925.399,5,2,3,1.2066324146769423
32989,703-004-5392,6043.619,3,2,1,1.6071519392212814
33209,207-008-2399,6789.667,3,2,1,1.0537620428254426
33327,703-004-5396,1247.0734,4,1,3,0.5047322191196231
33475,703-004-5392,2669.8845,5,3,2,2.0262394872482856
33861,703-004-5389,9126.911,3,2,1,0.7035756966924763
3396,703-004-5391,6181.7764,2,1,1,0.3602891303059864
33973,703-004-5388,8631.661,1,1,0,0.3978652972704144
34157,207-008-2399,1150.0096,5,2,3,0.5846532784987172
3448,703-004-5390,9615.925,1,1,0,0.5230519343373575
34962,703-004-5381,616.7078,3,2,1,0.7496281570099345
35319,703-004-5393,6117.7344,4,4,0,0.9502635175229973
35386,703-004-5382,1507.4838,5,2,3,1.4391208289482742
35445,703-004-5381,2399.109,4,2,2,1.4113201389695142
35519,703-004-5395,3372.0146,1,1,0,1.0827594017576456
35582,703-004-5396,4367.53,5,4,1,2.131687355870103
35616,207-008-2399,9260.937,4,1,3,0.3752948633058228
35819,703-004-5387,1090.0736,3,1,2,0.49139642877557393
35826,703-004-5380,7340.3887,5,3,2,0.6208213414531001
35883,703-004-5381,5232.812,5,3,2,0.8095788592587325
36085,703-004-5385,7458.7563,8,2,6,0.5620809398587298
36119,703-004-5396,6577.5356,3,1,2,0.5708853820156674
36221,703-004-5388,7829.542,6,2,4,0.8538006138222131
36247,703-004-5380,2235.1455,2,2,0,1.7353884221653333
36630,703-004-5396,9167.25,7,2,5,1.222767359720669
36659,703-004-5381,8554.278,4,4,0,2.8821562332630872
36984,703-004-5396,7392.6978,7,4,3,2.7926838145724027
370,703-004-5381,6926.3003,7,3,4,1.6047660111250972
37067,207-008-2399,4739.636,7,5,2,1.9708125659299922
37643,703-004-5392,5163.0566,3,3,0,1.0281351840151685
37768,703-004-5395,1852.1143,2,1,1,0.36268717629505864
37795,703-004-5392,8293.684,6,3,3,1.2609460672625024
37802,703-004-5388,4677.847,5,1,4,0.46460540415990065
37832,207-008-2399,9895.577,4,1,3,0.3750542566145088
37893,703-004-5398,2310.478,8,5,3,3.746984162067462
38479,703-004-5389,5748.648,3,0,3,0.27920371738274696
38554,703-004-5385,4606.5127,5,1,4,2.3537437794419973
38624,703-004-5392,1703.8018,6,3,3,1.3766616771234155
38967,703-004-5390,6131.451,8,1,7,0.6018123000012464
39061,703-004-5384,2599.8198,9,7,2,1.4444731834947935
39597,703-004-5385,1619.705,4,1,3,1.0259041881504063
39612,703-004-5399,618.98944,8,4,4,2.775259398057438
3966,703-004-5390,2933.8645,3,3,0,1.9210642875109916
3977,703-004-5391,6180.7354,3,2,1,0.973580456389521
39943,703-004-5384,2263.9866,"","","",0.27920371738274696
39977,703-004-5389,785.7728,9,2,7,0.8982677239105614
40023,703-004-5395,8414.975,6,3,3,1.9492302787361
40057,703-004-5381,3174.501,5,3,2,1.0754867121649643
40368,703-004-5391,3175.1443,6,1,5,0.7573458868833377
40482,703-004-5383,7470.558,6,3,3,1.000498257121787
4052,703-004-5389,9580.73,1,1,0,0.3917601322203778
40548,703-004-5397,3270.6064,4,3,1,0.5307755294380345
40615,703-004-5395,6083.079,5,1,4,0.3822662437476815
40751,207-008-2399,8507.624,6,4,2,1.4884652842556776
40815,703-004-5385,2433.136,7,4,3,1.1085478477960853
40839,703-004-5393,9506.994,8,6,2,4.055299476427808
40928,703-004-5387,1089.5801,2,1,1,0.5215112906778673
41199,703-004-5393,8874.092,7,4,3,0.7459916777870834
41247,207-008-2398,8329.879,2,2,0,0.7678792650270571
41474,703-004-5386,9653.602,4,1,3,0.6938764967651915
41506,703-004-5381,1206.4302,3,1,2,0.5865857956699647
41656,703-004-5382,9365.003,5,2,3,0.4563768233117806
41745,703-004-5395,6158.95,3,3,0,0.5686077308008103
42051,703-004-5399,6989.9917,2,1,1,0.7113932096597253
42096,703-004-5392,4211.7095,4,3,1,1.137615881947162
42212,703-004-5389,7757.929,1,1,0,0.5247151613668668
42213,703-004-5391,4876.8853,5,2,3,1.9939808885719374
4223,703-004-5388,8847.563,2,1,1,0.591441501352825
42609,207-008-2399,2896.288,7,4,3,0.7265677909502113
42820,703-004-5399,6134.309,6,4,2,1.7006394892043906
43109,703-004-5383,3736.0627,"","","",0.27920371738274696
43251,703-004-5382,1452.8549,7,3,4,0.8958265959335691
43382,703-004-5391,1554.3765,5,2,3,0.8452666690724306
43469,703-004-5381,3320.5962,5,5,0,1.8388323332678853
43567,703-004-5384,9609.69,5,2,3,0.7889685622814259
43985,703-004-5385,8602.529,5,2,3,0.3563337443097308
43995,703-004-5399,5803.6333,6,4,2,2.9524054398353514
44060,703-004-5396,7216.845,3,1,2,0.5610240197464694
44168,703-004-5384,6099.198,9,5,4,2.1736580061674626
44336,703-004-5399,5231.6914,3,2,1,0.7710709762805796
4442,703-004-5389,2331.7344,4,2,2,1.5142528400032471
44445,703-004-5388,7295.945,8,5,3,3.867032860687334
44462,703-004-5386,6378.933,3,0,3,0.27920371738274696
44591,703-004-5380,1404.1495,3,0,3,0.27920371738274696
44631,703-004-5397,2488.8562,2,2,0,0.9393523639264237
44679,703-004-5381,5873.969,5,2,3,1.2759374359346554
44903,703-004-5383,4143.5244,5,2,3,3.157496498281039
45169,703-004-5380,4330.846,4,4,0,3.7490075749389824
4520,703-004-5396,8139.4023,5,4,1,2.1823820087878154
45509,703-004-5397,2204.027,3,1,2,0.35831143730785864
45567,703-004-5383,1296.8623,7,5,2,1.2086930006597103
45748,703-004-5385,5048.021,3,3,0,1.5543805866060985
45821,703-004-5385,5364.0312,5,4,1,1.1706314963456548
46306,703-004-5380,1338.861,4,3,1,1.8733813084974995
46329,703-004-5380,2881.9143,2,1,1,0.3637500930527101
46563,703-004-5387,7494.7373,4,2,2,1.254542242778114
46682,703-004-5384,3646.0144,4,3,1,1.5277285583096742
46717,703-004-5397,1175.499,2,1,1,0.967863454227268
47165,703-004-5388,6604.8623,5,4,1,1.222480541460242
47215,207-008-2399,649.0183,4,1,3,1.707639233149269
47240,703-004-5394,7879.6367,4,0,4,0.27920371738274696
47246,703-004-5395,3748.9646,8,5,3,1.057729605402027
47723,703-004-5395,4301.633,1,1,0,0.3864713641289989
47783,703-004-5380,2753.4365,2,2,0,0.9140534233560953
47820,703-004-5383,2727.22,3,2,1,2.1497839729559716
47827,703-004-5397,3476.7527,9,8,1,2.5537030778596543
47854,703-004-5381,1937.365,3,2,1,0.6978018425796348
48592,703-004-5395,6428.446,2,1,1,0.5858133769668936
48826,703-004-5390,2211.0825,2,2,0,1.168994719406725
48841,703-004-5391,3925.8843,4,3,1,1.0307075869500524
48885,703-004-5396,1408.1139,3,1,2,0.47320386395659414
49138,703-004-5399,7679.359,8,4,4,1.4473235459672549
49157,703-004-5381,7334.7993,5,3,2,0.7672856978919819
49494,703-004-5395,8521.292,2,2,0,1.2799130035526516
49528,703-004-5387,7760.0547,5,1,4,0.4902593439896429
49734,703-004-5399,237.98405,4,2,2,1.029900315661951
49808,703-004-5384,4812.827,2,1,1,0.5250257369602347
5112,703-004-5381,6445.498,6,2,4,0.8293550436732327
5127,703-004-5391,3685.515,3,1,2,0.3591123161216112
5220,703-004-5392,3164.7695,2,2,0,0.8942738075218016
5309,703-004-5382,671.9971,2,1,1,1.3941373420635057
5449,703-004-5396,6389.209,3,3,0,2.4613926139838003
5586,703-004-5398,505.5368,9,4,5,2.764544352000263
6205,703-004-5386,3965.9775,6,4,2,2.355554120173596
6270,703-004-5391,658.0543,2,0,2,0.27920371738274696
6463,703-004-5382,3738.709,5,2,3,0.47697301719552604
6909,703-004-5390,3268.369,3,1,2,0.5230836956119044
7029,703-004-5394,7246.9326,6,4,2,1.6406596937914228
7110,703-004-5384,4842.819,3,0,3,0.27920371738274696
7128,703-004-5392,4438.403,1,1,0,0.782622206360323
7264,703-004-5384,1956.1923,2,1,1,0.5399229568444064
7286,703-004-5382,4217.996,9,6,3,1.783718056227677
765,703-004-5383,8814.956,4,3,1,0.8255703259190429
8054,703-004-5381,7890.819,2,2,0,0.9374363710138802
8127,703-004-5392,5487.3755,2,1,1,0.4354320221241743
828,703-004-5387,6476.791,4,1,3,0.35534489781066697
8400,703-004-5397,2528.0273,3,2,1,0.4788865104570735
8548,703-004-5381,513.6031,3,2,1,1.0590270272935165
8867,703-004-5391,3851.4375,6,3,3,0.7628707496239235
8960,703-004-5381,3017.9863,6,4,2,1.5423733171591771
9045,703-004-5394,790.3439,2,2,0,1.2247397659105508
9255,703-004-5391,6045.197,1,0,1,0.27920371738274696
9322,703-004-5391,8846.298,6,4,2,2.0279363855267842
9433,703-004-5395,2028.6113,6,2,4,0.6905031035134463
10360,703-004-5391,1538.3428,2,0,2,0.27920371738274696
10427,703-004-5394,5428.6577,6,5,1,1.1336389974342
10505,703-004-5385,5644.1367,6,0,6,0.27920371738274696
11567,703-004-5397,4155.8276,"","","",0.27920371738274696
11643,703-004-5396,3173.7305,3,2,1,0.8642416910985807
11896,703-004-5394,5393.812,2,0,2,0.27920371738274696
11911,703-004-5397,9057.541,4,2,2,0.7342109204027596
1195,207-008-2399,1639.3971,4,2,2,0.5048061590900832
12212,703-004-5395,2161.5886,2,0,2,0.27920371738274696
12218,703-004-5388,8451.678,3,2,1,0.9757265470375667
12442,207-008-2399,2485.2068,"","","",0.27920371738274696
1251,703-004-5396,8699.646,8,3,5,1.0143415551028856
12958,207-008-2398,8332.184,4,2,2,0.7141257554570379
1329,703-004-5383,3003.1865,1,0,1,0.27920371738274696
13354,703-004-5399,2160.8079,4,3,1,2.0877616751714716
13493,703-004-5384,867.0491,2,1,1,0.6233241531441682
13637,703-004-5392,4275.173,5,5,0,2.393376398875224
13810,703-004-5381,2212.0947,4,1,3,0.8046528076093996
13878,703-004-5396,1648.1858,4,3,1,2.4445271233932213
13888,703-004-5386,9249.058,3,2,1,1.9649724149987506
14145,703-004-5399,930.8892,4,2,2,1.2047457249709261
14167,703-004-5389,4738.3887,6,5,1,1.917364384644687
14254,703-004-5385,4676.3115,4,1,3,0.41779426277901666
14515,703-004-5397,961.04443,1,0,1,0.27920371738274696
14779,703-004-5386,9444.642,2,2,0,0.7753687132415488
14952,703-004-5395,2415.2554,3,1,2,0.45389230985893825
15337,703-004-5382,970.0251,4,1,3,0.5719579037212325
15345,703-004-5389,3503.6921,3,1,2,1.5757938732885401
15440,703-004-5392,8099.999,6,4,2,1.7325658742943166
15558,703-004-5391,4425.768,6,5,1,1.5006779986899441
16210,703-004-5395,5562.3335,3,1,2,1.332613636650837
16349,703-004-5385,2636.5232,4,2,2,0.7747195837639991
16363,207-008-2398,3791.1296,3,1,2,0.4230808829965438
16586,703-004-5384,9182.848,4,2,2,0.9038683727591368
16689,703-004-5394,9410.602,4,3,1,0.8505475278189993
16751,207-008-2399,6144.454,5,2,3,0.7503416766363138
16858,703-004-5396,6853.2974,5,3,2,0.9861885394259763
17081,207-008-2399,2796.6677,4,0,4,0.27920371738274696
17284,703-004-5396,8341.659,3,1,2,0.42011278225422183
17351,703-004-5390,6038.92,3,1,2,0.45576287318167
17563,207-008-2399,3723.4675,5,1,4,0.7003808172705404
1767,703-004-5380,4652.24,5,4,1,1.8602902218905113
17993,703-004-5383,9367.771,6,3,3,1.1677546524267668
18466,703-004-5382,1794.9193,5,3,2,0.8786705368193113
18777,703-004-5390,2375.0508,4,3,1,0.750189692812369
20112,207-008-2398,3855.607,3,3,0,1.1985326375994565
20774,703-004-5383,7371.89,6,3,3,1.6464633889746425
20782,703-004-5382,5934.7803,2,1,1,0.4633313734801445
20817,703-004-5381,4090.6077,2,1,1,0.4164371026555221
21305,703-004-5380,1807.8429,4,2,2,2.066411264219815
21665,703-004-5390,6160.611,6,2,4,0.848741240981012
21924,703-004-5389,1649.2206,2,2,0,1.291877716639123
22311,703-004-5393,3463.0132,5,2,3,0.9085238454968578
22492,703-004-5383,4521.4307,3,2,1,0.7771021115641373
22593,703-004-5391,6581.7676,4,1,3,0.7495724303824981
23083,703-004-5395,4080.363,"","","",0.27920371738274696
23185,703-004-5382,6484.9365,3,1,2,0.754749101721619
23424,703-004-5385,1998.5789,2,1,1,0.3870758832472951
23590,703-004-5384,442.49774,5,4,1,1.5500896771299193
2367,703-004-5386,5422.4595,1,0,1,0.27920371738274696
24295,703-004-5381,6391.259,2,0,2,0.27920371738274696
24560,703-004-5389,7599.1816,"","","",0.27920371738274696
24896,703-004-5387,6651.607,1,0,1,0.27920371738274696
25007,207-008-2398,8550.818,"","","",0.27920371738274696
25424,703-004-5398,6328.3574,2,0,2,0.27920371738274696
25502,703-004-5393,1272.8613,8,1,7,0.45614790992524046
25637,703-004-5392,3412.2573,2,1,1,1.4640301064592438
25667,703-004-5382,3198.9246,3,2,1,0.904219592945214
25716,703-004-5396,2254.1528,4,2,2,0.6191923938425488
25936,703-004-5380,8455.174,3,2,1,0.6822781582343521
26182,703-004-5391,8240.731,5,3,2,1.0546190340477963
26204,207-008-2398,3330.4453,3,0,3,0.27920371738274696
26334,703-004-5399,2331.2473,4,1,3,0.552662453235308
26460,703-004-5387,8734.3545,2,1,1,0.40358742234499756
26773,703-004-5393,6913.608,6,3,3,0.5782308986996688
26834,703-004-5398,704.69794,5,4,1,2.8711009880997187
26865,703-004-5391,1346.8152,4,1,3,0.4995368728434766
26974,703-004-5389,6802.346,2,2,0,0.8326987000813928
2717,703-004-5380,5125.459,4,0,4,0.27920371738274696
27219,703-004-5399,8980.364,4,2,2,0.605157698743155
27344,703-004-5381,4509.507,2,0,2,0.27920371738274696
27452,703-004-5390,6765.5176,4,3,1,1.565340574653814
27617,207-008-2398,3517.2026,4,2,2,1.6205296957366824
27769,207-008-2398,3349.245,5,2,3,0.8668673732968164
28431,703-004-5381,7529.467,9,2,7,0.5911191491809313
28453,703-004-5381,6226.266,4,2,2,0.6473610234798427
2854,703-004-5381,4849.4463,3,3,0,1.0071404023805295
28550,207-008-2399,6424.4736,3,1,2,0.43328719150473904
28684,703-004-5384,4509.5903,3,1,2,0.3807252912866403
28760,703-004-5384,6054.349,6,4,2,1.7223187207854638
29065,703-004-5385,1826.7119,2,1,1,1.6277118882699384
29108,703-004-5387,6284.303,3,1,2,0.3978652972704144
29201,703-004-5389,4346.0586,3,2,1,1.1842841626023843
29537,703-004-5389,8358.937,8,4,4,1.4055926641798466
29596,703-004-5397,7326.274,3,1,2,0.7716384925071013
29705,703-004-5397,4974.9756,1,0,1,0.27920371738274696
29743,703-004-5392,8850.756,6,4,2,0.9276349756877332
29804,703-004-5392,4852.368,1,0,1,0.27920371738274696
30224,703-004-5384,1507.681,8,6,2,2.1692330467053127
3033,703-004-5382,4791.7334,3,1,2,0.4230808829965438
30541,703-004-5390,2294.1345,3,3,0,0.9572863923024616
30611,207-008-2399,387.87662,3,0,3,0.27920371738274696
30771,207-008-2399,7164.5317,3,1,2,0.3975356817707265
30809,703-004-5385,6433.2964,5,2,3,0.8630876571187537
3093,207-008-2398,7697.7124,3,2,1,4.032147711238109
31078,703-004-5384,6452.7607,2,0,2,0.27920371738274696
31100,703-004-5398,6147.7695,6,3,3,1.8983805515465164
3120,703-004-5394,15.327334,3,1,2,0.4071750767918802
31269,703-004-5390,7125.506,2,0,2,0.27920371738274696
31792,703-004-5388,6275.41,4,3,1,0.6434999888576313
31910,703-004-5396,3311.813,7,4,3,1.5659029745278195
32718,207-008-2399,5193.5195,1,1,0,0.48764280101825097
32763,703-004-5388,4509.1777,2,0,2,0.27920371738274696
32963,207-008-2399,6370.475,3,0,3,0.27920371738274696
33073,703-004-5388,1091.932,6,3,3,0.8168414443153893
33298,703-004-5380,9471.347,5,4,1,1.0213478476276865
33403,703-004-5397,293.7454,4,3,1,1.4170207411528246
33622,703-004-5384,3693.5342,6,2,4,1.923865315159041
33673,703-004-5393,5161.2764,"","","",0.27920371738274696
33704,703-004-5383,5618.682,4,1,3,0.8477127512081127
34062,703-004-5398,1051.541,4,3,1,0.8536134095689086
34166,703-004-5384,5071.816,2,0,2,0.27920371738274696
34229,703-004-5398,3514.564,1,1,0,0.32666834933781397
34366,703-004-5384,460.26767,2,1,1,0.45524043733751407
34536,703-004-5399,159.04129,6,4,2,1.1686172592623756
34544,703-004-5383,1932.5728,7,3,4,2.0573702031777428
34613,703-004-5383,7899.6753,5,2,3,0.7489189627967934
34717,703-004-5386,8022.7407,4,1,3,0.49216183628610854
34801,703-004-5396,3543.4734,"","","",0.27920371738274696
34987,703-004-5397,116.66417,8,5,3,3.3573699074656496
35110,703-004-5383,1957.6842,3,1,2,0.9406596137705212
35201,703-004-5397,8003.4814,2,1,1,0.650036154954256
35230,703-004-5398,4441.7925,2,2,0,0.4856047583579544
3552,703-004-5382,6010.642,6,4,2,1.42798909138834
35657,703-004-5382,3959.6587,3,0,3,0.27920371738274696
36075,703-004-5394,8654.088,4,3,1,1.3256136933148743
36187,703-004-5386,2204.737,4,1,3,0.40530334910967003
36325,703-004-5386,2207.8972,"","","",0.27920371738274696
36629,703-004-5388,4873.5356,5,1,4,0.35831143730785864
36654,703-004-5395,731.1225,2,1,1,0.4409413048568235
3715,703-004-5388,987.7348,1,1,0,0.845186455823103
37458,703-004-5398,8979.457,3,2,1,1.0020662032736398
37566,703-004-5392,1076.5839,3,2,1,0.801075326634046
37729,703-004-5388,7754.9575,2,1,1,0.700070401877876
37730,703-004-5397,6298.9497,5,2,3,2.416389558781895
37817,703-004-5384,1779.0818,2,1,1,0.35831143730785864
37969,703-004-5382,9958.133,3,2,1,0.5566481908043193
38261,703-004-5392,6602.245,4,1,3,0.39851998850298115
38380,703-004-5394,5.4842234,5,4,1,2.0708143843835094
38599,703-004-5387,7381.723,8,4,4,1.83813943271074
38720,703-004-5384,1945.2953,2,0,2,0.27920371738274696
39039,703-004-5384,8125.6396,4,2,2,1.122740258522475
3920,703-004-5394,7032.516,4,2,2,0.9466414731694236
39228,703-004-5380,804.56793,3,1,2,0.7083602653837479
39287,703-004-5398,2503.196,3,2,1,0.5550702666203082
39298,703-004-5398,9662.993,6,3,3,3.0230673814751072
39724,703-004-5392,6524.248,6,1,5,0.678822492282309
39884,703-004-5392,6202.876,3,1,2,0.3978652972704144
39957,703-004-5394,7590.6274,4,2,2,1.2301931709272491
4007,703-004-5393,8760.231,7,4,3,0.750733553562221
40309,703-004-5396,2483.0408,4,2,2,1.478595130844928
40741,703-004-5385,641.33466,1,1,0,0.3978652972704144
41060,703-004-5383,8725.455,4,1,3,0.35534489781066697
41195,703-004-5390,4579.2783,2,2,0,0.7961393815013644
41714,703-004-5399,9007.051,2,1,1,1.1149494665101072
41814,207-008-2398,5481.024,3,3,0,0.7304475950515924
41855,703-004-5381,6162.223,4,0,4,0.27920371738274696
42015,207-008-2398,8745.643,4,0,4,0.27920371738274696
42269,207-008-2399,689.06305,4,2,2,1.9908083652086763
4229,703-004-5388,5561.888,4,4,0,1.1747615886159575
42886,703-004-5392,9913.936,2,1,1,0.4314860782385869
43454,703-004-5388,4215.4487,4,2,2,0.4415970336915152
43694,703-004-5395,9742.372,5,1,4,1.089695743695497
4379,703-004-5385,4141.3105,4,1,3,0.49630986394341187
438,703-004-5384,575.763,8,2,6,1.1515454911731882
43814,703-004-5388,1544.7206,7,3,4,2.4326438033428315
44115,703-004-5395,2572.8071,5,5,0,1.6216510832606446
44186,703-004-5398,9877.342,8,3,5,1.3398065698462256
44617,703-004-5391,2724.548,8,5,3,1.0890568166794479
44758,703-004-5392,7236.5596,4,1,3,0.4706797356706443
45106,703-004-5399,9560.854,7,3,4,3.4549812742095365
45266,703-004-5393,7639.4644,6,2,4,0.6437586346404691
45646,703-004-5398,711.9697,2,1,1,0.5913999717275129
45690,703-004-5386,5281.004,1,1,0,0.35831143730785864
45693,703-004-5393,102.77152,5,1,4,0.5535314354112756
45697,703-004-5384,7250.909,3,1,2,0.47751789378162657
46166,703-004-5390,9152.116,"","","",0.27920371738274696
47022,703-004-5391,7625.9414,"","","",0.27920371738274696
47272,703-004-5389,5083.6616,2,1,1,0.4590130926562781
47567,703-004-5381,4087.048,"","","",0.27920371738274696
47598,703-004-5397,6689.4663,6,2,4,0.47664340169583813
47686,207-008-2398,847.7771,3,3,0,0.8505008871590557
47692,703-004-5382,1203.5132,2,2,0,0.7568997853244103
48174,703-004-5382,6578.5015,4,1,3,0.9703570417297287
48516,703-004-5384,7255.605,4,1,3,0.3187575773453028
48983,703-004-5388,6048.9966,6,1,5,0.4061270996015839
49269,703-004-5396,3151.4507,2,0,2,0.27920371738274696
49457,703-004-5385,3557.203,2,2,0,0.516187860927996
49749,703-004-5390,8857.36,5,4,1,1.3066576424388272
5153,703-004-5391,4804.487,4,0,4,0.27920371738274696
5353,703-004-5382,4309.3794,6,3,3,1.2208174718489389
5852,207-008-2399,571.7158,5,3,2,1.793410324064568
5877,703-004-5386,1251.2767,3,2,1,0.6881722524598866
5884,703-004-5389,2816.3665,3,2,1,0.9035702042307278
5885,703-004-5387,8543.893,5,3,2,2.096028328464063
5891,703-004-5381,3425.3508,5,3,2,1.1480134594756206
5957,207-008-2399,1212.7566,4,4,0,2.002715991094335
6058,703-004-5392,1390.2456,3,2,1,0.7943060211986055
6068,703-004-5394,7593.737,7,4,3,0.6806261670685103
6254,703-004-5387,2857.296,2,0,2,0.27920371738274696
6396,703-004-5380,862.7963,5,2,3,0.6317513425300578
6474,703-004-5399,3126.372,3,1,2,0.3978652972704144
6720,703-004-5396,3069.1106,2,1,1,0.5764496656490167
699,703-004-5396,2015.403,3,2,1,1.3347698488565685
7223,703-004-5395,1506.623,4,3,1,1.5428237241358183
7307,703-004-5381,3448.0708,6,3,3,1.0302300264023754
7340,703-004-5386,7818.2983,3,1,2,0.5383820018013475
7392,703-004-5389,5552.4556,8,2,6,0.8980813612753777
7447,703-004-5392,5215.092,4,3,1,1.4602774125448432
7452,703-004-5395,8304.541,3,2,1,1.0006787678428035
8078,703-004-5386,6564.966,6,2,4,1.5310134772088826
8133,703-004-5380,2011.9679,2,2,0,0.7450765279058121
8189,703-004-5398,8235.913,4,2,2,0.885875794829851
8491,703-004-5384,8276.93,6,3,3,1.8521508767741401
8507,703-004-5392,9091.564,3,2,1,0.5996426470640072
8643,703-004-5391,3298.2637,5,2,3,1.0164362136571277
8700,703-004-5398,5566.682,5,5,0,1.713463407733141
8971,703-004-5395,9783.6455,2,2,0,1.8166440939484831
9015,703-004-5385,6206.3257,3,2,1,1.4863281001286741
9515,703-004-5390,9707.629,2,0,2,0.27920371738274696
9592,703-004-5386,5449.68,5,5,0,2.406729142055111
10304,703-004-5392,5035.301,6,2,4,0.5908321942911261
10488,703-004-5384,4472.4014,2,1,1,0.9812010097841765
10533,703-004-5386,8964.932,4,0,4,0.27920371738274696
10601,703-004-5394,9528.798,2,1,1,1.2060434419537294
1061,703-004-5384,1581.785,3,2,1,1.07207373959996
10744,703-004-5398,2602.8066,4,3,1,0.6200224737915139
10858,703-004-5385,9485.298,7,1,6,0.5188701652477854
10877,703-004-5398,4769.116,1,0,1,0.27920371738274696
1092,703-004-5390,1571.545,5,2,3,0.8964692072644277
11176,703-004-5387,250.1595,3,2,1,1.0902953486160143
11232,703-004-5396,4963.991,5,2,3,0.7412745608049038
1131,703-004-5381,3478.6128,3,1,2,0.505745641994228
11839,703-004-5389,9533.657,7,4,3,1.0414585179135842
11993,703-004-5390,2711.764,5,2,3,2.507922104318341
12130,703-004-5396,3244.7493,6,3,3,1.314222759664801
12142,703-004-5387,4437.691,2,0,2,0.27920371738274696
12536,703-004-5383,5840.6465,6,3,3,1.3062391658792087
1261,207-008-2398,5454.2827,2,1,1,0.4070411974325112
13219,703-004-5382,1671.0049,3,2,1,0.7827304556543596
13223,703-004-5385,3683.36,2,2,0,0.3741329812928809
13251,703-004-5388,1349.5022,3,2,1,0.7301177209558832
13292,703-004-5396,5437.839,3,2,1,0.9028605439629039
14010,703-004-5385,241.17827,3,0,3,0.27920371738274696
14034,703-004-5398,8683.06,2,0,2,0.27920371738274696
14047,703-004-5381,1918.8804,3,3,0,1.6927598471281795
14350,207-008-2398,7237.4897,3,2,1,1.5233868583840704
1453,703-004-5382,9994.276,5,3,2,3.1893766330190543
14686,703-004-5384,2876.6853,7,3,4,0.8103997850130793
14842,703-004-5398,8756.077,4,1,3,0.5165268771580819
15487,207-008-2399,3008.8484,5,1,4,1.2250665580150044
15753,703-004-5394,757.3092,7,4,3,2.1665037154618227
15916,703-004-5398,2247.4426,4,2,2,0.6811770809477504
16129,703-004-5391,6351.4023,4,1,3,0.49977297672948184
16135,703-004-5386,2007.9684,7,3,4,0.7772694646884403
16172,703-004-5387,8209.5625,2,1,1,0.48213678817926375
16261,207-008-2398,6560.3633,8,4,4,1.6844068848265479
16341,703-004-5380,3133.8132,4,0,4,0.27920371738274696
16471,703-004-5387,2010.246,1,0,1,0.27920371738274696
16712,703-004-5385,5050.695,2,1,1,0.9598637684405096
16759,703-004-5390,3955.036,4,1,3,0.6647177254359359
16788,703-004-5383,8581.204,4,1,3,0.37279108916795334
16968,703-004-5387,4828.2593,6,3,3,1.4054799098218251
17009,703-004-5382,4341.971,3,1,2,0.35114230018964543
17184,703-004-5385,169.27063,3,2,1,0.5964554126531242
17418,703-004-5387,7568.1567,5,4,1,3.7673088196381985
1769,703-004-5385,1763.6478,4,4,0,1.0625404185389986
18120,703-004-5393,3976.5137,5,1,4,0.4921805679721606
18146,703-004-5397,1821.0,10,4,6,1.5981436108956593
18157,703-004-5389,103.07074,6,1,5,3.7162275395382385
18221,703-004-5397,2537.7334,2,0,2,0.27920371738274696
18227,703-004-5399,2684.1128,3,0,3,0.27920371738274696
18297,703-004-5392,5906.418,2,1,1,0.643110494117215
18413,703-004-5382,2466.349,7,6,1,4.734481751231074
18488,703-004-5392,7430.364,3,3,0,1.0890886666248663
18598,703-004-5393,4536.391,3,1,2,0.8674562577147057
1865,703-004-5399,8831.538,3,2,1,0.6774524914222145
19014,703-004-5387,3404.7122,2,1,1,0.7869719789815595
19401,703-004-5387,2712.4023,5,4,1,1.9318195023953444
19417,703-004-5388,758.5538,3,1,2,0.36761977901904674
19566,703-004-5399,6784.6724,4,3,1,1.6377792784921263
19594,703-004-5390,9462.936,3,1,2,1.1461147523461275
1964,703-004-5398,7311.6606,2,1,1,0.6419041431102929
19890,207-008-2398,2242.2087,5,2,3,1.6071048332477695
19926,703-004-5387,9310.294,4,1,3,0.5344819181678091
20236,207-008-2399,2783.8813,3,2,1,1.2268513889099728
20268,703-004-5392,4440.0967,2,1,1,3.0912302957612607
20431,703-004-5398,918.48315,2,1,1,0.595619435098387
20472,703-004-5393,5693.7114,5,4,1,1.5501501925355927
20600,703-004-5386,4954.2607,6,3,3,1.3844218762491094
20730,703-004-5385,224.9229,"","","",0.27920371738274696
20814,703-004-5399,6569.7466,4,3,1,2.448761741486327
20846,703-004-5386,6799.314,"","","",0.27920371738274696
20890,703-004-5395,2512.2922,6,4,2,1.8011558068762086
21222,703-004-5384,8950.645,5,3,2,1.120614811360497
21289,703-004-5390,8394.0625,7,3,4,0.8797074263589532
21354,703-004-5399,4616.3438,2,1,1,0.7503210789328913
21488,703-004-5398,1058.4218,5,4,1,1.1675871479825972
21607,703-004-5387,1105.4552,1,0,1,0.27920371738274696
21792,703-004-5398,9480.496,4,2,2,1.5985961570943477
22078,703-004-5393,6808.0103,4,2,2,0.7061738400441321
22554,703-004-5382,9893.436,5,0,5,0.27920371738274696
227,703-004-5391,3398.658,"","","",0.27920371738274696
22739,703-004-5399,9048.186,3,1,2,0.5122193175009914
22822,703-004-5386,2406.134,5,2,3,1.4441417511697363
22881,703-004-5391,8076.001,10,3,7,0.8488929486626737
22973,703-004-5385,2300.0742,3,2,1,1.5123910074226823
23298,703-004-5380,7528.911,4,2,2,1.1830071951920635
23346,703-004-5386,8633.251,6,1,5,1.1175042629643939
23394,703-004-5392,4727.159,2,0,2,0.27920371738274696
23429,703-004-5398,5472.6333,6,5,1,2.0183794880544466
23474,703-004-5399,9848.609,3,2,1,0.8145384566910637
23619,703-004-5393,1573.959,2,2,0,0.684085240770275
23677,703-004-5384,7493.6865,3,1,2,0.7010209127209281
23734,703-004-5396,3390.3992,3,1,2,0.6569686612780761
23795,703-004-5392,5684.066,8,2,6,0.5699905112074698
23862,703-004-5392,8148.4365,"","","",0.27920371738274696
23864,703-004-5385,9453.492,1,0,1,0.27920371738274696
24018,703-004-5394,9203.997,1,0,1,0.27920371738274696
24322,703-004-5386,393.0205,1,1,0,0.7941232727196961
24422,207-008-2398,8449.391,2,1,1,0.7589229645055086
24684,207-008-2398,6602.483,2,1,1,0.4314860782385869
2481,703-004-5394,7923.376,2,0,2,0.27920371738274696
24815,207-008-2398,6875.1265,5,4,1,2.9005825231205655
25142,703-004-5399,8762.798,3,3,0,2.8173367953142496
25240,703-004-5389,4428.038,5,3,2,2.3892118118693393
25372,703-004-5381,5553.44,7,4,3,1.2556893187597804
25557,703-004-5394,8995.559,3,1,2,0.5814137387942511
26,703-004-5391,188.89725,5,3,2,1.6137801571775479
2616,703-004-5380,5255.265,4,2,2,0.6987729431138509
26443,703-004-5389,964.4717,10,5,5,2.487723266967827
26807,703-004-5397,1364.9994,4,3,1,1.5210042863247002
2794,703-004-5381,415.0766,1,1,0,0.7486128988541089
2802,703-004-5392,8875.312,3,2,1,1.8248062085982613
28137,703-004-5390,1209.2102,6,5,1,2.016002774989759
28155,207-008-2398,6939.0957,4,2,2,2.2954919658913506
28175,703-004-5396,9924.18,7,3,4,1.0206832005242852
28232,703-004-5389,374.02808,1,1,0,1.5724262782152916
286,207-008-2398,4317.0386,4,3,1,1.6121257051042797
29273,703-004-5386,4882.0923,6,2,4,0.7215023958327891
29781,703-004-5398,9446.961,4,2,2,0.979682545877444
29981,703-004-5399,460.11566,3,2,1,0.6382435251010311
30478,703-004-5382,9105.074,5,3,2,1.07064218206577
3048,703-004-5394,966.46783,4,3,1,1.1128065507646077
30813,703-004-5384,6680.81,3,2,1,0.8392808364278744
31007,703-004-5398,3254.7556,2,1,1,0.42219092114738627
31197,703-004-5387,3994.0227,6,4,2,2.661753909724352
31755,703-004-5384,2255.286,2,1,1,0.5270951741168273
31814,703-004-5392,5121.134,4,4,0,2.308904220051492
31992,703-004-5380,305.09293,3,0,3,0.27920371738274696
32022,703-004-5397,7031.4854,1,1,0,0.3978652972704144
32086,703-004-5393,6407.092,5,2,3,1.2776679042350636
32106,703-004-5394,5570.1836,3,0,3,0.27920371738274696
32153,703-004-5385,6544.808,5,1,4,0.5879850736947946
32492,207-008-2398,125.88799,2,0,2,0.27920371738274696
32596,703-004-5385,5115.26,6,4,2,2.610347780960945
32703,703-004-5395,4133.554,3,1,2,1.4950700292935903
32721,703-004-5381,1393.0905,5,3,2,1.068625421029294
3329,703-004-5399,7042.809,8,3,5,0.8673180283568882
3336,703-004-5394,5729.1216,7,7,0,1.933664243168547
33996,703-004-5386,4411.095,4,1,3,0.5544059725963051
34231,703-004-5397,4558.0415,2,0,2,0.27920371738274696
34289,703-004-5382,1513.1622,4,0,4,0.27920371738274696
34889,703-004-5381,9378.755,4,1,3,0.45617324946692395
34894,703-004-5388,6782.6333,5,3,2,0.9229093616040226
35056,207-008-2398,2296.1462,1,1,0,1.4068108148206224
35084,703-004-5393,9644.779,4,2,2,0.9678535799198839
35226,703-004-5389,4646.925,3,2,1,0.8832858105240494
35229,703-004-5396,2086.9272,5,3,2,0.590500365630117
35246,703-004-5391,8306.405,3,0,3,0.27920371738274696
3536,703-004-5399,1655.125,2,1,1,1.169137830942023
35611,703-004-5395,6583.484,2,1,1,3.2805358641916262
35654,703-004-5380,2877.481,"","","",0.27920371738274696
35793,703-004-5390,1009.1674,5,2,3,1.9689128600171353
35938,703-004-5395,3060.4714,3,2,1,0.4360628810889495
36532,703-004-5388,2170.5771,4,0,4,0.27920371738274696
36768,703-004-5392,7041.193,8,4,4,2.290272361526125
36793,703-004-5392,3104.6265,5,1,4,0.6532965861450631
36812,703-004-5395,6702.7324,5,1,4,0.5501476581262543
37013,703-004-5385,6812.047,2,2,0,1.408349047459103
37084,703-004-5385,4428.484,3,2,1,1.0507495204623776
37092,703-004-5384,5340.503,6,4,2,0.9987967436118363
37173,703-004-5389,5811.248,6,4,2,1.6706607398303097
37223,703-004-5390,2183.3557,5,3,2,0.8395088649148268
37524,703-004-5385,4679.171,7,2,5,0.951679310341443
37539,703-004-5381,5856.968,4,1,3,0.3226326195635094
37597,703-004-5397,4496.316,2,1,1,0.33898554886347426
37733,703-004-5392,5667.2544,6,1,5,0.4908239041377468
37823,703-004-5390,4693.361,4,2,2,1.078635739509092
37828,703-004-5397,4743.0605,5,3,2,1.1008930070869198
38313,703-004-5389,1038.0327,3,1,2,0.35831143730785864
38718,703-004-5382,5088.7896,4,0,4,0.27920371738274696
38746,207-008-2398,1606.7827,"","","",0.27920371738274696
38937,703-004-5387,3437.3408,6,2,4,0.564825451553478
39079,207-008-2399,3450.0015,3,1,2,0.44259665600796283
39688,703-004-5389,916.13116,6,5,1,2.7044464527175283
40287,703-004-5389,958.7425,4,2,2,0.5496975681614303
40302,703-004-5388,649.7002,3,0,3,0.27920371738274696
40465,703-004-5391,4808.273,1,1,0,0.4663168649958331
40694,703-004-5394,905.9745,4,1,3,0.4235479838743847
40868,703-004-5393,4388.7456,2,0,2,0.27920371738274696
40996,703-004-5385,4629.416,4,1,3,0.683026285486755
41111,703-004-5396,5166.058,3,2,1,0.5495825296835729
41435,703-004-5384,7044.7915,3,0,3,0.27920371738274696
41448,703-004-5393,2012.1509,2,1,1,0.4457749101500602
41652,703-004-5387,6019.7036,3,1,2,1.3058339309498803
41777,703-004-5391,4671.944,1,1,0,0.35831143730785864
42066,703-004-5398,1148.8014,8,3,5,1.0586965360594236
42262,703-004-5380,8374.766,8,4,4,1.2696856802381753
42297,703-004-5388,1733.9521,2,2,0,0.6809733616685174
42487,703-004-5395,3828.622,1,0,1,0.27920371738274696
42815,703-004-5397,1928.4194,8,4,4,1.8112715801215946
43344,703-004-5399,7389.3345,5,3,2,0.9730378344576815
43833,703-004-5385,8606.533,4,4,0,2.288017346097002
43953,703-004-5390,2037.2844,4,2,2,1.1342477717070325
4404,703-004-5380,9228.022,4,3,1,0.6046997142296014
44094,703-004-5391,1311.8029,2,0,2,0.27920371738274696
44354,703-004-5390,6952.401,2,1,1,1.0300848642295355
44422,703-004-5380,1998.2987,7,5,2,1.4415516733210845
44502,703-004-5388,9588.895,4,1,3,0.4705050455983494
44782,703-004-5390,612.62665,4,2,2,0.7557353059472439
4490,703-004-5382,5838.9497,5,3,2,1.6794401623254867
45590,207-008-2399,512.88544,7,1,6,0.8937823126033443
45635,703-004-5395,8010.009,3,0,3,0.27920371738274696
45648,703-004-5396,5383.362,2,1,1,0.3466348082314124
46339,703-004-5399,8875.528,5,2,3,0.7839064203457773
4640,703-004-5394,7821.8765,6,4,2,1.088686938372639
46859,703-004-5391,2059.7017,2,0,2,0.27920371738274696
4712,703-004-5385,2848.9214,5,2,3,0.9459431571672874
47405,703-004-5386,1856.4403,7,5,2,1.6797099534518138
47579,703-004-5398,7897.799,5,3,2,0.7491212314639372
48376,703-004-5388,6331.3843,4,2,2,0.6449881763868294
48707,703-004-5383,4328.0137,1,0,1,0.27920371738274696
48809,703-004-5384,2590.9077,3,2,1,0.6159174236850707
48863,703-004-5393,8074.8706,3,1,2,1.4639245462401014
48944,703-004-5398,4968.8584,6,5,1,3.2057983390366833
49108,703-004-5380,3067.8022,6,3,3,1.2253389664788463
49126,703-004-5397,4396.3164,3,1,2,0.48794797727701145
49281,703-004-5382,2117.8972,6,1,5,0.35114230018964543
49491,703-004-5398,371.16943,5,1,4,0.40223968391284093
4968,703-004-5381,1430.3523,3,1,2,0.4648574799606954
49799,703-004-5392,9218.863,1,0,1,0.27920371738274696
49945,703-004-5387,181.44786,5,2,3,2.3107077777628797
5040,703-004-5383,8460.989,4,3,1,0.6928577285035449
5137,207-008-2399,2140.7634,2,0,2,0.27920371738274696
5228,703-004-5384,7054.1924,2,2,0,0.7563112781092347
5756,703-004-5394,6999.5396,2,1,1,0.32666834933781397
6347,703-004-5390,8970.63,2,0,2,0.27920371738274696
6521,703-004-5393,9421.218,1,1,0,0.7971493796218332
6668,703-004-5399,5652.6875,5,4,1,1.4268267861575998
6777,703-004-5383,9451.274,1,0,1,0.27920371738274696
7137,703-004-5382,4245.549,4,2,2,1.0545459288514498
7251,703-004-5393,2654.108,3,0,3,0.27920371738274696
7271,703-004-5396,6912.112,3,1,2,0.46004626039046503
7424,703-004-5399,8260.381,3,1,2,0.7443685407223549
7451,703-004-5382,3253.8628,3,1,2,0.3862296935516973
7593,703-004-5383,441.6859,5,5,0,1.315736926557627
7597,703-004-5380,4620.7295,4,3,1,1.029313323530253
8167,703-004-5385,5788.0015,4,2,2,0.5900302751761902
8358,207-008-2399,6182.905,5,3,2,0.82009462974554
8772,703-004-5394,1762.1439,4,3,1,0.9435613647383253
8942,703-004-5388,135.35022,4,4,0,3.2759650845587336
905,703-004-5396,816.22003,6,5,1,2.9445563893094358
9079,703-004-5398,6909.4927,6,5,1,1.2164896997947472
9530,207-008-2399,8674.593,4,3,1,0.836364658121702
9562,703-004-5387,7160.0522,6,2,4,1.3480530261059185
9722,703-004-5388,8340.32,7,4,3,2.4040809206280382
9825,703-004-5381,4616.506,2,1,1,0.5335626302515727
10460,703-004-5389,9872.329,4,1,3,0.9312786353583224
10547,703-004-5385,194.88751,3,0,3,0.27920371738274696
10588,703-004-5393,2996.4465,3,3,0,1.649057774610965
10631,703-004-5393,3033.8096,2,2,0,2.4162318417308684
1064,703-004-5392,2947.3657,5,4,1,0.8227968708789399
11264,703-004-5385,6629.763,2,1,1,0.5645618768766151
11668,207-008-2399,6355.001,4,2,2,0.6426426607895596
11757,703-004-5381,961.979,2,0,2,0.27920371738274696
11760,703-004-5397,7511.5757,4,2,2,0.7165181422329708
120,703-004-5398,9223.523,2,2,0,0.8202007883784606
12312,703-004-5386,9538.603,4,3,1,1.6957610559515863
12592,207-008-2399,7286.6846,4,1,3,0.637461093834225
12910,703-004-5395,3951.3481,5,1,4,1.4202502077270156
13034,703-004-5389,6422.8286,9,4,5,1.8713176144241583
13310,703-004-5382,4309.2383,6,4,2,2.128421536719681
13492,703-004-5394,9698.621,3,3,0,1.4762621031471854
13729,207-008-2398,9221.72,4,4,0,1.758355585010144
13831,703-004-5394,1598.1359,1,0,1,0.27920371738274696
13874,207-008-2399,9390.435,6,5,1,1.6969300279067232
13972,703-004-5383,8113.015,5,1,4,0.6932160557911607
14095,703-004-5385,9884.779,3,1,2,0.5165268771580819
14298,703-004-5398,7421.167,4,3,1,1.5542281101212385
14337,703-004-5384,516.3443,5,2,3,1.444235828184051
14343,703-004-5396,5875.987,"","","",0.27920371738274696
14445,703-004-5396,1784.0677,1,1,0,0.33853450732658075
14604,703-004-5391,318.6089,6,2,4,0.7247575929132218
14744,703-004-5390,6001.387,3,3,0,0.9103282751093066
15024,703-004-5386,3244.705,5,4,1,1.305328502337153
15158,703-004-5384,7072.2227,6,3,3,1.5193066745689594
15550,703-004-5380,8406.879,3,1,2,0.363047605983471
15618,703-004-5387,6358.632,5,3,2,0.8856050186315142
1580,703-004-5383,1472.0249,5,3,2,0.773062500371479
15848,703-004-5388,8043.256,4,2,2,0.7710676564249421
15935,703-004-5395,2353.2217,2,2,0,0.9369052042493822
16225,703-004-5384,8493.438,2,0,2,0.27920371738274696
16366,703-004-5385,7214.2197,1,1,0,0.34093158307414184
16449,703-004-5384,8609.271,5,3,2,1.5790163706799627
16605,703-004-5385,5688.411,4,2,2,0.7099420560708184
1671,703-004-5398,1838.2596,6,3,3,3.6719564594718173
16899,703-004-5393,1021.27075,9,5,4,1.9177108642279979
16934,703-004-5399,1137.8491,"","","",0.27920371738274696
17232,703-004-5395,5449.7446,3,1,2,0.5286871797341659
17389,703-004-5398,4750.293,4,2,2,0.580582665090463
18039,703-004-5381,1647.9993,5,0,5,0.27920371738274696
18126,703-004-5398,6625.242,3,1,2,0.4046184537420305
18319,703-004-5399,3778.7402,1,1,0,0.33853450732658075
18442,703-004-5399,5550.9043,3,2,1,0.874388212984828
1860,703-004-5399,5349.415,9,3,6,1.427793836342903
18895,703-004-5399,9492.407,6,4,2,1.2240953074341607
19403,703-004-5385,179.04341,6,3,3,0.7075805915086999
19425,703-004-5397,1838.1304,5,1,4,0.3978652972704144
19484,703-004-5393,667.70435,7,4,3,1.0569525591201447
19499,703-004-5397,7225.22,7,3,4,1.0532873334558734
19672,703-004-5396,9570.241,7,3,4,1.7287396700309792
19709,703-004-5392,3247.9382,4,3,1,0.6731865318497781
19885,703-004-5387,4693.418,2,1,1,0.846797357825714
20186,207-008-2398,2310.7344,6,1,5,2.5190405173500365
20241,703-004-5399,458.76025,2,2,0,1.2632275204518233
20426,703-004-5389,2223.8064,4,1,3,0.9071707263743686
20577,703-004-5388,3134.4783,1,1,0,0.5807650036009784
20605,703-004-5391,39.03091,6,3,3,1.1920178274106723
21076,703-004-5380,1183.9104,5,3,2,2.729868807471966
21174,703-004-5384,7141.5996,4,2,2,0.818728829421783
21636,703-004-5397,6794.7515,4,2,2,1.161644680546254
21997,703-004-5395,3638.4272,4,2,2,1.0597357643451168
22175,703-004-5392,284.76178,5,4,1,1.8382456005791512
2221,703-004-5392,949.9717,3,1,2,0.37175974969512765
22308,207-008-2399,699.7192,3,1,2,0.5204613881208281
22724,703-004-5386,7594.004,4,3,1,2.3491361535112936
22810,703-004-5391,9823.738,4,0,4,0.27920371738274696
22921,703-004-5392,9268.305,6,4,2,1.5998817861849983
22943,703-004-5391,8432.638,6,4,2,3.158495588574489
2340,703-004-5382,5823.8345,3,1,2,0.7697193697828106
24186,703-004-5398,6061.0645,7,2,5,0.6995755135156949
24327,703-004-5392,8664.115,4,2,2,0.7348183182364642
24361,703-004-5381,6054.268,6,4,2,2.430575848455394
24367,703-004-5390,8365.362,6,3,3,1.8317845065642724
24383,703-004-5391,9858.855,4,1,3,0.6589345910901592
24449,703-004-5392,6654.376,4,2,2,0.4552347834722158
25255,703-004-5390,3877.5837,6,2,4,0.5278459303406225
25584,703-004-5388,2454.4412,8,7,1,4.961518062477956
25733,703-004-5393,6811.337,5,2,3,0.7552275857721701
25895,703-004-5387,3404.7407,4,1,3,0.5158578141346445
26497,703-004-5398,5317.4233,4,0,4,0.27920371738274696
26601,703-004-5382,688.49084,1,1,0,0.5769363709063882
26626,703-004-5380,1499.0253,1,1,0,0.5588773874183234
26661,703-004-5394,7972.344,3,1,2,0.5828893161637889
2668,703-004-5389,2774.04,3,1,2,0.679771863956117
26714,703-004-5380,2694.0662,4,1,3,1.5026579456919833
26860,703-004-5393,4764.128,5,2,3,0.5244807462763016
27123,703-004-5392,9661.131,4,3,1,1.1045535974867227
27487,703-004-5381,2610.0618,3,0,3,0.27920371738274696
27726,703-004-5382,7983.044,3,2,1,0.6577835031542419
27751,703-004-5380,5440.329,3,3,0,1.1019580403931017
27903,703-004-5392,4338.205,2,2,0,0.6513462088404534
27959,703-004-5398,903.7846,5,3,2,0.6049421662580542
28055,703-004-5387,9474.484,3,0,3,0.27920371738274696
28113,703-004-5388,4997.8774,8,3,5,0.47739339290618005
28597,703-004-5381,2057.507,3,1,2,0.7328259092609118
28666,703-004-5382,30.77686,1,1,0,0.3919322182760311
2875,703-004-5382,5546.5293,3,2,1,0.8424134622580471
28790,703-004-5385,9898.848,6,3,3,0.9341021676229716
28960,703-004-5395,6602.34,5,1,4,0.4221937228791336
28998,207-008-2399,5018.391,3,1,2,1.4103205439779043
2900,703-004-5392,8420.12,2,2,0,1.0257383177435961
2906,703-004-5382,1481.1957,2,0,2,0.27920371738274696
29228,207-008-2399,7414.9614,3,2,1,0.5203424782899427
29400,703-004-5388,3350.2358,3,3,0,1.9305523665442699
29500,703-004-5382,5255.0073,3,0,3,0.27920371738274696
29605,703-004-5385,696.578,4,2,2,0.5758576671019155
29928,703-004-5386,6189.9175,7,3,4,2.713635205198975
3021,703-004-5398,1879.5764,3,3,0,1.1214871466116672
30594,703-004-5389,6674.627,7,4,3,1.7055094328453568
30753,703-004-5397,5045.417,1,0,1,0.27920371738274696
30768,703-004-5382,2687.3892,7,4,3,1.2309293949498301
30796,703-004-5397,8075.5156,6,3,3,1.2448291312132636
31052,703-004-5395,5586.157,2,1,1,1.0154634969852934
31091,703-004-5390,3860.3108,3,2,1,1.8466295057223585
31664,703-004-5380,9576.284,2,0,2,0.27920371738274696
31954,703-004-5388,105.3679,2,1,1,0.6387391532745744
3208,703-004-5397,9773.042,3,2,1,0.6931066144863506
32278,703-004-5393,5126.0586,4,1,3,0.8401062837549941
32444,703-004-5387,8721.75,2,1,1,0.7841843431775332
32597,703-004-5387,1782.2075,2,0,2,0.27920371738274696
32967,703-004-5390,9399.041,2,2,0,0.7554211450020611
33019,207-008-2398,8489.443,7,4,3,2.379499688839132
3305,703-004-5383,5680.228,5,2,3,0.47736855579515164
33077,703-004-5397,6071.6846,6,5,1,1.7311629608163441
33191,703-004-5396,1136.279,3,1,2,0.6277413188061296
33391,703-004-5385,2271.2117,1,0,1,0.27920371738274696
33731,703-004-5392,473.96124,6,3,3,0.6456670376444039
34068,703-004-5399,7259.8164,6,3,3,1.3771985082308618
34121,703-004-5396,9281.424,4,2,2,1.2091334473556452
34227,703-004-5388,3762.0532,4,2,2,0.7828371418358391
3433,703-004-5386,4568.1626,2,1,1,1.0405637207636338
34413,207-008-2399,5041.199,3,2,1,0.48048366836065287
34652,207-008-2398,3446.1367,3,2,1,0.8086171592314267
34683,703-004-5387,4673.384,2,0,2,0.27920371738274696
35025,703-004-5390,7327.4214,4,2,2,0.6989688384973224
35240,703-004-5383,9199.727,4,3,1,1.05634085710557
35646,703-004-5395,6380.459,3,3,0,1.9167085136139024
35907,703-004-5380,4116.889,2,0,2,0.27920371738274696
35971,703-004-5385,8072.0693,4,1,3,0.580142304990761
35992,703-004-5381,9478.448,4,3,1,1.007802918812732
36008,703-004-5397,8738.842,6,4,2,1.0461729781495497
36016,703-004-5381,3643.2075,5,3,2,2.3976065644732407
36038,703-004-5387,5548.023,2,1,1,1.1024647850466487
36145,703-004-5399,2351.491,1,1,0,0.5429579139364008
3625,703-004-5381,2017.5493,4,1,3,1.9159179303643714
36256,703-004-5395,255.00536,4,3,1,0.9995603912702918
36871,703-004-5388,8804.713,5,1,4,1.3037623667481237
37004,703-004-5396,7562.4185,1,0,1,0.27920371738274696
37040,703-004-5381,9012.603,2,0,2,0.27920371738274696
37074,703-004-5396,5172.1543,5,3,2,0.9141378518882255
37304,703-004-5399,9371.8545,3,2,1,1.771263730025964
37406,703-004-5391,1391.8536,7,4,3,1.3209728935016618
37520,703-004-5391,1884.6637,5,3,2,0.4772582481140938
37588,207-008-2399,9898.118,5,1,4,0.3841200801902069
37902,703-004-5385,6614.37,6,3,3,0.9048565504675884
38295,703-004-5384,3066.951,1,1,0,1.2424279008558532
38326,703-004-5386,9785.7,4,4,0,1.4555132315513137
38424,703-004-5387,3838.632,7,6,1,2.265594078219532
38487,703-004-5397,7548.186,4,2,2,0.6377896712899846
38522,703-004-5389,9335.89,5,4,1,1.179195435461377
3864,703-004-5382,8350.017,3,0,3,0.27920371738274696
38650,703-004-5397,392.59195,8,6,2,2.356927050308994
38721,703-004-5398,8337.981,3,0,3,0.27920371738274696
38852,207-008-2398,8221.026,4,1,3,0.37369944815495104
38876,703-004-5384,8061.383,4,3,1,1.3197671250320702
38943,703-004-5397,8201.395,3,2,1,0.5105937981636984
39084,703-004-5386,1888.4486,4,1,3,0.7595828115275779
39118,703-004-5388,1705.479,2,1,1,1.1655278801231506
39254,703-004-5381,501.0581,6,5,1,1.4790219629022252
39324,703-004-5394,3144.1008,3,2,1,1.3512740047368372
39361,703-004-5389,5997.7476,3,2,1,0.8728065738482902
39520,703-004-5389,5690.3447,1,0,1,0.27920371738274696
39565,703-004-5392,5880.2812,4,2,2,0.9593185662748251
39651,703-004-5384,6827.9824,5,2,3,2.3077147352338754
39779,703-004-5382,9868.3125,1,0,1,0.27920371738274696
39886,703-004-5383,3132.1038,2,1,1,1.1085152231446103
3997,703-004-5384,4743.884,4,3,1,2.1805609700610082
40006,703-004-5395,4690.3926,3,2,1,1.9759058221713286
40487,703-004-5393,7596.955,3,1,2,0.831189142277867
4053,703-004-5382,2809.586,6,2,4,1.211027314330692
40597,703-004-5385,59.390663,4,3,1,1.040766433794919
40704,207-008-2398,3098.4448,7,3,4,1.080555658869793
40842,703-004-5395,2330.2346,6,2,4,1.7955798047267661
41053,703-004-5394,6411.9937,3,1,2,0.5622684314470698
41106,703-004-5398,8980.717,4,2,2,1.1042445897961415
41468,207-008-2398,5811.535,3,1,2,0.3978652972704144
41701,703-004-5396,2320.1316,2,1,1,0.48599562282858755
41704,703-004-5387,9385.302,9,2,7,1.007834336905458
41844,207-008-2399,7632.091,5,2,3,0.9935379966820793
42170,703-004-5388,9716.195,5,3,2,1.7448350666385297
42185,703-004-5392,9379.758,5,3,2,1.1950381147962572
4309,703-004-5385,185.33885,4,3,1,0.9543536878750684
43423,703-004-5398,4351.908,3,1,2,0.8708927102943669
43503,703-004-5397,1546.2112,5,4,1,1.4351861828505545
43529,703-004-5387,2423.721,5,2,3,0.47637970929608764
43708,703-004-5389,2121.5374,7,1,6,0.4738391732910641
4378,207-008-2399,1736.1003,10,4,6,2.471826554835324
43800,703-004-5380,6173.363,10,7,3,2.7018662248180934
43960,703-004-5398,4835.651,3,1,2,0.8023729663401844
4405,703-004-5388,2364.6348,2,1,1,0.4262734019874917
44730,703-004-5384,407.44962,5,2,3,0.6220557340513606
44779,207-008-2398,4050.886,2,1,1,0.7659420269024082
44851,703-004-5393,7408.8696,10,6,4,1.664900148142344
44947,703-004-5383,5699.7607,1,0,1,0.27920371738274696
45095,703-004-5384,7792.577,2,1,1,0.4819172496908456
45127,703-004-5395,7240.9863,6,4,2,3.6571390612434906
45129,703-004-5389,9527.814,7,2,5,0.6755961859602468
45422,703-004-5398,3389.8533,5,1,4,0.4544640691450845
45628,703-004-5387,5497.8438,2,0,2,0.27920371738274696
45649,703-004-5396,9916.286,1,1,0,0.4814381097849906
45661,703-004-5382,7815.0977,2,1,1,0.4827577692150498
45886,703-004-5381,4660.7427,3,2,1,0.6371296833313539
45913,703-004-5384,3814.919,2,0,2,0.27920371738274696
46168,703-004-5385,2990.1064,3,2,1,0.8603839776240735
46196,703-004-5389,6254.7944,2,2,0,0.5417424628842112
4624,703-004-5387,1362.5228,4,2,2,0.8805021100710204
46623,703-004-5394,4514.7065,4,2,2,0.5911999914688432
46661,703-004-5385,8970.255,4,1,3,0.8322901969087364
4670,703-004-5399,1357.7109,5,3,2,0.5668480762202575
46711,703-004-5394,5159.1807,4,4,0,1.837157758219987
46819,703-004-5389,3080.5725,9,5,4,0.6837493294976407
46999,703-004-5390,2505.2375,3,1,2,0.5741694121757683
47193,703-004-5397,4450.2725,3,2,1,0.7224186316540914
47252,703-004-5383,826.636,2,0,2,0.27920371738274696
47568,703-004-5381,6646.293,3,0,3,0.27920371738274696
47576,703-004-5393,9228.111,1,1,0,1.11135648019469
47781,703-004-5391,8919.331,5,3,2,1.9116950856585642
47871,703-004-5395,6017.2104,2,2,0,0.6462868696903138
48154,703-004-5385,346.1921,2,1,1,0.34445651043902575
48224,703-004-5399,2446.5603,2,2,0,0.4805646949772668
48428,703-004-5399,7423.063,4,2,2,0.6525590249976442
48603,703-004-5384,4133.784,3,1,2,0.664632437320664
48650,703-004-5392,8372.601,4,2,2,0.6454826463613739
48699,703-004-5399,4993.813,2,2,0,1.9346625759912786
48914,703-004-5391,1675.5033,3,2,1,0.4754943620639258
48931,703-004-5392,7671.6387,6,4,2,1.2982459010258447
492,703-004-5394,7067.39,7,3,4,1.6454937284627444
49201,703-004-5384,2884.6938,4,1,3,0.9752124813788641
49209,703-004-5389,6233.1914,1,0,1,0.27920371738274696
49237,703-004-5382,5812.608,5,3,2,2.5893988537085315
49610,207-008-2399,4845.547,2,0,2,0.27920371738274696
49807,703-004-5386,7248.721,3,3,0,3.0553244168291385
5102,703-004-5393,8825.271,6,2,4,1.6948466128911948
5191,703-004-5381,9572.9,3,1,2,0.32666834933781397
5433,703-004-5386,2793.994,1,0,1,0.27920371738274696
5574,703-004-5397,2558.059,2,0,2,0.27920371738274696
5628,703-004-5397,2925.071,2,1,1,0.40822268151129704
5919,703-004-5380,2700.172,2,2,0,0.5929193971782267
5950,703-004-5382,9575.63,2,1,1,0.4656122799501674
6293,703-004-5392,2337.5295,3,1,2,0.5144122910824741
6359,703-004-5399,9266.991,1,1,0,0.41467568775450064
6809,703-004-5399,773.3852,4,4,0,2.489366369605915
7051,703-004-5386,7250.1875,3,3,0,0.9498739540054526
7195,703-004-5396,1355.0013,3,1,2,0.6710844584321649
736,703-004-5389,6285.9004,3,3,0,0.8374456104102689
7747,703-004-5386,9715.921,2,2,0,1.081231236114105
876,703-004-5381,5427.8647,4,2,2,1.0699133176899542
889,703-004-5383,460.14072,5,5,0,2.781046697071475
8937,703-004-5399,4053.0325,1,1,0,0.4314860782385869
9023,703-004-5387,604.12225,4,3,1,1.021715222507992
9378,703-004-5386,8043.1743,7,4,3,1.8127900267942663
9714,703-004-5380,4881.883,2,0,2,0.27920371738274696
9892,703-004-5395,2798.965,5,1,4,0.810663779315928
10071,703-004-5390,3954.5571,2,0,2,0.27920371738274696
10148,703-004-5385,8640.2705,5,2,3,0.6603888992220652
10359,703-004-5393,4698.554,3,1,2,0.7726436466530656
10370,703-004-5380,8778.12,6,4,2,2.7099747056666286
10459,703-004-5387,6.8110228,"","","",0.27920371738274696
10790,703-004-5380,1681.7397,8,4,4,0.8628452712006179
10868,703-004-5390,1563.316,3,1,2,0.49494530231601236
11089,703-004-5388,987.4868,6,3,3,2.1151277331308505
11149,703-004-5382,5122.935,2,0,2,0.27920371738274696
11170,703-004-5385,5498.0166,2,0,2,0.27920371738274696
11420,703-004-5383,3498.5256,2,2,0,0.9367445699344221
11491,703-004-5386,6010.592,5,3,2,1.7692670990399826
11620,703-004-5385,6042.726,4,2,2,1.1208766530192147
11744,703-004-5392,6609.1973,6,2,4,0.7362580913617941
11952,703-004-5391,662.6987,2,1,1,0.4580569378186414
11990,703-004-5399,6956.061,2,1,1,1.3139302389334488
12002,207-008-2399,5931.9697,2,1,1,0.6316301193785162
12284,703-004-5388,1908.7434,10,4,6,1.9557098216593896
12719,703-004-5392,2254.9695,3,1,2,0.4293854341682636
12771,703-004-5385,6157.6504,4,2,2,1.2587600518604225
12821,703-004-5382,6202.6953,6,3,3,1.1440904281632986
12868,703-004-5395,2684.0334,4,0,4,0.27920371738274696
13209,703-004-5398,1699.518,2,2,0,2.702040611002226
13245,703-004-5399,6698.882,4,2,2,0.6351884570457493
1362,703-004-5383,2987.5642,2,0,2,0.27920371738274696
13685,703-004-5382,6360.636,3,0,3,0.27920371738274696
1369,703-004-5391,6362.6504,2,1,1,0.7888757503100744
1373,703-004-5380,5943.804,1,1,0,1.2481981297512035
14154,703-004-5391,7721.155,6,2,4,0.6262076560187507
14191,703-004-5389,7066.7026,2,2,0,0.9198207633402553
14656,703-004-5396,1540.8832,5,3,2,2.8590724260722915
1498,207-008-2398,5855.361,3,3,0,0.8766450070660015
15082,703-004-5383,6194.4937,2,0,2,0.27920371738274696
15194,703-004-5393,9569.88,2,1,1,0.5669580486103406
15197,703-004-5387,2947.7917,6,3,3,1.8454596386688746
15320,703-004-5384,2765.9875,6,3,3,2.8400464931835434
15512,703-004-5385,2268.8228,6,4,2,2.29660162021552
15604,703-004-5384,2401.3245,1,0,1,0.27920371738274696
15838,703-004-5382,6566.36,1,0,1,0.27920371738274696
15883,207-008-2398,3788.2036,4,2,2,0.7639140291910936
15961,703-004-5398,4392.6094,4,2,2,1.3140723649292287
16282,703-004-5399,1755.9891,4,3,1,0.8934395856057032
16346,703-004-5388,4647.1846,4,3,1,1.1030202676729837
16347,703-004-5383,5487.5146,7,5,2,2.2714212129337015
17052,703-004-5386,1004.3216,1,0,1,0.27920371738274696
17247,703-004-5398,1712.0707,3,1,2,0.4640756385908506
17295,703-004-5385,1764.8965,6,3,3,1.8851634862055662
17309,703-004-5397,4421.1084,7,2,5,0.986755610162623
17318,703-004-5391,1424.2202,4,3,1,2.294351613874265
17483,703-004-5396,5377.51,3,2,1,0.8272292184210057
17632,703-004-5393,9577.254,3,2,1,2.142218752283261
17685,703-004-5393,6729.36,3,1,2,2.185340837909479
17979,703-004-5393,3337.2122,8,5,3,2.8281559129926213
17985,703-004-5398,4866.061,3,1,2,0.3793617818362644
18265,703-004-5380,1540.0231,3,1,2,0.43973911899668544
18337,703-004-5384,2545.795,5,3,2,2.254119404418755
18558,703-004-5392,9277.1455,4,2,2,1.3479999684570154
18648,703-004-5385,4949.819,4,3,1,0.9400235807409858
19133,703-004-5380,805.0776,5,3,2,2.1845483842065416
19377,703-004-5391,3013.8838,5,2,3,0.36622220930036975
19459,207-008-2399,707.7354,2,2,0,0.6053110597752123
19463,703-004-5380,4422.801,3,1,2,0.6042012936195994
19542,703-004-5392,3435.616,2,1,1,0.385477028330142
1975,703-004-5392,670.5481,2,0,2,0.27920371738274696
19835,703-004-5394,8968.72,7,2,5,1.1134021783129249
20223,703-004-5390,3336.497,4,3,1,0.6024103851904576
2055,207-008-2399,7793.814,5,3,2,0.9945440389850058
20651,703-004-5385,6097.2476,2,0,2,0.27920371738274696
20948,703-004-5385,1767.8678,2,1,1,1.2488907169948953
21586,703-004-5397,1353.091,2,1,1,0.8154156199651349
21592,703-004-5392,2984.9802,3,3,0,1.2654455351728378
21919,703-004-5384,7258.527,3,1,2,0.6364514877357235
22201,703-004-5397,5412.9087,3,2,1,1.673436520364688
22236,703-004-5389,2045.1915,9,6,3,3.0971259444584742
22385,703-004-5383,7706.3403,5,3,2,0.5458058988728746
22425,703-004-5396,4538.241,9,5,4,2.177402023026689
22444,703-004-5389,6371.4897,4,3,1,1.0307995878161578
22573,703-004-5387,1474.098,5,5,0,2.877024771199966
22676,703-004-5394,8272.398,2,1,1,0.5746193724949611
22706,703-004-5382,8334.572,"","","",0.27920371738274696
22723,703-004-5397,5638.369,8,4,4,1.0337542747891368
22832,703-004-5390,5182.7725,3,3,0,1.323999515600623
23044,703-004-5389,272.74072,4,4,0,1.5448653965235126
23581,703-004-5381,7908.8193,3,2,1,1.1920015087673053
23736,703-004-5391,4897.8257,5,2,3,0.9021895591559956
24166,207-008-2399,8616.237,3,2,1,0.4583158631700788
24271,207-008-2398,2968.8455,7,5,2,1.7874199508581416
24487,703-004-5392,8087.2793,2,0,2,0.27920371738274696
24583,703-004-5399,76.02811,3,0,3,0.27920371738274696
25210,703-004-5388,5737.774,3,0,3,0.27920371738274696
2536,207-008-2398,291.7403,4,1,3,0.633650134276203
25361,703-004-5399,4890.1455,4,3,1,1.0750211559474543
25871,703-004-5396,4946.773,3,1,2,0.4658555563220378
26400,703-004-5394,8991.45,6,5,1,1.9058767832029087
26775,703-004-5389,2738.0269,4,2,2,0.8059781173626583
2732,703-004-5392,2166.8982,6,3,3,0.7349248254284223
27333,703-004-5381,2638.7524,6,3,3,2.233761196290685
27459,703-004-5387,2261.7024,1,0,1,0.27920371738274696
27469,703-004-5399,4697.1934,4,1,3,0.34811179936172837
27527,703-004-5385,6144.985,5,2,3,1.1381820196929031
27619,207-008-2398,481.46844,4,2,2,0.870286876291484
27636,207-008-2398,2548.1545,3,2,1,0.921456303149602
28351,703-004-5391,7240.3467,4,3,1,0.9787880381403137
29066,703-004-5399,5667.3037,3,2,1,1.8571619770763208
29133,703-004-5396,590.90076,7,2,5,1.9440532403061472
29209,207-008-2398,8867.259,7,3,4,0.696015144180478
29511,703-004-5388,9463.487,6,1,5,0.39100744078971905
29604,703-004-5387,9650.441,2,2,0,0.8107815399246978
29759,703-004-5393,4270.8857,2,0,2,0.27920371738274696
29779,703-004-5394,1914.0941,10,6,4,2.0041706921050118
29877,703-004-5382,7169.6973,6,5,1,2.319335554214156
29952,703-004-5391,1628.6069,"","","",0.27920371738274696
29965,703-004-5392,5788.4663,6,3,3,1.5225648535740646
30024,703-004-5382,3679.4495,4,2,2,0.9402721053156635
301,703-004-5396,4942.0684,5,2,3,0.5616688116916915
30231,703-004-5391,6483.527,2,1,1,0.6141545597304157
30580,703-004-5390,892.5754,2,2,0,1.1214771725526373
30628,703-004-5395,9406.226,4,3,1,1.1355566806093471
30720,703-004-5392,64.64303,3,1,2,1.600937656014188
31083,703-004-5393,8997.68,4,1,3,0.8289317922836739
31113,703-004-5389,5346.55,1,1,0,0.3414954639612464
31421,703-004-5391,4565.872,1,0,1,0.27920371738274696
31440,703-004-5391,5269.673,3,2,1,0.7250560987580028
31987,703-004-5385,3810.9487,8,5,3,1.7809649392201796
32040,207-008-2399,9262.152,3,2,1,1.0700745164671943
32081,703-004-5394,8606.36,5,2,3,1.3330252513885612
32082,703-004-5398,1880.2769,1,0,1,0.27920371738274696
3215,703-004-5395,872.9208,7,3,4,1.4808316163271826
32316,703-004-5380,4066.3052,5,3,2,0.9509001699117278
32586,703-004-5382,9844.089,3,1,2,0.49997935709509367
32649,703-004-5386,5141.3315,2,0,2,0.27920371738274696
32696,703-004-5395,8188.411,3,2,1,1.4398141729303988
33458,703-004-5384,2506.517,4,4,0,1.8145053010988526
33542,703-004-5388,558.6016,4,2,2,0.41764222725169237
3403,703-004-5385,8048.084,6,4,2,1.4058627448378074
3422,703-004-5383,9665.131,2,1,1,0.5149542665016936
34401,703-004-5386,2327.032,6,5,1,2.170706162185182
35053,207-008-2399,907.045,5,4,1,2.026880560705668
35098,703-004-5384,471.8262,5,1,4,0.475074767456334
35400,703-004-5392,9946.399,1,0,1,0.27920371738274696
35494,703-004-5396,5506.151,7,4,3,1.3599721681285737
35565,703-004-5383,5848.8906,4,2,2,0.791748286760193
35627,703-004-5386,7671.0938,3,1,2,0.44589498436780367
35858,703-004-5399,5768.4697,7,1,6,0.5195176271369029
35914,703-004-5389,1879.4602,1,1,0,0.43888830512010146
35990,703-004-5383,4547.2324,7,2,5,2.0497062756464213
36102,703-004-5394,4114.7983,4,1,3,0.6772569371746499
36241,703-004-5385,9015.218,2,1,1,0.5083183690259145
36312,703-004-5386,4516.179,7,5,2,2.2571130357878197
36412,703-004-5388,1214.3302,5,0,5,0.27920371738274696
3685,703-004-5388,1092.5818,1,0,1,0.27920371738274696
36939,703-004-5395,9482.222,2,0,2,0.27920371738274696
3705,703-004-5380,6796.1816,5,1,4,0.9652547396915562
37248,703-004-5395,3890.5645,7,3,4,0.7078936833944938
37323,703-004-5398,5966.274,2,2,0,1.242062437600201
3750,703-004-5394,6931.0527,4,2,2,0.6834017567728641
37920,703-004-5394,8322.922,6,3,3,0.7277316834050336
38122,703-004-5396,8545.401,"","","",0.27920371738274696
38314,207-008-2398,1001.34375,4,3,1,2.6286669972717664
38391,703-004-5383,3868.2979,7,3,4,1.244420595255916
38557,703-004-5390,8819.174,3,2,1,0.7335094563948941
38707,703-004-5382,9394.289,5,3,2,0.9494809887075176
38716,207-008-2398,7351.6655,6,3,3,0.7789819146057634
38738,703-004-5393,2034.0187,4,2,2,0.5041660963982162
38906,703-004-5395,7184.769,3,0,3,0.27920371738274696
39125,703-004-5399,3208.9846,4,4,0,1.212333366635571
39230,703-004-5383,7802.7056,5,3,2,1.1534328923991495
39245,703-004-5386,2474.6162,3,1,2,0.6075831589468823
39391,703-004-5381,1646.2004,1,1,0,0.4505983117495594
39537,703-004-5398,8439.943,3,0,3,0.27920371738274696
39679,703-004-5395,4477.8677,4,1,3,0.6940843497027801
39707,207-008-2398,9400.294,6,2,4,3.2945701984842355
39949,703-004-5393,8278.272,4,4,0,1.1965813779583405
40557,207-008-2398,749.4748,7,2,5,0.5823601960023783
40572,703-004-5394,9239.643,4,2,2,1.3290630698249108
40707,703-004-5397,3547.1106,4,1,3,1.4817770502134835
40922,703-004-5381,9217.013,6,3,3,1.1828594231761247
40953,207-008-2399,6631.9307,"","","",0.27920371738274696
40981,703-004-5388,7612.887,5,1,4,0.5250251004483215
41050,703-004-5389,3603.44,7,2,5,1.0587612020758599
41275,703-004-5394,3389.5981,3,2,1,0.7360507999502667
41538,703-004-5389,379.97366,3,1,2,0.5328898133958303
4154,703-004-5390,9056.605,5,2,3,1.3612138987823421
41742,703-004-5393,2791.5127,3,1,2,0.33853450732658075
4177,207-008-2399,140.36179,7,5,2,1.9417131023798329
41956,703-004-5392,1852.2638,"","","",0.27920371738274696
42685,703-004-5392,457.23795,2,2,0,1.6265831733854859
42958,703-004-5385,5414.6226,2,0,2,0.27920371738274696
43116,703-004-5383,6896.952,9,4,5,3.568042774463035
43566,703-004-5380,2594.4316,4,1,3,3.1427265964214803
43640,703-004-5395,6917.8037,5,3,2,1.0076222993492168
43746,703-004-5386,7331.7485,5,3,2,0.6550049236760332
43787,207-008-2398,9522.153,3,1,2,0.5633075569512964
43923,703-004-5382,8266.703,5,2,3,1.3293535291479328
44073,703-004-5399,3792.1924,6,4,2,1.7085882017594836
44104,703-004-5387,3112.7202,5,3,2,1.086621668555419
4421,703-004-5382,8229.945,2,0,2,0.27920371738274696
44557,703-004-5387,6895.6763,3,3,0,2.433214923877225
44829,703-004-5397,5017.907,2,0,2,0.27920371738274696
4538,207-008-2398,1441.0585,3,2,1,0.963251558033409
45442,703-004-5382,564.56683,2,1,1,0.6444661201698103
45446,703-004-5380,9359.054,7,3,4,2.1428341279182543
4561,703-004-5381,5159.512,5,4,1,2.5207133112630578
45804,207-008-2398,5242.151,5,1,4,0.6112434177564848
45994,703-004-5399,2829.4612,4,3,1,0.8997515639280429
46120,703-004-5386,2040.2711,1,0,1,0.27920371738274696
46210,703-004-5397,2403.6152,3,2,1,0.6641494190594007
46211,207-008-2399,5781.868,5,0,5,0.27920371738274696
46252,703-004-5385,4183.7256,5,4,1,2.3913175122103754
46377,703-004-5382,288.4835,2,2,0,0.5024726958313166
46430,703-004-5388,9992.912,1,1,0,0.49075247317778
46681,703-004-5396,7433.657,4,3,1,0.9043017798713158
47685,703-004-5398,5948.2183,4,2,2,0.6530498014125039
47878,703-004-5392,912.9137,5,4,1,1.0983248823721081
47883,703-004-5394,3750.5896,4,3,1,0.8465674005467386
4804,703-004-5398,65.755844,5,4,1,1.8713597429252589
48243,703-004-5395,3448.4768,"","","",0.27920371738274696
48625,703-004-5394,1997.7737,8,2,6,0.595026130308936
4866,703-004-5395,7827.3374,1,1,0,0.3981611253702159
48716,703-004-5382,342.67545,1,1,0,0.3572632600188509
48759,207-008-2399,89.37776,4,2,2,0.5986889811720073
48977,703-004-5386,5831.28,4,3,1,0.7241424201060197
49287,703-004-5382,2042.2697,1,0,1,0.27920371738274696
4966,703-004-5399,2901.2693,4,2,2,0.7722248766408245
49666,703-004-5384,7388.3857,6,5,1,0.9549986966090745
49752,703-004-5395,2765.4087,8,4,4,2.49361964589266
49848,703-004-5398,6764.6934,3,2,1,0.4825744603274668
5147,703-004-5387,2952.6729,2,1,1,0.37512182779194486
5544,703-004-5387,6310.7954,2,2,0,0.43956146416702824
5787,703-004-5391,5243.982,4,2,2,0.8404868234913628
5953,703-004-5380,6247.8994,6,4,2,1.3545660597136286
611,703-004-5398,6142.5947,3,0,3,0.27920371738274696
6438,703-004-5391,5207.1636,7,4,3,3.2847746684370134
6466,703-004-5383,8467.361,4,3,1,1.308274096491529
6471,703-004-5388,5379.2153,5,3,2,0.5895247943420836
6472,207-008-2398,1496.6387,6,5,1,1.8223606212453654
6473,703-004-5383,2175.7073,1,1,0,0.3978652972704144
6742,207-008-2399,1164.6097,8,3,5,1.6530998827832422
6780,703-004-5399,5890.76,4,1,3,0.3439031197777484
7019,703-004-5392,5345.234,5,4,1,1.717466335427637
707,703-004-5393,7616.9844,4,4,0,0.861423732941522
7152,703-004-5397,5081.5366,2,0,2,0.27920371738274696
7157,703-004-5381,8746.006,3,2,1,1.4732775624666026
717,703-004-5386,8280.948,4,0,4,0.27920371738274696
7198,703-004-5391,503.45242,2,0,2,0.27920371738274696
7214,207-008-2398,835.27985,4,1,3,0.5500828472005151
7317,703-004-5394,3931.496,5,3,2,0.6256759459219828
7388,207-008-2398,3583.8008,5,3,2,1.9761719409985856
7902,207-008-2399,6318.6167,1,1,0,0.7759522398389783
7987,207-008-2399,6559.315,3,2,1,1.5882249000005386
8116,703-004-5381,9951.413,2,1,1,0.32666834933781397
8381,703-004-5398,3541.7134,5,1,4,0.7459887072658588
8388,703-004-5380,8071.6436,5,2,3,1.06754642296289
847,207-008-2398,4585.368,8,2,6,0.7500037657012516
8588,703-004-5386,7136.8613,5,3,2,0.796038294718055
8725,207-008-2399,1949.2113,4,2,2,0.9890812153890086
8728,703-004-5396,8632.573,4,1,3,0.38465801621729234
8760,703-004-5382,8948.261,3,0,3,0.27920371738274696
8959,703-004-5392,8388.723,2,0,2,0.27920371738274696
9352,703-004-5391,5343.7485,2,0,2,0.27920371738274696
9615,703-004-5380,3974.4294,2,1,1,1.248615204131277
9917,703-004-5396,4999.5605,3,3,0,1.9480613887074478
9971,207-008-2399,989.94073,6,2,4,1.3780985222153113
10143,703-004-5395,7963.974,4,3,1,1.1436770253280135
10554,703-004-5391,9815.392,5,3,2,0.9903141424388557
10818,703-004-5386,1770.2354,8,4,4,2.3370944791441235
11108,703-004-5399,8053.131,2,1,1,0.33853450732658075
11260,703-004-5383,1601.1989,3,1,2,1.409244292208949
11396,703-004-5396,1624.6045,2,1,1,0.6059430421603113
1156,703-004-5399,6852.358,5,3,2,1.4797968656166771
11660,703-004-5388,2140.7688,1,0,1,0.27920371738274696
11767,703-004-5395,7666.7065,2,1,1,0.697582754826493
11806,703-004-5388,6401.807,7,3,4,0.6942617567406032
12055,703-004-5393,8312.22,3,1,2,0.32817961747674373
12151,703-004-5385,5761.33,3,1,2,0.6713473072639479
1222,703-004-5390,5140.192,"","","",0.27920371738274696
12427,703-004-5391,5286.2114,6,2,4,0.5465264998937474
12595,703-004-5394,3843.4995,4,2,2,1.0802447842752898
12621,703-004-5395,4788.283,3,2,1,2.1621537374934907
12693,703-004-5398,2646.8123,6,2,4,1.465144283250337
13266,703-004-5399,1200.9889,2,2,0,1.5888048832422528
13434,703-004-5390,4509.0264,6,1,5,0.46595151494665954
13581,703-004-5395,4548.872,1,1,0,1.3080217514669923
13603,703-004-5388,427.79028,2,1,1,0.45489651640166084
13698,703-004-5385,5067.2085,3,2,1,2.3303442243781793
14463,703-004-5382,5066.31,4,2,2,0.42182010371023726
145,703-004-5396,3309.614,4,0,4,0.27920371738274696
1469,703-004-5386,1548.2861,4,2,2,0.5067514231959074
14931,703-004-5399,6972.85,3,2,1,0.8056049874769708
14942,207-008-2398,1429.2806,2,1,1,0.564744715351299
14964,703-004-5396,3366.9817,1,1,0,0.7251814084503794
15083,703-004-5383,9662.868,6,4,2,1.4776730584788123
15136,703-004-5394,3094.0557,6,4,2,1.0304677656634793
15418,703-004-5387,8802.636,4,4,0,0.7852177485753303
15846,703-004-5393,1249.5482,6,2,4,0.9800292914274948
15862,703-004-5386,8803.61,2,1,1,0.6772492851366578
15871,703-004-5392,5305.5854,1,1,0,0.37842787125381516
16491,703-004-5384,3996.4717,3,1,2,0.3924859181577489
16494,703-004-5385,9684.408,4,1,3,0.35831143730785864
16620,703-004-5397,8078.873,"","","",0.27920371738274696
16642,703-004-5399,5161.0767,1,0,1,0.27920371738274696
16758,703-004-5386,2315.386,5,4,1,0.9997828353858497
17171,703-004-5399,957.9021,1,1,0,0.4739124335847675
17325,703-004-5381,6115.4927,7,4,3,0.9675807755076247
1757,703-004-5389,5791.3335,2,2,0,1.2432178413490078
17585,703-004-5385,8803.706,6,2,4,0.5087613628074197
17588,703-004-5393,3047.6653,4,2,2,1.1173484524902586
17804,703-004-5387,202.23677,1,1,0,0.4756644963809747
17949,703-004-5395,677.7638,9,2,7,0.48791386185089763
17992,703-004-5386,5242.918,4,4,0,1.324015614748433
18264,703-004-5398,6785.4033,3,2,1,0.7863361441330018
18302,703-004-5384,5235.3926,"","","",0.27920371738274696
1840,703-004-5389,3475.2214,5,3,2,1.6568105281329364
18527,703-004-5396,8082.0947,1,1,0,0.48989036536497743
18681,703-004-5392,4987.179,4,1,3,0.5069422590201653
18729,703-004-5399,7477.477,5,3,2,1.918162504086137
18776,703-004-5390,3551.879,7,4,3,1.4441572741979642
18898,703-004-5391,6863.781,3,3,0,1.6719696530685342
19039,703-004-5393,2330.7646,3,2,1,0.5482927433812018
19185,703-004-5399,8132.422,7,4,3,1.1492354856455076
19638,703-004-5393,6466.434,2,2,0,0.6170453603589169
19720,703-004-5398,1843.4894,7,4,3,1.595515542736129
19971,207-008-2399,6051.938,1,0,1,0.27920371738274696
20198,703-004-5384,5454.6245,2,1,1,0.688139951012497
20429,703-004-5396,7895.905,7,2,5,2.2254466054585333
20511,703-004-5396,9644.779,4,3,1,1.3013263738662535
20540,703-004-5384,2789.4587,1,1,0,1.2073158669338775
20586,207-008-2399,7194.6924,7,4,3,1.3185561399766075
20865,703-004-5388,6431.9175,6,3,3,2.129509074095216
2096,703-004-5381,8692.366,1,0,1,0.27920371738274696
20972,703-004-5393,725.20074,3,1,2,0.5142659125995221
20983,703-004-5395,4366.3193,4,1,3,0.5118778261053698
2112,207-008-2399,2460.4302,5,5,0,2.3572086158375907
21136,703-004-5397,2132.4666,3,0,3,0.27920371738274696
21182,703-004-5386,8260.262,4,3,1,2.0149386198734027
21464,703-004-5390,8851.646,4,3,1,2.020053518445878
21483,703-004-5391,7064.7847,6,3,3,0.9763682099286635
21777,703-004-5380,7417.2974,1,1,0,1.015658034207044
21983,703-004-5387,6444.5444,2,0,2,0.27920371738274696
22486,207-008-2399,5927.4546,2,0,2,0.27920371738274696
22515,703-004-5399,9455.576,2,2,0,0.4694035170089482
22689,703-004-5389,7844.5137,2,2,0,1.2942397181829814
2276,703-004-5392,1766.0165,7,4,3,1.8322130845860856
23061,703-004-5398,7852.4355,4,4,0,2.3816176077296127
23145,703-004-5389,5781.5527,7,5,2,1.7786330113083926
23539,703-004-5380,2012.6051,8,2,6,1.420079718983917
23561,703-004-5388,4743.155,3,2,1,1.0271943049427885
23586,703-004-5382,6323.9194,4,1,3,0.4248890872078945
2361,703-004-5385,4834.96,3,1,2,1.0894016014288495
23693,703-004-5397,7046.731,6,2,4,2.0135388411097948
23854,207-008-2398,221.98856,"","","",0.27920371738274696
23953,703-004-5387,7226.6875,2,1,1,0.5459105538826092
24213,703-004-5381,7805.9917,3,3,0,1.1794314819624867
24577,703-004-5399,801.67773,2,1,1,0.6948828852308336
24618,703-004-5382,6487.3423,4,1,3,0.4166518974828799
2483,703-004-5386,4490.2134,2,2,0,0.8078876682112979
24941,703-004-5396,9640.825,9,5,4,1.921119742215992
2505,207-008-2399,8564.839,4,3,1,0.8369417149182524
25286,703-004-5391,4343.202,6,4,2,1.6893257448627461
25439,703-004-5382,1917.7312,5,3,2,0.5383614062785467
26012,703-004-5382,8357.812,1,0,1,0.27920371738274696
26159,703-004-5395,7973.8354,8,5,3,1.6000348867945104
26173,703-004-5389,7754.29,2,1,1,0.3978652972704144
26253,703-004-5390,7472.2676,2,1,1,1.628475206871183
26295,703-004-5394,6676.965,5,2,3,0.7716857073034142
26377,703-004-5389,2590.3933,4,2,2,1.0772343246435234
26737,703-004-5389,2035.532,6,4,2,1.706152285088666
26778,703-004-5389,7085.7666,4,1,3,0.4150844305013413
27093,703-004-5381,9069.475,6,2,4,0.588917374593499
27192,703-004-5386,9280.856,3,2,1,0.8384075624349099
27408,703-004-5386,8954.116,9,7,2,2.8603470699636504
2818,703-004-5381,3644.7256,2,1,1,0.5334052809403781
2827,703-004-5383,3966.0054,5,2,3,1.2578666857831717
28309,703-004-5383,6726.5,3,1,2,0.44589809579654627
2838,703-004-5389,7742.577,2,0,2,0.27920371738274696
28444,703-004-5380,30.767918,5,3,2,0.870096719584144
28474,703-004-5385,2848.1787,4,1,3,0.5756429279943525
28485,207-008-2398,556.3301,2,0,2,0.27920371738274696
28625,207-008-2398,3449.117,4,3,1,1.4550208907462743
28628,207-008-2399,120.800735,6,3,3,1.5127744327914379
28661,703-004-5392,7961.34,8,5,3,1.0855046346826267
28747,703-004-5382,3574.1,6,3,3,0.9748439951852743
28771,703-004-5392,2361.2505,6,4,2,2.4373824032438636
28949,703-004-5386,5146.819,3,2,1,0.9873685577201463
29259,703-004-5396,1863.0797,3,2,1,0.7006979601086932
29325,703-004-5388,7331.9004,1,0,1,0.27920371738274696
29534,703-004-5386,5070.87,8,4,4,2.8602973762005797
29849,703-004-5386,9750.348,4,3,1,1.434213988752075
29851,703-004-5399,5038.2095,4,3,1,1.8531184993119214
3013,703-004-5383,2146.234,2,2,0,0.8049210584560682
30245,703-004-5387,8135.9897,8,5,3,1.314024109728558
30614,703-004-5387,2063.7285,4,2,2,0.6521172146675163
30686,703-004-5395,7659.813,2,1,1,0.42653962083864455
30988,207-008-2399,6397.3584,7,6,1,0.9301862608078005
31378,703-004-5380,1122.6737,2,0,2,0.27920371738274696
31842,703-004-5399,4144.3496,2,1,1,0.36694607923829753
32172,703-004-5396,544.5105,2,1,1,0.8450993723258295
32256,703-004-5385,9599.567,5,3,2,1.8614377014324444
32521,703-004-5399,256.8382,4,2,2,1.2633760327494312
32930,207-008-2399,6017.4697,3,1,2,0.39036324849751636
330,703-004-5395,6032.3823,1,1,0,0.476221335421941
33122,703-004-5397,930.12036,4,3,1,1.3200344829791577
33258,703-004-5394,4949.3877,5,3,2,1.9449400280625682
33506,703-004-5399,3345.235,4,3,1,2.8132112618954084
33524,207-008-2399,924.61945,5,3,2,0.578062794794828
33533,207-008-2398,8349.102,1,1,0,0.38300429405342035
33644,703-004-5396,3527.2866,1,1,0,0.32666834933781397
33905,703-004-5387,8960.527,2,0,2,0.27920371738274696
34297,703-004-5392,4609.4634,5,1,4,0.8619002523308044
34384,703-004-5389,1392.2036,1,0,1,0.27920371738274696
34505,207-008-2399,4750.9746,1,0,1,0.27920371738274696
34747,703-004-5397,7530.1367,3,2,1,0.6852525132459809
34941,703-004-5387,3514.377,3,1,2,0.4357424134105492
35047,703-004-5395,3945.1963,6,3,3,1.5300705021038212
35336,703-004-5395,1606.4012,8,4,4,0.9443093837870322
35411,703-004-5383,7591.175,3,0,3,0.27920371738274696
35550,703-004-5381,1723.1726,5,1,4,0.707992316991447
35906,207-008-2398,7204.005,4,4,0,1.4574640438578723
36401,703-004-5389,7799.6006,5,1,4,0.48395717033396846
36665,703-004-5380,858.8171,4,2,2,0.7033698524046275
37226,703-004-5388,8570.742,4,2,2,0.9496759208211637
37392,703-004-5398,6740.468,2,0,2,0.27920371738274696
37421,703-004-5387,9928.8545,4,2,2,1.4666218552274273
37976,703-004-5386,5440.2886,6,4,2,1.5689633692231026
38220,703-004-5395,9812.122,5,3,2,1.0997255653011404
39080,703-004-5388,4238.6943,5,4,1,1.9777367057973976
39135,207-008-2399,1391.4973,3,2,1,0.668097817893762
39205,703-004-5398,7983.7544,2,1,1,1.3916179194925482
39728,703-004-5388,2657.4434,4,2,2,0.5483520745567326
39839,703-004-5383,931.6063,2,0,2,0.27920371738274696
39852,703-004-5388,3708.0176,2,1,1,0.33853450732658075
39869,703-004-5384,6923.283,6,4,2,1.2977830712455456
39914,703-004-5391,4420.79,1,0,1,0.27920371738274696
39992,703-004-5387,8909.437,3,2,1,1.1953866321370648
40185,703-004-5384,5904.3877,4,0,4,0.27920371738274696
41179,703-004-5393,4989.36,2,0,2,0.27920371738274696
4141,703-004-5388,884.4537,5,1,4,0.5656455009822311
41496,703-004-5385,5020.5366,3,0,3,0.27920371738274696
41615,703-004-5382,5879.0674,3,2,1,0.4824116729403775
41664,703-004-5388,2065.4954,4,2,2,1.497968001609196
41691,703-004-5391,7816.1084,3,1,2,0.5729110693075482
41769,703-004-5387,5699.3286,6,1,5,0.5165268771580819
41906,207-008-2398,1945.8467,5,2,3,1.3907657185156452
41986,703-004-5380,1002.04407,1,1,0,0.44889223285844576
42004,703-004-5393,4221.886,3,1,2,0.5985291155898652
42138,703-004-5399,597.2415,4,2,2,0.7423212459420804
42173,703-004-5392,4448.91,7,4,3,1.0757269658208304
42182,703-004-5389,9480.95,3,2,1,0.7126163762685496
42464,703-004-5380,6713.002,6,3,3,3.010051774364743
42603,703-004-5391,5268.722,8,4,4,0.7410176294879569
43062,703-004-5394,7198.764,2,1,1,0.3518760311589403
43066,703-004-5392,8781.1,2,1,1,0.41757632737852945
43388,703-004-5387,7395.6157,6,3,3,0.842333973484953
43531,703-004-5383,5673.163,2,0,2,0.27920371738274696
44325,703-004-5389,7996.1045,6,2,4,0.6570543978184075
44568,703-004-5387,6330.6655,9,5,4,0.8464534087595674
44620,703-004-5396,906.0359,4,3,1,2.2477666465535915
45343,703-004-5384,3351.5347,2,0,2,0.27920371738274696
45738,703-004-5399,869.354,1,1,0,0.8134223746090136
45760,703-004-5398,129.90773,3,0,3,0.27920371738274696
45907,703-004-5397,2060.8206,4,3,1,2.0814155240586656
46103,703-004-5383,7593.64,7,3,4,1.2549209547701947
46222,703-004-5396,2196.7935,3,3,0,2.243115449295562
46489,703-004-5394,2125.0105,3,1,2,0.9380086430436231
46929,703-004-5384,3076.4204,3,2,1,0.7853996247300964
47251,703-004-5381,8982.237,3,0,3,0.27920371738274696
4794,703-004-5395,1839.4255,2,1,1,1.9835636590723484
48070,703-004-5386,1812.706,5,4,1,1.4498482373240777
48105,207-008-2398,1362.8352,3,1,2,0.3841148263545815
48356,703-004-5383,2291.6638,3,2,1,0.6781834021593344
48503,703-004-5392,6111.998,8,5,3,1.8526924621717555
49113,703-004-5388,8329.354,2,1,1,0.35831143730785864
49143,703-004-5397,7385.046,3,1,2,0.37175974969512765
49200,703-004-5386,7747.7915,6,3,3,1.7986269332137856
49225,703-004-5385,6721.5264,5,2,3,0.5746371038556732
49970,703-004-5387,6347.7783,1,0,1,0.27920371738274696
50,703-004-5382,8031.976,"","","",0.27920371738274696
5046,703-004-5393,9915.914,3,2,1,1.4411623900035946
5328,703-004-5391,716.67554,5,2,3,1.1044145345742704
5588,703-004-5380,2211.1697,4,1,3,0.4768247171964906
6482,703-004-5385,3907.5918,2,1,1,1.3295616249061633
6631,703-004-5391,7287.783,3,1,2,1.45849481981933
6829,703-004-5391,3079.9949,"","","",0.27920371738274696
6863,703-004-5387,5800.4824,6,5,1,1.2863669691375015
6969,703-004-5380,7230.744,"","","",0.27920371738274696
7100,703-004-5397,696.0303,5,2,3,1.0629065642906996
7124,703-004-5396,1271.8004,5,4,1,0.8194668423546236
7244,703-004-5392,6520.3135,2,2,0,1.090376033521933
7391,703-004-5392,4769.963,8,3,5,0.6269590351549059
7429,703-004-5395,1294.6445,"","","",0.27920371738274696
7707,703-004-5396,7189.2686,4,2,2,0.5558541687176549
7963,703-004-5394,657.1752,2,1,1,0.8590619591567954
7969,207-008-2399,9887.982,5,4,1,2.969499201103025
8423,703-004-5390,4161.9683,1,1,0,0.4713258352216451
8457,207-008-2399,9081.222,5,2,3,0.9109722177061537
8601,703-004-5391,6198.861,4,2,2,0.4556652292278849
8604,703-004-5396,5920.582,4,2,2,0.5347961731152732
8606,703-004-5399,6314.5225,"","","",0.27920371738274696
8623,207-008-2398,3818.696,2,0,2,0.27920371738274696
8827,703-004-5397,7399.4624,"","","",0.27920371738274696
8920,703-004-5397,5081.55,2,1,1,0.4903549875135948
8944,703-004-5398,5285.603,"","","",0.27920371738274696
9084,703-004-5392,1264.2134,4,1,3,0.7783899857246659
9111,703-004-5381,2138.2112,2,0,2,0.27920371738274696
920,703-004-5387,7052.5728,7,4,3,1.1081711696080154
9259,703-004-5382,4748.035,2,2,0,1.4234016199717054
946,703-004-5384,7563.4775,8,5,3,3.26505417691141
9505,703-004-5392,2110.5999,3,1,2,0.8329140973377018
9792,703-004-5396,8180.259,6,3,3,1.1819411524699976
9964,703-004-5387,9668.138,4,2,2,1.392679806044991
10003,703-004-5381,4814.24,1,0,1,0.27920371738274696
10300,703-004-5380,2327.6401,6,4,2,1.2133451959022319
10531,703-004-5398,5093.1655,3,3,0,1.0812021248346366
11207,703-004-5397,430.01056,4,3,1,0.9634783924201676
11505,703-004-5389,3977.4675,6,4,2,1.5023815296876575
11598,703-004-5394,4552.9624,3,2,1,0.8462416893254648
1175,703-004-5385,6576.4834,8,2,6,0.612274805838536
12030,703-004-5395,8394.771,5,4,1,1.8897505656029832
12038,703-004-5386,384.84753,4,2,2,1.3556088033607319
1243,703-004-5393,4671.4497,5,3,2,1.2421275811187504
12449,703-004-5397,7170.086,2,2,0,0.9366748792003956
12863,703-004-5382,7276.362,3,3,0,0.6977650286485748
13110,703-004-5386,6073.822,3,3,0,2.127668320558638
13228,703-004-5385,8878.332,3,0,3,0.27920371738274696
13340,703-004-5380,5118.2227,3,1,2,0.35114230018964543
13909,207-008-2399,8348.645,6,2,4,1.0023588351249761
13991,703-004-5398,3404.3218,4,1,3,0.49378258364086314
14348,703-004-5388,5704.6865,4,1,3,0.41049979195030195
14426,703-004-5399,7118.18,5,5,0,2.427328021435784
1444,703-004-5392,3800.8357,2,1,1,0.4633456418502256
147,703-004-5385,8509.438,5,3,2,1.1782357557246903
14803,703-004-5399,4555.273,4,2,2,1.3804120840359222
14955,703-004-5385,9550.842,3,1,2,0.37635788591577474
15031,703-004-5380,8932.421,5,4,1,2.2612012500450795
15456,703-004-5391,6170.802,3,2,1,0.8676190988489269
15729,703-004-5396,7644.432,2,1,1,0.485834025501431
16165,703-004-5396,6181.3574,2,1,1,0.6974744353530042
16203,703-004-5396,1552.5615,5,2,3,0.511042803935291
164,703-004-5387,5449.583,4,1,3,1.8460822449972611
16548,703-004-5390,4828.873,6,1,5,0.4713155303682893
16827,703-004-5383,6010.2666,6,2,4,1.0112549998468998
16939,703-004-5399,3661.1343,4,1,3,0.4519116486325267
17083,703-004-5397,568.5067,5,4,1,1.4840643383998915
17775,703-004-5389,2935.1956,3,0,3,0.27920371738274696
17827,703-004-5384,9660.831,4,1,3,1.1545807861088044
18097,703-004-5384,5537.171,5,2,3,1.0327690724959704
18360,703-004-5381,3428.8745,3,1,2,0.32666834933781397
18408,703-004-5392,6908.8345,4,1,3,0.8699703355002572
18537,703-004-5383,5377.375,4,2,2,2.0995193121947073
18603,703-004-5385,8575.524,3,3,0,1.4892912487739336
18941,703-004-5398,357.15936,"","","",0.27920371738274696
19630,703-004-5387,5551.6416,4,3,1,1.453885118037837
19681,703-004-5390,2988.8577,2,0,2,0.27920371738274696
19768,703-004-5391,1420.2166,4,2,2,2.02408314835197
19806,703-004-5389,6552.0835,2,2,0,1.2738682058692732
19915,703-004-5392,3839.7212,2,1,1,0.726511418374766
20666,703-004-5395,8420.15,3,3,0,0.5120689030359865
207,703-004-5382,1460.8217,4,3,1,0.9686285544192614
20822,703-004-5393,3326.5972,3,3,0,0.9450416429918803
20975,703-004-5394,6610.156,4,2,2,0.5420853948758378
21336,703-004-5383,1879.487,2,0,2,0.27920371738274696
21361,703-004-5385,8584.545,7,4,3,1.9548749872039615
2179,703-004-5381,9975.379,5,3,2,0.8665050470095259
21879,703-004-5394,3750.276,2,2,0,0.9381143304929807
21891,703-004-5397,6522.355,1,0,1,0.27920371738274696
21957,703-004-5396,6325.187,6,4,2,1.4188530437380982
22343,703-004-5398,1962.9609,3,2,1,0.6672693661521208
22511,703-004-5389,3901.2588,1,1,0,0.7027525311877634
22655,703-004-5394,6225.073,3,3,0,0.8937940570159032
22722,703-004-5399,1352.3232,1,0,1,0.27920371738274696
23264,703-004-5382,4859.111,4,2,2,0.5392061502521666
23269,703-004-5386,7469.323,8,7,1,1.9710791286113143
23296,703-004-5383,4467.217,6,0,6,0.27920371738274696
2335,703-004-5385,7338.9756,5,2,3,0.4908168681824206
23769,703-004-5390,7423.7554,4,1,3,0.5037300395544353
23786,703-004-5395,4766.968,3,2,1,0.952776061849349
23792,703-004-5386,1529.628,5,4,1,1.151932709435477
24073,703-004-5395,9273.6455,2,0,2,0.27920371738274696
24277,703-004-5381,2580.375,9,4,5,3.3632493360776783
24713,703-004-5394,4820.013,8,4,4,5.830885296385673
25204,703-004-5390,2659.0483,5,1,4,0.6738330552457837
25798,703-004-5388,2460.4792,3,3,0,0.6174564518196451
25839,703-004-5387,1389.0404,2,1,1,0.558465864333327
25887,703-004-5399,403.89716,5,2,3,1.8863807486007047
26811,703-004-5392,6876.701,4,1,3,0.3422921240230235
27376,703-004-5384,6644.489,4,1,3,0.6349061924688112
27997,703-004-5389,7685.507,7,2,5,2.212122200490866
28217,703-004-5396,9080.501,7,2,5,0.8481795547435024
28270,703-004-5390,1705.7639,"","","",0.27920371738274696
28285,703-004-5382,415.0641,4,2,2,0.9574922797016608
28749,703-004-5384,8177.5786,2,1,1,0.5501476581262543
28773,207-008-2398,1205.2739,6,2,4,0.756694265309763
28804,703-004-5390,4597.3525,3,0,3,0.27920371738274696
29613,703-004-5385,6258.6777,3,3,0,1.7907281596919413
29654,703-004-5394,5780.094,4,2,2,1.418176638752309
29658,703-004-5391,9953.526,3,1,2,1.988079683842218
29969,703-004-5384,5346.9966,4,1,3,0.47442419180630446
30026,703-004-5391,6575.932,3,1,2,0.5615373450074402
30093,703-004-5389,9459.384,4,2,2,1.2007571751805646
30201,703-004-5394,4336.392,7,6,1,1.8736636645227538
30369,703-004-5394,7209.262,3,0,3,0.27920371738274696
30456,703-004-5393,9961.454,2,1,1,0.35831143730785864
30790,207-008-2398,3179.8982,1,1,0,0.35831143730785864
30824,703-004-5394,1060.4548,6,4,2,1.713198662973765
31004,703-004-5391,7507.604,3,2,1,1.3427576724218873
31400,703-004-5399,3042.9072,2,2,0,0.8284546712765469
3151,207-008-2399,7672.359,2,1,1,0.35831143730785864
31595,703-004-5383,6907.3765,"","","",0.27920371738274696
3170,207-008-2398,4269.8228,2,2,0,0.5934369139115551
32277,703-004-5390,9641.162,2,0,2,0.27920371738274696
32422,703-004-5380,5440.1196,3,3,0,0.8156233068071836
32579,703-004-5385,101.13835,5,1,4,0.8505035370906354
32612,703-004-5389,2811.7847,2,0,2,0.27920371738274696
33031,703-004-5391,2220.992,3,2,1,0.549427151315296
33442,703-004-5397,8496.022,7,5,2,2.4045260654377336
33791,703-004-5391,1555.9429,4,1,3,0.39247388641385167
33958,703-004-5398,874.9896,4,0,4,0.27920371738274696
34379,703-004-5383,5978.761,4,2,2,0.7622579206397947
34767,703-004-5391,4193.174,3,0,3,0.27920371738274696
35073,703-004-5388,3066.1494,2,1,1,0.3227129633415584
35457,703-004-5398,2292.0269,3,2,1,3.051637714974002
35791,703-004-5390,2185.0693,6,2,4,0.6472940330068625
35808,703-004-5393,4095.9626,3,1,2,0.8339794358191419
35855,703-004-5390,3317.8193,5,1,4,0.6534075852814856
35960,703-004-5386,2659.222,7,2,5,0.5955357124332871
35999,703-004-5395,8746.498,3,2,1,0.9812955784314116
36064,703-004-5394,167.73105,6,3,3,2.196798823456025
36208,703-004-5388,5264.197,5,1,4,0.38510085717117953
36300,703-004-5387,9107.214,4,2,2,1.4075144468987237
36544,207-008-2398,9654.488,4,2,2,0.8274521360068186
36649,703-004-5386,5488.762,2,1,1,0.796367984893379
36690,703-004-5398,1220.7961,5,1,4,0.8990753340116923
36730,703-004-5388,5979.6045,4,3,1,0.7302953597747393
37324,703-004-5386,8257.197,5,1,4,0.6552579387290601
37361,703-004-5388,7230.266,3,3,0,1.4245391428823173
37373,703-004-5395,3321.9521,4,2,2,0.9288429646202955
37720,703-004-5388,1195.8933,3,2,1,0.802103180335922
37753,207-008-2399,1378.5404,3,2,1,1.3282694315114676
381,703-004-5397,8332.026,4,3,1,2.485165254280701
38172,703-004-5399,4201.515,5,2,3,0.7291929538694385
38234,703-004-5383,5924.9614,4,2,2,0.7744598454900404
38298,703-004-5384,8113.2407,7,5,2,1.6684635355427733
38600,703-004-5398,3499.081,5,1,4,0.5728827092517516
38678,703-004-5393,949.8596,4,2,2,0.4017403394886211
38708,703-004-5380,2803.5288,5,3,2,1.7291803664957814
38764,703-004-5393,5578.925,3,2,1,0.9066724817646695
39146,703-004-5389,5634.684,5,3,2,1.0816197783226298
39259,703-004-5383,2391.8242,6,0,6,0.27920371738274696
39271,207-008-2398,9688.282,5,3,2,1.315796764021357
39981,703-004-5392,1358.0334,2,1,1,0.45184754700052965
4006,703-004-5389,9622.82,6,3,3,1.6425634450212019
40135,703-004-5390,2847.2383,5,1,4,0.6901142192643328
40793,207-008-2398,2860.8699,"","","",0.27920371738274696
41507,703-004-5383,2049.8372,4,1,3,0.7603527159929716
41553,207-008-2399,5359.9106,3,0,3,0.27920371738274696
41810,207-008-2399,9046.854,6,2,4,1.9311590249678308
41909,703-004-5383,6833.1387,3,2,1,0.5402010984037955
4208,703-004-5397,6863.5566,4,3,1,1.1623658115088313
42194,703-004-5396,4261.905,5,3,2,1.6486323827420502
42196,703-004-5394,3887.8472,1,1,0,0.8409710742687567
42671,703-004-5391,7455.7812,2,0,2,0.27920371738274696
43203,703-004-5386,506.85944,1,1,0,0.6227386414558879
43927,703-004-5397,6332.3457,1,0,1,0.27920371738274696
44225,703-004-5382,5493.194,1,1,0,0.3978652972704144
44592,703-004-5395,6843.424,2,1,1,0.535420928895925
44747,703-004-5388,4054.4421,4,4,0,1.8169289289580726
45070,703-004-5389,7018.703,3,2,1,0.8429631704499213
45072,703-004-5385,3262.654,3,2,1,0.7864819714025253
45074,703-004-5396,8370.197,7,5,2,2.8677664609708895
45436,703-004-5385,2376.3745,3,2,1,1.903044468787416
455,207-008-2398,1683.8193,4,2,2,1.8029636462144198
45594,703-004-5381,992.5491,4,2,2,0.4921715903452292
4579,703-004-5388,9014.638,2,1,1,0.6155738357354646
45889,703-004-5399,8780.009,3,2,1,0.652761000968989
45950,703-004-5391,7049.259,2,2,0,0.8035801056236631
46141,703-004-5393,5285.544,4,2,2,1.2017204443471423
46144,703-004-5392,6869.7256,3,0,3,0.27920371738274696
4621,703-004-5392,7724.5195,6,3,3,0.8071010062964896
46251,703-004-5394,6680.997,3,3,0,0.6457146622412127
46281,703-004-5392,3346.2317,7,3,4,0.6990955366946678
46488,703-004-5397,8674.518,5,1,4,0.7534113459607273
46494,703-004-5397,519.2107,1,1,0,0.36303989103840123
46513,703-004-5383,769.40356,3,1,2,0.5165268771580819
46756,703-004-5397,2739.6936,3,3,0,2.2289636046418493
46786,703-004-5394,8688.407,6,2,4,1.5027881735315929
47033,703-004-5387,8908.646,8,4,4,1.4138150601256558
47179,703-004-5395,9398.509,5,2,3,1.4549007687389206
47269,703-004-5396,8069.8594,4,1,3,0.35831143730785864
47397,207-008-2398,2004.6824,5,2,3,1.8857200043329447
47785,703-004-5394,8726.864,2,2,0,0.7211864829625385
47882,703-004-5380,5088.872,3,2,1,0.7938514852625085
47926,703-004-5380,8258.215,3,2,1,1.0942700878009255
47983,703-004-5383,5637.416,2,0,2,0.27920371738274696
48087,703-004-5399,5418.776,5,2,3,0.6351884570457493
48457,703-004-5394,7592.779,8,2,6,0.8393102987231508
48596,703-004-5391,2803.8145,3,1,2,0.3975356817707265
49159,703-004-5386,607.7623,3,2,1,0.8008473709455433
49293,703-004-5394,5873.4487,2,2,0,0.6555238389139711
49454,703-004-5394,7275.217,3,3,0,0.7968770416987531
49551,703-004-5397,1012.3402,3,3,0,1.0120097020466057
49641,703-004-5397,1526.8273,5,3,2,1.6629231832240017
4992,703-004-5396,7191.8564,4,0,4,0.27920371738274696
5427,703-004-5382,3299.6755,1,1,0,0.40097496314235953
5593,703-004-5384,9248.196,6,2,4,1.3230285346950006
5630,703-004-5393,4643.91,8,4,4,0.8039012524091541
5899,703-004-5390,3322.2295,2,0,2,0.27920371738274696
6134,703-004-5386,7835.7085,6,4,2,1.3564335976739337
6167,703-004-5384,7378.096,4,2,2,1.0643110084101095
6373,703-004-5382,6359.4473,7,5,2,1.9738130663200555
6489,703-004-5383,7159.037,6,3,3,1.1696315729617102
6616,703-004-5398,567.5548,3,2,1,0.8210915988697618
6639,703-004-5395,9917.801,7,2,5,0.48816901978549865
6779,703-004-5381,8241.89,3,2,1,0.3741329812928809
6852,703-004-5399,2425.3833,5,2,3,1.4929473861600813
7077,703-004-5399,3603.6313,7,2,5,3.4685328890049814
7123,703-004-5387,4086.9146,3,1,2,1.2311113883985187
7289,703-004-5383,45.49265,3,0,3,0.27920371738274696
7853,703-004-5396,7875.645,5,3,2,0.6414618801144765
7872,703-004-5395,238.29639,4,3,1,0.5782209173995192
7949,703-004-5384,1982.0774,3,0,3,0.27920371738274696
802,703-004-5397,8646.625,2,0,2,0.27920371738274696
8367,703-004-5381,828.11176,3,2,1,0.6302499136407853
839,207-008-2399,112.195015,2,1,1,0.47424756689008496
8454,703-004-5395,9539.088,6,3,3,2.7791194523304883
8631,207-008-2399,3224.169,4,1,3,1.1163829711523872
8688,207-008-2398,2937.432,5,2,3,0.7651924720736306
8987,703-004-5389,8873.352,10,7,3,4.322996764955565
9115,703-004-5386,450.26718,2,0,2,0.27920371738274696
9151,703-004-5391,3843.4631,3,2,1,0.5648651682385518
9364,703-004-5391,3762.8757,5,3,2,0.6659692850768274
948,207-008-2399,2295.01,"","","",0.27920371738274696
9509,703-004-5382,1201.9735,3,2,1,0.8228583212098022
9682,207-008-2398,9955.305,3,1,2,1.1701124345548333
9734,703-004-5393,1868.9722,4,0,4,0.27920371738274696
9763,703-004-5391,3001.7197,9,5,4,1.7733662089950752
1000,703-004-5387,858.916,4,0,4,0.27920371738274696
10091,703-004-5382,2941.3818,3,1,2,0.5957758608687741
10115,703-004-5385,1402.2023,5,4,1,3.200462142489947
10223,703-004-5392,6022.1855,2,2,0,1.4397539077235915
10252,703-004-5399,3240.9382,4,3,1,1.0701604137173868
10491,207-008-2399,1993.4535,4,2,2,0.5980770280707642
10650,207-008-2399,495.79858,3,3,0,1.4605430752421007
10719,703-004-5382,8653.281,4,2,2,1.6529989739404267
10733,703-004-5399,3297.6853,3,2,1,0.9875121213190527
11254,703-004-5388,8203.95,5,4,1,1.461831278390915
11457,703-004-5399,9168.519,9,0,9,0.27920371738274696
11541,703-004-5394,1492.9015,3,3,0,1.1504502808729167
11779,703-004-5388,9018.299,4,0,4,0.27920371738274696
118,703-004-5382,7284.848,2,1,1,0.5496134008435851
11926,703-004-5387,7186.211,1,1,0,0.5313696419941093
12041,703-004-5384,541.59644,6,3,3,0.6067952722361086
12128,703-004-5396,2910.6223,1,1,0,0.6636603552872246
12159,703-004-5380,6459.743,8,3,5,1.0552721402132914
12321,703-004-5384,8180.2886,6,3,3,0.8896404945649857
12364,703-004-5388,9848.277,1,1,0,0.3250491131955969
12441,703-004-5393,128.38483,4,2,2,1.9615659750571544
12530,703-004-5381,2660.1143,2,1,1,0.49609142067248346
12561,703-004-5393,2178.3943,2,1,1,0.4379116479167463
13011,703-004-5394,1329.0184,2,2,0,1.437443588987204
13046,703-004-5389,4039.4353,3,2,1,0.9074077720140921
13149,703-004-5383,1533.8052,3,1,2,0.5416692601775934
13155,703-004-5385,8455.353,2,0,2,0.27920371738274696
13824,703-004-5380,7058.482,3,3,0,0.953241296628321
14053,703-004-5397,1316.9348,9,6,3,1.256858225675661
14438,703-004-5385,3113.6877,4,2,2,0.538280518501212
14461,703-004-5386,3203.2305,1,0,1,0.27920371738274696
14707,703-004-5388,8234.915,3,3,0,0.544073241771402
14728,703-004-5383,8170.001,4,3,1,1.6599690014856838
15395,703-004-5397,8645.944,6,5,1,1.6729322222892962
15514,703-004-5397,51.91207,7,5,2,2.252571351316583
15589,703-004-5396,5043.9624,6,4,2,1.168625571027429
15734,703-004-5386,6221.8516,7,2,5,1.854421966579214
15771,703-004-5381,8891.788,5,5,0,2.2072180386415465
15820,703-004-5399,8624.169,4,3,1,0.9511058489035815
16176,703-004-5393,2527.1934,5,2,3,0.43741915723297026
17101,703-004-5388,744.09546,5,3,2,0.9971285879754506
1734,703-004-5399,6681.292,7,3,4,0.6979095726054809
17751,703-004-5399,3999.819,7,3,4,1.4377956255627466
18596,703-004-5391,9708.694,4,1,3,0.4552106620330675
18780,703-004-5384,7817.606,2,1,1,0.7894155493497481
18781,703-004-5382,8476.258,4,2,2,0.6076361560433904
18789,703-004-5391,1766.6495,5,4,1,0.9920109293435267
18865,703-004-5398,1886.3636,5,1,4,0.3949422979206347
18939,703-004-5393,6481.5376,7,5,2,1.354036263744248
19087,703-004-5387,8084.3633,4,1,3,2.421198649134836
19244,703-004-5387,1309.6255,2,2,0,1.2003398792134052
19527,703-004-5381,9575.046,3,1,2,0.4474641447216291
19561,703-004-5380,1599.0717,4,2,2,0.5595350623126749
19840,703-004-5392,9362.3125,3,1,2,2.844340559013193
19908,207-008-2399,3496.812,3,2,1,0.7135651064337805
20361,703-004-5387,7660.6987,3,3,0,1.3160739050780434
20587,703-004-5381,6411.7334,3,1,2,0.7212584205514609
20757,703-004-5394,2241.9304,3,0,3,0.27920371738274696
2102,703-004-5387,6258.003,3,1,2,0.49356544943044367
21360,703-004-5393,5821.9985,3,1,2,0.30886911235466386
21500,703-004-5380,5075.5537,5,2,3,0.7519583059702185
21642,703-004-5399,4095.456,4,1,3,0.7207280119051231
2169,703-004-5394,8372.894,3,2,1,0.5931274927743988
21992,703-004-5382,2807.2202,7,4,3,1.4688555924253424
22050,703-004-5380,1943.8398,3,3,0,2.53657171554611
22073,703-004-5382,4218.0527,8,3,5,1.0103409487390227
22076,703-004-5380,5618.427,6,2,4,1.7347379218878383
22286,703-004-5397,1014.20996,2,1,1,0.6392460415184621
22653,703-004-5398,8503.8125,5,1,4,0.500376055683766
23062,703-004-5392,3466.423,4,3,1,1.5811303464384319
23101,703-004-5398,3375.73,5,2,3,0.6142571535877268
23607,703-004-5397,4748.5938,7,3,4,2.0780267149222738
23713,703-004-5397,959.27954,4,2,2,0.9719530974128238
24038,703-004-5396,3032.1194,3,0,3,0.27920371738274696
24294,703-004-5393,6677.419,5,5,0,2.2606633127768387
24520,703-004-5390,4310.348,3,2,1,0.6351884570457493
24828,703-004-5389,2878.554,6,3,3,1.6842425572491806
24927,703-004-5397,2884.5454,6,4,2,1.238681165758855
25205,703-004-5384,5093.162,3,2,1,0.7280308609716266
25319,703-004-5383,8973.591,1,0,1,0.27920371738274696
25328,703-004-5397,7740.7837,8,2,6,0.6087956289615157
25444,703-004-5388,886.91534,3,1,2,1.2449085805363957
25464,703-004-5383,5475.7925,4,2,2,0.7972591550746997
25472,703-004-5392,1764.3535,5,2,3,0.9897961486855528
25627,207-008-2399,2577.4927,6,1,5,0.4600188525506697
25691,703-004-5389,5631.6465,5,3,2,2.022700768096244
257,703-004-5385,6912.5776,6,4,2,0.9040909599608185
25837,703-004-5390,6866.3516,3,2,1,1.3764801567674287
26117,703-004-5388,551.64636,8,6,2,1.5207857904245765
26175,703-004-5383,587.23627,3,1,2,0.5165268771580819
26319,703-004-5380,5329.5303,6,3,3,0.917427496924814
26545,207-008-2398,5580.6533,3,1,2,0.4471469184326733
26693,703-004-5397,9510.866,3,1,2,0.5719579037212325
26735,703-004-5395,2567.212,4,3,1,0.7250287786724638
26851,703-004-5389,9664.708,7,4,3,0.8642858964702148
27208,703-004-5393,7848.23,8,5,3,1.603492619039539
27212,703-004-5385,9904.954,3,1,2,0.44301556894243893
27315,703-004-5396,2970.556,4,2,2,0.7697107981585726
2745,703-004-5392,7227.1523,5,2,3,0.7658547954095656
27577,703-004-5395,1683.1226,2,0,2,0.27920371738274696
27770,703-004-5395,9687.9375,3,3,0,2.4159220440388727
28325,703-004-5387,8056.2573,3,2,1,1.7978790242806977
28458,703-004-5390,6395.4346,2,1,1,0.6729712525518685
28544,703-004-5386,6119.0693,1,1,0,1.1354560697047482
29061,703-004-5395,1992.3633,4,1,3,0.7547833044330814
29166,703-004-5396,3105.7751,2,0,2,0.27920371738274696
29355,703-004-5399,2706.5254,4,1,3,0.864052583843993
29606,703-004-5396,9117.995,3,2,1,0.84551994927477
29617,207-008-2399,7448.3716,8,5,3,2.3389894769486674
29836,703-004-5381,9561.755,3,1,2,0.4656122799501674
29859,703-004-5383,1634.047,1,0,1,0.27920371738274696
29935,207-008-2399,1744.737,3,2,1,1.1065661018765558
29977,703-004-5391,767.0623,3,2,1,0.9161847437191843
30120,703-004-5399,802.63135,1,0,1,0.27920371738274696
30260,703-004-5391,43.988228,6,4,2,3.996734001560292
3046,207-008-2399,1892.6167,7,5,2,1.6830564522525382
3049,703-004-5382,1646.2714,5,0,5,0.27920371738274696
30533,703-004-5385,4541.226,8,4,4,1.8962747437133445
30697,703-004-5382,3031.9053,5,3,2,2.1531998681192417
30719,703-004-5398,7289.098,2,0,2,0.27920371738274696
30738,703-004-5392,5363.7236,2,2,0,0.45826260240963773
30876,703-004-5390,8379.666,6,4,2,1.2111155991584541
30937,703-004-5389,675.58826,2,1,1,1.2225496872225528
31291,703-004-5383,678.34674,6,3,3,2.221448876252239
31683,703-004-5386,221.85564,4,3,1,2.2084629601614743
31709,703-004-5383,4439.2524,3,2,1,2.000772352896516
31723,703-004-5385,586.74036,3,2,1,0.5087703110056583
31867,703-004-5394,4881.957,4,1,3,0.7265957934983719
31973,703-004-5388,6337.409,4,2,2,3.7152188028532094
32030,703-004-5392,7948.971,3,2,1,1.2423579248335876
32062,703-004-5388,1335.7562,4,0,4,0.27920371738274696
32110,703-004-5382,8505.347,6,3,3,1.4019308653898144
32131,703-004-5399,338.91498,3,0,3,0.27920371738274696
32291,703-004-5382,1839.264,3,1,2,0.4802362106424369
32311,703-004-5399,6010.1777,6,1,5,0.40622105018750443
32559,703-004-5384,4987.739,2,2,0,0.5938037424491848
32615,207-008-2399,9691.471,3,3,0,1.1739148269220538
32839,703-004-5382,3553.062,3,2,1,1.4781332518652448
33413,703-004-5388,8783.758,9,4,5,1.816488146188457
33455,703-004-5390,6712.717,5,5,0,2.659396204117272
33519,703-004-5393,9862.664,5,3,2,0.7112735950258812
34428,703-004-5387,3154.59,6,2,4,0.9533606489412393
35024,703-004-5397,1107.8662,6,3,3,1.1120716761139755
35155,703-004-5381,1900.9984,8,2,6,0.8977713852337026
35538,703-004-5394,4525.0337,5,2,3,0.5898481969861712
35934,703-004-5381,4000.5977,7,3,4,0.9723410542635664
36387,703-004-5389,6660.378,3,1,2,0.35831143730785864
36675,703-004-5397,2200.4795,5,2,3,0.9234668289432224
36785,703-004-5399,423.7455,4,3,1,1.7551961415529462
36786,703-004-5380,2185.5469,5,2,3,0.8907077315696292
36962,703-004-5395,2427.6526,3,2,1,0.6275596117472172
37384,703-004-5392,5759.909,2,0,2,0.27920371738274696
37461,703-004-5387,1736.0383,4,2,2,1.0683234518737252
37619,703-004-5399,1293.8583,"","","",0.27920371738274696
37697,703-004-5390,1377.8585,4,1,3,2.5028113136015024
37861,703-004-5394,9174.692,3,2,1,0.8571400360534257
38572,703-004-5397,7983.3843,2,2,0,0.6926552001321137
38817,703-004-5390,8069.833,8,4,4,1.5058491622211845
39295,703-004-5395,4221.737,3,1,2,0.48373833791126036
39464,703-004-5384,6546.622,2,1,1,0.5669580486103406
39506,703-004-5384,4064.5908,5,3,2,1.94456080248935
39637,703-004-5381,2871.4424,5,3,2,2.2393810312285614
39807,703-004-5393,9044.634,13,9,4,2.9067187927300515
40014,703-004-5393,1535.5015,6,5,1,2.589720096320405
40186,703-004-5394,5659.5967,4,3,1,0.7987552377284955
40341,703-004-5386,5570.512,3,1,2,0.42555299924420353
40517,703-004-5381,2310.623,4,2,2,0.8812319516905902
4058,703-004-5395,2918.2888,5,2,3,1.1953135273689501
40954,703-004-5387,2795.0984,3,1,2,1.3309466275327506
41483,703-004-5393,5560.6724,1,1,0,0.44786508443745654
41971,703-004-5394,856.5789,3,1,2,1.6781570491638245
42018,703-004-5397,8363.22,2,1,1,0.6373592001158445
42021,703-004-5381,7808.4756,8,7,1,2.883728561725213
4226,703-004-5381,6924.514,3,0,3,0.27920371738274696
42672,703-004-5380,6922.924,3,1,2,0.3486207416170325
42720,207-008-2398,9267.291,5,1,4,0.40543572748668766
4436,703-004-5387,2987.8801,6,4,2,1.181132452433083
44671,703-004-5385,1304.36,5,3,2,1.1287291601148064
45149,703-004-5388,9431.597,7,5,2,2.0989278702951837
45277,703-004-5386,1129.5676,6,3,3,1.5715810676679847
45278,703-004-5399,311.9421,5,1,4,0.35831143730785864
45388,703-004-5391,1921.9357,3,1,2,0.7611180587015365
45445,207-008-2398,842.2804,4,2,2,0.5570536860579329
45463,703-004-5380,3914.0217,3,3,0,5.117450284076115
45639,703-004-5390,5545.0356,9,5,4,2.2465595820147173
45832,703-004-5382,4887.009,10,4,6,0.9076219083664795
46423,703-004-5388,8921.257,7,4,3,1.3113612947846238
46512,703-004-5381,5135.0234,3,2,1,0.5074684342413126
46571,703-004-5392,7172.6284,3,2,1,1.059200152058553
4664,703-004-5386,8253.763,2,2,0,0.6102107247070844
46662,703-004-5394,6840.3076,2,1,1,0.3887297793789904
46765,703-004-5396,5276.8315,4,1,3,0.37867740460775706
47535,703-004-5382,4904.067,5,3,2,0.7562706818111293
47726,703-004-5394,2834.8994,2,1,1,0.3187575773453028
47753,207-008-2399,4860.555,1,0,1,0.27920371738274696
47777,703-004-5384,4238.084,4,3,1,1.8756083723213077
47789,703-004-5384,6378.0166,1,1,0,0.98978164693961
48106,703-004-5399,9973.894,6,3,3,0.6650091438810667
48124,703-004-5391,6320.1978,5,0,5,0.27920371738274696
48176,703-004-5395,4617.479,3,0,3,0.27920371738274696
48297,703-004-5395,781.54443,2,0,2,0.27920371738274696
48487,703-004-5384,1350.7712,1,1,0,0.5165268771580819
48510,703-004-5386,5194.178,7,4,3,2.0332936018444796
48537,703-004-5398,2192.8145,5,0,5,0.27920371738274696
48737,703-004-5386,7927.808,5,3,2,0.6426308720370689
4891,703-004-5397,6943.306,3,2,1,0.8415384734039524
4944,703-004-5382,8951.854,7,3,4,1.8145270218117735
49992,703-004-5386,8652.804,5,4,1,3.7654496517351443
5032,703-004-5398,5469.603,7,2,5,0.6795646093494705
5246,703-004-5387,2235.3481,6,4,2,0.8201071461916059
6,703-004-5387,2832.0205,4,2,2,0.9982043313354407
6088,703-004-5389,2372.2988,2,1,1,0.36241505826327547
6224,703-004-5394,6065.001,3,0,3,0.27920371738274696
6257,703-004-5395,3971.3972,4,1,3,1.2051930912194269
6393,703-004-5385,9956.441,5,1,4,0.39955292862881686
6680,703-004-5388,4996.254,3,2,1,1.1155440809280242
669,703-004-5396,6261.037,2,1,1,0.35831143730785864
6911,703-004-5397,4245.2944,5,3,2,1.4489025978942784
7201,703-004-5381,3672.9001,4,3,1,1.6273668169240518
7363,703-004-5381,9902.413,2,1,1,0.5264404643433888
7496,703-004-5386,4811.746,3,2,1,0.9752090938387568
8291,703-004-5391,7359.221,4,1,3,1.0662991608295964
8469,703-004-5399,7542.6304,4,3,1,0.7793835374924986
8486,703-004-5384,3567.192,3,0,3,0.27920371738274696
8822,703-004-5397,5713.315,5,2,3,0.5804650262143383
8926,703-004-5398,6731.003,4,2,2,0.8329416857299633
9124,703-004-5390,5001.5483,2,1,1,0.47336887084913587
9211,703-004-5385,2206.846,6,3,3,1.5674086828760077
9256,703-004-5396,9343.911,6,4,2,1.5309600828010015
9351,703-004-5380,4206.305,4,1,3,0.6589345910901592
9500,703-004-5389,839.76624,3,3,0,1.264117274052793
9677,703-004-5386,9913.153,2,2,0,0.7448718788569576
9947,703-004-5397,7077.5664,4,1,3,0.9133643897198613
9988,703-004-5389,5292.1997,3,1,2,0.5117272980447461
10189,703-004-5385,5187.935,3,2,1,0.5862088983712846
1023,703-004-5386,3759.5654,6,5,1,2.5599193782313656
10258,703-004-5380,1255.762,4,3,1,1.4139560394143973
10269,703-004-5395,6814.7676,6,5,1,3.424554201774963
10288,703-004-5383,8280.998,3,1,2,0.3704580156829849
10772,703-004-5380,3172.7534,3,2,1,0.5577949755468895
11240,703-004-5397,6023.055,1,1,0,0.3964756932596466
11275,703-004-5383,7201.807,4,2,2,0.9805743025902086
11481,703-004-5381,4213.4272,4,3,1,1.740884557006073
11597,703-004-5399,7028.6914,3,2,1,1.435145454229172
11692,703-004-5391,2926.8987,2,1,1,0.6582664134113767
1172,703-004-5380,9211.971,1,0,1,0.27920371738274696
1187,703-004-5395,7429.529,3,2,1,0.9125444446697801
11995,703-004-5394,6206.6753,8,6,2,2.8148075902083485
12044,703-004-5395,3636.4568,3,3,0,1.0091206647318927
12110,703-004-5382,2231.8708,3,1,2,0.8090274062460795
12350,703-004-5390,3178.3884,2,0,2,0.27920371738274696
12391,703-004-5380,3319.5972,4,2,2,0.8654604142338576
12956,207-008-2398,7947.4775,1,0,1,0.27920371738274696
12961,703-004-5384,8304.991,4,2,2,1.141373348562263
13465,703-004-5397,3147.977,3,2,1,1.3845527610802217
1351,703-004-5395,8367.474,1,1,0,0.6237510763645144
13547,207-008-2398,4276.3467,5,0,5,0.27920371738274696
13564,703-004-5390,3956.337,10,4,6,2.769093632144835
13966,703-004-5380,5290.53,4,2,2,0.6048642843730222
1402,703-004-5391,6607.8037,5,3,2,1.0444905026345734
14067,703-004-5397,7534.398,6,4,2,2.273740187584801
1408,207-008-2398,918.476,6,1,5,0.4613521787918738
14223,703-004-5381,6039.4062,6,3,3,2.29985462085114
14231,703-004-5384,3292.6768,4,3,1,0.8382327647329857
14394,703-004-5381,4084.8809,8,3,5,0.7069066809366229
14418,703-004-5388,4197.725,2,1,1,0.8879434540560183
14627,703-004-5380,6822.4956,4,1,3,0.558246204151871
1490,703-004-5393,3227.7864,4,1,3,0.3645100627891782
14916,703-004-5390,4126.266,4,2,2,0.43445261773577853
14992,703-004-5385,8933.748,6,6,0,4.0733429216885755
15185,703-004-5391,33.066273,3,2,1,0.8957543802767303
15457,703-004-5383,2303.162,7,3,4,3.369822743966899
15477,703-004-5397,3762.0466,4,3,1,0.7725255345393919
15562,703-004-5390,5729.0405,6,2,4,0.9266098656056255
15722,703-004-5387,2435.538,1,0,1,0.27920371738274696
15770,703-004-5381,2603.789,1,1,0,0.3807252912866403
1585,703-004-5387,3906.1887,11,5,6,1.4218321711981912
16092,703-004-5385,9925.113,6,3,3,1.319703156592743
16148,207-008-2399,8568.897,1,0,1,0.27920371738274696
16223,703-004-5396,1887.5754,5,3,2,0.8994437186473505
16611,703-004-5380,2409.916,3,1,2,0.4986581194486321
16769,703-004-5399,1060.8607,2,0,2,0.27920371738274696
16845,703-004-5385,2449.3052,4,2,2,1.6390431837165333
1705,703-004-5385,6874.4673,3,1,2,0.8139604896829092
17072,703-004-5397,4024.1648,2,1,1,0.9264448193028852
17945,703-004-5384,979.8938,5,3,2,1.8664815789473637
18043,703-004-5387,266.5633,4,1,3,1.0287900192242028
18241,703-004-5399,9757.168,4,4,0,3.1365086092151913
19368,703-004-5391,8115.7554,2,2,0,1.2313120648493259
19465,703-004-5386,2356.925,4,2,2,1.6346660874885872
1976,703-004-5395,6241.0693,3,0,3,0.27920371738274696
20118,703-004-5380,1272.2355,2,2,0,0.5105937981636984
20311,207-008-2398,5303.525,4,2,2,0.8084464008727725
20396,703-004-5388,6859.847,4,3,1,2.5000399071007875
2041,703-004-5388,7630.883,6,4,2,1.1170237959257827
20653,703-004-5386,7522.1094,4,1,3,0.8711398056802344
20704,703-004-5396,4394.3076,8,5,3,1.297332972067817
20960,703-004-5396,2582.5918,2,2,0,0.5477656574097275
21104,703-004-5391,3220.176,2,0,2,0.27920371738274696
21206,703-004-5382,4801.15,6,1,5,0.4976843475830808
2145,703-004-5399,228.10161,4,1,3,0.3978652972704144
21467,703-004-5385,5058.67,2,2,0,1.024877861925596
21566,703-004-5396,3382.604,2,2,0,1.2664641064734985
21600,703-004-5386,6599.5522,4,1,3,0.40656631791996994
21718,703-004-5389,4765.9653,4,2,2,0.8538588993789819
21743,703-004-5386,5633.551,2,0,2,0.27920371738274696
21762,703-004-5397,2911.632,3,2,1,0.7708521253175313
2178,703-004-5389,5269.081,5,3,2,0.5953423921262204
21862,703-004-5399,3052.1626,7,3,4,1.9109166203871761
22025,703-004-5384,2154.4653,3,3,0,2.434073854121702
22041,703-004-5381,6561.8145,7,5,2,2.1681102046749583
22208,703-004-5387,5872.5493,5,2,3,1.2879322539371938
22257,703-004-5388,8893.875,3,2,1,0.6512916886400175
22365,207-008-2398,730.6141,"","","",0.27920371738274696
22376,703-004-5383,9367.769,4,1,3,0.40210295942942326
22606,207-008-2398,6163.8086,7,5,2,1.741245271834822
22614,703-004-5389,4624.2095,7,4,3,1.5555147408982766
22900,703-004-5391,355.23535,2,0,2,0.27920371738274696
22959,703-004-5383,9393.56,2,0,2,0.27920371738274696
230,703-004-5382,3752.9683,5,2,3,3.1740937827709295
23098,703-004-5389,7655.3774,1,0,1,0.27920371738274696
23300,703-004-5386,2556.5745,4,2,2,0.43839852728641815
23321,703-004-5382,1911.9382,8,6,2,1.740784272369385
23522,703-004-5392,6631.942,7,5,2,2.9540218292422282
23530,207-008-2399,9108.021,5,2,3,0.8370528340652579
23669,703-004-5386,6025.876,3,2,1,0.6179302395590985
23698,703-004-5389,3479.9414,2,1,1,0.6851111749820624
23740,703-004-5392,8670.78,6,4,2,2.6433999157479997
23851,703-004-5391,8069.794,7,4,3,1.076907551157486
24288,703-004-5387,3549.6885,1,0,1,0.27920371738274696
24300,703-004-5380,9204.668,4,3,1,1.3370441773248942
24407,703-004-5395,587.61597,4,0,4,0.27920371738274696
24602,703-004-5388,5640.3745,7,2,5,0.7971973358461683
24807,703-004-5380,2255.317,3,2,1,0.6177679482717408
24892,703-004-5389,3563.0679,4,0,4,0.27920371738274696
25128,703-004-5389,2859.7642,5,2,3,0.6422093975618569
256,703-004-5395,5433.8706,6,3,3,0.7589666977207506
25876,703-004-5390,819.6479,1,0,1,0.27920371738274696
25945,703-004-5391,260.84662,2,1,1,0.47618310226512317
2599,207-008-2398,4432.74,4,1,3,0.33853450732658075
26044,703-004-5392,5632.976,3,0,3,0.27920371738274696
26303,703-004-5393,2273.4111,2,2,0,0.621527876396875
26440,703-004-5392,2613.2053,1,0,1,0.27920371738274696
2657,703-004-5393,4670.1963,5,2,3,0.5602560931339755
26602,703-004-5395,5420.1924,1,0,1,0.27920371738274696
26639,703-004-5391,6372.5825,8,6,2,2.4437937798022618
26692,207-008-2398,5500.8755,3,2,1,2.9346106028212877
26843,703-004-5399,7619.0825,3,0,3,0.27920371738274696
27252,703-004-5388,2206.3535,5,4,1,1.0472893911041756
2747,703-004-5393,5563.1216,2,1,1,0.5177823466439362
27700,703-004-5385,549.438,1,0,1,0.27920371738274696
28083,207-008-2398,9163.198,6,4,2,1.626894441364549
28118,703-004-5389,2581.8235,6,3,3,1.5089564249951808
28214,703-004-5395,3733.9717,2,1,1,0.6674572452892925
28585,703-004-5393,9550.522,6,4,2,1.234524423939986
28725,703-004-5392,4969.6904,4,3,1,0.6295189435743896
28782,703-004-5384,9908.723,1,0,1,0.27920371738274696
28808,703-004-5399,4410.5034,6,1,5,1.2794606843559442
29309,703-004-5384,1521.7876,2,1,1,0.385921668098264
2936,703-004-5385,1666.5364,2,0,2,0.27920371738274696
29407,703-004-5396,1409.6195,5,2,3,1.190953001194466
2952,703-004-5382,6983.025,4,2,2,0.757561712741906
29641,703-004-5396,3388.0513,5,3,2,0.610307925737284
29734,703-004-5383,1409.5288,6,1,5,1.5376848252525173
29735,703-004-5382,4403.3276,3,2,1,0.47903776867381775
30071,703-004-5390,4041.0322,6,3,3,0.7054029151603405
30116,703-004-5396,4646.485,7,2,5,0.5875349864175854
30129,703-004-5382,1677.9983,2,0,2,0.27920371738274696
3026,703-004-5398,429.63922,5,3,2,1.0244231602397753
30339,703-004-5389,532.5574,3,1,2,0.7137477965917081
30388,703-004-5384,2586.7175,2,1,1,0.8482491143123027
30450,703-004-5394,962.9399,6,5,1,1.9812956757827238
30542,703-004-5392,4460.9146,5,1,4,0.3919322182760311
30563,703-004-5390,4980.9795,1,0,1,0.27920371738274696
30822,703-004-5386,5782.549,2,0,2,0.27920371738274696
31227,703-004-5380,7276.5312,4,1,3,0.8399446269049542
31679,703-004-5399,3416.1584,4,3,1,0.7887644736381473
31798,703-004-5395,7808.941,3,1,2,0.5368097037599591
31899,703-004-5387,4926.49,5,2,3,0.5762724451465256
3202,703-004-5396,4459.3857,4,3,1,3.094161904553208
32099,207-008-2399,593.8828,3,2,1,0.5323613689292536
32530,703-004-5380,1082.3506,4,1,3,0.3187575773453028
32594,703-004-5386,172.33432,5,4,1,1.586361998223274
32678,703-004-5380,7971.338,3,3,0,3.3843826588572252
32693,703-004-5396,785.4134,8,5,3,1.947972503915685
32811,703-004-5381,1575.563,4,3,1,1.0199405329083606
329,703-004-5392,8345.709,3,2,1,0.573224672812288
33621,703-004-5384,6033.7656,6,3,3,1.381761110057562
3366,703-004-5396,2469.2153,1,1,0,0.5131226778349266
3420,703-004-5387,3334.102,5,4,1,2.726291294333318
34344,703-004-5385,9774.606,3,1,2,0.32666834933781397
34723,207-008-2399,4369.9443,3,1,2,0.9569753546933524
35377,703-004-5390,6047.569,5,5,0,2.114260578130515
35497,703-004-5393,830.9186,8,1,7,0.35831143730785864
35507,703-004-5398,4922.8687,6,3,3,1.7147235232161273
35720,207-008-2399,5165.26,2,2,0,0.6065119085728964
3579,703-004-5395,9211.706,5,3,2,0.863881344707042
35945,703-004-5383,418.4973,2,2,0,0.7259596214273196
36285,703-004-5384,9514.345,5,3,2,0.8075127492970873
36342,703-004-5398,3371.8335,6,2,4,1.079685249219651
36456,703-004-5392,8369.068,2,2,0,1.6200691496747053
36540,703-004-5398,1955.4353,3,1,2,0.43697121546826795
37032,703-004-5389,209.741,6,5,1,1.220035037336731
3757,703-004-5393,2643.6968,8,3,5,4.853701486200839
37871,703-004-5394,3700.1587,2,1,1,0.37367312211809955
37991,703-004-5387,4493.0933,2,2,0,1.0878750553951082
38016,703-004-5390,9721.872,5,2,3,0.5911118604081
38616,703-004-5386,1549.1248,5,0,5,0.27920371738274696
39001,703-004-5383,461.65942,2,1,1,1.2708367499951743
39104,703-004-5389,8206.195,1,0,1,0.27920371738274696
39143,703-004-5399,4051.2097,2,1,1,0.9410955337348699
39404,703-004-5388,2369.587,1,0,1,0.27920371738274696
39638,207-008-2398,3155.3555,2,2,0,0.9366172984685007
39784,703-004-5399,8696.073,5,3,2,2.0124696332572536
39836,703-004-5388,4751.509,8,4,4,1.4687635689888467
3995,703-004-5381,657.1847,4,1,3,0.35181739393494377
40181,703-004-5399,2320.3533,3,1,2,0.47064538426188224
40222,703-004-5381,3091.3264,4,0,4,0.27920371738274696
40328,703-004-5391,1426.825,1,0,1,0.27920371738274696
40492,703-004-5389,5988.291,6,2,4,0.5165268771580819
40693,703-004-5380,4499.007,6,5,1,1.6220828257602553
40712,703-004-5382,7120.1606,2,1,1,0.3461522107877409
40814,703-004-5394,6660.3887,6,2,4,0.906960227505719
41678,703-004-5398,7941.106,7,3,4,1.6644477166775895
4173,207-008-2398,2424.888,4,1,3,0.708751665693301
4187,703-004-5382,6844.8228,5,3,2,2.0659053432217513
42180,703-004-5398,4953.3867,3,1,2,1.0557909160669987
42719,703-004-5382,2075.2412,1,1,0,0.33853450732658075
42754,703-004-5380,5307.604,5,3,2,1.285398907232266
42922,703-004-5395,6399.595,3,1,2,0.3637500930527101
42994,703-004-5385,3106.4707,4,2,2,0.7673808382655648
43125,703-004-5392,3015.9385,5,3,2,1.101308450732268
43525,703-004-5393,6323.245,4,2,2,1.2983759618866233
43929,703-004-5392,5239.5693,4,4,0,0.9998457064259367
43942,703-004-5381,9284.725,"","","",0.27920371738274696
44001,703-004-5393,4329.755,4,1,3,0.4346846191457371
44121,703-004-5393,1494.8696,4,2,2,1.621614731442503
44134,207-008-2399,550.2039,1,1,0,0.5701047847949285
44244,703-004-5385,6097.833,6,4,2,3.6302378525426557
44746,703-004-5387,7462.0117,3,1,2,0.35831143730785864
44846,207-008-2399,2416.7686,3,1,2,0.5413974103728796
44858,703-004-5392,1616.5101,1,1,0,0.6837637975678114
44864,703-004-5386,6433.496,1,0,1,0.27920371738274696
452,207-008-2398,4317.1895,3,2,1,1.2437978186668677
45574,703-004-5386,3721.86,5,3,2,0.8831445278168585
45826,703-004-5398,3205.6309,5,4,1,2.653840538185382
46082,703-004-5385,7333.3364,1,0,1,0.27920371738274696
46212,703-004-5393,7333.5054,3,2,1,1.2192160342484493
4635,703-004-5393,887.49347,4,1,3,0.4230808829965438
46369,703-004-5398,8725.784,3,2,1,0.6604040427718787
46379,703-004-5383,5593.196,7,3,4,1.477316196158411
4677,703-004-5392,6287.907,4,2,2,1.989991069233352
47150,207-008-2398,1692.3254,5,1,4,0.5224056911095566
47203,703-004-5394,9280.396,5,3,2,1.0474235215640202
47257,703-004-5394,5294.521,4,3,1,2.1374559803109316
47280,703-004-5386,3514.1392,5,4,1,1.4259304362862892
47662,703-004-5392,5592.787,4,3,1,1.2215047161555317
47876,703-004-5385,2012.5717,4,0,4,0.27920371738274696
48039,703-004-5397,1644.3002,5,1,4,0.539003081316987
48392,703-004-5394,9266.26,7,3,4,2.107008626297627
48674,703-004-5386,2061.4702,5,3,2,1.5602785980035705
4885,703-004-5382,8125.9004,3,1,2,0.5853028168949431
48856,703-004-5395,8481.43,4,1,3,0.5617944664858461
4899,703-004-5389,7884.297,3,1,2,0.7182515629671166
4935,703-004-5386,6662.0444,1,0,1,0.27920371738274696
49483,703-004-5399,4677.3525,4,1,3,0.33853450732658075
49592,703-004-5390,9069.375,5,4,1,1.6843914897923515
4964,703-004-5398,5463.4536,3,2,1,1.3067366911876745
4967,207-008-2399,3000.6838,5,5,0,2.261632013657509
49686,703-004-5396,8153.328,8,4,4,0.970707649217601
4970,207-008-2398,7445.416,4,3,1,1.1943006460055727
537,703-004-5382,8262.758,4,3,1,1.1593346591764164
5512,703-004-5387,6923.65,2,1,1,0.7790615248742543
5577,703-004-5382,5836.614,2,1,1,0.35831143730785864
5658,703-004-5383,6030.619,4,2,2,0.9667509864735555
5996,703-004-5392,5346.3394,4,3,1,2.2785881235952785
6086,703-004-5392,805.6581,2,0,2,0.27920371738274696
6164,703-004-5390,8402.744,3,2,1,0.9550868632332353
6206,703-004-5391,4278.06,5,1,4,0.5466837862989621
6418,703-004-5384,2310.8982,5,2,3,0.5482919415670103
7305,703-004-5396,3320.1587,4,0,4,0.27920371738274696
7488,703-004-5396,5613.889,2,1,1,1.725843158754719
7628,703-004-5388,21.075607,5,0,5,0.27920371738274696
7690,703-004-5384,3411.2458,4,0,4,0.27920371738274696
7728,207-008-2398,8266.921,4,3,1,1.0781528612878455
7816,703-004-5395,6642.672,5,2,3,1.0875358996885203
8011,207-008-2399,449.44107,7,2,5,0.4842183833447094
8185,703-004-5393,7071.566,1,0,1,0.27920371738274696
8322,703-004-5383,5064.9683,8,4,4,1.454631941059797
8503,207-008-2398,686.031,6,3,3,1.346149663946592
8687,703-004-5388,7816.5176,4,3,1,0.5957224945497769
8706,703-004-5388,5903.41,4,3,1,1.479914364507516
8998,703-004-5387,4047.3801,3,1,2,0.7681112466579343
9772,703-004-5398,2226.9917,4,3,1,0.7013027528492076
9906,703-004-5393,1543.2024,5,4,1,1.343036534871087
10062,207-008-2399,3243.701,4,2,2,1.2970194099497154
10230,207-008-2399,9087.991,5,3,2,1.4207653289171576
10991,703-004-5391,9219.297,4,3,1,1.9685493456901422
1110,703-004-5380,4694.1304,3,2,1,1.550996967242413
11377,703-004-5396,5062.606,2,1,1,0.36446910499104274
11439,703-004-5387,7127.7456,6,5,1,1.8800821708261122
1147,703-004-5399,4091.4363,1,1,0,0.5290650730138073
11531,703-004-5397,3461.513,5,3,2,1.444267979711959
11629,703-004-5382,9651.926,1,0,1,0.27920371738274696
11635,703-004-5381,8402.679,2,1,1,1.1084775225096475
11658,703-004-5390,2734.748,4,2,2,0.5988466167811642
1167,703-004-5386,3311.1829,6,3,3,0.71120077841426
11972,703-004-5381,8441.347,1,0,1,0.27920371738274696
12265,703-004-5394,9398.044,8,3,5,1.2063008466369212
12362,703-004-5399,5974.302,8,5,3,1.3959979448360293
12484,703-004-5384,5461.163,5,2,3,0.7108190464205866
12620,703-004-5392,6435.8325,2,2,0,0.8150347038003344
12721,207-008-2398,6689.4375,5,1,4,0.6187987219148143
12772,207-008-2399,7628.4404,5,2,3,0.9223298041387245
13385,207-008-2399,7719.953,4,3,1,1.0515322180277291
13467,703-004-5383,271.3591,3,2,1,0.9652385309655841
13701,703-004-5382,8568.916,4,3,1,2.4205003185761793
13771,703-004-5394,1569.4553,2,1,1,0.3949395738931663
1378,703-004-5384,9023.074,9,6,3,2.2641770974872255
13795,703-004-5396,507.8709,7,3,4,0.8000135006143582
14061,703-004-5382,8569.472,6,5,1,1.7857231626860055
14491,703-004-5380,8626.195,6,4,2,1.231176097771585
14609,703-004-5380,9489.424,5,1,4,0.3860872871481011
14778,703-004-5380,7522.963,1,1,0,0.3978652972704144
15115,703-004-5394,5730.7583,5,1,4,0.32666834933781397
15472,703-004-5393,3140.7053,5,2,3,0.5975906711985753
15567,703-004-5387,2473.0981,6,4,2,2.1460963059691465
16087,703-004-5388,2725.7996,1,0,1,0.27920371738274696
16122,703-004-5399,2522.0442,8,3,5,2.081596758199045
16309,703-004-5386,124.154686,4,1,3,0.3271627725873459
16725,703-004-5384,1415.2957,3,2,1,0.6660152442193289
17102,703-004-5388,9471.032,6,4,2,0.8593716836462906
17149,703-004-5391,1591.7152,3,1,2,0.5495150896474871
17391,703-004-5392,50.28129,3,3,0,1.569750081281245
17523,703-004-5393,7188.7603,3,0,3,0.27920371738274696
177,703-004-5386,3195.014,6,2,4,1.9146019009121855
17799,703-004-5381,8304.61,2,1,1,0.49458890101227637
17861,703-004-5387,9695.737,5,1,4,0.4951112811947613
17907,703-004-5397,4836.0522,3,0,3,0.27920371738274696
17935,207-008-2398,9634.56,3,2,1,0.886326677737208
18335,703-004-5396,1643.477,4,3,1,0.7874910222253907
18432,703-004-5385,3101.3113,2,0,2,0.27920371738274696
18625,207-008-2398,9696.01,5,2,3,1.2407090312473932
1871,703-004-5397,6338.6875,2,0,2,0.27920371738274696
18764,703-004-5392,3260.0361,2,1,1,0.3511274674921594
18853,703-004-5393,1605.2407,4,0,4,0.27920371738274696
18883,703-004-5389,5528.21,6,5,1,0.8793353289264593
18901,703-004-5395,2500.4292,2,0,2,0.27920371738274696
18967,703-004-5396,699.30316,7,3,4,1.250050047204604
19073,703-004-5385,2013.7012,4,2,2,0.6488666108109127
19092,703-004-5381,2279.1929,5,4,1,2.3532295254221816
19124,703-004-5392,65.290924,5,3,2,1.232643137873175
19227,703-004-5397,2017.7263,8,3,5,0.49378340767961226
1935,207-008-2398,4352.867,4,4,0,2.8794930782694426
19380,703-004-5382,5449.412,6,1,5,0.44632266814491545
19428,703-004-5395,3304.569,6,3,3,0.6492779909874524
19508,703-004-5382,7814.4365,6,2,4,1.036498328695102
19584,703-004-5383,1138.9136,3,1,2,0.33853450732658075
19895,703-004-5397,9025.523,3,1,2,0.7433560183733344
19931,703-004-5381,4630.316,4,2,2,0.5964608009364708
19982,703-004-5390,4340.2505,5,1,4,0.663527005667078
20093,703-004-5387,1427.6934,4,2,2,0.6630409798405559
20231,703-004-5392,8602.984,4,2,2,0.49864373378123106
20744,703-004-5384,9494.748,3,1,2,0.47782720510460414
20807,703-004-5384,1186.878,3,0,3,0.27920371738274696
21294,703-004-5396,8231.051,2,0,2,0.27920371738274696
21531,703-004-5397,9173.215,3,2,1,0.7428741119677064
21545,703-004-5382,5861.4604,3,2,1,1.1761091760651
21678,703-004-5399,5863.3745,1,0,1,0.27920371738274696
22103,703-004-5395,817.2494,3,2,1,0.9047232915280907
22155,703-004-5398,1767.1323,6,5,1,1.1316266298761501
22167,207-008-2399,1038.3397,5,1,4,0.38278921513952113
2217,703-004-5384,2811.1064,3,0,3,0.27920371738274696
22242,703-004-5399,4050.479,6,3,3,0.7367527017930435
22274,703-004-5388,9719.3955,2,1,1,0.7572076305294254
22503,703-004-5399,2119.4988,3,2,1,0.47335908525164905
22688,703-004-5386,1524.9437,4,3,1,1.0863394130894028
22864,703-004-5396,2266.156,8,2,6,0.524602456900437
23037,703-004-5388,1983.1174,6,3,3,1.135369636566469
2304,703-004-5397,5224.7124,2,1,1,0.5167959308482185
23180,703-004-5398,8172.531,8,5,3,1.4120868668758813
23531,703-004-5385,6302.1885,4,2,2,1.6222027416827611
23643,703-004-5389,6579.7036,7,3,4,0.6772113155250766
24374,703-004-5387,2307.0222,5,3,2,1.8828850462147264
24627,703-004-5395,9540.911,5,4,1,1.7915401810284648
24666,703-004-5397,9875.27,3,2,1,0.592504075790629
24674,703-004-5390,6528.602,5,3,2,0.9680777058015518
2494,703-004-5395,6703.012,"","","",0.27920371738274696
25020,703-004-5382,9879.304,4,2,2,1.8854786330849458
25322,703-004-5389,1051.0612,4,1,3,0.6425754797143172
25408,703-004-5393,6127.5,1,1,0,0.5632075835814672
25522,207-008-2399,5911.237,4,1,3,0.5979039895645881
25542,703-004-5394,8298.329,2,1,1,0.3187575773453028
25595,703-004-5392,511.90616,6,4,2,1.205078635213229
25957,703-004-5398,1602.1472,3,1,2,0.4314860782385869
26071,703-004-5396,4741.4785,5,2,3,1.7805144223101401
26286,703-004-5395,1460.6964,6,3,3,0.8659992031774165
26390,703-004-5386,5741.0664,8,5,3,2.24111223858175
26568,703-004-5382,5420.0923,6,4,2,0.7105435045069135
26622,703-004-5383,2504.0298,3,1,2,0.4364495887819955
2687,703-004-5381,800.4987,2,1,1,0.5907802886392215
27059,703-004-5387,433.23755,"","","",0.27920371738274696
27251,703-004-5396,6907.211,6,2,4,1.1017388728771216
27375,703-004-5390,9695.136,7,4,3,0.6680695087292313
27438,703-004-5392,3277.499,6,2,4,0.6460479044642333
27829,207-008-2399,3700.9023,5,3,2,3.3242116106676534
2787,207-008-2398,5780.381,4,1,3,0.3979935664456396
2797,703-004-5380,5807.1846,5,3,2,1.948782752422091
28016,703-004-5388,2599.4993,"","","",0.27920371738274696
2809,703-004-5395,4439.9683,2,2,0,1.006369774659105
28593,703-004-5386,6256.327,5,2,3,0.8380429351978109
28777,703-004-5386,4234.246,4,2,2,0.9515069753158846
28828,703-004-5397,2069.0293,4,3,1,0.7763965729424013
28854,703-004-5392,9870.519,"","","",0.27920371738274696
28875,703-004-5386,6809.4375,3,1,2,0.54638002100234
28978,703-004-5385,3007.0728,3,2,1,1.2020299907500485
29084,703-004-5384,1230.8502,3,2,1,0.5127352563016938
29338,703-004-5390,4769.9897,1,0,1,0.27920371738274696
29737,703-004-5396,8059.933,6,3,3,2.179299315768643
30423,703-004-5395,657.7921,5,3,2,0.8946768681941456
30498,703-004-5383,1412.4865,3,3,0,0.8630552496830864
30590,703-004-5394,6496.6904,3,2,1,0.6512284218812154
30634,703-004-5380,5689.9585,2,1,1,0.4180377658513179
30814,703-004-5397,2268.7073,3,2,1,1.4280844367097685
31066,703-004-5393,9834.272,6,4,2,1.811923764348864
31071,703-004-5397,1328.9678,2,1,1,0.4853623584576199
31114,703-004-5398,913.85486,4,2,2,0.6997749213407551
31314,703-004-5390,2262.752,5,2,3,1.2620353148979615
31318,703-004-5387,7392.262,2,1,1,0.3978652972704144
31451,207-008-2399,3198.3237,1,1,0,0.6347906910133321
31687,703-004-5392,7769.9194,4,1,3,0.9938847453566007
31714,703-004-5395,757.1119,6,1,5,0.5607557369633541
32049,703-004-5389,8728.029,2,2,0,0.8654702141848272
32163,703-004-5389,6566.2188,4,1,3,0.35831143730785864
32295,703-004-5398,8759.057,4,2,2,0.49138192332474284
32384,703-004-5390,3025.9473,5,1,4,0.32666834933781397
32504,703-004-5399,8463.763,8,3,5,1.2956775299791126
32740,703-004-5398,3603.7112,6,4,2,2.1593976955123244
32997,207-008-2399,2740.3032,1,0,1,0.27920371738274696
34154,703-004-5383,938.74097,6,2,4,2.1091140929211067
34169,703-004-5386,1063.8207,3,1,2,0.35831143730785864
34278,703-004-5398,5175.504,1,0,1,0.27920371738274696
344,703-004-5384,5282.737,2,0,2,0.27920371738274696
34432,703-004-5383,4522.1074,11,7,4,2.2764870618204487
34492,703-004-5380,9211.775,6,4,2,1.2128145059413578
34496,703-004-5391,4525.4443,5,2,3,0.7126942260256772
34698,703-004-5397,3505.3677,6,4,2,1.4722333048548435
35235,703-004-5383,1025.8269,2,1,1,0.4172227881935576
35264,703-004-5383,8268.735,8,3,5,1.125395861820845
3535,703-004-5387,3587.7305,7,2,5,0.6293795194889358
35825,703-004-5387,5906.3984,6,3,3,1.7315720732130397
36074,207-008-2398,6134.1924,4,3,1,3.4218806142751084
36180,703-004-5394,294.0458,4,1,3,0.4037481699872542
36276,703-004-5399,4163.6074,5,3,2,1.9383528157776149
36593,703-004-5384,9473.74,5,1,4,0.4068442997924077
36736,703-004-5382,1541.0322,5,4,1,1.4135650405656248
36902,207-008-2399,3035.3933,4,2,2,0.689155952787384
37019,703-004-5392,4736.5654,6,4,2,2.0277520165951453
37198,703-004-5383,8787.856,5,2,3,1.128117778016524
37329,703-004-5396,6966.977,6,3,3,1.7865233349088185
37334,703-004-5387,9669.602,3,3,0,0.9189603353093176
37420,703-004-5395,7378.4204,5,2,3,1.1553400924605364
37604,703-004-5393,1129.5844,4,2,2,0.5280381786161326
37978,703-004-5396,7199.5547,2,2,0,1.0288965493984028
38304,703-004-5394,3570.3909,4,3,1,1.302822193741844
38639,703-004-5395,9513.529,4,2,2,0.6903831746702374
38830,703-004-5390,7077.1396,4,0,4,0.27920371738274696
38881,703-004-5380,3176.1794,5,3,2,1.1713418593094382
38884,703-004-5380,3496.537,5,3,2,1.6483750375562944
3910,703-004-5384,8778.666,1,0,1,0.27920371738274696
39202,703-004-5395,1580.7158,3,1,2,1.0702128750509932
39267,703-004-5383,7711.665,8,4,4,1.8900836608041505
39374,703-004-5397,2858.9653,3,2,1,0.9685796754166229
40002,703-004-5391,1158.6458,5,2,3,1.9091103182972216
40475,703-004-5398,3872.534,4,1,3,1.0143797185142356
40730,703-004-5386,2905.4028,1,0,1,0.27920371738274696
4075,703-004-5381,3789.9785,5,3,2,0.8443747123693071
4099,703-004-5391,6795.1035,7,3,4,1.0382125446025532
41086,703-004-5381,9258.982,6,3,3,0.7129769939382037
41268,703-004-5384,1134.1155,2,2,0,0.7027697462340493
41548,703-004-5391,5564.682,2,2,0,2.182670745804686
41688,703-004-5389,1548.605,3,0,3,0.27920371738274696
41807,703-004-5384,4413.1924,4,3,1,1.8025561077852406
42079,703-004-5397,9827.939,5,4,1,2.2434544532701897
42197,703-004-5387,7050.891,6,2,4,0.7566473546759583
42371,703-004-5398,1856.8057,6,3,3,1.2268554748678842
42623,703-004-5391,8532.518,4,2,2,0.49008721395383165
42789,703-004-5392,765.1895,5,3,2,1.1877436510125132
42821,703-004-5384,748.45435,4,2,2,0.6358994906582592
43024,207-008-2399,3852.5068,4,2,2,0.6158312759882215
4307,703-004-5395,2629.5894,2,2,0,0.7782016373233693
4318,207-008-2399,3334.7566,6,3,3,0.9332063024864186
4347,703-004-5390,2569.6248,1,0,1,0.27920371738274696
43736,703-004-5381,8483.419,3,3,0,1.1572713097100913
4374,703-004-5382,7970.422,3,2,1,0.6180484510619751
4384,703-004-5382,4828.266,5,3,2,1.8501869221167504
43847,703-004-5399,3263.0552,7,4,3,1.8399738425114933
43905,703-004-5397,9929.292,2,1,1,0.4434539529854838
44146,703-004-5391,7269.035,4,2,2,0.9779052761462916
44316,207-008-2398,166.48412,8,4,4,1.2580441282672539
44424,703-004-5396,580.1099,3,1,2,0.47338337616289383
44483,703-004-5393,6132.2676,1,1,0,0.36437417879943174
4459,703-004-5395,5132.918,5,1,4,2.0130443333336587
44652,703-004-5399,9946.942,2,2,0,0.5651078402076442
45055,207-008-2399,3198.0186,1,0,1,0.27920371738274696
45721,703-004-5396,6438.5005,2,1,1,0.5095213549936232
45892,703-004-5389,5922.1685,5,2,3,0.6964969399877108
45947,703-004-5385,648.84064,1,0,1,0.27920371738274696
45998,703-004-5393,9222.438,4,3,1,2.1689580541833973
46038,703-004-5389,9720.439,3,0,3,0.27920371738274696
46137,703-004-5390,516.4725,5,4,1,1.2015670606801532
46325,703-004-5393,2377.4934,3,1,2,0.3978652972704144
4666,703-004-5399,9947.738,3,1,2,0.3919550190720685
46729,703-004-5388,2513.7974,2,1,1,0.6046938584729626
4680,703-004-5385,3795.498,5,2,3,1.175728266074957
46801,703-004-5397,9049.899,3,0,3,0.27920371738274696
46965,703-004-5386,7217.1084,4,3,1,1.0646989122123272
47043,207-008-2399,4692.7363,6,3,3,0.7631404735392678
47059,703-004-5386,2454.1313,"","","",0.27920371738274696
47077,703-004-5381,4873.2524,5,4,1,4.187381482932136
47656,703-004-5388,4824.3867,5,2,3,0.724548563421488
48236,703-004-5385,6008.5366,1,1,0,1.2794606843559442
48888,703-004-5395,1532.0701,2,1,1,0.8921915623741834
49176,703-004-5390,9963.164,3,0,3,0.27920371738274696
49317,703-004-5387,8573.666,2,2,0,1.0044447075086045
49697,703-004-5389,5587.4775,5,2,3,0.8334331125896831
49834,703-004-5392,392.09604,4,3,1,1.4229609340581022
49950,703-004-5380,3485.5913,4,2,2,0.714810574005874
5203,703-004-5385,678.7622,1,1,0,0.6816324220399136
5277,703-004-5395,3335.895,3,2,1,1.079454659565844
5312,703-004-5390,9297.986,4,3,1,0.8289829566859199
5314,207-008-2398,4619.4434,4,0,4,0.27920371738274696
5318,703-004-5386,880.0942,5,2,3,0.48603055345418683
5789,703-004-5384,7650.7217,6,1,5,0.5199147392564659
5838,703-004-5397,7707.6177,2,1,1,0.606926788342581
5860,703-004-5391,8944.726,5,0,5,0.27920371738274696
604,703-004-5389,6540.3237,1,1,0,1.0035495729989738
6083,703-004-5392,2772.6292,4,3,1,0.9682316088584988
6611,703-004-5388,1510.5015,4,2,2,0.7208042061531819
6637,703-004-5390,5840.4136,5,3,2,3.0404561081639465
6750,703-004-5396,5112.6904,2,1,1,0.3978652972704144
6762,703-004-5394,8163.5034,4,2,2,0.40753745208938325
678,703-004-5382,1454.8058,5,3,2,1.4441539055361723
6959,207-008-2399,3346.1536,5,3,2,0.856175123467986
7578,703-004-5393,6674.968,4,3,1,0.715602095543332
7931,207-008-2398,4253.8184,3,1,2,0.44045581975739195
8070,703-004-5398,4990.896,1,0,1,0.27920371738274696
8305,703-004-5391,3636.067,5,1,4,0.397380335702471
8723,703-004-5387,8305.393,4,3,1,1.6134061253310457
9020,703-004-5387,7749.5605,3,2,1,0.45488286726845517
9069,703-004-5397,7442.951,4,2,2,0.8802676371923353
9164,703-004-5386,4100.9014,4,3,1,0.7719682824924798
9172,703-004-5384,380.29193,7,4,3,3.717277212803442
9179,703-004-5397,2640.5562,2,1,1,0.9379566573993611
9243,703-004-5399,1943.8767,2,1,1,1.479682624439129
9632,207-008-2398,6577.2144,3,2,1,1.5415353662681859
9795,703-004-5391,8742.834,4,4,0,2.653556161811685
9848,703-004-5397,5884.2573,1,1,0,0.5579410996735074
1002,703-004-5392,6125.389,2,1,1,0.5615281683631441
10208,703-004-5390,2578.017,4,1,3,0.35831143730785864
10375,703-004-5395,5680.604,6,2,4,1.2038576969858348
10426,703-004-5397,360.6498,5,3,2,1.2288721760957269
10704,207-008-2399,3782.357,6,4,2,1.0143188403462984
10876,703-004-5396,2598.8352,5,2,3,0.7903665181918905
1125,703-004-5386,4410.8804,3,1,2,0.3978652972704144
1154,703-004-5398,2452.286,3,1,2,0.32666834933781397
11546,703-004-5384,8722.824,4,1,3,1.0227330602801423
11853,703-004-5384,1628.4138,7,3,4,1.4211699623946716
12046,703-004-5388,9163.952,6,2,4,0.6183699469429879
12445,703-004-5380,9040.244,7,2,5,1.610397700105691
12551,703-004-5380,3086.7178,5,1,4,0.32666834933781397
12660,703-004-5380,8846.82,5,2,3,1.0357764735679262
13103,703-004-5383,6114.0894,6,4,2,1.6450658258730186
13249,207-008-2398,7377.059,4,3,1,1.8617873313465059
13413,703-004-5392,8611.365,4,3,1,1.120107788825942
13962,703-004-5397,6065.9756,2,0,2,0.27920371738274696
14434,703-004-5380,7976.0996,6,3,3,3.469453419147683
14487,703-004-5398,3488.7488,2,0,2,0.27920371738274696
14537,703-004-5397,8176.1245,8,6,2,3.1262561690768687
15017,703-004-5383,9273.985,2,1,1,0.6476289414880726
1522,703-004-5394,9393.786,4,2,2,0.7592772287293235
15352,703-004-5382,4819.3525,3,1,2,1.4223115246180804
15359,703-004-5382,658.7273,2,1,1,0.757674275997707
15606,703-004-5388,8828.162,2,1,1,0.3670132864996209
15651,703-004-5394,9689.654,5,0,5,0.27920371738274696
15716,703-004-5386,9446.544,6,3,3,3.384561746489526
15758,703-004-5392,2199.6426,1,0,1,0.27920371738274696
16205,703-004-5397,9397.414,1,1,0,0.6584649502945389
16901,207-008-2399,2226.317,4,3,1,0.6083501836608065
17011,703-004-5398,6233.1533,4,0,4,0.27920371738274696
17459,703-004-5392,215.28482,1,1,0,0.8485532865116997
17765,703-004-5381,5399.0083,5,2,3,0.5636263276827919
17806,703-004-5384,4587.303,4,3,1,3.0077648078016095
1781,703-004-5385,4303.5845,4,3,1,1.3046220579657204
18168,703-004-5395,49.101112,4,2,2,1.1249866751101951
18626,703-004-5390,4707.017,2,2,0,0.9215188999969365
18817,703-004-5382,4894.312,5,3,2,2.570259303382841
19379,703-004-5380,3594.393,3,1,2,0.859583937015681
196,703-004-5392,1554.7395,5,2,3,0.4767331110101721
19683,703-004-5384,4408.6743,3,1,2,0.7583451710247853
19775,703-004-5380,4541.7495,8,6,2,1.2644699556773709
2,703-004-5395,7926.8657,5,0,5,0.27920371738274696
20014,703-004-5394,154.80042,2,0,2,0.27920371738274696
20153,703-004-5393,7263.3096,3,2,1,1.7240432662338534
20286,207-008-2398,9725.613,10,9,1,4.152602635068587
20353,703-004-5393,5720.5903,7,4,3,1.2635500608349954
20465,703-004-5384,533.34595,4,1,3,0.6792956671385524
20629,703-004-5390,7501.366,2,0,2,0.27920371738274696
21079,703-004-5398,4514.551,7,5,2,2.6262014453383165
21199,703-004-5397,4036.2632,4,1,3,0.8898707935612529
21257,703-004-5392,9509.363,6,2,4,1.553944001639162
21276,703-004-5383,3359.844,5,4,1,1.0539417654694565
21414,703-004-5398,9259.804,8,3,5,1.8401598427846069
2153,703-004-5380,3646.987,3,0,3,0.27920371738274696
21650,703-004-5384,5974.497,6,4,2,0.6444636418983402
21688,703-004-5387,4210.2607,2,0,2,0.27920371738274696
21760,703-004-5393,8566.747,7,3,4,1.5459777916271282
21776,703-004-5381,6472.3228,1,1,0,0.35831143730785864
21844,703-004-5391,9953.549,3,3,0,1.3931068327620713
21874,703-004-5381,1504.6638,4,3,1,2.1165833350139205
21883,703-004-5389,7663.5522,3,2,1,1.6110654093691459
2194,207-008-2399,7147.558,2,0,2,0.27920371738274696
22035,703-004-5382,9889.132,5,2,3,1.4669070106017101
22055,703-004-5384,5230.76,4,1,3,0.41467568775450064
22317,703-004-5380,316.512,3,1,2,0.5179366610506716
22715,703-004-5389,3137.6665,3,1,2,0.40400271474279525
22812,703-004-5387,8281.485,7,2,5,1.1048907808948611
23317,703-004-5392,4542.2207,1,0,1,0.27920371738274696
23495,703-004-5388,3545.5525,2,0,2,0.27920371738274696
23520,703-004-5389,8365.472,6,3,3,1.291826170798349
23702,703-004-5393,6325.497,2,1,1,0.7288700387354473
23885,703-004-5381,1961.7092,3,1,2,0.626027599653786
24748,703-004-5393,9202.418,2,0,2,0.27920371738274696
24810,703-004-5396,8284.184,3,1,2,0.5966865053449779
24820,703-004-5382,5439.3765,9,4,5,0.8244211779929708
25435,703-004-5398,9547.611,6,4,2,1.2848141485199178
25437,703-004-5391,7388.5347,6,4,2,1.730337114635048
25707,703-004-5384,3504.9558,2,1,1,0.35831143730785864
25770,703-004-5388,1023.1352,5,2,3,0.7162768231297948
25794,703-004-5384,6902.0293,2,1,1,0.3978652972704144
25958,703-004-5397,414.49844,8,4,4,2.3219100850730627
26535,703-004-5381,5537.141,6,4,2,3.639872088707035
2655,703-004-5395,8823.041,"","","",0.27920371738274696
26554,703-004-5393,45.263172,2,1,1,0.7265547199598705
26724,703-004-5382,6114.7676,5,1,4,0.3976682078025698
26874,703-004-5399,900.93555,6,2,4,1.2163242147370688
26897,703-004-5387,313.38095,3,2,1,1.4372020422158507
2704,703-004-5396,563.16675,3,2,1,0.8776287241060428
27218,703-004-5389,1892.5804,4,4,0,1.8552005752503506
27347,703-004-5395,801.2396,2,1,1,0.7688641952067574
27426,703-004-5392,7638.8813,2,1,1,0.891029800554766
278,703-004-5397,4125.726,10,7,3,2.35748331017411
27979,703-004-5392,6394.4507,3,2,1,0.541989125149811
28101,703-004-5384,3693.6187,5,4,1,1.3670224952985615
28274,703-004-5395,8690.771,6,3,3,1.6981528316347443
28455,703-004-5392,1209.5142,3,2,1,0.7181366928448953
28606,207-008-2399,7032.8633,5,2,3,1.3717487620020135
28640,703-004-5389,7606.6177,7,2,5,0.9639120554954318
2905,703-004-5387,4288.921,2,2,0,0.6688092380139217
29107,703-004-5396,8359.82,6,4,2,0.8919880945850849
2911,703-004-5383,5052.437,3,3,0,0.9157132665031938
2937,207-008-2399,8836.599,4,3,1,0.6382597318679668
29378,703-004-5380,2161.7627,9,3,6,0.9844984828400704
29389,703-004-5384,8241.632,3,0,3,0.27920371738274696
2961,703-004-5391,6888.9814,9,3,6,0.736640317405876
29670,703-004-5390,8418.149,5,4,1,1.1344994275102591
29993,703-004-5381,1199.6764,7,5,2,2.515831134554718
30043,703-004-5382,2937.7068,2,1,1,0.5462293721999921
30044,703-004-5383,7379.7417,3,3,0,1.7038431083769017
3040,703-004-5389,3367.709,4,2,2,0.9092426178690404
30526,703-004-5396,3067.1113,4,2,2,0.6116425852599043
30545,703-004-5386,8479.666,2,0,2,0.27920371738274696
30707,703-004-5399,6874.217,2,1,1,0.639848283312572
30909,703-004-5393,7619.265,2,0,2,0.27920371738274696
30993,703-004-5387,6967.1772,3,1,2,1.9285670514965634
31129,703-004-5381,8253.538,3,0,3,0.27920371738274696
31502,703-004-5399,8094.9097,4,3,1,1.2495886229462791
31670,703-004-5390,1121.5431,6,3,3,1.4403049585169887
31794,703-004-5395,7315.6274,4,2,2,0.8503595392455087
32183,703-004-5380,3139.0703,4,1,3,0.44815638213530573
32715,703-004-5389,9303.377,4,2,2,1.0088479651481381
32716,703-004-5396,2465.456,5,3,2,1.5252535741395217
33051,703-004-5398,5197.6064,2,1,1,0.46079919664521224
33231,703-004-5381,4495.7065,1,1,0,0.46344261345415466
33430,703-004-5389,6824.0967,8,4,4,3.4066534334087293
337,703-004-5382,7994.99,4,3,1,1.267608847195508
3371,703-004-5395,8862.933,6,3,3,1.9045840814987263
33921,703-004-5398,7628.147,6,1,5,0.3807252912866403
34174,703-004-5399,7802.5366,2,0,2,0.27920371738274696
34256,207-008-2398,4595.302,5,2,3,0.6699040886168932
34357,207-008-2398,7416.0137,4,2,2,1.0453893455190482
34539,703-004-5382,7246.319,2,0,2,0.27920371738274696
3464,703-004-5393,4282.5083,2,1,1,0.3975356817707265
34810,703-004-5391,1471.1768,2,1,1,0.49638103051390076
34897,703-004-5397,4645.4443,5,2,3,0.4948071764781931
34942,703-004-5392,3923.6797,4,2,2,1.2922324357349961
34975,703-004-5380,1197.8108,4,1,3,0.7296410762748046
35039,207-008-2398,5827.598,9,8,1,3.4130143936101507
35092,703-004-5392,7400.7617,5,3,2,1.4176871244171194
35131,703-004-5398,6913.1553,4,4,0,0.9716243590480722
35257,703-004-5392,2657.5405,2,1,1,0.5944691913326433
35742,703-004-5394,3495.7505,6,2,4,1.2332002464814236
3594,703-004-5385,9368.479,4,2,2,1.834238657167354
3611,703-004-5390,7399.1133,6,3,3,1.2204632511779872
36206,703-004-5395,9833.488,3,1,2,0.7252068154341338
36493,703-004-5386,10.662675,7,5,2,4.297000630713417
36787,703-004-5387,8220.2705,3,2,1,0.5001701365651259
36967,703-004-5384,3886.307,3,1,2,0.4917931362750305
37081,703-004-5385,5241.6533,3,2,1,1.0875811720598003
37207,703-004-5391,468.08957,6,4,2,1.2638430440739092
37298,703-004-5399,4548.226,7,1,6,0.4045517605298771
37331,703-004-5391,7660.3433,6,1,5,0.4745053471519426
37429,703-004-5381,4483.858,3,2,1,0.4918830239291754
37540,703-004-5396,8053.371,2,0,2,0.27920371738274696
37606,703-004-5386,2926.5576,5,3,2,0.8374740296134512
37662,703-004-5382,5139.412,1,1,0,0.46460540415990065
37930,703-004-5394,9442.283,3,2,1,1.032068877305347
3796,703-004-5391,4810.4595,4,1,3,0.37512182779194486
38023,703-004-5393,8326.179,1,1,0,0.3187575773453028
38860,703-004-5398,515.67255,6,3,3,0.7156750906350045
38894,703-004-5390,1743.0634,5,2,3,1.7569320296215203
39060,703-004-5385,2890.7673,4,3,1,2.216031542246236
39082,703-004-5383,6097.201,6,2,4,1.473138825225169
39362,207-008-2399,7977.1357,1,0,1,0.27920371738274696
39414,703-004-5383,1250.0018,7,3,4,1.1729022616954323
39415,703-004-5389,776.67474,2,0,2,0.27920371738274696
39480,207-008-2399,854.8749,4,3,1,0.7809815258631406
39582,703-004-5382,859.2075,4,2,2,1.7374359430335058
39870,703-004-5387,5619.5015,5,3,2,0.7415770097549977
39871,703-004-5382,5384.246,7,1,6,0.4104730901334791
3989,703-004-5387,618.63007,"","","",0.27920371738274696
40005,703-004-5394,6068.873,2,2,0,0.9375610991298755
40153,703-004-5380,792.6583,4,2,2,1.0250528194883108
40240,703-004-5381,6374.8394,5,4,1,2.4511316731556123
40304,703-004-5398,1745.9131,2,1,1,0.3878083747187935
40470,703-004-5385,6706.5674,4,2,2,0.81727914497107
4057,703-004-5381,2277.2627,6,2,4,0.9725151792722855
40611,703-004-5386,4626.8555,4,1,3,1.1174560875245927
4072,703-004-5389,5192.496,3,1,2,1.1525611110548433
4097,703-004-5393,9815.324,6,4,2,2.087796818211573
41033,703-004-5396,9958.694,3,1,2,0.3571015074397575
41042,703-004-5389,8297.267,2,1,1,0.6640794648155299
41116,703-004-5385,8393.687,"","","",0.27920371738274696
41321,207-008-2398,8542.821,"","","",0.27920371738274696
41544,703-004-5395,1194.557,2,0,2,0.27920371738274696
41677,703-004-5394,2173.664,6,4,2,0.883377408760197
41858,703-004-5390,8722.12,4,3,1,1.0317736474534176
41907,703-004-5385,7698.421,2,1,1,0.5624866055750715
41929,703-004-5380,4984.5547,4,2,2,1.0806115492725898
42417,703-004-5387,3447.3848,3,1,2,0.8446305794218687
42426,703-004-5392,4777.5815,4,2,2,0.6414670206848845
42552,703-004-5385,3850.9822,5,3,2,1.780035774067287
42586,207-008-2398,9065.324,4,1,3,0.7077907108758094
42595,703-004-5385,5958.55,7,3,4,0.6599839479985256
42652,703-004-5380,8299.215,2,1,1,0.5671989049660108
43022,703-004-5396,1578.1533,2,1,1,0.4432533515774473
43023,703-004-5381,3167.2085,5,3,2,1.136209875690636
43061,703-004-5392,7771.4927,4,4,0,2.5653658468583203
43136,703-004-5392,1499.9467,8,1,7,0.41985471326294643
43391,703-004-5383,2808.3855,4,2,2,0.7277842693999125
43466,703-004-5383,2369.2769,"","","",0.27920371738274696
43969,703-004-5397,9248.74,5,2,3,0.7713397223579733
44099,703-004-5382,8716.219,4,3,1,1.1409487675025358
44170,703-004-5397,2984.087,7,2,5,1.7599324989813618
44559,703-004-5395,8581.107,7,3,4,1.5825677842073191
44574,207-008-2399,1165.8633,2,2,0,1.6634299256733385
44696,703-004-5395,5242.0366,6,5,1,1.730940331808929
44711,703-004-5393,2085.8586,2,2,0,0.5120243795820713
44816,207-008-2398,4604.451,2,1,1,0.5165268771580819
44875,703-004-5395,6715.4707,"","","",0.27920371738274696
44969,703-004-5382,5647.6934,2,1,1,0.5047148750231292
4566,703-004-5382,4595.428,6,3,3,2.0604836322711537
45752,703-004-5380,997.96295,5,2,3,0.6543345213092461
45813,703-004-5384,3628.7327,4,0,4,0.27920371738274696
45891,703-004-5394,9952.464,3,1,2,0.586101581770717
45965,703-004-5380,1240.6909,5,2,3,0.4822287363380507
460,703-004-5385,573.38116,3,1,2,0.6542322206366158
46276,703-004-5385,1928.0529,3,1,2,0.5865857956699647
46597,703-004-5398,3010.4326,2,1,1,0.4051036536435622
46628,703-004-5383,7111.6646,2,2,0,0.8486928896512613
46919,703-004-5390,3399.8591,5,4,1,1.8159695039483044
46939,703-004-5397,5171.353,5,1,4,0.45177166673878955
47408,703-004-5398,4297.424,4,1,3,0.354868535593512
48015,703-004-5396,3989.3513,5,2,3,0.7954438328321154
48479,703-004-5393,4941.7476,1,1,0,0.3978652972704144
48544,207-008-2399,7912.6084,2,0,2,0.27920371738274696
48676,703-004-5382,6920.4526,6,3,3,1.2589401835007505
48775,703-004-5393,4796.5176,2,1,1,0.649483613468786
48876,703-004-5387,2820.4626,4,3,1,1.2358521984439428
49161,703-004-5380,8252.544,8,3,5,3.2542071357646063
49525,703-004-5388,510.20264,1,0,1,0.27920371738274696
49806,703-004-5388,9072.196,5,2,3,1.8088597957090862
49882,703-004-5396,6909.8677,4,3,1,0.9038319892891474
49898,703-004-5392,5331.2285,4,4,0,0.9988564311613496
49951,703-004-5388,8950.008,4,4,0,4.057793217471317
5035,703-004-5392,5436.187,5,4,1,0.9973739788988535
5143,703-004-5380,562.68036,2,0,2,0.27920371738274696
5269,703-004-5385,4843.9604,4,1,3,0.4342142645275668
5292,703-004-5387,5726.6484,6,3,3,0.8963196409994497
5390,703-004-5389,4829.688,3,2,1,0.8668986362873453
5672,207-008-2399,3400.1904,2,2,0,0.8362303676653549
5864,703-004-5399,4475.0054,3,1,2,0.41113199460683936
6115,703-004-5394,6503.085,2,2,0,0.4993868711743077
6301,703-004-5389,6662.3813,6,4,2,1.1982754845447185
6340,207-008-2398,438.73132,2,1,1,0.33790541260146195
6912,703-004-5383,125.724075,2,1,1,0.5669580486103406
7084,703-004-5398,9006.263,3,2,1,0.671110859331303
7103,703-004-5394,8873.731,1,1,0,0.7901652649310998
7236,703-004-5386,8677.915,3,1,2,0.4256154614569312
7531,703-004-5395,6593.006,6,3,3,0.7098584541321838
7873,703-004-5394,7823.5405,3,2,1,0.9397675020829229
7886,703-004-5398,7558.658,7,4,3,2.6749998440021363
8022,703-004-5386,1815.8323,6,3,3,2.1524213612602225
8177,703-004-5382,9057.8,4,1,3,0.5531050507933297
8566,703-004-5393,9806.161,2,2,0,0.4770394216492393
9292,703-004-5398,1429.3253,4,3,1,1.0942561331401066
9479,703-004-5387,8734.157,4,1,3,0.42528473342939505
9559,703-004-5388,439.24512,5,2,3,0.9678357106932258
9824,703-004-5394,8649.068,5,2,3,0.770345457023478
9978,703-004-5394,9271.138,4,3,1,1.879536449074509
9994,703-004-5399,1037.7579,5,3,2,1.0511708848802659
10101,703-004-5383,4718.5596,4,3,1,1.025366956237991
10598,207-008-2398,5132.7505,3,1,2,0.3919322182760311
10751,703-004-5396,3088.8801,1,0,1,0.27920371738274696
10833,703-004-5386,9950.318,7,4,3,1.6100069401654278
10980,703-004-5395,4496.4854,3,2,1,0.6209653592998863
11411,703-004-5383,658.642,6,4,2,1.0608156417073753
11536,703-004-5380,410.5842,6,5,1,1.4472045236085354
11788,703-004-5390,6326.769,10,4,6,1.289886431612126
11892,703-004-5388,72.41845,4,3,1,1.7713092656887257
12020,703-004-5386,8075.5806,1,0,1,0.27920371738274696
12634,703-004-5395,6348.2754,3,1,2,0.552662453235308
12934,207-008-2398,1180.7263,3,1,2,0.7786101352409149
13738,703-004-5395,8686.312,3,3,0,2.15163798087224
13766,207-008-2398,7306.426,4,3,1,0.8145162826722813
13987,703-004-5393,5686.98,4,2,2,0.5597674864846476
14023,703-004-5391,8116.1177,3,3,0,0.8869988876636111
14153,703-004-5381,1824.1047,3,1,2,0.6663369790295475
14404,703-004-5382,4317.56,"","","",0.27920371738274696
14732,703-004-5382,496.17053,2,2,0,1.1490713908767944
14886,703-004-5380,7270.5947,3,2,1,3.387110207718982
14982,207-008-2399,2235.446,2,2,0,1.1181143727984617
15056,703-004-5395,4922.176,5,1,4,0.5317370068507926
1507,703-004-5388,9643.035,3,1,2,0.49201862967095666
15256,703-004-5389,4281.2524,1,1,0,0.4965144831330909
15764,703-004-5385,6728.478,2,2,0,0.8727751714192392
15792,703-004-5396,2943.0854,6,3,3,1.1903295917838093
15861,703-004-5390,880.7236,6,5,1,1.9107411043919438
15923,703-004-5384,1959.7256,2,2,0,1.1760042764654783
16021,703-004-5396,5937.6074,4,3,1,1.0938064381595043
1622,703-004-5385,6733.239,3,1,2,0.4266110649982019
16242,703-004-5384,9143.088,5,0,5,0.27920371738274696
16453,703-004-5399,1189.2628,3,0,3,0.27920371738274696
1680,703-004-5399,3097.0632,2,2,0,0.9049639185487439
16801,703-004-5395,7778.5117,4,1,3,0.593340838423263
170,703-004-5385,5666.69,2,2,0,0.6507593086869299
17113,207-008-2398,2228.3298,6,3,3,1.3328029204802234
17682,703-004-5395,7881.858,2,0,2,0.27920371738274696
17748,703-004-5397,1662.789,7,2,5,1.2944801883719887
17764,703-004-5391,9593.523,6,3,3,1.194711540536031
17792,703-004-5399,7075.38,7,4,3,1.4691352656437398
18604,703-004-5398,1490.7491,4,3,1,1.2913629693381523
18971,703-004-5380,2249.2104,5,4,1,1.4421771503235383
19135,703-004-5389,3135.3384,1,0,1,0.27920371738274696
19195,703-004-5388,4312.053,8,3,5,0.6472459597599126
19209,703-004-5388,8849.455,8,4,4,1.0401595120444218
1923,703-004-5385,9783.283,4,2,2,0.8142415763060645
19349,703-004-5389,9913.961,6,1,5,0.47100804972823196
19535,703-004-5387,9230.1,4,2,2,0.8139317989938931
1969,703-004-5383,9989.625,1,0,1,0.27920371738274696
19992,703-004-5385,5937.265,3,1,2,0.42067153792063455
20119,703-004-5398,1391.1152,4,1,3,0.6183778141298999
2023,703-004-5392,6447.527,6,5,1,1.1658632192381606
20398,703-004-5383,7540.8306,6,4,2,2.277651925102541
20416,703-004-5398,1049.372,2,2,0,0.46853490817814164
20612,703-004-5398,7073.8154,1,1,0,0.8292829355296474
20677,703-004-5397,9429.571,6,3,3,1.3851976518495976
20811,703-004-5390,7989.0894,8,6,2,1.697445946264162
21124,703-004-5393,600.1711,3,3,0,1.8791248935577558
21188,703-004-5390,4950.3726,"","","",0.27920371738274696
21358,703-004-5391,6857.1396,4,2,2,0.5162697770683252
21460,703-004-5384,8593.211,2,0,2,0.27920371738274696
21578,703-004-5396,2475.9358,14,5,9,1.9826124517420456
21620,703-004-5395,4753.782,4,2,2,0.6072166625383996
21953,703-004-5399,2817.384,2,1,1,0.35831143730785864
22700,703-004-5393,6109.8135,6,1,5,0.5731416167893638
22826,703-004-5393,1113.0596,1,0,1,0.27920371738274696
23309,703-004-5388,1988.6755,4,1,3,1.5809446328440246
23770,703-004-5397,7290.493,5,5,0,1.6564399923769662
23879,703-004-5399,7995.9287,4,3,1,0.8563814032867748
23887,703-004-5385,4343.8677,3,3,0,1.0415852242489811
24553,703-004-5380,6553.367,7,5,2,1.3889215292073624
24784,703-004-5385,1474.5879,5,1,4,1.3787778417830172
24816,703-004-5392,8718.822,6,2,4,1.728898713087699
24843,703-004-5382,3313.9385,9,3,6,0.9482074164540647
25184,703-004-5383,62.592625,5,1,4,0.8478649396000382
25282,703-004-5381,8038.4683,5,2,3,0.8002696936847966
25692,207-008-2399,5784.445,3,2,1,1.5981370253246778
25827,703-004-5389,3888.6763,5,2,3,1.9209395998184668
26272,703-004-5395,7608.73,8,5,3,1.79318454987179
26799,703-004-5389,1165.3423,6,3,3,0.9352616184815733
27233,703-004-5396,4419.1665,7,4,3,3.1701156736100224
27287,703-004-5387,7714.901,3,1,2,0.5949838950884268
27310,703-004-5393,556.6466,3,1,2,0.7215891585851393
27393,703-004-5389,4679.334,3,0,3,0.27920371738274696
27443,703-004-5396,2574.3396,3,3,0,2.4231397704303244
2771,703-004-5396,477.14532,3,1,2,0.4754578614847428
28031,703-004-5386,3539.088,4,1,3,0.48549803797219016
2813,703-004-5380,6838.1836,2,1,1,0.47837529576141335
28263,703-004-5392,1732.2886,4,0,4,0.27920371738274696
2836,703-004-5396,2738.5605,5,2,3,0.46620023003441924
28757,703-004-5389,7874.2266,6,5,1,1.4572744174199046
28810,703-004-5392,9885.049,3,2,1,0.7772449263358228
28855,703-004-5389,2130.81,5,1,4,0.43187914273255107
29009,703-004-5384,9754.365,2,0,2,0.27920371738274696
29051,703-004-5387,2901.1487,4,3,1,1.1973282749510672
29072,207-008-2399,8754.713,7,5,2,1.3297912452880873
29175,703-004-5392,5986.347,5,4,1,2.424335480712392
29315,703-004-5386,5853.294,2,2,0,1.5922285320654253
29342,703-004-5380,3305.192,10,3,7,1.0941347423278391
29460,703-004-5391,2471.8035,6,3,3,0.6166012330086577
29486,703-004-5381,3798.2065,3,1,2,0.3919322182760311
29498,703-004-5394,8222.852,3,1,2,0.8723009790352212
29509,703-004-5395,8884.868,3,2,1,1.5214354125325817
30168,703-004-5387,2631.5303,3,2,1,0.7701019515536913
30390,703-004-5393,3445.8118,6,3,3,1.2269737532103253
30820,703-004-5399,7145.5215,7,4,3,1.456081787878792
30853,703-004-5390,2464.6343,4,1,3,0.5602980266365367
31023,703-004-5389,6535.8857,2,1,1,0.35831143730785864
31187,703-004-5396,9421.35,2,0,2,0.27920371738274696
31343,703-004-5390,735.4927,5,3,2,1.0083747609174165
31392,703-004-5399,8021.7515,6,1,5,0.7377389277872219
31456,703-004-5382,1343.2109,4,3,1,0.8402258120121274
31748,703-004-5397,8211.661,3,1,2,0.7200738040032839
31933,703-004-5396,4352.994,2,2,0,0.6153230567732374
31939,703-004-5394,9055.804,3,1,2,1.0257851826428221
32035,703-004-5396,8858.792,6,5,1,1.9933924934305556
32314,703-004-5387,3276.0786,3,0,3,0.27920371738274696
3245,703-004-5399,9373.001,4,2,2,0.7079379100500888
32793,703-004-5380,7443.6387,3,0,3,0.27920371738274696
32890,703-004-5390,2385.2617,6,2,4,1.409622413832557
33136,703-004-5390,2720.114,3,1,2,1.3983522157518482
33768,207-008-2398,6327.4497,2,1,1,1.6466089175325436
33786,703-004-5386,7757.7217,5,2,3,0.9928880425885557
33982,703-004-5398,6755.9497,6,4,2,1.0426018262412078
34116,703-004-5390,234.24149,4,3,1,1.176163880434107
34144,703-004-5397,7437.1196,5,2,3,0.719130907477138
34212,703-004-5393,1307.1442,2,1,1,0.35831143730785864
34335,703-004-5394,5378.579,4,3,1,0.86703546121869
34396,703-004-5393,3920.3303,6,4,2,1.6937943669641744
34465,703-004-5396,1325.4076,3,1,2,0.5796538517925846
3455,703-004-5384,5238.1406,3,3,0,2.120865869647556
34551,703-004-5388,3360.1016,5,4,1,3.0238133744470526
35802,703-004-5398,437.04688,4,3,1,1.4077917597408303
35965,703-004-5390,9605.096,3,0,3,0.27920371738274696
36137,703-004-5390,8516.493,13,9,4,2.7525497368135565
36214,703-004-5383,9180.814,2,0,2,0.27920371738274696
36291,703-004-5381,1513.614,2,0,2,0.27920371738274696
37166,703-004-5381,7778.362,6,2,4,0.5184139808297121
37269,703-004-5381,3280.0686,4,0,4,0.27920371738274696
37780,703-004-5397,6478.6626,4,2,2,0.6033463912317995
38040,703-004-5380,8432.394,8,6,2,1.63223134588277
382,703-004-5387,6038.753,3,1,2,0.6879079830058733
38330,703-004-5386,4824.8804,6,3,3,2.0210533957331505
3857,703-004-5397,3234.9766,3,2,1,0.7538500369334169
38596,207-008-2399,6247.026,6,4,2,2.16572372225396
38820,703-004-5381,5835.4224,5,3,2,2.293502695465576
39266,207-008-2399,3873.1116,4,1,3,0.679362347962305
393,703-004-5391,6157.2285,4,3,1,1.1936289992444635
39300,207-008-2398,2032.0624,4,2,2,1.0439382063304838
39389,703-004-5393,6758.22,5,4,1,1.9972293980598415
39654,703-004-5388,3376.631,2,1,1,0.4850339021558253
39748,703-004-5399,6022.746,8,4,4,1.8517161333448389
39782,703-004-5383,3112.439,3,2,1,0.8823869740740332
39924,703-004-5389,5041.534,6,3,3,1.0761081734931222
39946,703-004-5392,9982.539,3,2,1,0.7318914649065374
40058,207-008-2399,1874.7961,4,1,3,0.5867842414867391
40227,703-004-5391,6534.748,5,4,1,3.6502177289823727
40343,703-004-5395,469.82468,4,2,2,0.5148277607596123
40520,703-004-5395,5329.906,4,2,2,0.6763373960890884
40546,703-004-5387,6182.056,6,4,2,1.095001152111736
40578,703-004-5382,888.3262,"","","",0.27920371738274696
40877,703-004-5388,6148.927,3,3,0,1.4149104934195689
40929,703-004-5391,7678.125,7,3,4,2.8956949962599814
4096,703-004-5392,8674.34,3,1,2,0.5915900235686967
41067,703-004-5390,6801.1133,3,2,1,0.7331358909063331
41302,207-008-2398,98.037125,3,1,2,1.070642676983733
41386,703-004-5391,3397.0208,3,0,3,0.27920371738274696
41633,703-004-5385,59.084892,6,4,2,1.1370893253290424
42177,703-004-5385,3037.728,3,3,0,0.9907215015109161
42215,703-004-5386,3267.9343,3,1,2,0.3807252912866403
42362,703-004-5386,2775.0713,4,2,2,0.5512189085002401
42506,703-004-5383,8596.202,3,1,2,0.5165268771580819
42533,703-004-5387,1591.9418,10,4,6,1.1792298962138308
42570,703-004-5388,8174.4204,1,0,1,0.27920371738274696
42654,703-004-5395,3765.399,4,3,1,1.3957908700616644
4298,703-004-5381,6244.906,7,4,3,1.4308560512977653
4299,703-004-5392,6120.852,3,2,1,3.022716706884889
43010,703-004-5384,8373.717,2,0,2,0.27920371738274696
43447,703-004-5394,6455.354,2,1,1,0.54359384749897
43703,703-004-5392,8702.097,6,3,3,0.9024663602433132
44026,703-004-5391,1584.711,1,1,0,0.3978652972704144
44126,703-004-5390,4529.281,5,2,3,3.010077895887901
44203,207-008-2399,2542.0935,2,2,0,0.7901901457740149
44680,703-004-5395,1405.6862,2,1,1,0.3655591877227474
44817,703-004-5383,9967.336,5,1,4,0.6674678269051048
4488,703-004-5388,8639.788,1,1,0,0.7372018670283969
45205,703-004-5380,216.90012,5,2,3,0.9264278994977982
45910,703-004-5381,345.8768,6,2,4,0.99968083394773
45980,703-004-5388,6223.018,5,3,2,1.0201134375813552
4625,207-008-2398,1706.686,3,1,2,0.33853450732658075
46273,703-004-5382,1295.0581,4,2,2,0.6892304755380705
46420,703-004-5380,2104.8367,5,2,3,0.9672609906775683
46629,703-004-5391,2409.2817,3,2,1,1.46531368114431
46669,703-004-5386,5553.9585,2,1,1,0.32666834933781397
46810,703-004-5385,5590.8438,3,2,1,1.192271175594644
46896,703-004-5381,646.33606,3,1,2,0.7145577864662762
4733,703-004-5395,8205.767,4,0,4,0.27920371738274696
47492,703-004-5382,108.124016,5,4,1,1.6203438510648334
47619,703-004-5381,9924.635,3,2,1,1.1473603194866446
47961,703-004-5388,1523.3308,4,2,2,0.7043954404814136
48231,703-004-5397,2787.2092,5,2,3,0.6856196284980081
48278,703-004-5386,3772.4048,9,3,6,1.3358005112587932
48315,703-004-5399,5189.568,3,3,0,0.6819036804192818
48348,703-004-5387,2479.1323,5,3,2,0.8535694914193867
48616,703-004-5388,1750.1533,6,4,2,1.3821145185355097
49179,703-004-5390,1062.3932,4,2,2,0.5438969337422883
49495,703-004-5388,2072.2026,4,2,2,1.3261387917645011
49677,703-004-5398,1894.5348,"","","",0.27920371738274696
49698,703-004-5381,8117.655,3,2,1,1.8274302559533677
49754,703-004-5389,3718.8716,2,1,1,0.5831223017425857
49774,703-004-5382,8089.4834,3,2,1,0.5903302034620207
5098,703-004-5385,8523.8125,3,1,2,0.5937855498577888
5227,703-004-5390,2058.1125,6,3,3,1.269977169656866
5341,703-004-5392,8063.4487,3,2,1,0.4598082900492753
5455,703-004-5398,1202.088,4,1,3,0.41631837786536624
566,703-004-5390,9066.21,3,1,2,0.5107260462786637
5856,703-004-5399,8153.2056,5,3,2,1.1656000920984222
5892,703-004-5386,171.99635,6,3,3,2.3736136468927373
593,703-004-5388,5255.3057,5,1,4,0.4615554239215286
6078,703-004-5382,7279.293,3,0,3,0.27920371738274696
6287,703-004-5393,3449.4656,3,2,1,0.8877929939516197
654,703-004-5380,2655.4185,4,1,3,0.4122491253049764
6566,703-004-5387,88.29475,3,1,2,0.37512182779194486
6633,703-004-5386,9276.424,1,1,0,0.4258359818941489
6671,703-004-5396,5226.929,5,2,3,3.223151802781782
6696,703-004-5388,2439.447,6,4,2,1.716394845533732
687,207-008-2398,534.37115,5,1,4,0.6052776848158963
6924,703-004-5390,7749.8657,4,0,4,0.27920371738274696
7102,703-004-5385,2176.724,6,1,5,0.5165268771580819
7258,703-004-5399,5195.264,7,3,4,1.1861790303266353
7535,207-008-2398,9458.017,3,1,2,0.4871612358949792
7647,207-008-2398,467.73434,4,1,3,0.3978652972704144
8134,703-004-5396,9071.008,1,0,1,0.27920371738274696
8163,207-008-2399,249.71605,3,2,1,1.2388015757615647
8254,703-004-5380,6081.0483,7,4,3,2.038958520241989
8320,207-008-2399,4929.452,4,1,3,0.5585156983016745
8378,703-004-5385,2021.0642,4,2,2,0.798122067282896
8517,703-004-5383,8983.576,2,0,2,0.27920371738274696
860,703-004-5380,9927.866,4,3,1,1.5749915327863608
8618,703-004-5393,3360.2578,1,1,0,0.5022213830100445
8686,703-004-5380,8530.335,2,1,1,1.7697694369040475
8738,703-004-5388,4151.5146,1,1,0,0.8408141865947473
9346,703-004-5388,1309.759,5,1,4,0.4565907620830503
9424,703-004-5382,2320.019,2,2,0,0.963146194599135
9450,703-004-5399,6190.7725,2,2,0,1.139653823821105
9471,703-004-5384,6105.3193,3,2,1,0.48751354789162127
9855,703-004-5383,7465.8916,2,2,0,0.6525294005400679
9896,703-004-5396,4669.889,4,4,0,0.9506451664863937
10165,703-004-5380,3675.8125,2,2,0,0.8631670483667668
10303,703-004-5396,3892.635,4,2,2,0.9264351211533759
1046,703-004-5385,3716.5635,6,1,5,0.514368913022305
10526,703-004-5394,1060.9454,1,1,0,0.6106791224567384
10694,703-004-5387,4338.5024,1,1,0,0.887286304170913
10759,703-004-5386,9668.912,1,1,0,0.5079477409010584
10979,703-004-5383,2880.6692,7,2,5,0.6628761590195384
10985,703-004-5384,3714.5186,3,2,1,1.6471637588965395
1108,703-004-5393,5446.673,5,4,1,1.5209798074524137
11352,703-004-5389,1273.4026,3,1,2,0.45691371921119844
11466,703-004-5384,3704.1753,5,1,4,0.5628487733776681
11494,703-004-5396,8169.334,2,1,1,0.5053733038781228
11528,703-004-5397,7065.3003,"","","",0.27920371738274696
1161,207-008-2399,5875.5254,5,3,2,1.4829679323024736
12240,703-004-5390,7585.4985,3,2,1,0.6736458373287827
12317,703-004-5386,9896.39,1,0,1,0.27920371738274696
12461,703-004-5395,1103.341,2,0,2,0.27920371738274696
1257,207-008-2399,997.0397,2,1,1,0.7297124877870789
12584,703-004-5398,9998.853,5,4,1,1.1285202849339129
12617,703-004-5381,8539.995,5,3,2,1.4380764741804026
1267,703-004-5394,3331.6433,4,2,2,0.4200401800119223
12787,703-004-5388,1987.2612,4,2,2,0.8083348996422712
12899,703-004-5392,2279.1135,4,3,1,0.7584826421786769
12992,703-004-5382,8088.535,9,7,2,2.409368537469873
13152,703-004-5397,589.5352,5,3,2,1.3904608983400726
13159,703-004-5395,3892.0278,8,4,4,1.0533893469143867
13620,703-004-5389,8135.36,5,3,2,1.9553827844018277
13635,703-004-5391,2655.095,4,3,1,2.578033649666357
13677,703-004-5388,5720.5664,3,1,2,0.4821430586239468
13757,703-004-5388,8475.602,4,2,2,1.415257561002652
1384,703-004-5383,2708.6394,3,3,0,1.4888311892812875
13964,207-008-2398,5003.6304,5,3,2,0.9451427399246316
14037,703-004-5380,4034.1716,2,1,1,0.35352239877697555
14065,703-004-5392,4901.4224,10,5,5,1.1121689578415188
1446,703-004-5380,1024.5818,2,1,1,0.41721799672153725
14547,703-004-5386,9047.853,5,0,5,0.27920371738274696
14567,703-004-5390,4617.8555,6,2,4,1.3613471768183398
14573,703-004-5383,4611.569,4,0,4,0.27920371738274696
14610,703-004-5397,5723.5737,1,0,1,0.27920371738274696
14815,703-004-5392,2109.779,3,3,0,2.2899047394074694
14841,207-008-2398,6323.3955,3,0,3,0.27920371738274696
14930,703-004-5389,6400.736,8,4,4,0.955928875489018
1551,703-004-5381,9993.699,2,0,2,0.27920371738274696
15632,207-008-2399,3765.0657,4,1,3,0.4239692843870844
15973,703-004-5387,6764.153,2,2,0,1.0429606883330849
16018,703-004-5385,7009.979,2,2,0,1.6876999540917104
16154,703-004-5383,8402.383,6,4,2,2.839843744095165
1665,207-008-2399,9254.303,9,4,5,1.380346608426011
16881,703-004-5399,9334.615,7,4,3,1.1045655813055395
16923,703-004-5380,3743.4727,3,1,2,0.5035186014628963
17050,703-004-5381,7271.294,6,6,0,2.219978993483533
17679,703-004-5383,8885.254,3,2,1,0.6373170663029939
17951,207-008-2399,845.2106,7,4,3,1.5614132260555138
17957,703-004-5397,6011.6274,2,0,2,0.27920371738274696
18002,703-004-5392,284.02267,4,2,2,1.821758936488986
18014,703-004-5389,1743.4221,3,1,2,0.35831143730785864
18129,703-004-5386,7573.6255,5,4,1,3.0392937819932095
18177,703-004-5396,2946.6062,"","","",0.27920371738274696
18219,703-004-5383,830.42505,1,0,1,0.27920371738274696
1827,703-004-5399,5441.9785,4,1,3,0.5806748862391449
18354,703-004-5388,1679.151,6,3,3,1.0151466250486751
1868,703-004-5389,1769.5022,1,0,1,0.27920371738274696
18720,703-004-5390,6876.012,6,1,5,0.35831143730785864
18788,703-004-5388,6341.433,2,1,1,0.4932184991270373
18794,703-004-5388,1548.8446,2,1,1,0.3978652972704144
19036,703-004-5388,1514.3711,5,2,3,0.43741915723297026
1905,703-004-5380,5513.2593,2,0,2,0.27920371738274696
19296,703-004-5388,9592.507,2,2,0,1.2638821650179182
19423,207-008-2398,7854.5146,3,1,2,0.37512182779194486
19894,703-004-5385,5894.1235,4,2,2,1.3373413519285755
20048,703-004-5384,437.9767,8,5,3,1.580426738079808
20590,703-004-5380,1197.7845,2,2,0,1.3410943581687191
20824,703-004-5392,6443.456,4,2,2,0.7816979533009835
21312,703-004-5394,7075.1855,7,4,3,1.9065826676591755
21668,703-004-5386,3377.4084,2,2,0,1.8988124402238649
22248,703-004-5394,9326.376,4,3,1,1.4733432173575602
22304,703-004-5385,6769.866,2,1,1,0.5323484211431042
22388,207-008-2398,9893.053,3,1,2,0.4238641731831465
22754,703-004-5396,4494.1514,5,2,3,0.6945745359690227
22755,703-004-5384,1119.7114,1,1,0,0.56620355529806
22841,703-004-5395,3804.7886,4,2,2,0.9691903784727073
22964,703-004-5396,9012.293,6,1,5,0.5567360958690277
23159,703-004-5386,5628.056,3,1,2,0.40930295510958686
23184,703-004-5394,8839.782,4,2,2,0.4805658261421249
23203,703-004-5385,123.52645,3,3,0,2.609536207881122
23244,703-004-5388,521.2849,2,2,0,0.4478020454731411
23279,703-004-5380,4687.2173,9,5,4,2.3011654437342104
23360,207-008-2399,425.3447,6,4,2,0.8476042923256607
23416,703-004-5394,3948.347,4,3,1,1.2499093656229112
23532,703-004-5388,5600.874,2,1,1,0.5356862251528014
23587,703-004-5381,3419.952,6,4,2,0.9756748010218829
23628,703-004-5393,2039.1923,8,3,5,1.6636635131272757
23870,703-004-5392,5567.95,4,2,2,0.578230227978196
24211,703-004-5392,8818.25,3,1,2,0.5353013709079859
24232,703-004-5399,1056.562,5,3,2,1.7704658975889835
24539,703-004-5386,6684.3726,4,4,0,1.3957444064171243
24698,703-004-5383,8145.2476,3,3,0,1.15721880648869
24785,703-004-5395,546.57697,6,1,5,0.4740194896564528
25176,703-004-5383,3770.9702,1,1,0,0.5762958630609512
25190,703-004-5393,9359.148,6,2,4,0.9017136238725948
25298,703-004-5396,7306.7065,5,1,4,0.6494453684585105
25321,703-004-5387,204.42188,2,2,0,0.6950751487773918
2537,703-004-5395,5957.406,7,4,3,0.6189282289382928
25517,703-004-5381,8696.539,3,0,3,0.27920371738274696
25748,703-004-5383,2673.7476,6,5,1,1.3259304460051724
25787,703-004-5383,4962.8193,2,0,2,0.27920371738274696
25901,703-004-5399,1792.5054,5,1,4,0.7398729889219429
26096,703-004-5383,9486.486,1,0,1,0.27920371738274696
26228,703-004-5395,4011.2192,4,2,2,0.5388216573672763
26248,703-004-5399,7371.734,8,3,5,3.1609166759845073
26487,703-004-5381,435.85062,12,8,4,2.5454051440635594
26513,703-004-5385,7475.4893,5,3,2,0.7753043654094758
26684,207-008-2398,8209.486,3,3,0,1.394838396970287
26819,703-004-5397,4118.031,6,2,4,2.011324135432461
2690,703-004-5387,2131.0579,2,2,0,0.942608745449752
27845,703-004-5393,2909.3623,3,3,0,1.3558637412336636
27876,703-004-5389,673.6434,2,2,0,1.223442102698136
28092,703-004-5398,3744.1313,6,2,4,0.6787769834212617
28291,703-004-5385,7934.8667,7,4,3,0.9598965131726799
28512,703-004-5383,6033.137,1,0,1,0.27920371738274696
2860,703-004-5381,1760.3362,2,1,1,0.42228170308037244
28878,207-008-2399,8427.93,5,5,0,2.4047621427838366
29540,703-004-5387,3527.003,2,1,1,1.1270909691537723
29581,703-004-5381,6316.2305,2,1,1,0.35831143730785864
2974,703-004-5386,5444.4727,5,3,2,0.7903000270652729
29808,703-004-5397,3777.6064,10,4,6,1.4699683672074177
29854,207-008-2398,3617.2104,4,0,4,0.27920371738274696
30373,703-004-5389,8498.468,5,4,1,1.1992581218269953
3042,703-004-5395,3493.2495,1,0,1,0.27920371738274696
30510,703-004-5395,1621.0557,1,0,1,0.27920371738274696
30581,703-004-5388,5142.3486,6,3,3,1.4135063189198003
30593,703-004-5391,2072.4475,5,3,2,0.6626294980030658
31140,703-004-5397,6873.89,2,2,0,0.8713551382333962
31847,703-004-5384,158.58888,7,3,4,0.9127158142029692
32331,703-004-5391,3762.774,5,2,3,0.5065312871300444
326,703-004-5399,9896.504,4,2,2,0.863649099019431
33070,703-004-5389,6384.748,9,3,6,0.8975640647776236
33081,703-004-5392,4371.806,2,1,1,0.41258796369482276
33296,703-004-5394,5094.8467,5,3,2,0.8137117982276623
33308,703-004-5380,5955.545,2,0,2,0.27920371738274696
33383,703-004-5397,4639.382,5,1,4,0.492770326514383
33467,703-004-5384,9425.136,6,2,4,0.5897352989198507
33663,703-004-5383,8168.13,2,1,1,1.1010182849560688
33747,703-004-5399,4451.3,6,5,1,2.7273827803066997
3377,703-004-5386,8559.644,2,1,1,0.3511274674921594
34055,703-004-5391,6804.374,8,5,3,1.4308401956672543
34096,703-004-5389,7593.9805,3,0,3,0.27920371738274696
34149,703-004-5389,3701.9705,3,0,3,0.27920371738274696
34263,703-004-5381,5066.307,7,1,6,0.50414717111973
34550,703-004-5382,4570.3804,3,2,1,1.2843752392344265
34620,703-004-5382,231.45676,6,3,3,0.9414583522148159
34712,703-004-5386,9134.066,1,1,0,0.9304346526504869
34981,703-004-5395,492.2086,4,2,2,1.0155824689186186
35099,703-004-5397,1373.9603,2,2,0,1.012472630767722
35132,703-004-5382,5900.877,7,4,3,1.484406186446617
35187,703-004-5383,6430.5405,6,1,5,0.3807252912866403
35298,703-004-5386,2299.549,3,1,2,0.4897851128084867
35534,703-004-5391,8458.356,1,1,0,0.5556072879945589
35592,703-004-5398,7777.3135,7,2,5,0.42769667719038845
35676,703-004-5380,5438.497,5,3,2,1.0140017154881278
35749,703-004-5391,9251.546,2,1,1,0.9123384075713923
35864,703-004-5380,1859.8223,6,3,3,1.2455969440260646
36078,703-004-5399,4937.463,3,1,2,0.3978652972704144
37239,703-004-5395,9776.629,5,3,2,1.4505005652496454
37348,703-004-5395,5695.8003,5,4,1,0.9251543340009941
37362,703-004-5387,9435.247,1,1,0,0.32666834933781397
37451,207-008-2398,5257.566,3,2,1,0.8376833889158318
37645,703-004-5382,4430.042,1,0,1,0.27920371738274696
37732,703-004-5397,5440.9785,6,5,1,1.267107024471721
38183,703-004-5380,9059.704,7,4,3,1.638964751546804
38192,207-008-2399,5973.2544,4,2,2,0.5609307224660645
38237,703-004-5392,5405.7886,4,0,4,0.27920371738274696
38392,703-004-5391,1543.7949,9,6,3,2.0537338133678453
38398,703-004-5396,4948.6987,1,1,0,0.3919322182760311
38452,703-004-5391,7582.2886,2,0,2,0.27920371738274696
38468,703-004-5388,8325.967,3,2,1,0.9133229188089217
38804,703-004-5393,1195.3467,3,2,1,0.4402934043902493
38911,703-004-5396,522.9193,2,2,0,1.3205356994675999
39020,207-008-2399,1565.3884,4,1,3,0.4108429736600457
39054,703-004-5391,3217.3186,5,2,3,0.7426319509440595
39193,703-004-5395,7624.8296,3,1,2,1.5035811639214014
3923,703-004-5391,7885.812,2,0,2,0.27920371738274696
39241,703-004-5392,4780.641,2,1,1,0.35831143730785864
39262,703-004-5399,1230.188,"","","",0.27920371738274696
39536,703-004-5383,7694.242,8,5,3,3.427736984913973
39725,703-004-5380,4991.4453,8,5,3,5.676405690171196
40010,703-004-5389,4257.709,3,1,2,0.4381012006905436
40065,703-004-5384,3926.9805,7,5,2,2.1438701530532316
40305,703-004-5396,4877.342,2,1,1,0.35831143730785864
4036,703-004-5399,3293.3198,3,2,1,2.234829521064082
40593,207-008-2398,3140.7542,4,3,1,1.1301446566592324
41394,703-004-5387,2617.0044,3,0,3,0.27920371738274696
42292,703-004-5382,9043.815,8,6,2,3.321410756427574
42300,703-004-5398,4056.8542,3,2,1,0.9745093736732512
4239,703-004-5385,5474.579,3,2,1,1.6296130464188991
4263,703-004-5381,9561.115,4,1,3,0.8129717806746712
42661,703-004-5393,3634.0989,3,1,2,1.3943128682471848
42674,703-004-5386,2186.5022,2,1,1,0.8782366913314783
42912,703-004-5384,7366.133,6,2,4,1.5267850621829695
43000,703-004-5395,9016.895,2,1,1,0.44436865454794217
43474,703-004-5387,8931.837,4,3,1,1.1318189636047462
43596,703-004-5391,4160.981,4,2,2,0.4043036344466838
43816,207-008-2398,8227.137,1,0,1,0.27920371738274696
4395,703-004-5386,4413.6416,5,2,3,2.4969366709849172
44017,703-004-5387,8406.459,5,2,3,1.9131398255527596
44218,703-004-5394,4717.2163,4,3,1,1.776712020493959
44299,207-008-2399,6248.7256,1,1,0,0.4861341049786822
44460,207-008-2398,2109.8477,3,0,3,0.27920371738274696
44971,703-004-5385,5107.817,3,0,3,0.27920371738274696
45040,703-004-5390,4663.5664,2,0,2,0.27920371738274696
45132,703-004-5388,191.26952,5,3,2,0.7354896742628512
45483,703-004-5390,2801.6245,6,3,3,2.029076675567974
45493,703-004-5390,5520.077,2,2,0,1.7408960157769142
46012,703-004-5381,4839.8457,5,2,3,1.5802928093785598
46219,703-004-5387,2594.1313,6,3,3,1.8008444969666744
46221,703-004-5398,9610.232,4,1,3,0.35831143730785864
46495,703-004-5382,6355.895,2,1,1,0.6089130253784297
46516,207-008-2399,4301.6357,5,4,1,1.8605803442808047
46550,703-004-5396,9078.991,7,5,2,1.7560461028182293
46760,703-004-5388,1868.3994,2,2,0,1.192057833785738
47198,703-004-5398,1127.4535,4,3,1,1.1227603809053814
47739,703-004-5399,3104.4263,8,3,5,2.099396249591988
47990,703-004-5388,7480.5195,7,3,4,3.295511273865533
48185,703-004-5381,5351.351,7,1,6,0.41633530179542955
48328,703-004-5381,7959.458,3,2,1,1.8531053193206968
48639,703-004-5391,8720.108,"","","",0.27920371738274696
4868,703-004-5398,9202.624,9,3,6,0.7618054387239208
48722,703-004-5399,5475.499,8,4,4,1.4935712743228666
48936,703-004-5380,9517.31,2,1,1,0.49285255599460753
4931,703-004-5395,5177.0435,5,1,4,0.7579431356130888
49372,207-008-2398,3748.8604,3,1,2,0.43150108751580485
4940,703-004-5398,8148.895,4,3,1,1.6162086016977997
49404,703-004-5387,3212.5718,4,2,2,0.5830421910289711
49493,703-004-5385,5844.659,5,1,4,0.6818553890760928
49517,703-004-5394,6781.0454,5,2,3,1.5391810323774944
49577,703-004-5389,4712.783,5,3,2,2.474621197484926
49739,207-008-2398,1449.1123,2,1,1,0.814702517947553
49786,703-004-5389,3808.8203,6,2,4,0.7359870950358955
49952,703-004-5388,8821.809,6,3,3,1.8603327719732794
5107,703-004-5381,446.37024,3,2,1,0.5463912151185025
5467,207-008-2398,3307.7544,3,3,0,0.6931579519432475
548,703-004-5391,3573.5464,4,2,2,2.561700416600575
5842,207-008-2398,1196.9393,4,3,1,1.5978151146795987
6028,703-004-5392,368.74832,5,1,4,1.7380343223458306
6098,703-004-5380,6357.2275,2,1,1,1.8651301012096118
6136,703-004-5393,7323.943,5,1,4,0.3486207416170325
6268,703-004-5395,8999.731,4,3,1,1.9135975167341501
6314,703-004-5396,3738.6882,4,1,3,0.5498004166809265
6357,703-004-5382,1028.1647,7,5,2,1.4096693781033178
6433,207-008-2398,5772.6313,3,2,1,1.1822397993523186
6832,207-008-2398,5934.07,2,1,1,0.4611844347604725
6881,703-004-5381,2244.1274,3,2,1,1.074931730128621
7028,703-004-5389,8545.786,3,0,3,0.27920371738274696
7040,207-008-2398,8514.008,4,3,1,1.5492428151347821
7349,703-004-5397,9498.624,3,0,3,0.27920371738274696
7755,703-004-5393,9001.588,3,2,1,0.8692610598418896
7968,703-004-5390,4967.3237,1,1,0,0.5054683984349729
8170,703-004-5398,946.6952,5,2,3,0.5711875332854982
8202,703-004-5389,4102.402,8,5,3,1.7154965126828623
8402,703-004-5393,7766.7686,4,2,2,0.730850718168379
8594,207-008-2399,5855.835,5,4,1,1.179140935138495
866,703-004-5383,8400.832,3,2,1,0.836671548066743
8860,703-004-5384,3289.0117,3,2,1,0.7884510940415789
8939,703-004-5380,847.0404,8,4,4,0.9765988841359226
8993,703-004-5387,8724.614,2,1,1,0.35831143730785864
9284,703-004-5382,3676.685,4,1,3,0.3978652972704144
9543,703-004-5395,1283.9484,4,2,2,0.8035270069204519
9902,703-004-5399,3600.0264,5,1,4,0.6588010205973074
9946,703-004-5393,8424.59,5,3,2,1.4132134125595612
10103,703-004-5397,5267.2505,4,2,2,1.0223499210537634
10167,703-004-5392,5041.0425,5,1,4,0.8326969142930659
10286,703-004-5383,1853.258,2,2,0,0.7836777540772598
10335,703-004-5385,9468.903,3,2,1,1.25611259167088
10408,703-004-5395,808.3451,3,1,2,0.5105993630403363
10420,703-004-5393,1030.0875,4,2,2,0.43215226206490936
10626,703-004-5389,14.686584,3,2,1,0.8434387670921595
10967,703-004-5391,2829.0552,3,1,2,0.4093272642526889
11380,703-004-5394,3753.072,9,6,3,1.8477097410897287
1139,703-004-5383,1892.395,3,1,2,0.37545027088077415
11429,703-004-5386,3525.786,5,4,1,1.4999080628637844
1144,703-004-5390,1828.264,4,1,3,0.33853450732658075
11646,703-004-5391,5460.3237,4,1,3,0.5202323606558777
11761,703-004-5390,7522.637,6,2,4,0.5101528810655815
12000,703-004-5386,9220.069,5,3,2,0.6764831141729511
12600,703-004-5385,2112.6294,1,1,0,0.37701518385758476
12655,703-004-5385,3448.0542,3,1,2,0.6608701602903749
12657,703-004-5381,7782.322,4,3,1,1.0335155984378677
12713,703-004-5394,7136.0107,5,2,3,0.7264217673527197
12769,703-004-5388,2727.6396,10,6,4,2.304243045127458
12974,703-004-5390,8079.6865,1,0,1,0.27920371738274696
13008,703-004-5381,6023.3535,5,2,3,0.4526638740935387
13012,703-004-5385,5372.877,6,4,2,1.4368822085435466
13265,703-004-5381,867.9009,2,1,1,0.5052045094523951
13501,703-004-5387,6901.311,4,1,3,0.9815809376709224
13572,703-004-5393,3098.628,2,1,1,1.1117905227082303
1419,703-004-5380,154.10066,4,2,2,1.1095402339723754
14777,207-008-2398,6891.2793,8,6,2,0.9459102573757338
14943,703-004-5396,9088.122,4,0,4,0.27920371738274696
14983,703-004-5386,4203.9556,8,3,5,0.6656592048935723
15070,703-004-5388,6959.877,4,2,2,1.3589943198703895
15087,703-004-5388,1189.8721,5,3,2,1.2610908319043432
15490,703-004-5393,8748.649,3,2,1,2.372426156669432
15496,703-004-5397,5815.7246,2,1,1,1.6808686495276086
15548,703-004-5380,6199.6304,5,3,2,0.8981059699730115
15560,703-004-5395,3402.3726,3,2,1,0.6218219318397248
1559,703-004-5381,8389.457,1,0,1,0.27920371738274696
15824,703-004-5398,6545.4453,3,2,1,0.9698382513215208
16314,703-004-5389,5129.1973,5,2,3,0.4924809414174811
16476,207-008-2398,8171.149,6,1,5,0.5476503310550599
1652,703-004-5399,6472.3345,6,0,6,0.27920371738274696
16612,703-004-5380,6760.7515,3,1,2,0.8672149704206819
16757,703-004-5399,27.865171,5,3,2,1.272219486281225
16829,703-004-5381,2801.369,2,2,0,1.0567372417330425
16912,703-004-5389,3052.2031,3,0,3,0.27920371738274696
16982,703-004-5386,2686.9434,5,2,3,0.8567593068477986
17188,703-004-5388,1641.0059,5,0,5,0.27920371738274696
17320,207-008-2399,5723.208,6,4,2,0.6868691840911637
18857,703-004-5389,1379.2742,1,1,0,0.3889656787788394
19175,703-004-5399,565.0699,4,2,2,1.139230487099436
19301,703-004-5394,2144.404,5,2,3,0.6468982118083815
19387,703-004-5385,3421.305,7,5,2,2.5226683920237765
1946,207-008-2398,1262.4717,5,3,2,2.553170964083548
19881,703-004-5397,5229.3003,7,4,3,1.5064962453295767
20043,703-004-5397,1606.4817,5,2,3,1.522381772017489
20065,703-004-5381,6263.314,1,0,1,0.27920371738274696
20154,703-004-5390,8446.766,5,3,2,0.5810006106556185
20813,703-004-5398,432.87396,4,1,3,0.5919076562235307
21146,703-004-5386,6328.0234,5,1,4,1.6799392045476904
21351,703-004-5388,2324.6306,2,1,1,1.431638398911049
21393,703-004-5389,2971.705,5,2,3,0.4442519027882182
21626,703-004-5399,6226.6396,4,1,3,0.9867133520725461
21766,703-004-5394,6827.943,4,1,3,2.085286167357264
21824,703-004-5386,6125.7876,7,3,4,0.9843294542414068
2187,703-004-5398,9805.798,4,2,2,0.8466089178179975
22092,703-004-5388,8841.46,3,0,3,0.27920371738274696
22098,207-008-2398,2458.5266,5,2,3,1.3030517773037167
22141,703-004-5393,8687.075,1,1,0,1.41709538599996
22162,703-004-5387,2501.3708,2,0,2,0.27920371738274696
22203,207-008-2399,4124.758,1,1,0,0.3978652972704144
22440,703-004-5393,6971.05,6,5,1,2.679706514768235
22509,703-004-5383,9360.643,2,2,0,1.5475366667981925
22713,703-004-5396,2254.5295,5,2,3,0.7904781589319639
23162,703-004-5388,4392.429,3,0,3,0.27920371738274696
23197,703-004-5382,2602.0957,4,3,1,2.106996200034602
23206,703-004-5390,4410.473,6,1,5,0.4510729055896038
23384,703-004-5381,9686.332,6,3,3,0.6218361834949436
2342,703-004-5380,7769.7593,1,1,0,0.39907663423176776
24024,703-004-5389,8318.708,6,3,3,0.8412563456959004
24070,703-004-5384,1412.0328,5,4,1,1.2655009213853463
24654,703-004-5380,4589.8403,3,2,1,0.5511220427452694
24718,703-004-5387,954.2364,5,0,5,0.27920371738274696
24787,703-004-5382,4080.0215,3,0,3,0.27920371738274696
25104,703-004-5385,2107.7805,4,0,4,0.27920371738274696
25229,703-004-5382,5870.1396,6,5,1,2.1740327520658917
25294,703-004-5395,2611.8518,3,3,0,0.5858939411819503
25432,703-004-5399,66.59031,3,2,1,0.9469463252460029
26210,703-004-5394,4030.6418,1,0,1,0.27920371738274696
26230,703-004-5399,2031.4998,5,1,4,0.5122652375952216
2637,703-004-5387,6951.0483,4,2,2,0.7093790913879814
26498,703-004-5381,7443.1445,1,0,1,0.27920371738274696
26529,703-004-5394,4270.868,2,1,1,0.4352809739783714
26550,703-004-5398,3191.942,"","","",0.27920371738274696
26911,703-004-5395,4690.722,7,2,5,0.7814719332239906
26992,703-004-5394,5377.3125,7,2,5,1.4404324027749806
27037,703-004-5388,292.3155,5,2,3,0.7386475251787334
2710,703-004-5391,7450.913,2,0,2,0.27920371738274696
2712,703-004-5390,4329.02,7,2,5,0.8225213660604946
27316,703-004-5381,1440.2312,4,1,3,1.1312235073206232
27405,703-004-5395,4546.318,5,3,2,0.8328781107420954
27462,703-004-5383,884.2516,4,2,2,0.9558495872013729
2763,703-004-5390,7291.6587,8,4,4,2.503668781403577
27908,703-004-5390,7521.0474,4,2,2,0.826740097369235
27953,703-004-5386,3946.4927,5,0,5,0.27920371738274696
28499,703-004-5393,5909.347,2,0,2,0.27920371738274696
28601,703-004-5385,8396.036,3,2,1,0.9655874847635898
28974,703-004-5387,9974.434,5,3,2,2.8615120240194813
29002,703-004-5396,4869.6846,3,2,1,1.7101827378780519
29190,703-004-5397,3213.8193,3,0,3,0.27920371738274696
29472,703-004-5385,8136.6436,4,1,3,0.35831143730785864
29503,703-004-5394,3757.186,"","","",0.27920371738274696
29593,703-004-5396,2441.8752,8,4,4,1.13996109179331
29686,207-008-2399,7238.5005,6,5,1,3.515023650700515
29756,703-004-5384,9406.756,1,0,1,0.27920371738274696
29880,207-008-2398,6932.0107,4,1,3,0.48875506824553666
29947,703-004-5380,7152.023,1,0,1,0.27920371738274696
30327,703-004-5387,617.7932,"","","",0.27920371738274696
3038,703-004-5384,1958.9454,6,2,4,0.8713718362918695
31264,703-004-5385,1068.5546,5,3,2,0.8462611485036954
31368,703-004-5384,3272.0745,6,3,3,0.9240382446368294
31457,703-004-5393,9924.764,5,4,1,1.7201227199030573
31805,703-004-5385,6351.431,6,3,3,1.5797205957010927
32115,703-004-5383,4746.8804,6,2,4,0.6880733274796226
32166,703-004-5387,9437.581,3,3,0,0.851082618502628
32228,703-004-5381,8880.243,3,1,2,0.3978652972704144
32369,703-004-5390,4263.9736,3,1,2,0.6098245443447605
32377,703-004-5380,7403.564,6,5,1,2.693746616588217
32623,703-004-5382,5883.078,2,0,2,0.27920371738274696
32870,703-004-5386,1203.019,2,2,0,0.46123340620614045
33089,703-004-5390,3444.3032,6,2,4,0.605694820376834
33149,703-004-5380,4658.6006,5,4,1,0.9487737799145491
33244,703-004-5389,713.4843,3,1,2,0.35114230018964543
33534,207-008-2398,104.31052,6,2,4,0.6577998228122346
33681,703-004-5392,3189.972,2,1,1,0.44485314040518276
33889,207-008-2399,7351.838,3,1,2,0.8055168007284614
34016,703-004-5394,8258.723,3,2,1,1.1298957408392838
34178,703-004-5392,9873.354,6,4,2,1.6791163777963158
34195,703-004-5385,7936.552,3,0,3,0.27920371738274696
3436,703-004-5397,9696.745,6,2,4,0.7246700600893763
34440,703-004-5393,9222.348,4,3,1,1.853407301673948
34466,703-004-5386,136.6049,"","","",0.27920371738274696
34828,703-004-5389,4761.603,5,3,2,1.5511663648793803
34968,703-004-5386,5626.989,7,2,5,0.7395834770887842
35125,207-008-2398,6044.4004,3,0,3,0.27920371738274696
35398,703-004-5390,8643.351,3,2,1,0.6063992116901077
35955,703-004-5399,5964.555,4,3,1,2.2946875996643805
36377,703-004-5386,8254.317,5,3,2,1.9481508277922301
36623,703-004-5383,5371.729,3,2,1,0.7575449225160072
36656,703-004-5387,1591.8494,3,0,3,0.27920371738274696
36803,703-004-5389,7259.1597,4,2,2,1.0384032229215576
36914,703-004-5394,9413.638,6,4,2,1.384901420984203
36966,703-004-5398,2269.8647,3,1,2,0.33853450732658075
37073,703-004-5393,2797.297,3,1,2,0.3299645043346936
3721,207-008-2399,4537.2314,5,1,4,0.6830560378470185
3722,207-008-2399,8647.139,4,3,1,0.9508885597797126
37411,703-004-5399,2964.844,4,2,2,0.7635937676062107
37423,703-004-5395,1003.3613,4,1,3,0.5701664881158606
37481,703-004-5388,7967.592,1,1,0,0.4850431505567731
37867,703-004-5387,6418.6465,5,2,3,2.275254432567871
37977,703-004-5395,3495.608,3,2,1,0.8612640254424341
38085,703-004-5382,73.71426,4,2,2,0.9628597083139029
38333,703-004-5390,3788.0945,3,3,0,1.457718004616985
38533,703-004-5388,7118.4185,5,1,4,0.8193056390263579
38577,207-008-2398,4305.2236,2,1,1,0.5741505367208308
38733,703-004-5386,2809.7678,5,3,2,1.0998932156270438
38779,703-004-5398,3060.5835,7,2,5,0.608408568853015
38794,703-004-5398,5900.5713,8,3,5,1.2762046532795548
38849,207-008-2398,2354.0396,1,1,0,0.6254740687327703
39000,703-004-5380,9294.572,3,1,2,1.232407874121027
39065,703-004-5388,522.5307,9,4,5,2.760471199100745
39233,703-004-5383,3901.3887,7,4,3,0.9030061220891611
3930,703-004-5397,1068.0968,2,0,2,0.27920371738274696
39570,703-004-5383,2988.289,3,3,0,1.0598911220682994
39603,703-004-5394,453.06564,6,0,6,0.27920371738274696
39819,703-004-5399,4716.116,9,4,5,1.491578536348952
39830,703-004-5391,5543.347,1,1,0,0.4803816775721352
3987,703-004-5383,8523.363,6,3,3,2.6848889174386277
39910,207-008-2399,4730.057,5,3,2,2.0452223862870795
40132,703-004-5391,2482.9668,3,1,2,0.6547339117077161
40241,703-004-5398,7501.9873,4,1,3,0.6906825225732152
40903,703-004-5386,7845.0244,2,2,0,1.7410214757761318
41095,703-004-5393,5757.025,1,1,0,0.5165268771580819
4111,703-004-5381,1967.1428,4,1,3,0.3660046630705757
41367,703-004-5398,7487.7124,6,3,3,0.9557337374764703
41472,703-004-5391,849.5891,2,1,1,0.5920308906561303
41498,703-004-5383,456.44046,4,3,1,2.052536559211047
42007,703-004-5395,4118.304,5,1,4,1.197847655544524
42737,703-004-5390,1502.2933,4,0,4,0.27920371738274696
43051,703-004-5397,6552.303,4,3,1,1.8984704780119053
43087,703-004-5397,4146.412,2,1,1,0.9849281356335545
43732,703-004-5381,4608.47,6,3,3,1.4837177541415765
43818,703-004-5384,9982.114,7,3,4,1.0749079577976917
44163,207-008-2399,8209.189,5,5,0,1.3045927568549747
44493,207-008-2399,3979.9524,3,0,3,0.27920371738274696
44637,703-004-5382,5142.522,5,3,2,1.1549515019595484
44856,703-004-5383,2585.2144,4,2,2,1.1788359217339799
45447,703-004-5393,5580.6255,2,1,1,0.3999899332780649
4552,703-004-5398,2957.9104,6,4,2,1.315253693061532
45653,703-004-5395,985.95026,5,4,1,1.3122782330616825
4601,703-004-5389,3505.5608,4,3,1,1.4183568290356783
46105,703-004-5395,7534.4653,3,1,2,1.6815364799753636
46544,703-004-5386,8754.185,5,2,3,0.4803477916450907
46901,703-004-5398,2549.1702,3,2,1,0.6262888385541743
47019,703-004-5380,8677.775,2,1,1,0.44416581091479407
47395,703-004-5388,6911.8623,5,1,4,1.2508273598052007
47545,703-004-5394,4922.52,3,3,0,1.064046149106241
4775,703-004-5383,9938.3125,2,2,0,1.0845023353791585
48034,703-004-5387,7785.4653,5,1,4,2.038600689406586
48112,703-004-5381,9773.251,2,1,1,0.377456604248068
4815,703-004-5387,2004.8457,4,3,1,1.610564489566618
4870,703-004-5395,6926.8477,2,0,2,0.27920371738274696
48834,703-004-5396,200.98746,3,1,2,0.524356481333795
48920,703-004-5389,8610.94,"","","",0.27920371738274696
49167,703-004-5394,8168.7827,4,3,1,0.5934494092530895
49222,207-008-2398,5285.9316,4,3,1,1.101951073327442
49418,703-004-5392,6799.125,5,4,1,1.1220334399739773
49518,703-004-5384,9963.683,6,3,3,0.6149766882543108
49540,207-008-2399,651.9705,3,1,2,0.3769891840405616
49740,207-008-2398,6387.6685,8,4,4,1.2747725869026978
49930,207-008-2399,489.9764,2,1,1,0.35831143730785864
49990,703-004-5385,9436.976,4,1,3,0.5541845828619568
5215,703-004-5390,3174.7283,7,6,1,2.5000617867194994
5238,703-004-5399,4138.446,4,1,3,1.7578608850872433
5257,703-004-5384,1775.5092,2,1,1,0.4230808829965438
5501,703-004-5381,2034.3477,6,2,4,0.6273098921132149
5724,703-004-5388,3687.4956,4,1,3,1.3875590570779759
6317,207-008-2399,8017.326,4,1,3,0.6477042352905608
6338,703-004-5387,3795.3079,4,2,2,1.4887970242163786
6378,703-004-5383,8651.913,5,2,3,0.6935470386572181
6853,703-004-5399,2350.9468,6,2,4,0.5423575755629871
6855,703-004-5383,9413.422,5,1,4,0.7946201543867042
6944,703-004-5384,6204.376,8,2,6,0.8819699121098055
7114,703-004-5393,6347.0586,5,3,2,0.91194564284802
7163,703-004-5390,6141.323,3,1,2,0.6148808405362673
7534,703-004-5382,7673.9453,4,1,3,1.4744033760650448
773,703-004-5391,348.5495,2,1,1,0.5880403955834561
8136,703-004-5383,8093.4097,4,3,1,2.0372912594354258
8245,703-004-5380,1045.8004,6,3,3,1.1384357421282503
8343,703-004-5380,4061.4526,3,1,2,0.7664433383260821
8345,703-004-5381,4188.364,3,1,2,0.6088868299728
835,703-004-5395,8676.876,5,2,3,0.968575631537105
842,703-004-5388,9161.048,3,2,1,0.37808836728913653
8436,703-004-5393,4518.929,2,0,2,0.27920371738274696
8570,703-004-5391,6630.7383,3,1,2,0.900677211707003
8684,703-004-5395,78.917145,6,3,3,1.66951469259076
8925,703-004-5384,2912.4778,5,2,3,1.3481937527340788
9533,703-004-5399,5151.1567,6,2,4,0.8022377878005149
9871,703-004-5395,5018.7915,3,1,2,0.3807601814404417
10006,703-004-5391,3349.0479,4,2,2,0.6784761538663637
10281,703-004-5386,3494.4307,6,2,4,0.66108586258206
10297,703-004-5386,7055.1113,7,1,6,0.530466049136307
10342,703-004-5384,7049.0225,8,6,2,3.324505123394246
10760,703-004-5382,3586.3787,1,0,1,0.27920371738274696
10902,703-004-5380,653.0249,6,6,0,2.115324387652422
10959,703-004-5390,8117.077,6,3,3,0.8273714551089214
11128,703-004-5385,2974.6587,7,5,2,1.560306466377081
11215,703-004-5389,346.91394,7,4,3,1.003057092567985
11704,703-004-5390,5051.635,3,3,0,2.247442454065406
11831,207-008-2398,6623.5737,5,3,2,0.8171681611840323
1218,703-004-5382,9405.841,1,0,1,0.27920371738274696
1224,703-004-5394,530.3341,4,2,2,0.6460982591987782
12591,703-004-5385,2449.025,6,5,1,1.9190936693876905
12626,703-004-5394,9458.528,1,1,0,0.6706829134790682
12757,703-004-5391,3848.0325,4,3,1,0.7102604105531235
1310,703-004-5392,9657.108,8,5,3,2.1870913402985357
1324,703-004-5394,1039.3549,2,1,1,0.44784926574822576
13470,703-004-5383,2714.7085,5,2,3,1.5658526697466766
13747,703-004-5385,6109.6377,5,3,2,0.8251513231870435
1409,703-004-5381,5694.64,5,2,3,1.5870048271445394
14186,703-004-5385,7669.3237,5,3,2,1.068952772797073
14548,703-004-5397,6542.119,3,0,3,0.27920371738274696
14883,703-004-5393,2683.777,6,1,5,0.4657313250795166
14972,703-004-5394,4675.565,7,4,3,1.9884469714856012
16268,703-004-5396,5910.215,2,1,1,0.45702014660138235
16460,703-004-5381,9484.346,3,2,1,0.7183214910909409
16604,703-004-5380,2816.354,7,2,5,0.8697453964387554
16951,703-004-5397,2537.0771,7,2,5,1.1061715330057897
17012,703-004-5383,7138.482,5,2,3,0.696336252431613
17132,703-004-5396,4597.159,1,0,1,0.27920371738274696
17135,703-004-5393,4292.7163,3,3,0,1.2434526944986874
17446,703-004-5381,8208.584,6,3,3,1.3534310257667863
17476,703-004-5388,7804.266,4,2,2,1.5048343581165955
17516,703-004-5390,4793.144,5,3,2,0.9569522338753138
17713,703-004-5380,888.34406,1,0,1,0.27920371738274696
17940,703-004-5381,1100.8883,9,4,5,2.297246755571392
17969,703-004-5380,1555.4655,5,2,3,0.9033135848754257
1803,703-004-5387,9467.214,3,1,2,0.5663477023123792
18074,703-004-5382,1498.3392,8,4,4,0.8779777342277906
18164,703-004-5391,7679.3086,2,2,0,0.5164774348331287
18172,703-004-5384,923.7432,5,3,2,1.1138865396950128
18310,703-004-5384,636.5085,1,1,0,0.33853450732658075
18414,703-004-5386,9536.9795,6,2,4,0.6388913720420907
18447,703-004-5387,2715.6216,3,2,1,0.6017446383989719
18632,703-004-5387,6784.9497,5,2,3,1.272825231875902
18805,703-004-5386,4617.904,3,2,1,1.4614255356573438
19498,703-004-5385,2010.5022,4,2,2,1.23104153789582
1970,703-004-5380,8249.065,3,3,0,1.4002054025416568
19929,703-004-5393,7899.585,2,1,1,0.5238308984030042
19957,703-004-5388,2736.101,8,3,5,0.706682058928069
20172,703-004-5383,7342.145,5,3,2,0.774450433895165
20854,703-004-5384,1447.7808,6,4,2,1.3285032796862084
21119,703-004-5391,2140.7593,2,0,2,0.27920371738274696
21261,703-004-5383,3023.6394,5,1,4,0.7675320455078064
21310,703-004-5381,4747.086,3,0,3,0.27920371738274696
21562,703-004-5381,5996.2993,1,1,0,2.4026344146163137
21705,703-004-5380,5366.684,5,4,1,2.996547871307265
21787,703-004-5394,7260.891,4,3,1,1.4330154124832117
22153,703-004-5390,8957.349,3,3,0,1.9474411569396741
22318,703-004-5392,1700.1498,1,1,0,0.6916156710667631
22576,703-004-5388,1780.8944,3,1,2,0.8459471559963214
2271,703-004-5388,6567.2334,2,2,0,0.5663047188565968
2295,703-004-5396,6634.863,4,3,1,0.835021082321326
23013,703-004-5380,510.54358,3,1,2,0.5109226355527361
2347,703-004-5399,3820.9092,1,0,1,0.27920371738274696
23641,703-004-5388,3905.745,5,1,4,1.410473311102064
23846,207-008-2398,157.37296,5,2,3,0.7030527631902629
23961,703-004-5384,5983.9937,2,2,0,2.978749972570915
23978,703-004-5395,5152.3438,4,3,1,2.735236437854167
24309,703-004-5396,4414.3506,6,4,2,3.6544904500773314
24363,703-004-5394,6295.275,4,1,3,0.3367545836282657
2456,703-004-5388,5304.55,7,5,2,1.6639644303261842
24894,207-008-2399,9205.753,4,2,2,0.4931216721517979
25537,703-004-5387,8143.996,5,4,1,0.9410422409569559
26366,703-004-5393,7468.647,3,2,1,0.7333202153309178
26452,703-004-5393,6230.218,1,0,1,0.27920371738274696
26501,703-004-5385,4495.915,3,2,1,0.6339287531951101
26704,703-004-5382,3875.9756,5,4,1,1.243840737853757
26732,703-004-5383,4604.8027,6,3,3,0.6757066277045611
2678,703-004-5382,9897.338,5,4,1,1.662558778923608
27028,207-008-2398,7793.4556,2,0,2,0.27920371738274696
27072,703-004-5392,4931.1,4,2,2,0.847818162249511
27355,703-004-5393,9872.284,2,1,1,0.6256164093502187
27360,703-004-5382,2120.1355,5,0,5,0.27920371738274696
27502,703-004-5399,6167.29,5,0,5,0.27920371738274696
27978,703-004-5386,5550.3315,5,2,3,0.7733320324335645
28187,703-004-5397,3987.4143,5,4,1,0.9544731412020956
28411,703-004-5396,9554.088,5,3,2,1.6333726195378273
28461,207-008-2399,2868.0813,2,1,1,0.950588767057757
28577,703-004-5385,6795.346,8,2,6,3.2989447075214704
2886,207-008-2398,3768.1265,5,3,2,2.5220746998464434
29189,703-004-5383,3294.8118,2,2,0,0.6553056917322907
29203,703-004-5383,3370.527,7,4,3,1.0920666342929326
29512,703-004-5399,2125.0833,5,3,2,2.8575944373387094
29514,703-004-5389,2598.8591,5,3,2,0.8250986600781335
29723,207-008-2399,7007.2563,3,2,1,0.6660535716777062
29800,703-004-5387,1537.1686,3,2,1,0.5557993136928848
29858,703-004-5381,9173.199,6,1,5,0.5816844720359136
30065,703-004-5391,483.50037,3,0,3,0.27920371738274696
30259,207-008-2398,4868.6675,6,4,2,1.9454673327584622
30574,703-004-5392,6776.9043,2,1,1,0.3934264752079499
30618,703-004-5386,812.52875,4,2,2,0.7149453352692088
30690,703-004-5383,8427.454,5,3,2,2.6151807241009184
30812,703-004-5383,6001.389,2,1,1,0.35831143730785864
30872,703-004-5384,3300.2483,3,1,2,0.4503203078907572
31104,703-004-5381,6859.643,3,1,2,0.4191944692305501
31468,703-004-5382,7641.309,2,1,1,0.7027551659650426
31572,703-004-5384,6641.52,2,2,0,0.8725258567701445
3198,207-008-2399,5246.1616,"","","",0.27920371738274696
32152,703-004-5385,1474.0062,4,3,1,2.219805626735179
3223,703-004-5387,6611.431,2,1,1,0.6848240363108155
32282,703-004-5380,525.03467,2,0,2,0.27920371738274696
32387,703-004-5385,6946.6885,3,2,1,0.6491729181347716
32430,207-008-2399,3886.5715,2,1,1,0.5165268771580819
33347,703-004-5380,8770.77,4,4,0,2.1557766341507327
33360,703-004-5399,5568.6636,2,0,2,0.27920371738274696
33414,703-004-5390,4105.9424,3,1,2,0.8681179567214222
33436,703-004-5398,4327.863,4,0,4,0.27920371738274696
33492,703-004-5399,2523.994,2,2,0,1.174759945159815
3380,703-004-5396,9598.402,5,3,2,1.80218063101549
34244,703-004-5398,2524.7234,8,4,4,3.2928009330748327
34375,703-004-5398,9654.275,1,1,0,0.3978652972704144
34861,703-004-5393,3921.9202,3,1,2,1.1773707830922564
34886,703-004-5383,6026.9844,4,1,3,0.3978652972704144
35452,703-004-5384,3586.1785,5,2,3,1.0883699683959505
35699,703-004-5390,4469.6533,3,3,0,1.3852965159421597
35722,703-004-5392,1593.2173,1,0,1,0.27920371738274696
35805,703-004-5398,3026.0002,2,1,1,0.5204613881208281
35868,207-008-2398,8389.371,3,2,1,0.6117582439839743
35919,703-004-5398,8781.193,8,5,3,2.0746978083014493
36013,703-004-5389,6634.992,3,2,1,1.6699539835837702
36084,207-008-2399,3941.536,6,5,1,1.6105052804610358
36352,703-004-5391,3316.3894,3,1,2,1.331331500446746
37107,703-004-5382,1697.231,"","","",0.27920371738274696
37885,703-004-5385,2229.1577,2,1,1,1.1723463660577744
37924,703-004-5394,5959.2344,5,2,3,0.382524050156366
38165,703-004-5395,11.994839,5,4,1,1.4693533128862213
38423,703-004-5394,5852.5264,7,3,4,0.9906431887192326
38647,703-004-5386,1179.732,4,2,2,0.5996422938538584
38821,703-004-5395,7624.608,3,2,1,0.7735049376372982
39049,703-004-5387,2471.8892,2,1,1,1.0030811860838107
39273,703-004-5394,4584.423,5,4,1,1.5668599180904121
39454,207-008-2398,1162.65,3,1,2,1.1613024969696286
3974,703-004-5397,1987.0479,2,2,0,1.5754005684085783
4065,703-004-5392,2335.655,10,4,6,1.9809537335741452
40880,703-004-5399,7450.773,2,0,2,0.27920371738274696
40902,703-004-5399,2133.0898,3,2,1,0.7269740354144524
41128,703-004-5389,7166.369,4,1,3,0.6041743660034314
41152,703-004-5391,2267.5085,4,2,2,0.5788860095052989
41396,703-004-5383,3883.9578,5,2,3,0.6554382330181105
41508,207-008-2398,5052.007,6,3,3,0.8039733311311966
41716,703-004-5387,1774.1871,3,2,1,1.6268203164209287
41796,703-004-5380,7970.8125,4,1,3,0.40538053066330004
41821,703-004-5380,7492.0537,5,1,4,0.5680632633712756
42000,703-004-5382,9334.613,4,2,2,0.6340227165642495
42049,703-004-5388,6208.215,3,0,3,0.27920371738274696
42441,207-008-2399,7112.522,2,1,1,0.3543840069263139
42546,703-004-5395,5281.1704,4,3,1,1.140278849141215
42761,207-008-2398,2237.0679,3,1,2,0.59583020809524
43101,207-008-2399,6034.7773,3,2,1,0.7770526354061275
4316,703-004-5395,4101.423,3,1,2,0.3978652972704144
43213,703-004-5395,1532.594,5,5,0,1.443896324228761
4325,703-004-5380,8577.066,3,3,0,0.897211435496584
43301,703-004-5389,8572.315,5,3,2,0.6613609032668408
43319,703-004-5395,2517.9595,7,2,5,0.4291956625351301
43355,703-004-5386,9203.484,"","","",0.27920371738274696
43570,703-004-5382,6794.0728,3,2,1,0.6744468856695155
43965,703-004-5392,9735.517,3,0,3,0.27920371738274696
44403,703-004-5384,803.9278,4,3,1,0.938047761898049
44499,703-004-5390,4261.876,4,1,3,0.897247701952731
44641,703-004-5394,6442.2505,1,0,1,0.27920371738274696
44995,703-004-5398,7580.5073,3,2,1,2.0836444699634624
45099,703-004-5398,9756.263,4,0,4,0.27920371738274696
45327,703-004-5384,1795.8259,4,1,3,0.5796115503943935
45490,703-004-5398,1931.2876,6,5,1,1.5338990729203366
45571,703-004-5398,1145.4058,9,4,5,1.71041508579811
45645,703-004-5388,8023.0947,6,3,3,0.7448666204326845
45755,703-004-5385,8267.743,1,0,1,0.27920371738274696
45789,703-004-5389,3365.1233,1,0,1,0.27920371738274696
45802,703-004-5380,3153.5398,3,2,1,0.648648419839187
45807,703-004-5387,9250.041,3,1,2,0.4684689373035765
46452,703-004-5389,579.8936,4,3,1,1.1589161493802098
4649,703-004-5389,3608.9087,4,1,3,2.1715299808169384
46540,703-004-5397,4231.551,4,1,3,0.4795086359292976
46647,703-004-5396,6376.79,5,1,4,0.9063312013895963
46656,703-004-5387,9943.844,5,3,2,0.9035023134981263
47079,703-004-5385,4394.688,5,2,3,0.673110218136237
47141,703-004-5388,6560.829,7,3,4,1.3353970148062826
47201,703-004-5387,7377.4253,7,4,3,0.7281400279577555
47336,207-008-2398,5823.7476,"","","",0.27920371738274696
48336,703-004-5382,4348.7036,4,2,2,0.6744905061142652
48433,703-004-5398,602.1601,5,2,3,1.2238786978935166
48768,703-004-5388,2967.4565,4,1,3,0.3940313072026002
48773,703-004-5384,6532.973,2,0,2,0.27920371738274696
49131,703-004-5383,8782.453,4,3,1,1.3595727496797803
49193,703-004-5385,5591.171,3,2,1,1.4266958727309207
5176,703-004-5382,5899.0405,7,4,3,1.8054573408097692
532,703-004-5392,1389.7366,1,1,0,0.8990359133248169
5567,703-004-5384,1065.43,4,0,4,0.27920371738274696
5570,703-004-5388,459.47372,5,3,2,1.656886981868441
5634,703-004-5395,9662.99,6,4,2,2.008423221732737
5733,703-004-5397,6911.359,5,3,2,1.416016056064002
5893,703-004-5399,9545.595,6,1,5,0.4383309583979787
5952,703-004-5395,2770.421,"","","",0.27920371738274696
6311,703-004-5381,2126.3445,3,1,2,0.5301422348350785
7287,703-004-5393,8917.598,1,1,0,0.7811233812601196
7292,703-004-5396,3772.9197,3,2,1,0.9361834845394411
7513,703-004-5399,1659.652,3,2,1,1.3706729160898627
7681,703-004-5380,2985.5735,2,2,0,2.725708861142755
7990,703-004-5399,4950.249,7,2,5,0.5610679673279196
8068,703-004-5395,2374.9011,5,3,2,1.0810588977488065
8151,703-004-5392,3749.5088,3,2,1,1.1070436058670212
8571,703-004-5396,9967.2705,6,2,4,1.0533501625816215
872,703-004-5394,2850.4717,6,2,4,4.488664810180028
8833,207-008-2399,4642.237,5,3,2,0.7532050830465629
8967,703-004-5394,4006.5317,4,2,2,2.5903765812115687
9176,703-004-5382,8200.291,3,1,2,0.35831143730785864
9223,703-004-5396,9333.09,5,2,3,2.031857633315296
9510,703-004-5398,3671.453,4,2,2,1.178893080292643
10192,703-004-5397,811.8969,7,5,2,1.3945676607132989
102,703-004-5383,6598.238,11,2,9,0.7825570807194665
10224,703-004-5392,5817.138,2,2,0,1.9643221554715837
10658,703-004-5393,4178.0474,5,2,3,1.112496841116989
10766,703-004-5391,9440.196,4,3,1,2.4886252728902756
11126,703-004-5398,418.55692,3,1,2,0.6808321007048317
11206,703-004-5384,9311.415,2,1,1,0.7818507916827975
11423,703-004-5386,9402.274,7,2,5,0.9901098406958566
11475,703-004-5398,2519.393,5,3,2,1.0000721361378235
11933,703-004-5396,4244.547,4,4,0,0.8885238263380216
11943,207-008-2398,9202.119,1,0,1,0.27920371738274696
12032,703-004-5394,4795.0425,8,6,2,3.3953536104335433
12085,703-004-5386,2458.2964,2,2,0,0.6978029192622435
1302,703-004-5395,2679.171,4,2,2,0.6182266772861557
13294,703-004-5388,7363.993,6,3,3,1.1410167445938788
13443,703-004-5391,5750.527,8,6,2,1.6784548375831887
13606,703-004-5398,3180.499,"","","",0.27920371738274696
13693,703-004-5393,5347.829,1,1,0,0.4936747432344577
13926,703-004-5399,5020.08,5,3,2,1.1049050628635375
14087,703-004-5388,9472.4795,4,2,2,0.7291219693444256
15093,703-004-5383,922.3151,2,1,1,2.6228914643362837
15268,703-004-5393,856.36615,1,1,0,0.5756805856772204
15363,703-004-5395,217.65709,2,2,0,2.492722629718809
15455,703-004-5391,4901.2524,5,2,3,0.9456678844965488
16398,207-008-2398,4119.952,3,0,3,0.27920371738274696
16462,703-004-5398,1623.1251,4,3,1,0.5674925294832402
16496,703-004-5381,9958.141,2,2,0,0.45719608721424815
16673,703-004-5395,6111.937,4,2,2,0.4749221881832839
16721,703-004-5399,3987.5781,2,1,1,0.33853450732658075
16964,703-004-5395,4655.101,3,1,2,0.3978652972704144
17333,703-004-5396,2651.112,1,0,1,0.27920371738274696
17820,703-004-5394,7668.9565,5,2,3,0.7215044795897646
17830,703-004-5399,6115.297,3,2,1,0.6023897863008337
17862,703-004-5382,1755.6083,4,1,3,0.5748372358440257
18033,703-004-5381,575.93823,9,3,6,1.9955776995083467
18134,703-004-5391,2296.1633,3,2,1,0.5189989934057416
18193,703-004-5392,7903.5664,5,3,2,1.0318781923278555
18272,703-004-5387,4945.6055,6,4,2,2.4823385644176335
18277,703-004-5387,9574.073,5,3,2,1.2255753801511675
18721,703-004-5392,3793.2534,7,3,4,0.621923612308001
19010,207-008-2399,8136.6157,6,4,2,2.0862212540637803
19134,207-008-2398,5998.333,2,1,1,0.48801060983729216
19299,703-004-5388,6257.9976,4,2,2,0.6033732373263998
19303,703-004-5394,7278.424,3,2,1,2.1721228488363478
19560,703-004-5387,2302.792,5,2,3,0.8465323523444294
19646,703-004-5397,6425.22,3,2,1,0.9522723457701445
19756,703-004-5393,32.67467,4,2,2,0.8479617453925856
2060,703-004-5399,3460.7517,2,0,2,0.27920371738274696
20921,703-004-5392,6660.0825,4,1,3,0.41953900673476024
21019,703-004-5386,3820.4385,2,0,2,0.27920371738274696
21588,703-004-5384,626.2386,7,6,1,1.3289257500375664
21886,703-004-5382,7410.1084,3,1,2,0.4584522121609208
22207,703-004-5392,2423.8193,6,3,3,2.7139666064743952
22464,703-004-5399,2380.5637,5,4,1,2.6337660774211065
22592,703-004-5392,3902.657,2,1,1,0.33853450732658075
22793,703-004-5380,8589.5205,2,1,1,0.4495780478770348
23161,703-004-5398,7089.051,5,3,2,1.2684877022001606
23276,703-004-5395,3243.376,5,4,1,2.2744768067647727
23299,703-004-5399,5881.679,3,1,2,0.4091542211571305
2373,703-004-5381,1906.9415,5,2,3,0.9027259153858915
23744,703-004-5382,6841.9863,3,1,2,0.566204715678251
23768,703-004-5381,6018.0146,2,1,1,0.450809926140235
24042,703-004-5389,2878.2207,9,8,1,2.5365378964179772
24302,703-004-5390,6871.473,4,2,2,0.587880298818741
24342,703-004-5380,8323.123,6,3,3,1.69862968312492
24488,703-004-5390,6950.254,6,1,5,0.47851828938344854
24541,703-004-5398,3303.4092,4,1,3,0.9208464230190708
24597,703-004-5396,8882.95,4,2,2,0.684286394437288
24689,703-004-5396,7098.237,"","","",0.27920371738274696
24732,703-004-5383,6283.804,3,2,1,0.7442639738268148
24990,703-004-5383,1151.9319,5,2,3,0.7627391548169304
25099,703-004-5388,2711.0613,7,1,6,0.4354699692544637
25313,703-004-5393,3635.9565,5,2,3,1.06159665652841
25965,703-004-5380,8474.871,3,2,1,1.0027756767642262
26105,703-004-5391,8258.507,7,3,4,0.9724470719138534
26115,703-004-5384,50.465466,5,0,5,0.27920371738274696
26177,207-008-2399,2342.3386,2,1,1,0.5465260106900864
26502,703-004-5394,7504.534,6,4,2,1.2538959386726818
26747,703-004-5392,7677.7295,8,7,1,1.7314355714064527
26968,703-004-5386,3242.8123,2,0,2,0.27920371738274696
27009,207-008-2398,1800.6771,4,2,2,0.8645404850246864
27100,703-004-5395,3607.1592,4,3,1,2.2865066682584527
27442,703-004-5392,2978.4507,3,1,2,0.3978652972704144
27451,703-004-5389,1915.8185,1,0,1,0.27920371738274696
27652,703-004-5391,5727.8164,"","","",0.27920371738274696
27685,703-004-5388,56.16963,5,2,3,0.7357214090273798
28338,703-004-5395,280.9453,4,3,1,1.42943995090321
2870,703-004-5385,6398.277,2,1,1,0.44829646872267315
28723,207-008-2399,8786.363,4,2,2,0.6982623863173332
29591,703-004-5394,6993.6294,5,3,2,1.1659159694427963
30177,703-004-5385,3564.1409,2,2,0,0.7214880575585527
30180,703-004-5388,4541.5845,6,3,3,1.055802931725136
3047,703-004-5389,5850.4087,2,2,0,1.3510389435285803
31057,703-004-5380,9022.152,1,1,0,0.4670084036395385
31271,703-004-5388,5501.947,6,5,1,4.004792843154729
31381,703-004-5396,3682.8518,5,5,0,1.5277297458217374
31467,703-004-5388,84.88774,2,1,1,0.35831143730785864
31547,703-004-5383,7110.2886,7,7,0,1.492884534648366
3157,703-004-5381,2279.787,4,3,1,1.059855144854051
32270,703-004-5397,9382.403,4,3,1,1.400007244696314
32391,703-004-5388,208.25803,6,4,2,1.8643672216594067
32445,703-004-5385,3332.715,4,1,3,0.40626987448339563
32469,703-004-5381,3488.7249,5,2,3,1.6877266990350535
32541,703-004-5385,4140.9307,3,1,2,0.9196204617803384
32576,703-004-5394,4197.0234,4,3,1,1.9218418664899546
3287,703-004-5392,784.7863,5,3,2,1.0793305944735352
33203,703-004-5386,3860.8325,3,2,1,0.5213310230660338
33365,703-004-5388,4554.6655,4,2,2,0.6733547030172107
33523,703-004-5393,610.8022,3,0,3,0.27920371738274696
33592,703-004-5385,5941.013,4,3,1,1.1902979535960394
33985,207-008-2398,3659.8396,4,2,2,0.8230482220011819
34106,703-004-5397,6411.8325,2,1,1,0.39753897792572335
34448,703-004-5393,2293.721,2,0,2,0.27920371738274696
35391,703-004-5397,4049.5945,5,2,3,3.679328100336841
35663,703-004-5384,6263.7725,3,2,1,1.5874743904852098
35856,703-004-5395,1228.6908,3,0,3,0.27920371738274696
36559,703-004-5391,7156.4106,4,2,2,1.1353661379809532
36682,703-004-5396,7122.521,3,1,2,1.7662942601462788
36727,207-008-2399,1463.5432,6,3,3,1.6569322839881502
36729,703-004-5394,3583.7417,2,0,2,0.27920371738274696
37118,703-004-5387,575.4566,3,1,2,1.0885907791941296
37167,703-004-5395,3720.1284,4,3,1,1.2171850138497842
37609,703-004-5383,4993.1123,4,3,1,1.3442988095558175
3780,703-004-5389,3024.9333,3,1,2,0.8116105504488785
37889,703-004-5397,8480.102,2,1,1,1.3364202912074383
38224,703-004-5388,4756.8975,1,1,0,0.6274018378599259
38310,207-008-2398,9285.717,4,3,1,1.6338972022012597
38811,703-004-5381,4759.3486,5,3,2,1.8769250945049594
39238,703-004-5399,9748.181,6,3,3,1.3860755592120768
39247,703-004-5380,2794.3743,4,2,2,0.6955879826494975
39393,207-008-2398,7388.411,3,3,0,1.2490427326572693
39449,703-004-5393,8573.344,1,1,0,0.789002810358589
39479,703-004-5383,7428.218,"","","",0.27920371738274696
39584,703-004-5389,1550.784,3,1,2,2.513570665063748
39596,703-004-5397,2610.3032,4,3,1,0.8358828487590118
40216,703-004-5384,7606.023,8,3,5,0.8449558245100051
40292,703-004-5399,3327.4353,2,0,2,0.27920371738274696
40401,703-004-5381,275.1416,1,1,0,0.833910336629107
40410,703-004-5381,1537.6097,1,1,0,0.35831143730785864
40610,703-004-5384,1894.5908,4,1,3,0.5383791487292702
40840,703-004-5389,2532.794,5,2,3,0.4941473031912678
40960,703-004-5387,1569.0189,12,9,3,4.492246393748992
40997,703-004-5386,515.30896,4,1,3,0.48439918023986245
4121,703-004-5386,5671.0786,7,6,1,1.8516308629340932
41421,703-004-5383,8904.542,1,0,1,0.27920371738274696
41490,703-004-5399,1891.2345,3,1,2,0.5192058688781354
41734,703-004-5386,3840.1824,3,2,1,0.4359678246645743
41753,703-004-5387,8298.538,2,2,0,0.49778205571020184
4191,703-004-5380,3325.352,5,2,3,0.9765938048201193
42181,703-004-5390,3021.89,5,2,3,1.1230918636542981
42333,703-004-5380,2861.2197,3,1,2,0.3807252912866403
42361,703-004-5384,4876.708,6,2,4,0.6393079139390049
42430,703-004-5393,3583.463,5,4,1,1.2743273691898729
42636,207-008-2398,4746.907,5,2,3,0.932655980281424
42790,703-004-5397,1808.7018,2,1,1,0.4330153003973981
4290,703-004-5398,58.40719,4,1,3,0.6964268463468577
42916,703-004-5399,8857.844,2,0,2,0.27920371738274696
43086,207-008-2399,4907.3457,2,2,0,1.5193975199493628
43654,703-004-5386,3455.0012,4,1,3,0.3187575773453028
44255,703-004-5382,2181.65,4,2,2,1.2247362358638822
44343,703-004-5394,9966.702,5,3,2,1.4112431280022761
44444,703-004-5381,6676.101,2,2,0,1.486255120201669
44572,703-004-5392,284.69205,3,3,0,1.3123873199774336
45015,703-004-5388,9929.138,1,0,1,0.27920371738274696
45315,703-004-5396,8368.65,1,0,1,0.27920371738274696
45444,703-004-5394,1941.694,"","","",0.27920371738274696
45482,207-008-2399,3852.7793,4,2,2,1.6375675266987084
45694,703-004-5394,7441.2793,8,5,3,1.80538627376918
45816,703-004-5395,5348.5596,6,3,3,0.938613237290751
46034,703-004-5386,8917.025,1,0,1,0.27920371738274696
46083,703-004-5395,1261.7255,2,2,0,0.7113552996244995
46147,703-004-5387,9478.567,5,3,2,1.5479558530507151
46416,703-004-5395,9816.248,9,5,4,3.0758156971506647
46706,703-004-5393,3870.0027,2,1,1,0.4626644872416187
46719,703-004-5389,9554.51,3,2,1,0.7374783339524855
47493,703-004-5385,8697.552,4,1,3,0.6479685917446629
47507,703-004-5392,9931.476,"","","",0.27920371738274696
47732,703-004-5382,7774.139,6,2,4,0.987883934550966
47916,703-004-5392,6310.1895,3,0,3,0.27920371738274696
48003,703-004-5396,3671.7559,3,1,2,0.6879703755002938
48163,703-004-5391,1833.216,5,3,2,0.8097241079637865
48230,703-004-5381,7519.578,3,2,1,1.1666710587889109
48486,703-004-5396,4755.125,3,2,1,0.7906732482798465
48628,703-004-5384,7701.7695,2,1,1,0.5501476581262543
48690,703-004-5394,5441.0117,7,5,2,1.6062406309212118
48744,703-004-5391,4940.6343,5,2,3,1.164798296290965
48989,703-004-5398,4531.836,3,1,2,0.36815297947202014
4924,703-004-5393,7151.078,3,1,2,1.1771716075799508
49541,703-004-5393,8733.146,4,1,3,0.3978652972704144
49642,703-004-5380,5855.991,4,2,2,2.727465489218769
49966,703-004-5399,9400.111,2,1,1,0.38274253814473064
49987,703-004-5393,7821.9614,6,3,3,2.6820071433960115
530,703-004-5395,7340.671,2,1,1,0.4938708831308786
5716,703-004-5391,1479.5005,3,0,3,0.27920371738274696
6051,703-004-5395,5470.573,7,3,4,0.982493679934808
6054,207-008-2398,7327.69,4,1,3,0.7355302896885763
6364,703-004-5382,6390.187,5,1,4,0.5568718143198889
6794,703-004-5398,9610.56,6,0,6,0.27920371738274696
6980,703-004-5386,8376.721,7,2,5,0.9999078637931296
6983,703-004-5390,2673.528,3,1,2,0.43744964666669145
6988,703-004-5389,1220.7819,4,2,2,0.931961582945999
7497,207-008-2398,9877.863,5,2,3,1.207989983435604
7860,703-004-5395,1434.2559,8,5,3,2.1094897297564685
7956,703-004-5393,4297.035,7,0,7,0.27920371738274696
8106,703-004-5386,9426.427,6,2,4,0.8474376111444768
8168,703-004-5388,4215.0586,5,5,0,2.4237731007889
8376,703-004-5384,9197.599,3,1,2,0.40460781133063417
8380,703-004-5394,2445.3271,6,4,2,1.5823412524875877
8476,703-004-5388,6026.305,6,4,2,1.3356900484939478
8593,703-004-5384,6182.6636,3,2,1,0.6390735959376905
8605,703-004-5393,9270.044,2,0,2,0.27920371738274696
8693,703-004-5392,4032.2285,2,2,0,0.6810070560987189
8946,703-004-5386,7396.974,3,2,1,0.8774162917677557
8964,703-004-5389,9517.556,2,2,0,1.1054682459165386
9074,207-008-2398,6588.562,4,1,3,0.6919882593243974
9251,703-004-5399,306.05792,7,4,3,1.4571488764056955
9282,703-004-5381,9032.508,1,0,1,0.27920371738274696
9307,703-004-5395,4413.0474,5,3,2,0.7194047730243184
9637,703-004-5385,5552.776,6,4,2,1.9277949380046038
9685,703-004-5383,9870.996,4,2,2,0.7952970490177909
9813,703-004-5384,3134.1243,3,0,3,0.27920371738274696
9861,703-004-5385,5359.4375,7,5,2,1.805073276065851
10065,703-004-5383,4840.658,"","","",0.27920371738274696
10216,703-004-5382,4784.9727,3,1,2,0.4158571747625472
10396,703-004-5381,1856.9111,1,1,0,0.8682802848270806
10454,703-004-5389,2917.3738,3,2,1,0.9285309794704576
10817,703-004-5382,196.90097,4,2,2,0.8897031271824283
11433,703-004-5392,8294.034,4,1,3,0.7594132149357188
11447,703-004-5393,7556.4946,2,1,1,0.401953928743529
11623,703-004-5394,8715.332,3,1,2,0.7445167973460916
11784,703-004-5382,3739.3086,2,2,0,0.3978652972704144
12120,703-004-5392,5570.69,5,3,2,1.4854385009427489
13132,207-008-2399,5822.826,7,6,1,2.632034667230556
13322,703-004-5397,5021.3647,2,1,1,1.0631419196541496
13336,703-004-5389,4749.919,6,4,2,1.2667732443834117
13379,703-004-5380,575.0871,7,2,5,1.8834687372316692
1344,703-004-5387,5130.232,3,0,3,0.27920371738274696
13525,703-004-5398,3605.618,4,2,2,0.9236762357737417
13538,703-004-5399,2763.2964,4,3,1,1.2922111706778396
13567,703-004-5382,2648.6653,8,4,4,1.854747702791198
14058,703-004-5387,2892.3267,4,1,3,0.33853450732658075
14203,703-004-5390,1487.9531,3,2,1,1.8802865810869311
14372,703-004-5398,805.6772,"","","",0.27920371738274696
14526,703-004-5396,1351.8644,9,3,6,0.7395117626969903
14543,703-004-5392,1517.5831,6,3,3,1.2831427081070779
14596,703-004-5384,7033.434,2,1,1,0.70003777715397
14827,703-004-5384,5041.302,5,1,4,0.5165268771580819
15073,703-004-5393,9836.373,4,2,2,0.7740398542993379
15124,703-004-5388,7544.629,9,6,3,1.6411214843618516
15525,703-004-5389,186.74194,2,0,2,0.27920371738274696
15882,703-004-5384,7879.5747,1,0,1,0.27920371738274696
15905,703-004-5393,1644.2418,4,0,4,0.27920371738274696
16058,703-004-5382,7217.4014,2,1,1,0.6788008743945527
16104,703-004-5387,1671.9008,1,0,1,0.27920371738274696
16513,703-004-5396,3445.245,4,3,1,0.9949022325447371
167,703-004-5397,466.37057,4,1,3,0.5165268771580819
16739,207-008-2399,7370.911,4,0,4,0.27920371738274696
17057,703-004-5381,2514.1836,5,3,2,0.8240003388970427
17202,703-004-5396,4066.559,3,2,1,1.3533086843360667
17272,703-004-5391,8471.378,3,2,1,1.418372201865481
17638,703-004-5384,300.23456,1,0,1,0.27920371738274696
17762,703-004-5397,4881.6016,10,6,4,2.5913294831082623
17889,703-004-5399,3560.8625,3,2,1,1.0944219221847868
18279,703-004-5393,3385.6953,7,5,2,2.730567804955594
18826,703-004-5393,2431.2407,4,1,3,0.3131070259220805
18911,703-004-5396,3794.4692,5,4,1,1.032144753836761
19126,207-008-2399,7433.0674,3,1,2,0.7793128159723398
19137,703-004-5394,9409.273,5,4,1,1.07653672481434
19510,703-004-5395,9446.151,2,0,2,0.27920371738274696
1961,703-004-5396,9396.865,1,1,0,0.6983150037188051
19860,703-004-5388,1349.3687,1,1,0,0.5165268771580819
19925,703-004-5381,105.3077,3,0,3,0.27920371738274696
20377,703-004-5392,5281.955,7,3,4,1.217617714682089
20610,703-004-5390,3185.348,7,4,3,2.4355685421756736
20968,703-004-5395,172.2479,3,0,3,0.27920371738274696
21093,703-004-5381,5946.154,4,0,4,0.27920371738274696
21095,703-004-5381,4311.13,4,2,2,1.5480998149752858
21381,703-004-5398,2609.8157,2,1,1,0.8924389540705021
21450,703-004-5380,5396.2725,2,2,0,0.7841466597438906
21539,703-004-5397,5912.8584,"","","",0.27920371738274696
2160,703-004-5390,180.72844,6,3,3,0.8011218273403913
21724,703-004-5398,1139.1616,6,4,2,1.3744861866077094
21914,703-004-5386,9651.12,5,3,2,1.8165668264764967
22927,703-004-5380,3034.0618,3,1,2,0.33853450732658075
22933,703-004-5385,7419.4253,5,4,1,2.519088357951368
23523,703-004-5389,6907.4756,6,3,3,1.1812713054219808
23664,703-004-5382,6030.886,2,1,1,0.4465921163382542
23688,703-004-5384,5028.3003,5,2,3,0.6303060274566213
2391,207-008-2399,6277.77,7,3,4,1.1704768698508465
24045,703-004-5384,5983.608,3,2,1,0.9642711447616851
24067,703-004-5392,8009.867,2,2,0,1.3027588705292465
24252,703-004-5391,7042.5737,3,1,2,0.5442236535650768
24350,703-004-5383,1816.8527,4,3,1,1.8966819584854502
24369,207-008-2399,4174.8257,3,2,1,0.8441047762308509
24906,703-004-5389,6726.555,3,0,3,0.27920371738274696
25088,703-004-5388,6023.8433,7,2,5,0.8923722377249758
25125,703-004-5388,269.09827,5,4,1,1.926165473560481
25228,703-004-5381,9675.596,4,0,4,0.27920371738274696
25326,703-004-5385,7009.4507,1,1,0,0.7819639671752678
25396,703-004-5383,6462.2563,2,2,0,1.009868905394288
25446,703-004-5391,4733.428,1,0,1,0.27920371738274696
25511,703-004-5380,5905.1597,1,1,0,0.4180377658513179
25515,703-004-5392,8171.746,7,3,4,0.7236168357380185
25968,703-004-5389,6482.3877,3,2,1,0.9801727118581414
26470,703-004-5380,6885.456,2,2,0,3.3024316755507983
28099,703-004-5392,1686.6135,1,1,0,0.43804213052738056
28835,207-008-2398,115.546585,2,0,2,0.27920371738274696
28925,703-004-5387,8321.017,3,1,2,0.3919322182760311
29018,703-004-5395,6820.921,4,3,1,1.147850500788044
29303,207-008-2398,2211.7424,4,2,2,1.44203815791048
29650,703-004-5398,9524.269,3,2,1,1.4300400912633284
29763,703-004-5394,3085.5037,1,0,1,0.27920371738274696
30049,703-004-5384,547.83167,5,1,4,3.5578494683852724
30140,703-004-5388,3003.9482,3,3,0,1.914098064284628
30202,703-004-5393,905.63116,5,0,5,0.27920371738274696
30343,703-004-5387,7551.4478,8,5,3,1.6124356127386141
30411,703-004-5388,1671.9926,9,3,6,0.6277201114576942
30746,703-004-5398,8210.0,7,4,3,1.6981309327036656
3082,703-004-5380,5416.236,5,1,4,0.6477082202662382
31239,703-004-5382,8914.137,5,3,2,1.2610549228178318
31441,703-004-5389,1920.2274,7,2,5,1.3282317092535267
31693,703-004-5389,5271.1924,2,1,1,0.33853450732658075
32127,703-004-5391,4149.603,4,2,2,0.4854313633149871
32242,703-004-5380,612.43536,4,0,4,0.27920371738274696
32655,703-004-5389,9627.949,7,3,4,1.3817919987849454
32806,703-004-5387,9231.812,2,2,0,0.6023655605235955
32928,703-004-5384,7921.6724,3,1,2,0.4382756631089095
3294,703-004-5386,5030.496,5,4,1,1.463803690627367
33111,207-008-2398,5373.476,7,5,2,1.5948934689335408
33424,703-004-5391,5007.6885,5,2,3,2.417990007879275
33457,703-004-5397,3362.658,3,3,0,0.9190062197851644
33613,703-004-5398,6820.981,4,2,2,0.4542295477170565
33775,703-004-5397,328.20105,4,3,1,2.1392845463464503
34285,703-004-5389,5298.35,2,0,2,0.27920371738274696
34291,703-004-5380,7175.644,4,3,1,0.7210159609149438
34329,207-008-2399,6829.9116,2,1,1,0.48770851603475696
34534,703-004-5384,2033.8333,3,3,0,0.9288693754706765
34630,703-004-5389,5864.8105,6,4,2,0.817593166078926
35159,703-004-5381,5837.4536,7,4,3,1.9186802091324848
35219,703-004-5390,9997.98,6,3,3,1.0587871212766602
36017,703-004-5399,2821.4055,7,2,5,0.6968871319177203
36048,703-004-5386,2896.0002,6,2,4,1.0491736712260171
36289,703-004-5388,2071.1685,3,2,1,0.6230791003178056
36441,703-004-5389,7468.468,7,2,5,0.5017794974578801
36442,703-004-5380,9846.817,7,3,4,1.5410635265775205
3655,703-004-5391,4139.2715,7,2,5,3.1901119251888472
36588,703-004-5383,4524.9604,5,2,3,2.3149429039591403
36664,703-004-5391,9492.089,3,1,2,0.679771863956117
36864,703-004-5382,5204.619,4,1,3,0.48104975520679977
36865,703-004-5391,3201.772,3,0,3,0.27920371738274696
36923,703-004-5392,6529.715,4,2,2,0.7040201222129251
37405,703-004-5382,1566.9424,6,3,3,1.202220795264028
3761,703-004-5394,5292.4546,1,1,0,0.4990905162025851
37664,703-004-5382,6032.2656,2,0,2,0.27920371738274696
38184,207-008-2398,2622.0215,6,4,2,1.3670226841274384
38198,703-004-5395,8078.1006,3,1,2,1.017267034119475
38417,703-004-5398,7629.2534,2,1,1,0.42017396362992965
38464,703-004-5385,4982.975,4,2,2,0.8292898105455041
3847,703-004-5384,9606.354,2,0,2,0.27920371738274696
38896,703-004-5388,1229.4889,1,1,0,0.5873298793792827
39076,703-004-5382,9568.892,4,3,1,1.2674093338302814
39286,207-008-2398,3553.5378,6,5,1,1.6424753443306446
39296,207-008-2398,6157.869,2,1,1,0.3902511792276225
39355,703-004-5390,1089.3005,8,3,5,0.6117744413386788
39601,703-004-5388,4452.401,5,3,2,1.821439455813836
39628,703-004-5387,9908.689,6,4,2,1.970337466553817
39920,703-004-5380,3293.572,3,1,2,0.39809625885104577
39955,703-004-5386,6319.204,3,2,1,1.1833157470170013
40112,703-004-5391,8690.508,5,3,2,1.6738428218733
40262,703-004-5399,1613.6682,6,2,4,0.6402304798073731
40299,703-004-5396,3942.7834,1,0,1,0.27920371738274696
40337,703-004-5387,9728.272,2,1,1,0.35831143730785864
40780,703-004-5384,8595.968,4,3,1,1.1646058304714082
41162,703-004-5383,2807.7317,5,4,1,1.082799376081255
412,703-004-5393,8501.14,4,2,2,0.8888586915184216
41578,703-004-5386,4975.959,2,1,1,0.6868305125990304
41651,703-004-5399,6186.928,4,3,1,0.6931424350768055
41760,703-004-5398,7412.5073,6,2,4,0.4698038800773128
41901,703-004-5396,7622.245,3,1,2,0.6268545795797698
42155,703-004-5382,227.8024,3,1,2,1.744540559997265
4238,703-004-5380,6711.3687,7,3,4,1.688270849820477
42473,703-004-5382,164.12079,3,1,2,0.45439294601728986
42575,703-004-5382,8293.258,4,3,1,1.2426252936643818
42610,207-008-2398,4365.3784,6,4,2,2.5792649776038616
42926,703-004-5383,7319.831,3,0,3,0.27920371738274696
43147,703-004-5392,7844.6865,3,1,2,0.43669954067405153
4327,703-004-5381,9901.48,1,1,0,0.3666442600459473
43881,703-004-5383,4977.4424,2,0,2,0.27920371738274696
4394,703-004-5395,4453.331,2,1,1,0.6989270056557659
43997,703-004-5397,6402.513,5,3,2,1.5933185249432802
44293,207-008-2398,7118.503,4,2,2,0.7752435249309768
44432,703-004-5387,4183.058,6,2,4,0.8288855745155743
44506,703-004-5388,4022.0183,3,2,1,1.2918720349026358
44542,703-004-5398,2599.2798,"","","",0.27920371738274696
44644,703-004-5390,5493.0483,6,4,2,1.350655652784461
44899,703-004-5390,3097.6277,3,1,2,0.7522945994952074
44974,703-004-5395,2499.5972,2,1,1,0.6399476133809896
44975,703-004-5397,8001.7446,"","","",0.27920371738274696
45045,703-004-5384,4152.44,3,2,1,0.6109898244070219
45351,703-004-5383,8784.186,4,2,2,0.6022096732150174
45682,703-004-5390,4843.812,4,0,4,0.27920371738274696
45829,703-004-5387,1427.0055,6,2,4,0.6860290626240731
45867,703-004-5398,1176.1165,2,1,1,0.5227024898367817
46008,703-004-5383,6826.1963,5,2,3,0.8397992417692606
4602,703-004-5383,8310.352,3,2,1,1.65341822052816
46045,703-004-5386,3900.5708,2,1,1,0.6733376042258765
46298,703-004-5395,2033.6282,5,1,4,0.8220450992093
46348,703-004-5383,1471.8652,7,3,4,1.3969857882446075
47114,703-004-5397,9415.95,7,6,1,1.271940428099676
47210,703-004-5390,9520.089,2,2,0,0.8719757632813899
47468,703-004-5388,5060.0737,3,3,0,1.2484929606498951
47671,703-004-5381,2313.6592,2,1,1,0.42053789941645114
4773,703-004-5386,2.0891428,6,1,5,0.5057947243031805
47835,703-004-5398,3338.5403,9,4,5,1.160336829108288
47993,703-004-5388,9493.207,6,4,2,2.3108824248039017
48377,703-004-5395,9111.584,5,3,2,3.400616470791073
48380,703-004-5388,6068.695,5,3,2,1.1173150768434252
48438,703-004-5394,9375.657,8,4,4,2.1549576390311667
48620,703-004-5398,828.7126,6,1,5,0.5508743328270361
49087,703-004-5388,1212.9265,7,3,4,1.8767861791679312
49101,703-004-5390,1079.4055,3,2,1,0.7700513542070112
49447,703-004-5395,860.78107,5,1,4,0.32666834933781397
49644,703-004-5388,7752.8555,4,2,2,1.0176517544893025
49921,703-004-5381,2851.9226,1,0,1,0.27920371738274696
49968,703-004-5385,232.63335,1,0,1,0.27920371738274696
5011,703-004-5380,7311.746,3,0,3,0.27920371738274696
5025,703-004-5391,8110.1606,5,3,2,1.1993264459906188
5388,703-004-5384,4897.9146,2,0,2,0.27920371738274696
5430,703-004-5389,7848.913,4,3,1,0.6399401652526351
5468,703-004-5398,3350.8755,5,4,1,2.150470086724998
5596,703-004-5389,6314.0366,6,2,4,0.998433935137267
5720,703-004-5396,1993.6365,4,2,2,0.8765794507673741
6034,703-004-5381,7876.029,4,3,1,0.6414751672714734
6040,703-004-5382,9694.201,6,3,3,1.339226729786129
6446,703-004-5380,4770.9346,3,1,2,0.4272075660477935
6476,703-004-5391,7487.3423,6,2,4,0.7973592828922281
6531,703-004-5385,3905.5938,7,3,4,0.6642853475987421
6552,703-004-5397,4075.4038,2,0,2,0.27920371738274696
6574,703-004-5390,6047.9893,5,2,3,0.9070920759648591
6672,703-004-5392,9820.192,7,3,4,1.3366356205535623
6694,703-004-5397,4812.9487,2,2,0,1.9720029704832442
6730,703-004-5396,1130.7329,4,2,2,0.47103993820114265
6810,703-004-5396,8495.777,3,2,1,0.7978839828659096
6950,703-004-5380,6368.279,9,3,6,1.172582603670977
729,703-004-5396,4351.8965,8,4,4,1.1468783250275425
738,703-004-5386,4280.6187,2,1,1,0.3131070259220805
7642,703-004-5386,9527.087,1,1,0,0.6356074807497276
7658,703-004-5396,2471.6406,"","","",0.27920371738274696
7803,703-004-5389,1738.205,"","","",0.27920371738274696
7825,703-004-5384,685.6221,3,1,2,0.5158578141346445
8023,703-004-5389,4303.034,3,1,2,0.8534626196509595
8033,703-004-5390,6272.253,5,3,2,2.1238688110183563
8093,703-004-5391,8360.104,4,1,3,0.35831143730785864
8268,703-004-5387,4772.9834,2,1,1,0.44249002800326986
9112,703-004-5383,3839.3557,2,0,2,0.27920371738274696
9350,207-008-2399,5111.814,3,1,2,0.45761277283495216
936,703-004-5395,1376.2444,3,1,2,0.35831143730785864
9987,703-004-5391,1262.6923,5,3,2,1.9855193044866675
9992,207-008-2399,8760.731,7,4,3,2.5785141901123203
10028,703-004-5388,7324.2104,2,1,1,0.8440048409315394
1028,703-004-5397,2063.9258,6,1,5,0.8055907446143682
10403,703-004-5396,183.40886,3,3,0,1.452321119237687
10575,703-004-5382,1354.8142,7,4,3,1.1460749720136438
10615,207-008-2398,1852.4873,1,1,0,0.3565006121564479
10736,703-004-5383,1126.3389,3,2,1,1.6912095900594368
10920,703-004-5384,9821.0,2,2,0,1.1243196622515377
11190,703-004-5399,686.96735,2,1,1,0.5886880170583915
11210,207-008-2399,1402.4985,3,2,1,0.8044667613092475
1138,703-004-5393,1878.6377,3,0,3,0.27920371738274696
11707,703-004-5382,3700.341,5,5,0,1.0264205703260811
12098,703-004-5389,8206.216,2,0,2,0.27920371738274696
12180,703-004-5384,6267.532,6,5,1,1.882065585584211
12261,703-004-5392,5577.068,4,4,0,1.3672337114819268
12524,703-004-5386,3161.9578,2,1,1,0.9524867164120726
12578,703-004-5399,1819.7787,2,1,1,0.33853450732658075
12615,703-004-5397,4310.467,1,0,1,0.27920371738274696
12929,703-004-5395,1078.1145,4,3,1,2.3385708326633314
12998,703-004-5391,7343.135,4,2,2,1.1417620760780685
13100,703-004-5392,5675.101,4,2,2,2.2697194446960576
1355,703-004-5386,3578.9788,12,5,7,2.1080783223875375
13770,207-008-2398,2964.4246,6,4,2,2.535351714983797
14093,207-008-2399,9854.956,1,1,0,0.34693970256862383
14107,703-004-5384,7836.423,3,0,3,0.27920371738274696
14284,703-004-5380,7461.5054,2,2,0,0.4169829962523164
1449,703-004-5397,7821.9785,2,2,0,2.299942909089975
14529,703-004-5384,8406.408,3,2,1,0.7315724646458865
14541,703-004-5387,2746.7268,4,2,2,0.735812185292595
14711,703-004-5389,6140.1826,4,1,3,0.5517305763999629
14775,703-004-5383,2552.9617,2,2,0,1.193907975079634
15074,207-008-2399,8346.306,4,3,1,1.194705851796824
1621,703-004-5388,9760.861,4,4,0,1.137402416131755
16308,703-004-5381,6789.3164,6,0,6,0.27920371738274696
16420,703-004-5397,7891.2505,6,3,3,1.4688536356909796
16583,703-004-5390,9393.624,4,1,3,1.3639157587917674
16677,703-004-5394,3660.184,7,3,4,1.2908607858864227
17010,703-004-5393,6342.5664,5,1,4,0.39829505709890495
1725,703-004-5391,2039.5231,4,1,3,0.6333118016802312
17298,207-008-2399,8457.83,5,3,2,1.2379881046714798
17409,703-004-5383,9064.989,4,3,1,1.1055390916972998
17527,703-004-5389,5171.6807,3,0,3,0.27920371738274696
17560,703-004-5384,6280.834,4,3,1,0.49166500796287427
17687,207-008-2398,7987.7944,5,2,3,0.8351506536240683
17709,703-004-5385,4807.8867,3,1,2,0.6218719908583555
18071,703-004-5398,5718.5923,6,3,3,2.4573928200503468
1828,703-004-5396,439.34344,5,5,0,2.705622551153336
18343,703-004-5384,5358.3706,3,2,1,1.5331809346259229
18561,703-004-5395,8048.8813,3,2,1,0.7665884988403608
18713,703-004-5381,7270.892,5,3,2,0.6971460594653452
18741,703-004-5394,7520.2515,5,1,4,0.613816434998519
18800,703-004-5386,1055.3973,8,6,2,2.2933175366667475
1900,703-004-5391,2744.6277,3,3,0,1.192228196020968
19174,703-004-5393,9680.237,4,2,2,0.892635677049465
19215,207-008-2398,7976.187,6,5,1,1.7131817717677076
19255,703-004-5397,535.0554,1,0,1,0.27920371738274696
19782,703-004-5386,1540.8867,1,1,0,0.33853450732658075
19967,703-004-5392,3129.9812,2,0,2,0.27920371738274696
20788,703-004-5380,4305.631,6,1,5,0.5762590782668437
20823,703-004-5382,6980.0596,1,0,1,0.27920371738274696
21173,703-004-5380,8800.171,5,2,3,0.4453299292254814
21224,703-004-5387,2835.384,1,1,0,0.34077043346774527
21237,703-004-5389,2352.5137,1,0,1,0.27920371738274696
21246,703-004-5389,4422.984,1,0,1,0.27920371738274696
21291,703-004-5390,4728.81,4,2,2,1.2390038098512623
21652,207-008-2399,4216.3726,6,4,2,1.4436877966868693
22051,703-004-5386,250.59938,2,0,2,0.27920371738274696
22225,703-004-5386,3190.4614,3,1,2,0.5133729967164694
22306,703-004-5387,512.27094,7,3,4,0.9354668728417386
22350,703-004-5398,2469.6375,4,1,3,0.32666834933781397
2245,207-008-2399,9815.534,5,3,2,0.7976493770463211
22562,703-004-5380,1227.9231,3,1,2,0.7400259252368169
22659,703-004-5383,9724.528,7,2,5,1.6401074442364183
22764,703-004-5380,1969.8983,7,3,4,0.7113924944501067
22769,703-004-5394,6710.476,4,4,0,1.2505284045090936
22872,703-004-5383,8020.9487,5,1,4,0.5228193115158452
23004,703-004-5391,6676.984,"","","",0.27920371738274696
233,703-004-5382,6859.137,8,6,2,2.97520999768912
23342,207-008-2398,8266.726,1,1,0,0.33853450732658075
23558,703-004-5391,4922.612,4,2,2,0.8264899580665945
23915,207-008-2398,4543.0405,3,0,3,0.27920371738274696
23997,703-004-5398,8927.043,3,2,1,0.8139933225447473
2416,703-004-5391,1404.3569,3,2,1,1.5159462717841805
24551,703-004-5381,7698.7427,2,1,1,0.35831143730785864
24628,703-004-5389,5134.8984,1,0,1,0.27920371738274696
2482,703-004-5380,5056.563,2,1,1,0.3978652972704144
25310,703-004-5387,5790.919,6,3,3,0.955843907165901
25377,703-004-5381,5741.638,1,1,0,0.6198447217970151
26010,703-004-5396,5752.84,5,0,5,0.27920371738274696
26243,703-004-5387,2689.9202,2,2,0,0.5607173823530698
26369,703-004-5390,4457.309,7,4,3,1.3645411861732313
26922,703-004-5394,4780.4946,1,0,1,0.27920371738274696
27488,703-004-5386,2869.5203,1,0,1,0.27920371738274696
27579,703-004-5390,5154.4004,3,2,1,0.5513394272746265
27897,703-004-5385,6325.672,5,5,0,4.489980827621088
27950,703-004-5382,5653.625,5,2,3,0.7644841616198292
27968,703-004-5398,9335.343,5,4,1,1.6396592812598214
27985,207-008-2399,5490.668,6,3,3,0.8972249645346841
28043,703-004-5392,1829.0382,3,3,0,1.0986529165223005
28100,703-004-5392,6668.798,5,3,2,1.651682096150887
28331,703-004-5386,8172.005,9,3,6,0.8432215724150357
28805,703-004-5388,4553.773,1,0,1,0.27920371738274696
292,703-004-5396,4586.122,7,5,2,1.4854625570237716
297,703-004-5390,6511.7495,4,3,1,1.037100808237993
29720,703-004-5382,3809.8323,3,1,2,0.617732898966439
29972,703-004-5386,202.34346,6,3,3,1.051736272888296
29984,703-004-5396,8485.935,5,3,2,0.9938565325298805
3018,703-004-5397,7833.116,4,2,2,0.5789043037481364
30186,703-004-5386,8987.226,9,4,5,1.5332108587025153
30261,703-004-5388,1931.7085,5,1,4,0.5203691984728398
30471,703-004-5390,8855.827,6,1,5,0.49528320791896285
3083,703-004-5398,1131.866,6,4,2,1.1201167966734373
30851,703-004-5384,783.7862,7,5,2,5.379328203515782
31000,703-004-5396,3866.5188,2,1,1,0.8525169436905025
3103,703-004-5392,4770.0127,12,3,9,1.3028513654239249
3141,703-004-5392,3739.9458,"","","",0.27920371738274696
3144,703-004-5399,4678.1694,1,1,0,0.8178699229992361
31881,703-004-5391,7232.3174,3,2,1,1.4155280111325501
32051,703-004-5391,4095.1555,2,1,1,0.5676370967055053
32067,703-004-5389,473.07193,2,2,0,0.7094839859402803
32447,207-008-2399,8459.636,2,1,1,0.4442987182924171
32603,703-004-5399,7657.4434,3,1,2,0.4582790558898871
32794,703-004-5390,7604.243,6,3,3,0.9481401967847773
32804,703-004-5392,5018.5176,3,2,1,1.228967764376823
33054,703-004-5385,6754.7417,7,3,4,1.3231384675045303
33452,703-004-5394,4466.4277,6,3,3,0.9493497163254802
33652,703-004-5394,8467.748,5,4,1,0.8801155012970958
33670,703-004-5394,8921.044,6,4,2,1.2734635990860448
33699,703-004-5392,100.13699,2,0,2,0.27920371738274696
33746,703-004-5393,8661.567,4,3,1,0.7063307236646519
34292,703-004-5387,8519.722,3,1,2,1.5869761211168998
34294,703-004-5391,1816.2966,3,2,1,0.9805456568346014
34585,703-004-5387,9127.166,2,1,1,0.5976838850633303
34728,703-004-5387,489.45605,5,3,2,2.0566783151398447
34734,703-004-5396,1063.5227,4,2,2,0.6994252283867806
3476,703-004-5380,3766.805,1,1,0,0.403045754207177
3480,703-004-5395,851.9584,1,1,0,0.3978652972704144
34907,703-004-5395,3624.808,4,2,2,0.7649310689994492
35442,703-004-5398,6246.7427,6,5,1,1.7572024171756644
35488,703-004-5387,3247.8828,"","","",0.27920371738274696
35730,703-004-5394,8537.277,4,3,1,1.3629442115298533
35743,703-004-5396,9595.694,"","","",0.27920371738274696
35828,703-004-5391,6856.0415,2,0,2,0.27920371738274696
36278,703-004-5389,6336.224,4,2,2,1.037800085212396
36859,703-004-5394,9411.471,5,2,3,0.5266501931922485
37003,207-008-2399,4014.386,3,1,2,2.2580513514598577
37053,703-004-5395,7136.3594,2,1,1,0.7524526218230835
3734,207-008-2399,8270.3955,1,0,1,0.27920371738274696
37849,703-004-5389,2017.5105,5,1,4,0.41453547343308783
37883,703-004-5394,1054.9658,5,3,2,1.432032070247018
38214,703-004-5391,9081.429,7,4,3,1.6140441282291433
3832,703-004-5380,4837.931,3,1,2,0.7367748029003134
38406,703-004-5391,3469.9453,6,3,3,3.078087260696785
38877,703-004-5395,5484.27,2,1,1,0.4345119485257224
38910,703-004-5386,732.0273,6,2,4,1.2314097904546013
39132,703-004-5398,9700.125,4,1,3,0.5239203217440266
39141,703-004-5390,4688.3374,6,2,4,0.9826101753080583
39251,703-004-5392,6255.2373,2,2,0,0.5755313477572246
39335,703-004-5398,9272.688,5,3,2,1.317729768088879
39432,207-008-2399,419.4796,4,2,2,1.2271573103066447
39451,703-004-5398,2292.9102,6,3,3,3.490507788758883
39623,703-004-5396,4655.2925,1,0,1,0.27920371738274696
39737,207-008-2398,207.96895,2,2,0,0.9212388879436371
40075,703-004-5387,3840.9412,1,1,0,0.8647084438307584
40268,703-004-5397,2634.2166,3,0,3,0.27920371738274696
4039,703-004-5390,1544.0214,4,2,2,1.0301818460747052
4070,703-004-5385,5016.186,4,1,3,0.5640478390382845
40961,703-004-5395,9795.301,6,4,2,2.132520950057695
41172,703-004-5385,2411.57,7,1,6,0.6316309960177309
41289,703-004-5396,2578.7961,3,1,2,0.6587553935046891
41582,703-004-5392,8734.216,3,3,0,1.9338608940014184
41610,703-004-5394,4512.8276,7,3,4,1.568695739057373
41663,703-004-5384,1081.4131,5,2,3,1.765441363999367
41743,703-004-5391,5808.665,2,1,1,0.39907663423176776
41943,703-004-5391,6996.9346,4,2,2,0.7532958055416542
41979,703-004-5394,5494.0464,4,2,2,1.2473206644972754
4203,703-004-5399,3821.2722,4,4,0,1.6964811505795048
42117,703-004-5390,8536.989,2,1,1,0.469729716589883
42518,703-004-5397,167.22679,3,0,3,0.27920371738274696
42681,703-004-5397,5822.3086,3,2,1,1.8507615963830586
42749,703-004-5391,8264.655,4,4,0,1.3325509322665696
42774,703-004-5384,9383.506,6,4,2,0.8003575539622725
43074,703-004-5381,4897.6577,2,1,1,0.646359746639391
43248,703-004-5384,3407.2393,5,2,3,1.2197988516285674
43415,207-008-2399,571.44226,2,0,2,0.27920371738274696
43804,703-004-5391,8711.411,8,3,5,1.8668815164175983
4422,703-004-5383,6887.3555,4,0,4,0.27920371738274696
44365,703-004-5394,9618.134,4,1,3,1.6757073559985127
44463,703-004-5392,3131.0005,4,3,1,1.9078513534981272
44511,703-004-5395,4879.8955,4,2,2,1.1170193501887111
45145,703-004-5387,6465.684,3,2,1,0.7708210065211031
45362,703-004-5383,8435.734,5,3,2,1.302401336593111
45385,703-004-5384,768.6615,5,3,2,0.7369251169285218
45507,703-004-5398,5098.7456,5,3,2,1.1999356094423426
45533,207-008-2399,4038.3386,3,2,1,1.0905298464303086
45616,703-004-5381,2293.8586,4,3,1,1.0904257693858688
45809,207-008-2399,6709.714,3,2,1,1.6017817563593275
45926,703-004-5389,5088.9746,5,2,3,1.2435721361708658
46155,703-004-5392,975.0521,4,3,1,1.8022474309429615
46323,703-004-5383,314.65173,4,3,1,1.101960127431172
46448,703-004-5392,4240.945,3,1,2,0.6992366664873492
4655,703-004-5383,2620.9575,2,1,1,0.4083803780451922
4746,703-004-5386,7780.08,8,5,3,1.6246645645040536
47555,703-004-5381,6213.2095,4,1,3,0.4459155650622224
47583,703-004-5382,2223.2817,1,0,1,0.27920371738274696
47709,703-004-5389,9676.497,2,1,1,0.5224861810650763
47939,703-004-5386,2188.332,6,2,4,0.5936169400170295
48485,703-004-5399,4222.6694,9,4,5,0.625706679840153
48612,207-008-2398,9334.57,2,1,1,0.41337322149236944
48917,703-004-5391,1973.5753,1,1,0,0.35831143730785864
4914,207-008-2398,4027.4197,8,5,3,1.1147236601521064
49481,207-008-2399,4321.7095,3,2,1,0.5701110511338419
49571,703-004-5397,6226.29,2,0,2,0.27920371738274696
49626,703-004-5391,244.37488,5,5,0,1.761073677859488
49926,703-004-5387,5581.462,6,1,5,0.3468408179187174
49943,703-004-5382,1040.0516,5,4,1,3.5580389930682466
5013,703-004-5382,7357.788,4,2,2,0.7778274697862685
5255,703-004-5394,5075.222,6,3,3,2.423667752152647
5435,703-004-5380,3166.7136,4,2,2,2.337460572226266
5648,703-004-5382,1708.9265,3,2,1,0.46731519292543056
6549,703-004-5386,2001.6968,5,5,0,1.17825185430008
6635,207-008-2399,1486.9636,7,5,2,2.749420510922128
6712,703-004-5388,7440.3296,2,0,2,0.27920371738274696
7272,703-004-5398,7058.7974,3,2,1,0.7587762683753496
7519,703-004-5386,239.9671,4,2,2,0.6870003142513126
7972,703-004-5391,6012.811,5,1,4,0.6121856242133732
8077,703-004-5389,6087.3877,3,3,0,1.0594520744971632
8094,703-004-5397,8404.725,7,4,3,1.692733885201586
8138,703-004-5391,111.80699,5,2,3,0.7058181188051927
827,703-004-5382,929.8706,2,1,1,0.5323484211431042
8364,703-004-5391,1110.6622,3,2,1,0.5733216500004226
8450,703-004-5391,8392.791,4,1,3,0.7150970098767694
8676,703-004-5380,330.5185,3,1,2,0.8638236275233123
879,703-004-5381,3454.1433,6,4,2,1.6767327383039783
8901,207-008-2399,1185.1543,2,2,0,0.5751030990223278
9244,703-004-5388,1464.5791,3,3,0,0.5790549374488888
9414,703-004-5387,5599.5303,7,3,4,3.400831233195457
971,703-004-5396,7942.5146,2,1,1,1.2329386630872254
993,703-004-5385,8550.526,5,4,1,0.883801054760325
10511,703-004-5383,8083.296,3,3,0,0.5116076130368638
10698,703-004-5387,3095.4617,3,1,2,0.8130889459810572
10724,703-004-5390,5775.6655,5,4,1,1.856180028484656
10797,703-004-5389,3939.194,"","","",0.27920371738274696
11204,703-004-5386,4059.2349,4,2,2,0.566349896863142
11548,703-004-5383,6895.525,7,6,1,1.5433877680888766
11624,703-004-5384,3227.0098,4,2,2,0.5063738954403485
11664,703-004-5382,4519.485,6,3,3,1.0560261863301375
11740,703-004-5384,4556.4087,4,2,2,1.692697978051893
12228,703-004-5394,9858.631,8,3,5,1.171167270973889
12324,703-004-5382,725.8117,7,4,3,1.8367091048846
126,703-004-5387,6608.22,4,0,4,0.27920371738274696
12610,703-004-5385,4249.8745,3,2,1,0.9112824885507819
12635,207-008-2399,8900.126,2,2,0,0.893424146092277
12716,207-008-2398,7699.3633,8,2,6,1.244550947298733
13004,703-004-5393,1651.1261,4,3,1,1.9937340175438663
131,703-004-5383,2013.7632,4,2,2,0.7124927506167728
13347,703-004-5388,7357.4146,3,1,2,0.35831143730785864
13359,207-008-2398,8794.424,3,3,0,1.0277521351875367
13485,703-004-5398,84.640976,3,2,1,0.9793506969473278
13763,703-004-5383,2476.5747,6,2,4,0.6955466114653563
140,703-004-5387,4591.8228,5,4,1,1.0802698421475931
14256,703-004-5399,3544.3115,4,2,2,0.5560423898888437
1433,703-004-5392,4572.9106,1,1,0,0.7919326452551593
14406,703-004-5391,3599.153,5,3,2,2.289105068060366
14874,703-004-5398,8101.986,5,2,3,1.7495133353630377
14918,703-004-5394,9126.902,4,2,2,1.1277102349594783
14921,703-004-5396,5797.7676,5,2,3,0.4806191882020045
15439,703-004-5397,1977.7471,5,2,3,2.5293293264637895
15551,703-004-5397,7808.5713,4,3,1,0.6850534040961458
15677,703-004-5386,8090.8555,8,2,6,0.4698038800773128
15888,703-004-5383,6449.253,6,2,4,0.8110025566549416
15968,703-004-5394,5540.8325,7,5,2,1.076292194837827
1633,703-004-5398,5479.4336,3,3,0,0.9263760990801638
16569,703-004-5387,2287.4546,5,3,2,1.336284329375037
16652,703-004-5392,6406.0396,5,2,3,1.406868902213582
16670,703-004-5384,5138.277,3,2,1,1.063669270859717
1676,703-004-5383,8040.9126,1,0,1,0.27920371738274696
16866,703-004-5389,8944.551,6,3,3,0.6354580172102189
16906,703-004-5398,9338.162,5,2,3,0.5946749020043984
17,703-004-5395,8090.748,5,4,1,2.020036179011454
17086,703-004-5384,9145.496,2,1,1,0.5112063607585607
17096,703-004-5381,8503.616,2,0,2,0.27920371738274696
17287,703-004-5399,5448.581,6,3,3,2.1382257772141346
17550,703-004-5394,1172.3202,6,1,5,0.35831143730785864
17672,703-004-5388,5971.0474,2,0,2,0.27920371738274696
1772,703-004-5386,2699.0217,7,2,5,1.2264988156000587
17800,703-004-5383,6089.4243,5,2,3,1.3749635871020731
17807,703-004-5392,3221.2197,4,2,2,0.5296455740456628
17905,703-004-5386,5801.456,3,1,2,0.8342642702954165
18087,703-004-5396,6056.9346,2,1,1,0.439863412515508
1834,703-004-5395,8990.557,2,0,2,0.27920371738274696
18580,703-004-5387,867.3382,3,1,2,0.34174256551797944
18643,703-004-5386,7806.8696,2,0,2,0.27920371738274696
18730,703-004-5380,5990.532,7,3,4,1.2165229283190078
1887,703-004-5399,4955.548,4,1,3,0.7125116131940056
19284,703-004-5383,2314.7964,10,2,8,0.7939733708676074
19310,703-004-5384,7239.074,4,4,0,1.3053575844994851
20336,703-004-5386,5142.72,5,1,4,0.4230808829965438
20346,207-008-2398,9290.074,4,2,2,2.9792838354547215
20718,703-004-5386,8359.705,4,1,3,0.7539043229858328
20785,207-008-2398,960.3244,5,3,2,2.4818787943208998
20864,703-004-5393,5003.2495,7,3,4,0.9967051704135202
21768,703-004-5399,6389.66,4,2,2,0.8818845203412582
21816,703-004-5383,2419.3442,4,2,2,0.5985177508976284
22038,703-004-5380,1110.8386,5,2,3,0.7783521241055691
22087,703-004-5389,1076.9767,4,2,2,1.2885144069479224
22929,703-004-5387,7659.8066,6,3,3,0.644770627029413
22969,703-004-5381,6639.6753,3,2,1,0.47868380877494343
2325,207-008-2398,7792.46,4,3,1,1.7561375586507768
23773,703-004-5383,4052.6873,5,2,3,0.6206585669959083
23960,703-004-5391,7102.593,8,4,4,1.5187242528127172
24006,703-004-5381,8859.113,5,2,3,0.7016747360667038
24112,703-004-5380,3256.383,5,4,1,1.3401709782636433
24356,703-004-5396,946.216,2,1,1,0.3978652972704144
2441,703-004-5385,5166.2974,3,3,0,1.5993402618224695
24432,703-004-5396,3533.4766,5,2,3,1.101398012017874
24770,703-004-5394,7013.411,2,2,0,1.7771860586782893
24799,703-004-5397,1378.29,8,2,6,0.925906717134981
24811,703-004-5398,6325.7646,4,0,4,0.27920371738274696
25023,703-004-5384,183.80225,4,3,1,1.1041622026318112
25059,703-004-5389,4975.2573,4,1,3,0.5609260849660508
25358,703-004-5390,9942.683,5,4,1,1.1673280469421023
25813,703-004-5394,8725.685,5,3,2,1.0774791009765858
26147,207-008-2399,5962.4,2,1,1,0.8441210111293709
2631,703-004-5394,3092.6443,6,4,2,5.255138072763342
26379,703-004-5380,3600.4644,4,4,0,1.5516151918558214
26581,703-004-5394,6022.578,5,3,2,2.3315963611590407
26658,703-004-5398,9236.278,"","","",0.27920371738274696
26717,703-004-5394,3683.325,4,0,4,0.27920371738274696
26793,703-004-5394,6748.771,5,1,4,0.5837684390944268
27294,703-004-5393,2720.0996,6,2,4,1.1314359256941777
27596,703-004-5386,6864.448,"","","",0.27920371738274696
27598,703-004-5396,4342.1274,4,2,2,2.151464861813194
27744,703-004-5399,2001.4197,5,2,3,1.1439162205597009
27747,703-004-5396,7090.8057,1,0,1,0.27920371738274696
27887,703-004-5390,1742.9161,2,0,2,0.27920371738274696
27893,207-008-2399,8003.318,3,1,2,0.7435778810088333
27929,703-004-5392,1599.2338,3,2,1,0.5196211953580929
28072,703-004-5396,3895.355,3,2,1,0.8812275803679227
29165,703-004-5388,6141.3726,5,1,4,0.5643390099396794
29225,207-008-2399,7805.724,3,1,2,0.35831143730785864
29250,703-004-5394,6827.3096,4,3,1,2.2055054123734013
29523,703-004-5383,3676.1594,1,1,0,0.4733019245677514
29717,703-004-5396,5439.851,4,2,2,1.0845944697078134
29727,703-004-5385,3128.2043,9,3,6,1.1263237856299113
2981,703-004-5386,287.52267,4,1,3,0.9993843308253536
30207,703-004-5396,6900.024,6,3,3,3.6678715838416154
30238,703-004-5398,2704.546,6,2,4,0.6808395327233359
30501,703-004-5399,5354.8374,7,4,3,1.6061244192070774
30534,703-004-5395,5955.7134,5,2,3,0.9319862566192714
30573,703-004-5380,7158.6143,9,6,3,3.799244097258846
30650,703-004-5386,8656.234,2,2,0,0.5381208125813898
30674,703-004-5396,214.39075,5,2,3,0.8832900436608809
31013,207-008-2398,174.0414,1,1,0,0.5031227681070214
31138,703-004-5390,5424.0815,2,1,1,0.8583559189172434
31202,703-004-5388,1967.1989,6,2,4,0.5884587942742576
31274,703-004-5397,5280.833,3,1,2,0.7700852968855999
31373,703-004-5380,8138.9546,4,2,2,0.9629342833045195
31519,703-004-5397,1862.6207,4,2,2,1.111253987083274
31524,703-004-5399,6583.7246,4,1,3,0.7584025350637935
31957,703-004-5384,631.1804,4,3,1,0.5812956797301887
32092,703-004-5387,2299.3494,"","","",0.27920371738274696
3228,703-004-5397,4797.726,4,2,2,1.0582359730968014
32419,703-004-5387,827.3065,6,2,4,0.4542295477170565
32653,703-004-5383,364.1176,5,3,2,1.0027324646872071
32692,703-004-5381,7923.058,3,1,2,0.6251720706002025
32949,703-004-5389,9015.382,3,3,0,1.1834104897972768
33026,703-004-5397,5313.935,4,3,1,1.0194608826125933
33184,207-008-2398,7259.3384,6,3,3,0.6178506420878647
33210,703-004-5383,778.18036,6,2,4,2.1539436520079938
3351,207-008-2398,7868.4775,6,2,4,1.3052988802671914
33822,207-008-2399,9014.916,6,6,0,2.681871589754158
34034,703-004-5383,9699.094,1,1,0,0.5757662211787072
34112,703-004-5380,406.53467,6,1,5,0.5165268771580819
34170,703-004-5387,9540.045,5,2,3,1.0165405968835213
34349,703-004-5384,931.0359,3,2,1,0.9324568912787059
3437,703-004-5389,8755.292,5,3,2,1.4193981962531619
34394,703-004-5396,7617.3853,4,2,2,0.7836489460519168
34395,703-004-5385,5835.931,3,2,1,0.8841581828411705
34777,703-004-5395,7564.1084,2,0,2,0.27920371738274696
34876,703-004-5397,5275.9365,8,6,2,3.578266235755119
34983,703-004-5386,3744.3472,5,2,3,0.6427047807497984
3511,703-004-5396,4135.9253,2,1,1,0.42413709234417374
35223,703-004-5388,2776.2668,2,0,2,0.27920371738274696
35236,207-008-2399,3029.7322,3,1,2,0.5669580486103406
35683,703-004-5386,739.2847,2,0,2,0.27920371738274696
36205,703-004-5384,3279.9285,4,1,3,0.5632783772115243
36977,703-004-5383,6951.1274,3,1,2,0.726894827215479
37050,703-004-5396,5842.088,6,2,4,0.47697301719552604
37062,703-004-5381,7788.6016,4,4,0,1.1202723316023118
37129,703-004-5380,5508.736,3,2,1,0.47691055460952847
37471,703-004-5384,70.18685,5,3,2,1.173979746150551
37620,207-008-2398,2093.656,5,2,3,0.7394024684366435
3774,703-004-5382,7617.026,7,4,3,1.337743049867152
37798,703-004-5399,1926.6254,4,3,1,0.6034077158420583
38273,703-004-5390,5979.136,"","","",0.27920371738274696
39011,703-004-5388,1511.1965,4,2,2,1.4159352596404855
39070,207-008-2398,3788.8186,4,2,2,0.7777050154380654
39180,703-004-5398,1335.3235,3,2,1,1.2072061558109184
3939,703-004-5382,3863.0586,4,2,2,1.1416021087309278
39476,703-004-5382,1846.0637,2,0,2,0.27920371738274696
39633,703-004-5391,6544.151,2,1,1,0.5192058688781354
39684,703-004-5390,6241.3906,3,2,1,3.017778385157804
39763,703-004-5381,978.8781,9,5,4,1.8521749890165122
39873,703-004-5395,9665.785,4,3,1,1.08968764880485
39898,703-004-5391,9667.548,6,3,3,1.4549939056028502
40535,703-004-5399,3010.5698,7,4,3,1.2278814938126723
40656,703-004-5382,2613.3782,5,2,3,0.7099846247461162
40860,703-004-5397,4689.7554,3,2,1,0.5252009989920539
41297,703-004-5392,9637.614,1,0,1,0.27920371738274696
41732,703-004-5384,7134.7603,6,2,4,0.8589964237583512
41776,703-004-5390,3520.0046,5,2,3,1.908426467378985
4186,703-004-5394,3848.3948,4,1,3,1.099016472754877
42379,703-004-5380,381.338,7,4,3,2.0065024723248204
42459,703-004-5390,7477.8564,5,1,4,0.4230808829965438
42559,207-008-2399,1574.7804,1,1,0,0.48236389995783113
4273,703-004-5384,435.72784,3,1,2,0.5049962141339766
42811,703-004-5382,6318.3896,3,1,2,0.33853450732658075
42878,703-004-5389,5606.4805,6,4,2,2.966520202534543
42924,703-004-5388,8654.471,4,1,3,0.8063929367604675
43265,703-004-5384,7928.056,3,2,1,1.210886427152077
43432,703-004-5399,3242.3455,2,1,1,0.3953899716207262
4407,703-004-5383,141.02995,4,1,3,0.6516186118661117
44177,703-004-5385,771.9928,8,6,2,2.0292161067821435
44413,703-004-5380,4218.1226,3,1,2,0.5088246510966035
4446,703-004-5392,5345.9097,5,2,3,0.6319483366838164
44723,703-004-5393,8199.453,5,3,2,0.9596330897350802
44743,703-004-5389,3765.9114,4,1,3,0.38384586422702993
4495,703-004-5392,2149.3984,4,2,2,0.7897093380009654
45006,703-004-5387,2678.8164,2,2,0,0.7259795552942541
45081,703-004-5385,8545.979,3,3,0,1.7632741361987694
45294,703-004-5380,8835.606,4,1,3,0.9501717358269189
45573,703-004-5387,1502.5503,6,4,2,1.2633481580610724
45914,703-004-5384,1881.4534,8,6,2,2.5305706825511924
46047,703-004-5383,637.31134,4,1,3,0.6678035689051041
46286,703-004-5389,5122.0996,2,1,1,0.33853450732658075
46359,703-004-5389,1221.8403,7,5,2,1.3546534317784487
46596,703-004-5381,302.23547,3,1,2,0.3468408179187174
46615,207-008-2399,5358.174,4,1,3,1.0972492512346177
46646,207-008-2399,7554.702,5,2,3,0.7980019097990318
47243,703-004-5393,8987.701,3,2,1,1.4648671149382853
47540,703-004-5383,2533.9763,3,1,2,0.3978652972704144
47558,703-004-5389,9248.399,5,3,2,1.010564546708264
47632,703-004-5388,677.9695,6,4,2,1.2377748314855963
47660,703-004-5395,8118.931,2,1,1,1.1155401787264763
47886,703-004-5396,4901.846,1,0,1,0.27920371738274696
47907,703-004-5398,5737.7363,4,3,1,0.6910656158037807
48064,703-004-5390,619.67017,10,6,4,2.0200947711764843
48173,703-004-5381,7206.881,4,1,3,0.45835355205613326
48252,703-004-5391,5387.8345,4,3,1,1.2425737291909231
48453,703-004-5389,9765.422,5,0,5,0.27920371738274696
48779,703-004-5381,7703.4907,2,1,1,0.3978652972704144
48793,703-004-5381,6601.9077,5,3,2,2.110870940756283
49177,703-004-5388,9247.432,1,0,1,0.27920371738274696
49248,703-004-5381,8546.356,5,1,4,0.5516190111279945
49325,703-004-5392,8051.168,4,2,2,0.5950215267259543
49367,207-008-2398,5359.872,3,0,3,0.27920371738274696
49425,703-004-5393,4664.163,3,2,1,0.555972203350525
49662,703-004-5383,2278.244,5,4,1,1.2429179557024992
49787,703-004-5388,6977.3726,3,3,0,1.141651469200633
49816,703-004-5382,8439.943,7,2,5,0.4604131565435546
49829,703-004-5388,8458.771,7,4,3,0.792716384650815
49937,703-004-5388,9385.65,1,1,0,0.3271627725873459
5230,703-004-5388,7712.492,5,3,2,2.4196843301588804
5418,703-004-5389,7481.107,4,2,2,0.5493996865312738
549,703-004-5387,9826.854,3,3,0,1.3878284970874948
5649,703-004-5395,9460.715,2,0,2,0.27920371738274696
5836,703-004-5386,8364.162,4,2,2,0.520057172465068
6008,703-004-5387,3449.263,7,3,4,0.8838080161128937
640,703-004-5386,160.50577,1,0,1,0.27920371738274696
6546,703-004-5396,9866.31,3,2,1,0.944657416285955
6570,703-004-5391,1125.2874,4,3,1,1.598157321530044
6876,703-004-5381,917.57654,3,0,3,0.27920371738274696
6907,703-004-5394,7079.7603,2,0,2,0.27920371738274696
7296,703-004-5399,270.11633,3,1,2,0.594921258161381
7350,703-004-5398,4600.549,1,0,1,0.27920371738274696
7463,703-004-5380,7868.4707,4,3,1,0.8565126398992718
8020,703-004-5391,6062.9155,2,1,1,0.9678896605869816
8074,703-004-5383,71.60783,5,3,2,3.466633095135352
8299,703-004-5383,244.62997,2,1,1,0.4056771288970555
8668,703-004-5391,6207.6636,10,4,6,1.7442619358521438
8834,703-004-5393,9098.274,4,2,2,0.6248107365395094
8992,703-004-5391,1060.8768,2,1,1,0.7996587758080144
9302,207-008-2399,8242.03,8,5,3,3.0473682388386796
9390,703-004-5384,5994.403,4,1,3,0.3415216477925028
9576,703-004-5392,5484.1357,4,1,3,0.7359478260080674
9638,703-004-5399,4598.647,5,4,1,0.9188662874619141
9799,703-004-5399,4662.8975,8,2,6,0.6801526216780082
9800,703-004-5397,1506.8871,2,0,2,0.27920371738274696
9844,703-004-5392,1905.5688,1,1,0,0.49136799617134763
10163,703-004-5397,8332.708,3,0,3,0.27920371738274696
10187,703-004-5388,2590.4941,3,1,2,0.35831143730785864
10306,703-004-5385,358.38187,2,1,1,1.2197786913941044
10474,703-004-5396,6748.304,3,0,3,0.27920371738274696
10627,703-004-5383,4690.336,4,2,2,0.9467125158133651
10821,703-004-5384,8591.559,1,0,1,0.27920371738274696
10832,703-004-5382,9310.747,7,1,6,0.6472381090292468
10899,703-004-5397,6465.497,5,3,2,0.6481014563476392
10900,703-004-5384,4171.2188,5,2,3,1.061803962840818
1091,703-004-5380,7187.276,3,0,3,0.27920371738274696
11605,703-004-5396,8238.859,5,1,4,0.46191016503014665
11645,703-004-5387,2528.792,1,0,1,0.27920371738274696
11680,703-004-5386,2301.5952,4,3,1,0.9202419116425604
1188,703-004-5398,2635.7812,7,3,4,0.9410532405089562
11919,703-004-5394,8052.776,2,1,1,0.33853450732658075
12057,703-004-5398,2067.7388,3,2,1,0.9153487392202678
12182,207-008-2398,4906.6157,4,3,1,1.326502922925714
12197,703-004-5394,6865.2534,2,1,1,0.35831143730785864
1223,207-008-2399,810.6524,3,1,2,0.6198391669212007
12280,703-004-5398,817.7698,1,0,1,0.27920371738274696
12286,703-004-5386,4253.728,6,2,4,0.5685402030088428
12303,207-008-2398,9071.738,6,2,4,0.5941977171454409
12702,703-004-5386,8813.232,6,3,3,1.2447589271438388
1306,703-004-5382,4772.487,1,1,0,0.457080320572115
13083,703-004-5387,8391.355,6,1,5,0.44776873686551916
13307,207-008-2398,8756.573,1,1,0,0.3978652972704144
13344,703-004-5391,5326.7114,4,3,1,1.834300255654331
13481,703-004-5386,7111.1094,1,0,1,0.27920371738274696
13559,703-004-5383,9749.684,3,3,0,1.1157564641870603
13725,703-004-5383,9393.771,4,1,3,0.3187575773453028
14001,703-004-5389,2298.2185,2,0,2,0.27920371738274696
14465,703-004-5392,6452.123,3,1,2,0.6906428757287673
14473,703-004-5396,2492.727,5,2,3,0.9138427840662902
14506,703-004-5387,4469.246,2,1,1,0.5182197632350083
14661,703-004-5386,3144.5676,3,1,2,0.35831143730785864
14702,703-004-5391,7597.7314,4,3,1,1.7410133988322558
14865,207-008-2399,3336.9995,2,2,0,0.8832883879060524
1493,703-004-5387,6425.664,6,1,5,0.4294688313804965
15040,703-004-5383,2929.8352,8,2,6,1.9167931876340267
15182,703-004-5384,9895.878,9,8,1,3.935918610406175
1537,703-004-5392,6163.941,7,3,4,2.2197232647616087
15649,703-004-5387,6782.9854,6,2,4,0.6850235112540486
15856,703-004-5381,2762.5007,1,1,0,0.5388042473634393
15917,703-004-5387,6500.198,5,0,5,0.27920371738274696
15933,703-004-5382,3279.316,2,1,1,1.248700441009823
15959,703-004-5390,2088.1016,"","","",0.27920371738274696
15970,703-004-5387,8646.489,6,2,4,1.1172304026456947
16079,703-004-5380,5139.794,3,1,2,0.35831143730785864
16630,703-004-5391,8013.308,5,2,3,1.1987813581269222
1703,207-008-2399,9352.451,2,1,1,1.41080838105377
17045,703-004-5399,1848.5033,3,2,1,1.3225485685475717
17074,703-004-5382,5459.012,4,2,2,0.7849155248937252
17173,703-004-5384,1780.6041,3,1,2,1.5390762274477625
17196,703-004-5397,2926.6555,5,3,2,1.4569950078684222
17492,703-004-5394,9173.723,3,1,2,0.589487456922928
17508,703-004-5396,9469.899,4,1,3,0.925487474527316
17517,703-004-5398,9941.533,6,2,4,0.7632282799510236
18116,703-004-5393,2748.5322,4,1,3,0.6334722904788371
18204,703-004-5380,363.1884,"","","",0.27920371738274696
18207,703-004-5386,5527.7397,6,3,3,1.247464099468755
18231,703-004-5398,1867.792,3,0,3,0.27920371738274696
18244,703-004-5386,442.23846,1,1,0,0.7777731252267605
18744,207-008-2398,6112.5737,5,1,4,0.8955787218558326
1876,703-004-5394,6344.8994,6,3,3,0.9726409480655116
18915,703-004-5388,245.04305,4,2,2,0.9188466123802094
19023,703-004-5387,7325.8696,2,2,0,0.5524483657528086
192,703-004-5383,9887.067,1,0,1,0.27920371738274696
1945,703-004-5381,5789.4873,6,2,4,1.2749969978327023
19732,703-004-5394,9906.393,10,2,8,1.2348247263793926
19787,703-004-5393,7942.8145,4,2,2,1.1538856764039536
20061,703-004-5397,503.968,2,2,0,1.1847013046588868
20259,703-004-5385,7151.9365,2,1,1,0.6556888930488423
20281,703-004-5387,9452.692,5,2,3,1.1843438665912365
20409,703-004-5386,1297.0048,8,3,5,0.6789206432546674
2081,703-004-5382,3448.0447,3,0,3,0.27920371738274696
20941,703-004-5385,1977.6797,8,3,5,0.9464499938773352
21122,703-004-5390,460.5633,8,4,4,3.3466889021762913
21742,703-004-5398,1406.8436,4,2,2,0.6262295077642304
21744,703-004-5380,7807.965,1,1,0,0.7360868740730449
22032,207-008-2399,8437.376,3,2,1,1.1463168937867187
22159,703-004-5382,4827.903,4,2,2,0.6541759204899135
22244,703-004-5389,4498.6772,6,1,5,0.32666834933781397
22522,703-004-5382,6337.2217,5,1,4,0.45522898524765815
2273,703-004-5388,5266.4785,3,2,1,1.8589970909656746
22838,703-004-5386,1703.0632,7,3,4,0.9795428933880291
2284,703-004-5385,7984.468,4,1,3,0.5165059293288617
22896,703-004-5391,9606.352,4,2,2,0.5378269503174284
22994,703-004-5387,1577.9132,4,2,2,0.7130820743429442
23312,703-004-5390,911.11005,2,1,1,0.401885928342064
23649,703-004-5393,918.36926,3,3,0,2.1213810545289133
23680,703-004-5387,9892.553,3,3,0,0.8628120465000609
23827,703-004-5390,8110.6577,9,4,5,2.346476560485679
23913,703-004-5390,7314.9224,1,1,0,0.3807252912866403
23998,703-004-5394,3431.5425,4,0,4,0.27920371738274696
24192,703-004-5391,5378.22,5,2,3,0.6343797373322663
24486,703-004-5381,5949.6685,3,1,2,0.6784357843873348
24747,703-004-5384,1914.5018,4,3,1,1.080806777247585
24879,703-004-5386,8822.733,2,1,1,1.1940480111459724
25243,703-004-5397,9530.792,3,2,1,0.793961814890753
2525,703-004-5394,884.6104,1,1,0,0.43635686333262635
2534,703-004-5398,2174.1611,4,0,4,0.27920371738274696
2590,703-004-5396,9953.885,6,3,3,1.2452782407859082
26453,703-004-5392,4514.4014,11,3,8,1.8660239220389923
26496,703-004-5389,6066.436,3,0,3,0.27920371738274696
26505,703-004-5384,875.8229,7,2,5,0.7426131784075333
27041,703-004-5390,8084.877,4,2,2,0.6873986803675312
27107,703-004-5398,9830.515,1,1,0,1.0439669816777724
27289,703-004-5390,6145.63,2,0,2,0.27920371738274696
2800,703-004-5389,6816.8447,7,3,4,1.8534550604553877
28227,703-004-5395,9802.748,"","","",0.27920371738274696
28355,703-004-5384,8025.358,5,4,1,1.0805508870389409
29277,703-004-5391,21.46244,2,1,1,0.35831143730785864
29718,703-004-5393,7106.702,7,3,4,0.9171339299574837
29975,703-004-5390,4921.019,2,1,1,0.3653802771383096
29995,703-004-5387,7627.717,4,2,2,1.6312101902480756
30298,703-004-5388,31.094551,4,2,2,1.289622536455488
30677,703-004-5390,7697.921,7,2,5,0.9502511148027636
311,703-004-5395,3216.381,5,3,2,2.1256131407440377
31604,703-004-5382,7756.5547,5,1,4,0.35831143730785864
31618,703-004-5391,3063.1064,8,6,2,3.9906512305115
3175,703-004-5385,8943.965,4,2,2,0.7245225603921466
31889,703-004-5381,8071.4736,8,4,4,2.631348058819949
31896,703-004-5396,9313.083,4,3,1,1.4836376323385603
31961,703-004-5398,8414.655,4,3,1,1.139592376584806
32241,703-004-5380,9625.07,6,4,2,1.0094072679933819
32258,703-004-5384,2244.6238,2,1,1,0.5665980207073232
32324,703-004-5399,9249.375,2,1,1,0.613796703979811
32478,703-004-5391,5384.9077,3,3,0,1.111178733931175
33138,703-004-5390,3156.4343,5,4,1,0.6902370763880202
33154,207-008-2399,2583.4495,2,1,1,0.7284438845939849
33240,703-004-5382,1083.6315,2,1,1,0.43404458121512324
33530,703-004-5389,2736.2375,3,0,3,0.27920371738274696
33630,703-004-5387,8548.645,3,2,1,1.1020920668268348
33888,703-004-5399,9137.607,2,1,1,0.7638410689971227
34027,703-004-5383,7975.493,4,2,2,1.2460337718780117
34437,703-004-5395,919.67523,7,4,3,1.2386733022598226
34521,703-004-5396,4383.205,3,2,1,0.6199828663684196
34542,703-004-5387,4298.175,1,0,1,0.27920371738274696
34678,703-004-5385,20.515324,6,5,1,1.7514292863183323
34961,703-004-5398,8132.447,"","","",0.27920371738274696
35074,703-004-5390,2007.0059,4,2,2,0.5499044569063621
3522,703-004-5396,1306.9087,5,3,2,1.1261547379999683
35817,703-004-5389,851.8058,2,1,1,0.9976517446132785
36046,703-004-5387,6574.385,4,2,2,1.137760955516083
36395,703-004-5382,9129.468,1,0,1,0.27920371738274696
36605,703-004-5390,1941.2798,5,4,1,1.4425832646565535
36618,703-004-5398,29.801727,3,1,2,1.1060881018512927
36760,703-004-5392,5059.5225,6,5,1,1.7030591906628654
36874,703-004-5391,3528.315,10,5,5,0.9958092722253666
37077,703-004-5380,3579.871,6,2,4,1.3804138019914154
37377,703-004-5391,8040.8228,2,1,1,0.35831143730785864
37490,703-004-5382,9651.981,5,3,2,1.6015100142174195
37493,703-004-5388,7449.854,5,2,3,0.6605346570143518
37509,703-004-5394,1336.3141,5,3,2,2.080834176621714
37743,703-004-5390,7744.2764,3,0,3,0.27920371738274696
37744,703-004-5392,1182.158,5,3,2,1.26878170813755
37943,207-008-2398,4914.1235,2,1,1,0.4158571747625472
38163,703-004-5389,339.92767,6,2,4,0.7585682631146534
3824,703-004-5386,8730.315,4,4,0,1.4978957719603723
38250,703-004-5393,5008.5396,5,1,4,0.32666834933781397
38420,703-004-5398,904.3056,4,1,3,0.37635788591577474
38626,703-004-5386,5531.6646,"","","",0.27920371738274696
38681,703-004-5390,7236.511,1,0,1,0.27920371738274696
38751,703-004-5391,8315.314,5,0,5,0.27920371738274696
38994,207-008-2398,7326.3193,6,3,3,0.9751332597157062
39173,703-004-5381,4733.4907,6,1,5,0.3606139538272136
39179,703-004-5387,6735.6167,6,4,2,1.858262216893305
40040,703-004-5386,2033.1598,3,1,2,0.6735009857531908
40170,703-004-5381,9583.965,5,1,4,0.5426674635645088
40335,703-004-5383,4975.0557,6,2,4,0.6989811189941287
40357,703-004-5399,2447.858,3,2,1,0.47404108732580164
40692,207-008-2398,4708.2144,3,0,3,0.27920371738274696
40799,703-004-5397,6402.1646,6,3,3,1.458840485991656
40823,703-004-5386,8352.339,5,3,2,1.8142796519151623
4106,703-004-5395,5997.901,4,3,1,1.1462805987504827
41150,703-004-5390,326.69843,4,3,1,0.9150845990461858
41234,703-004-5390,5175.355,2,1,1,0.8546076157777222
41530,703-004-5393,2506.2346,6,4,2,1.1284318981006387
41562,703-004-5392,8246.368,3,2,1,1.7216074793989822
41719,703-004-5384,4407.9375,4,0,4,0.27920371738274696
41741,703-004-5381,7068.5635,3,3,0,1.440890883640733
41880,703-004-5385,9236.666,2,1,1,0.7935982557456054
41951,703-004-5384,3458.7349,4,4,0,1.7069482166906338
41988,703-004-5391,8610.841,"","","",0.27920371738274696
42034,703-004-5380,1750.6683,7,4,3,1.9445728020853166
42214,207-008-2399,8597.581,3,2,1,0.8221241922629752
42414,703-004-5389,6066.412,8,3,5,2.8867201800406264
42640,207-008-2399,5261.169,5,2,3,1.0265986408200405
42835,703-004-5386,1198.3842,8,1,7,0.509545657611898
43451,703-004-5394,8666.779,2,0,2,0.27920371738274696
435,703-004-5396,7096.015,8,5,3,1.3821643208054386
43540,703-004-5395,5736.4224,6,5,1,2.7424506599312664
43721,703-004-5390,2978.6687,3,1,2,0.5165268771580819
43869,703-004-5399,1996.0922,2,1,1,0.47142771318836235
44231,703-004-5388,5968.93,2,1,1,0.6480340972024824
44722,703-004-5384,1834.1761,2,0,2,0.27920371738274696
44991,703-004-5386,4470.0337,4,4,0,3.647666062463933
45257,703-004-5387,497.67493,7,2,5,1.0392745487783028
45541,703-004-5381,384.7915,4,2,2,0.5846971554188322
45582,703-004-5396,8328.618,3,1,2,0.9584644064424027
45890,703-004-5392,9183.393,11,8,3,4.537173213345467
45893,703-004-5386,9313.247,5,1,4,0.7182515629671166
46129,703-004-5389,9199.913,1,1,0,0.44819604540597213
46268,703-004-5395,5429.377,6,4,2,1.4087946451439242
46455,703-004-5390,7628.7783,2,2,0,0.6402599036100624
46751,703-004-5393,8323.562,5,3,2,1.1845348069543353
46865,703-004-5384,3483.5935,2,2,0,0.9121498450103683
46877,703-004-5399,6302.1416,7,5,2,2.058994992876778
47023,703-004-5385,5153.1855,5,2,3,1.0378628612134762
47027,703-004-5381,953.04785,4,2,2,0.8890893929382477
47331,703-004-5397,9181.743,8,5,3,1.9717736689349359
47413,703-004-5389,7550.6025,3,2,1,1.273340499624253
47816,703-004-5393,5480.2515,3,3,0,0.8909917911981751
47864,207-008-2399,3772.5276,2,1,1,0.6097225115114098
47982,703-004-5381,7783.8755,9,7,2,3.6781291406886907
48033,703-004-5382,3421.0903,6,2,4,0.7559403796909574
48164,703-004-5389,8221.274,7,3,4,1.5542139378900257
48574,703-004-5390,3276.9568,2,2,0,0.8920163344425889
49621,703-004-5398,3487.3462,5,2,3,0.5693915294533815
5164,703-004-5384,7947.9746,6,2,4,1.0106989598930394
5594,703-004-5382,4821.577,4,3,1,1.9220659435649587
5601,703-004-5399,8220.269,5,3,2,0.7632834625676652
5639,703-004-5381,4916.568,5,2,3,0.6084845668105352
590,207-008-2399,3646.891,3,2,1,1.4810111885241775
655,703-004-5383,4826.679,3,1,2,0.6267261378614718
664,703-004-5398,9050.205,3,2,1,1.542819439059317
6799,703-004-5399,5213.2495,7,2,5,0.8289015497038006
7338,703-004-5384,7681.6016,7,4,3,3.3224621419964424
7367,703-004-5383,8869.264,8,4,4,1.3070657257712417
7413,703-004-5386,5288.0996,6,2,4,0.6926888925203032
7656,207-008-2398,6041.88,4,2,2,0.886339924730231
8111,703-004-5394,4160.782,2,0,2,0.27920371738274696
8310,207-008-2398,6298.5264,4,0,4,0.27920371738274696
8437,703-004-5384,8206.542,1,1,0,0.39500725460357117
848,703-004-5391,1349.5458,2,0,2,0.27920371738274696
8628,703-004-5396,5775.94,6,1,5,0.6113971146848679
8916,703-004-5391,1345.0927,1,0,1,0.27920371738274696
9058,703-004-5398,2178.9526,7,2,5,0.5564738530600747
9396,703-004-5388,9787.079,6,4,2,2.100462572086388
9460,703-004-5397,9151.06,7,3,4,2.8071452609737584
9538,703-004-5392,731.2024,8,5,3,1.825719871643019
956,703-004-5399,4691.2427,5,3,2,1.1291030686597412
9672,703-004-5398,1731.3462,2,0,2,0.27920371738274696
972,703-004-5396,685.8468,5,0,5,0.27920371738274696
9856,703-004-5382,3735.534,5,3,2,0.9735700386265749
10016,703-004-5380,4263.9023,3,2,1,1.6602540395937564
10043,703-004-5382,7374.235,3,2,1,0.47697301719552604
10045,703-004-5396,5683.33,4,3,1,0.775950756187495
10126,703-004-5383,4455.2314,4,1,3,0.4851215510430012
10158,703-004-5399,2725.5332,4,2,2,0.8770947121991284
10172,703-004-5397,5130.447,5,3,2,0.8648920390150467
10236,703-004-5386,2599.8562,4,3,1,0.5263093943095354
10369,703-004-5394,5064.374,4,2,2,1.6191357940806947
10387,703-004-5388,3332.7908,4,3,1,0.8561999748860257
10800,703-004-5388,3529.3687,3,1,2,0.8407329345256286
10924,703-004-5399,551.0026,2,1,1,0.35831143730785864
11401,703-004-5398,568.7797,5,4,1,1.7400287920435573
11426,207-008-2399,2340.0222,3,2,1,0.7751544350122024
11556,703-004-5398,9034.848,6,3,3,1.610564372844103
11650,703-004-5395,7993.293,2,0,2,0.27920371738274696
11661,703-004-5393,7318.644,4,2,2,0.7037497717084776
11732,703-004-5389,3729.4287,2,0,2,0.27920371738274696
11751,703-004-5396,12.690425,5,2,3,0.7515068869656912
11764,703-004-5383,6503.6206,5,3,2,0.9406440463768412
12039,207-008-2398,6111.0728,2,2,0,0.4670528953829379
12373,207-008-2398,2331.7163,2,1,1,0.5447638366665719
12580,703-004-5381,942.722,6,3,3,2.2816826034323676
12725,207-008-2399,5470.0225,4,3,1,2.3670569162876127
12981,703-004-5388,5787.6255,7,3,4,1.0075419223156454
13048,207-008-2398,3645.0278,3,1,2,0.4838504445965155
13236,703-004-5391,2731.1558,5,3,2,1.2670040863749856
13376,703-004-5388,8478.805,1,0,1,0.27920371738274696
13488,703-004-5389,666.16656,3,2,1,0.7314406741667586
13618,703-004-5396,7511.2944,2,2,0,0.5014876933678359
13704,703-004-5387,8374.714,3,0,3,0.27920371738274696
1380,703-004-5398,9125.5625,4,4,0,0.9081355594287683
14049,207-008-2398,6384.2183,3,2,1,1.448278627264972
14293,703-004-5386,8770.818,3,1,2,1.9553820494674243
14516,703-004-5386,6713.9644,3,0,3,0.27920371738274696
15245,207-008-2398,6613.2354,5,1,4,0.3551100467671392
15298,207-008-2399,7218.8164,5,2,3,0.7480998390952858
15545,703-004-5396,5277.132,5,2,3,0.8711451446800677
16007,703-004-5385,29.574633,4,2,2,0.6657081100133323
1619,703-004-5384,2862.295,2,2,0,2.777061000209289
16442,703-004-5385,1901.6117,7,3,4,0.623544756557722
1647,703-004-5388,465.6327,1,0,1,0.27920371738274696
16539,703-004-5392,7814.8154,6,3,3,2.0221586361823047
16749,703-004-5395,1250.0953,5,3,2,1.8622484524206564
16787,703-004-5386,3890.6802,6,5,1,1.6809995340060269
16806,703-004-5386,6562.3657,5,4,1,3.7470171788856144
17005,207-008-2399,9763.14,3,2,1,1.644727906835035
17337,703-004-5382,4556.6304,1,0,1,0.27920371738274696
17582,703-004-5392,1986.9292,4,1,3,0.31887058837376725
17668,703-004-5386,1333.3767,5,2,3,4.082143214163802
17956,703-004-5398,9340.823,7,2,5,0.5125734220114389
17999,703-004-5398,2924.8298,3,1,2,1.1263960144391276
18096,703-004-5399,8925.354,2,1,1,0.5030280615578878
18141,703-004-5382,4698.1587,6,5,1,2.6351021176085756
18158,703-004-5394,950.88837,3,1,2,0.6248043890615499
18259,703-004-5393,6227.3613,6,2,4,0.6392646264234685
18318,703-004-5386,5132.2056,6,3,3,2.284288589009131
18581,703-004-5394,384.88327,2,2,0,0.5571562055171756
18942,703-004-5390,8265.931,4,3,1,0.5277861563879384
19144,703-004-5384,2651.6484,2,1,1,0.4973099639107738
19183,703-004-5397,8664.037,6,4,2,2.0633444532800365
19189,703-004-5385,4673.884,5,2,3,0.9993379797029089
19268,703-004-5395,7529.349,2,2,0,1.044704427298832
19412,207-008-2399,4730.449,4,3,1,1.3967794938637124
19460,703-004-5390,6799.093,8,2,6,1.4108534687557759
19467,703-004-5384,7598.2314,5,0,5,0.27920371738274696
19724,703-004-5386,3238.9592,7,5,2,1.125464609125929
19976,703-004-5399,1914.8951,3,1,2,0.8360681359899612
20106,703-004-5397,4832.096,2,1,1,0.42546240820095854
20139,703-004-5381,5368.6006,1,0,1,0.27920371738274696
2027,703-004-5397,598.9087,3,3,0,2.067689901319467
20443,703-004-5384,4686.9067,5,4,1,1.6283719650701527
20863,703-004-5380,1218.1354,5,3,2,0.7495994505390184
21047,207-008-2398,7438.8535,4,2,2,1.4543473521174413
21069,703-004-5396,6385.0093,2,0,2,0.27920371738274696
21140,703-004-5385,2034.0251,"","","",0.27920371738274696
21778,703-004-5388,5674.3784,4,2,2,0.5792169922308166
21837,703-004-5395,4777.694,5,4,1,1.9155599665315646
22406,703-004-5393,5519.7983,7,3,4,1.0659648907520476
22426,703-004-5399,5416.689,4,1,3,0.6058387057414679
22524,703-004-5386,3489.0264,3,2,1,1.4265809769555537
226,703-004-5388,8716.046,7,4,3,4.601993818253783
22662,703-004-5383,8734.148,5,1,4,0.42015214520959915
22686,703-004-5396,1782.1324,5,3,2,1.3855271500552946
22742,703-004-5396,7187.4614,3,1,2,0.3624893137664036
23059,207-008-2398,4873.4536,5,2,3,2.2197629045283374
23089,703-004-5384,8825.746,4,0,4,0.27920371738274696
23562,703-004-5399,5837.5835,7,5,2,1.0416463176876936
23651,703-004-5394,7611.8438,5,1,4,0.688254025646214
2382,703-004-5384,8385.491,5,5,0,1.2870706240354386
23828,703-004-5391,9043.883,4,2,2,0.5393878961822426
23935,703-004-5391,3006.22,10,5,5,2.3671481909034946
24149,703-004-5397,7974.8477,4,1,3,0.5165268771580819
24163,703-004-5394,1689.6653,3,3,0,1.2839000806063767
24626,703-004-5383,6922.7095,4,0,4,0.27920371738274696
24680,703-004-5387,7498.7783,3,2,1,0.4275306922423313
24746,703-004-5397,1708.8413,6,4,2,1.9632649339577917
24855,703-004-5384,8950.122,3,1,2,0.42421679105046867
25076,703-004-5399,4573.2896,2,1,1,0.804211493550568
2509,703-004-5398,165.65085,2,0,2,0.27920371738274696
25362,703-004-5384,9371.332,3,1,2,0.5502446257208264
25899,703-004-5397,3669.2822,3,2,1,1.9757128644060489
25990,703-004-5390,7199.5776,2,1,1,0.4097932581653727
2647,703-004-5395,5702.19,4,2,2,0.5898843951403695
26582,207-008-2399,2035.3765,2,1,1,0.7182515629671166
26794,703-004-5386,8731.143,7,2,5,0.6089618280343596
27043,703-004-5389,5192.1045,4,2,2,2.543234251662971
27436,703-004-5398,3077.0857,2,1,1,1.1699514542898348
2746,703-004-5381,1163.4916,2,2,0,0.7822289444973168
27467,703-004-5392,216.45605,6,3,3,0.7499391647148151
27470,703-004-5386,2022.1526,4,2,2,0.8905879142861856
27601,703-004-5391,9125.931,5,3,2,1.218494726412652
27663,703-004-5395,1340.5942,3,3,0,2.6080214740896275
27797,703-004-5383,7299.574,4,3,1,0.7228943037494439
2780,703-004-5380,611.96027,4,2,2,1.335038282305053
27806,703-004-5390,4455.8374,5,4,1,2.055447099947591
27989,703-004-5392,2026.7296,4,2,2,2.070557866918009
2807,207-008-2399,9978.22,4,2,2,0.6637695969331138
28142,703-004-5398,280.8529,6,2,4,1.1970010806385887
28156,703-004-5387,2961.4915,9,5,4,2.560653766310081
28297,703-004-5396,9264.094,6,3,3,0.6375175164936248
28522,207-008-2399,8666.685,6,5,1,2.541608521059084
28831,703-004-5390,7693.511,3,2,1,0.6691681147242489
28969,703-004-5398,9458.784,6,2,4,0.5222784475621763
2901,703-004-5385,9384.061,6,1,5,0.7647323674318101
29069,703-004-5396,4743.753,7,1,6,1.7007204220203114
29171,207-008-2399,7799.2773,4,2,2,1.393863423004388
29244,703-004-5390,6078.9346,7,3,4,1.5943331397904246
2973,703-004-5394,4111.4624,5,1,4,0.35958595703386825
30264,703-004-5395,1347.3749,7,4,3,2.1426088146737503
30361,703-004-5385,3797.2092,1,1,0,0.43657760766032944
30463,207-008-2399,4981.2954,2,1,1,0.5732585450232344
30660,703-004-5388,2240.8242,3,1,2,0.32666834933781397
30664,703-004-5397,4442.062,2,1,1,0.47538877694893994
31054,703-004-5380,7616.6484,3,1,2,0.8090412552014461
31384,703-004-5395,4192.683,3,3,0,0.9110574065957521
31722,703-004-5384,1373.2004,2,1,1,0.5353004527603231
31822,703-004-5396,8698.335,4,2,2,2.0318838912711907
31917,207-008-2398,2456.3247,6,2,4,0.8007296318774163
32168,703-004-5395,1370.6362,4,2,2,0.6446263375355001
32272,703-004-5397,5304.309,5,3,2,1.174936095590397
324,703-004-5393,9467.705,5,2,3,1.0097994733009996
32648,703-004-5397,3960.473,4,2,2,0.7695875289660187
32685,703-004-5392,3717.001,"","","",0.27920371738274696
32906,703-004-5393,8144.731,4,3,1,2.0232628181936185
33249,703-004-5392,4774.5854,"","","",0.27920371738274696
33641,703-004-5386,2693.352,6,2,4,0.8582027609907991
33954,703-004-5384,4565.6562,2,1,1,0.4554359692188502
340,703-004-5389,7324.249,4,1,3,0.5546199253680926
34459,703-004-5384,7629.5186,2,1,1,0.5154889035288864
34851,703-004-5387,1637.5435,3,1,2,0.37320593770000854
35106,703-004-5381,9616.334,4,2,2,0.5815486234631139
35337,207-008-2398,8730.906,2,2,0,1.294196896044776
35432,703-004-5399,2936.3352,1,0,1,0.27920371738274696
35490,703-004-5384,3155.7983,6,4,2,1.5796487693129155
35553,703-004-5398,4941.6807,6,2,4,0.6060066711881789
35630,703-004-5391,388.79395,6,4,2,2.233252267753443
35714,703-004-5386,1784.7198,8,0,8,0.27920371738274696
35795,703-004-5385,3731.1936,7,2,5,1.2672932548030529
3601,703-004-5388,2454.607,2,1,1,0.4619267440589843
36124,703-004-5392,87.29577,2,1,1,0.5669580486103406
36340,207-008-2399,2914.1235,6,2,4,0.4991007031176723
36541,703-004-5388,1429.45,8,2,6,2.7908332134739515
36824,703-004-5390,8898.768,2,2,0,1.061326589434749
3688,703-004-5391,3689.069,8,2,6,0.99037522202568
36921,703-004-5398,4048.2234,5,2,3,1.1852311664540478
3696,703-004-5395,4791.8047,3,2,1,0.65418644929195
37006,703-004-5393,705.5199,2,2,0,0.7133099256359142
37131,703-004-5392,5883.908,3,1,2,0.30886911235466386
37704,703-004-5395,2821.778,7,2,5,0.6128304997940452
37750,703-004-5391,7904.246,5,2,3,1.0054079666157107
37783,703-004-5392,7826.073,4,3,1,1.8450679482054264
37947,703-004-5397,4922.551,4,1,3,0.33853450732658075
3798,703-004-5392,3068.431,3,0,3,0.27920371738274696
37984,703-004-5380,4500.4277,4,2,2,0.6190175692007178
37990,703-004-5385,206.53963,5,2,3,0.6698352765133225
37995,703-004-5384,4339.0034,5,3,2,1.044149444088991
38083,703-004-5389,1213.5369,3,0,3,0.27920371738274696
38128,703-004-5399,4464.1147,2,2,0,0.7680264282934118
38584,703-004-5390,8953.44,4,2,2,0.727259555843095
38932,207-008-2398,7681.396,2,2,0,0.8080575337487422
38949,703-004-5390,916.031,7,3,4,0.6853891677854032
38970,703-004-5388,2260.9824,4,1,3,0.9606854438965002
39115,703-004-5394,9703.624,4,1,3,1.5857596617376777
39249,703-004-5381,7738.0054,5,2,3,0.8053047822277682
39694,703-004-5390,7285.0137,2,0,2,0.27920371738274696
39972,703-004-5393,9771.935,3,2,1,0.9941873201905459
40345,207-008-2399,5139.898,5,3,2,0.5340625695883394
40451,703-004-5386,4545.231,4,2,2,0.8949526248168411
40580,703-004-5382,7142.466,4,2,2,0.6794205819170912
40789,703-004-5396,6106.9824,5,1,4,0.6270272328023236
41064,703-004-5395,8738.812,6,3,3,1.4105299526683663
41122,207-008-2398,3614.682,5,2,3,0.5323859756279408
41209,703-004-5387,6780.9814,4,4,0,1.41365984395371
41215,703-004-5395,9974.991,6,4,2,1.731528463291104
41492,703-004-5393,9738.367,3,2,1,1.1774403739432522
41524,703-004-5395,6054.25,3,2,1,0.4512630082198648
41528,207-008-2399,567.4332,1,0,1,0.27920371738274696
41696,703-004-5386,6317.5835,1,1,0,1.7087324166827567
41953,703-004-5394,5345.254,7,4,3,0.7192704879293526
42311,703-004-5394,8210.797,3,3,0,0.828873702650238
42604,703-004-5388,2711.3372,1,0,1,0.27920371738274696
42642,703-004-5391,1018.4592,4,3,1,1.2724466348045318
4268,703-004-5391,9500.348,3,1,2,0.6850340947667068
42723,703-004-5394,1177.981,6,3,3,0.8947931844995336
42802,703-004-5394,1461.9124,8,3,5,1.3183955439274277
42944,703-004-5395,2565.4846,3,1,2,0.4823953354208099
42992,207-008-2398,8041.6904,6,0,6,0.27920371738274696
43653,703-004-5386,5063.8926,3,2,1,0.7370001037888244
4375,703-004-5398,5996.361,5,4,1,3.3537840171638154
43828,703-004-5388,158.04231,2,1,1,0.3978652972704144
44068,703-004-5395,8281.896,6,4,2,3.391529262892813
4409,703-004-5390,5970.428,5,2,3,1.7036654198231411
44178,703-004-5382,5995.369,4,4,0,1.3396186077215835
44189,703-004-5382,7501.027,4,3,1,1.3277786303171568
44273,703-004-5396,9839.541,2,0,2,0.27920371738274696
44540,703-004-5391,4010.927,3,1,2,0.9717295955062203
44654,703-004-5383,5419.789,3,0,3,0.27920371738274696
44693,703-004-5395,3943.0315,5,4,1,1.5315294003732904
44802,703-004-5382,8192.994,3,0,3,0.27920371738274696
44843,703-004-5385,9608.599,3,1,2,0.9843265945515538
45197,703-004-5384,5337.5713,2,0,2,0.27920371738274696
45215,703-004-5392,2112.9978,3,1,2,0.47920193470400885
45993,703-004-5396,4253.892,4,1,3,0.4703246725668198
46041,703-004-5393,8250.973,6,5,1,1.1331821621074942
46253,703-004-5384,5974.8613,4,2,2,1.088805336627994
46545,703-004-5380,95.92712,4,4,0,2.4740659779018617
46649,703-004-5399,3122.2915,2,0,2,0.27920371738274696
46790,703-004-5382,1660.8453,1,1,0,4.438996991064625
46957,703-004-5385,580.80615,2,2,0,0.534118298027107
4709,703-004-5397,466.20966,7,4,3,2.0701538448396963
47098,703-004-5390,3173.4873,5,2,3,1.4826341347735925
47115,703-004-5390,8326.739,5,1,4,0.35831143730785864
47136,703-004-5384,1700.7405,4,0,4,0.27920371738274696
47241,703-004-5383,3386.2822,4,1,3,0.33853450732658075
4744,703-004-5392,2534.9832,5,2,3,0.8062109663693978
47566,703-004-5383,4374.7812,6,3,3,1.4206251926177784
47957,703-004-5384,3125.4507,5,3,2,0.697189200147473
47995,703-004-5390,6237.785,6,4,2,1.1561211552294188
48036,703-004-5390,2936.1147,2,0,2,0.27920371738274696
48077,207-008-2398,1503.2423,4,3,1,1.6010876207158322
48285,703-004-5391,1656.1943,3,2,1,0.7431882428278216
48999,703-004-5392,9861.249,1,1,0,0.531463804675499
49068,703-004-5382,8975.106,3,2,1,0.7613528580316062
49118,703-004-5395,4758.292,4,2,2,2.756021563944356
49456,703-004-5382,5866.3613,4,4,0,2.9438022291908466
49673,207-008-2398,2122.8594,6,3,3,1.1964414716090621
49763,703-004-5390,4910.3926,1,1,0,0.4342079668242591
49819,703-004-5389,7625.8306,3,1,2,0.41996396629891697
504,703-004-5388,74.16904,7,4,3,1.2887868733904315
5372,703-004-5394,8115.6323,8,6,2,3.0279630665551545
5636,703-004-5385,4826.4497,5,3,2,1.9943157218819465
569,703-004-5391,3927.5378,5,2,3,0.532433873503599
5705,703-004-5397,4090.7263,8,4,4,1.6507788485037855
6168,703-004-5392,4552.39,10,6,4,1.5724642006915606
6344,703-004-5382,4527.521,4,2,2,1.8987245268109993
6443,703-004-5395,4462.533,4,3,1,1.1744040800759485
6761,703-004-5397,8713.258,5,2,3,2.369540250165172
6833,703-004-5397,9101.801,5,1,4,0.32436104083999817
6918,207-008-2398,6610.977,8,4,4,2.229507602884682
693,703-004-5398,3012.429,8,2,6,0.6179739041969101
7010,207-008-2398,3338.7524,3,2,1,0.5314033170929653
7357,703-004-5381,4204.032,5,3,2,3.829024733457225
7528,703-004-5388,4644.6973,3,3,0,3.462162329294388
80,703-004-5394,2791.8994,3,1,2,0.48582619141375494
8061,703-004-5383,3437.2134,4,1,3,0.3978652972704144
814,703-004-5397,7941.121,3,1,2,0.6217081045708889
817,703-004-5383,2417.7444,6,2,4,0.7752845983175835
8672,703-004-5387,7546.7944,3,2,1,0.7168089300595192
8737,207-008-2399,6511.993,5,1,4,0.5428446421792512
8800,703-004-5397,2305.7615,3,2,1,1.1288925425118628
9117,703-004-5395,9104.34,2,1,1,0.7063732978218681
9291,703-004-5394,6138.0054,7,3,4,1.6228178109739606
9721,703-004-5397,2173.7712,3,2,1,1.4536493368425667
9984,703-004-5382,8158.7876,6,4,2,1.5254222964022999
10153,703-004-5381,4226.584,4,0,4,0.27920371738274696
10226,703-004-5392,7078.8193,4,0,4,0.27920371738274696
10295,703-004-5386,2244.6733,6,3,3,1.0223478574886644
10324,703-004-5390,1094.4098,6,3,3,1.3886522339419631
10395,703-004-5390,3077.9475,3,1,2,0.3793292046853429
10897,703-004-5395,8814.6,1,1,0,0.3359840249938701
11261,703-004-5385,6435.1465,3,1,2,0.6978133817651754
11513,703-004-5385,4979.8105,5,4,1,1.8817507742761572
11522,703-004-5394,4279.1685,7,2,5,0.6863316299083068
11969,703-004-5391,9785.822,2,1,1,0.5301118732562354
12026,703-004-5381,8437.224,10,5,5,1.3153254593060655
12405,703-004-5390,3594.125,5,4,1,1.4092419884718768
12447,703-004-5390,1454.8749,5,2,3,1.1502518065726832
12857,703-004-5380,1893.5109,7,5,2,2.9996073656143936
12916,703-004-5394,6547.5645,2,1,1,0.5837684390944268
12930,703-004-5388,1473.4799,4,3,1,1.9826156805304584
12933,703-004-5383,5559.096,8,3,5,0.7302162496271508
12991,703-004-5396,2932.7976,4,2,2,2.4525394402121266
13095,703-004-5380,3625.1301,8,4,4,1.3501537829993209
13111,703-004-5398,470.286,3,2,1,1.1299000450223877
13201,703-004-5386,9907.951,3,1,2,0.7970508255483351
13673,703-004-5398,3392.7058,3,2,1,0.7705180543149746
13880,703-004-5399,1087.0773,4,2,2,0.6353099038859444
13922,703-004-5386,491.81998,3,2,1,1.585149457207584
13983,703-004-5383,8624.793,2,1,1,0.6888455799126714
14140,703-004-5388,8598.632,3,2,1,0.6711168422664167
14226,703-004-5393,5892.0405,7,1,6,0.5468589218971006
14597,703-004-5381,744.17175,4,2,2,1.0817061103730004
14598,703-004-5399,469.93555,4,1,3,0.5543447193874605
14631,703-004-5393,5210.1987,4,3,1,3.4948003873859803
14773,703-004-5398,7942.167,3,1,2,0.39669409408629347
14805,703-004-5394,1349.5868,7,4,3,1.1497603887275532
15123,703-004-5382,7308.2524,2,1,1,0.7469952296756803
15131,703-004-5385,580.7924,7,4,3,1.1160867849623302
15310,703-004-5394,7640.1113,3,1,2,0.41127475287564275
15730,703-004-5387,7131.094,"","","",0.27920371738274696
16070,703-004-5399,183.12097,2,0,2,0.27920371738274696
16224,703-004-5397,3170.9397,6,3,3,0.5401316829491587
16541,703-004-5399,1345.3972,4,3,1,1.3751863751276197
16763,703-004-5394,686.50183,3,1,2,0.5440216538555556
16854,703-004-5399,9753.932,7,5,2,0.9868313523827488
1691,703-004-5390,8744.811,8,5,3,1.4366642375910768
16971,703-004-5391,5896.48,3,0,3,0.27920371738274696
17555,703-004-5388,4568.89,2,1,1,0.532408458251976
17716,703-004-5398,1459.6266,7,5,2,2.1631650944645404
17763,703-004-5391,2140.4272,6,4,2,1.101214746572577
17838,703-004-5382,363.55496,1,0,1,0.27920371738274696
18155,703-004-5386,2445.5798,4,3,1,1.1322846478237303
18338,703-004-5386,9168.89,3,1,2,0.42866913990371397
18416,703-004-5395,2374.7134,2,1,1,0.47774796002780023
18419,703-004-5387,6125.575,5,3,2,0.7350256373046362
18532,703-004-5398,127.36797,2,2,0,0.8046699349316407
1920,703-004-5391,1499.409,3,2,1,0.993614527337773
19760,703-004-5383,1238.1506,6,4,2,2.4794519720251245
19883,703-004-5387,3995.1223,4,3,1,0.7216893286749759
20012,703-004-5382,6950.1616,5,1,4,1.3144286002938161
20200,703-004-5391,586.4692,2,1,1,0.4865122368036763
20329,703-004-5381,9419.611,6,4,2,1.4721190429250508
20393,703-004-5393,2576.0884,4,3,1,1.8521446429856792
2059,703-004-5384,8060.8213,6,1,5,0.3528933825317377
20640,703-004-5388,1671.3303,5,2,3,0.6351884570457493
20673,703-004-5392,1561.7776,7,5,2,2.3640417499951876
20692,703-004-5398,1989.7592,5,3,2,1.8853923642604913
20755,703-004-5395,3831.1816,7,4,3,3.689073778713594
2078,703-004-5384,4329.6416,2,2,0,0.9370400631780208
20943,703-004-5390,8773.896,1,0,1,0.27920371738274696
20945,207-008-2398,2437.8813,7,2,5,1.6154509573412235
21207,207-008-2398,694.16583,5,4,1,2.7862974368107585
21231,703-004-5393,5846.978,4,3,1,0.7408981721981877
21297,703-004-5390,771.6155,6,4,2,1.5158817301917151
21431,703-004-5396,8848.711,5,5,0,1.7119412854676976
216,703-004-5399,3983.7651,2,0,2,0.27920371738274696
21609,703-004-5382,999.6319,4,2,2,0.5905772386071038
21725,703-004-5385,8.5783,6,2,4,0.5528129358468605
21871,703-004-5399,5568.701,2,2,0,0.6032363545447472
22165,703-004-5382,4800.4087,2,1,1,0.5718568464248756
22261,703-004-5398,7861.0225,6,0,6,0.27920371738274696
22416,207-008-2399,6578.1997,4,2,2,0.9401238501381043
22462,703-004-5390,5489.7856,2,1,1,0.33853450732658075
22637,207-008-2398,1287.2542,6,3,3,0.9408315152391995
23102,703-004-5397,3722.3154,2,1,1,0.5484557858169418
23293,207-008-2399,1287.5372,2,1,1,0.4686996681533581
23410,703-004-5399,466.96127,5,3,2,0.9106485551072375
23826,703-004-5391,4255.1206,4,2,2,0.6476759964271231
23860,703-004-5386,5190.3413,5,2,3,0.7669815768383325
2398,703-004-5381,3016.1135,8,7,1,4.747284848860842
23988,703-004-5397,1524.4097,2,1,1,0.6446258049661233
24126,703-004-5395,8856.396,5,2,3,0.562647000939549
24400,207-008-2399,8277.953,5,3,2,0.4967705481455344
24461,703-004-5391,3763.5356,3,3,0,1.306978470543949
24500,703-004-5394,8109.7417,3,1,2,0.3655285995385259
24642,703-004-5398,2587.6128,"","","",0.27920371738274696
24797,703-004-5386,4006.9683,3,0,3,0.27920371738274696
24994,703-004-5396,2561.3188,6,3,3,0.8379961638841512
25071,703-004-5381,9594.744,4,0,4,0.27920371738274696
25183,703-004-5399,4164.5723,4,3,1,1.4509185748746147
25280,703-004-5385,9746.544,7,4,3,1.0152105522952222
25738,703-004-5390,440.30188,5,1,4,0.3978652972704144
26251,703-004-5393,5726.4355,3,1,2,0.7489037223263038
26543,703-004-5398,4795.3677,"","","",0.27920371738274696
26579,207-008-2399,3270.8137,4,1,3,0.8931167382166438
26884,703-004-5384,2970.0625,1,0,1,0.27920371738274696
26919,703-004-5399,6906.8076,5,1,4,0.3468408179187174
27069,703-004-5386,7456.139,3,1,2,0.3464986635249618
27503,703-004-5384,4561.648,2,1,1,0.32666834933781397
27665,703-004-5389,1779.0944,3,2,1,1.1869579195205422
27874,703-004-5384,5219.1973,6,4,2,1.6435603228970963
28147,703-004-5397,2336.7004,2,1,1,0.42555299924420353
28264,703-004-5382,2056.8484,7,2,5,1.2220926929613318
28357,703-004-5390,3494.789,2,1,1,0.4068887962539556
28928,703-004-5398,6505.808,1,1,0,0.5028927872720081
29548,703-004-5392,558.6868,6,4,2,0.8195778964087787
30142,207-008-2398,7898.547,2,2,0,0.50003721596594
30311,703-004-5395,4397.011,3,3,0,0.8482721416617484
30386,703-004-5397,1294.9396,7,4,3,1.1845126631031788
30487,703-004-5395,5867.8223,5,2,3,1.0632054746028097
30671,703-004-5382,6484.767,3,3,0,3.0262263958908897
30910,703-004-5382,9726.767,5,3,2,0.8153324427798758
30994,703-004-5393,407.6779,7,2,5,2.4566873054065246
31174,703-004-5396,6362.2866,8,6,2,1.4007357325505132
31208,207-008-2398,9531.269,2,2,0,0.8434400902542877
31218,207-008-2399,9155.885,3,2,1,0.6787575478802155
32011,703-004-5398,7779.4717,6,3,3,1.5645642167090739
32126,703-004-5393,8827.799,3,2,1,1.1043645021647064
32343,207-008-2398,2214.2153,5,0,5,0.27920371738274696
32500,703-004-5380,8597.898,4,2,2,1.2166752806576513
32830,703-004-5393,8491.255,4,3,1,1.4162727550295782
3291,703-004-5382,5140.86,6,5,1,1.5328502094964926
33068,703-004-5385,1394.3713,3,1,2,0.5766749819810664
33214,703-004-5392,6280.9253,6,4,2,1.3361507690696097
33248,207-008-2399,2562.9097,4,2,2,2.059665502065648
33282,703-004-5386,5906.743,2,1,1,0.6369070790961403
33484,703-004-5387,9995.959,2,0,2,0.27920371738274696
33614,207-008-2399,7385.93,2,2,0,1.4386010542417762
33635,703-004-5389,5094.2417,4,3,1,0.9595995229411267
33762,703-004-5382,6824.644,3,2,1,1.577182499667139
3443,703-004-5384,4661.4473,1,0,1,0.27920371738274696
34453,703-004-5380,9576.995,4,3,1,0.7443290750420323
34873,703-004-5384,252.56992,4,2,2,3.0100143279784706
35315,703-004-5390,8740.61,2,0,2,0.27920371738274696
35379,703-004-5393,9656.97,1,1,0,0.35831143730785864
35691,703-004-5386,4567.9404,4,3,1,1.6942276908604441
35704,207-008-2399,1478.8438,8,5,3,1.6973060176802737
35878,703-004-5380,2482.213,4,3,1,1.1986023455253179
35911,703-004-5396,1749.0077,6,2,4,0.9946821156695602
36209,703-004-5396,2795.884,4,1,3,0.32666834933781397
36282,703-004-5384,182.08563,"","","",0.27920371738274696
37060,703-004-5386,2408.671,3,3,0,1.2470708015328522
37189,703-004-5393,9768.356,5,2,3,1.561828428706904
37242,703-004-5397,8063.6035,4,1,3,0.40476817716827035
37374,703-004-5399,6240.5044,6,3,3,1.6869056924475947
38044,703-004-5387,7844.292,7,3,4,1.0479518074139709
38502,703-004-5390,6266.3706,4,2,2,1.1119301301580862
38593,703-004-5381,9404.619,6,4,2,0.7463505997715056
38792,703-004-5396,6529.319,2,1,1,0.48677047667945444
39074,207-008-2398,482.10025,4,3,1,0.936785138675876
39809,703-004-5392,6663.3354,3,3,0,1.6436531857339898
39835,703-004-5392,5936.6494,8,2,6,0.871259600384382
39864,207-008-2399,3560.593,4,4,0,2.367938308669303
39911,703-004-5383,6698.1836,5,4,1,1.3952466993587815
40019,703-004-5383,3694.6238,10,4,6,1.1228645086897329
4005,703-004-5387,7092.306,5,2,3,0.9726698464257011
40136,703-004-5389,6342.979,4,1,3,0.35831143730785864
40201,703-004-5392,2487.7698,6,4,2,0.7762758394740621
40236,703-004-5385,1676.8419,2,1,1,0.7899175388696655
40354,703-004-5396,1974.5367,8,4,4,2.3299580530718997
40441,703-004-5382,3902.1116,4,2,2,0.9746981225782767
41026,703-004-5391,3447.5105,1,1,0,0.519166989514907
41048,703-004-5383,8865.183,2,0,2,0.27920371738274696
41632,703-004-5386,5091.245,4,1,3,0.9488690555882913
41695,207-008-2399,5211.247,4,2,2,0.6886185505714891
42342,703-004-5399,772.90894,5,4,1,1.8005523118347682
42483,703-004-5393,9790.809,3,3,0,0.8068758460894545
42854,207-008-2399,6584.324,7,3,4,2.545491705051613
42858,207-008-2399,7722.8403,4,2,2,0.8760243256431085
43360,703-004-5385,6348.5537,2,0,2,0.27920371738274696
43440,703-004-5391,3057.1694,2,0,2,0.27920371738274696
43621,703-004-5382,5511.059,6,3,3,1.6200057569671258
43784,703-004-5395,2699.0862,5,4,1,1.5816381861005213
43978,703-004-5398,3497.362,5,0,5,0.27920371738274696
44070,703-004-5386,5994.4927,5,3,2,2.303682233870566
4411,703-004-5382,310.0252,4,3,1,0.7388877918718818
44440,703-004-5380,8020.826,4,2,2,0.9925661133074298
44805,703-004-5392,8887.029,8,5,3,2.4477958508363105
45170,703-004-5392,5319.9087,2,0,2,0.27920371738274696
45298,207-008-2399,3687.257,5,2,3,0.4907248796638781
45479,703-004-5384,8058.746,5,4,1,1.9664051245935843
45542,703-004-5394,4883.8857,6,2,4,0.841253245905172
45823,207-008-2399,902.1032,1,1,0,3.3053120586505775
45923,703-004-5384,1140.5087,1,0,1,0.27920371738274696
45949,703-004-5392,4595.4595,8,4,4,1.3019110431033492
4604,207-008-2398,3110.8577,5,2,3,0.478137658627757
46077,703-004-5389,12.769699,5,2,3,0.5122982673453907
46354,703-004-5388,4237.131,5,2,3,0.9286753981281904
46402,207-008-2399,6087.38,2,1,1,0.4230808829965438
46426,703-004-5397,4530.142,"","","",0.27920371738274696
46589,703-004-5391,6074.478,3,1,2,0.9175731167733618
46724,703-004-5384,1159.3038,4,2,2,0.5401371572887242
46818,703-004-5390,2526.5747,4,3,1,0.9413585563298792
46821,703-004-5380,1349.4342,6,0,6,0.27920371738274696
46987,703-004-5394,7329.2305,"","","",0.27920371738274696
47045,703-004-5385,4232.341,5,3,2,1.933236416357732
47455,207-008-2399,5020.65,1,1,0,0.8964803537520146
4758,703-004-5393,1102.6055,"","","",0.27920371738274696
4761,703-004-5387,8525.342,5,3,2,1.9272824586887323
4768,703-004-5394,7697.5,4,1,3,0.9841834901993225
47698,703-004-5382,1952.2238,2,2,0,0.7054659790985837
47731,703-004-5399,7177.114,3,1,2,0.4832121575719994
47895,703-004-5396,8897.058,3,0,3,0.27920371738274696
47923,703-004-5389,3944.983,6,6,0,2.8901439879209554
47966,703-004-5394,155.82323,3,2,1,1.1652886297853564
48157,703-004-5381,1663.6991,5,3,2,1.2494557608200032
48257,703-004-5395,8282.078,3,1,2,0.9311463399559852
48271,703-004-5396,7623.75,5,3,2,1.5044374496731119
48338,703-004-5381,9194.99,2,1,1,0.54424376594723
48432,703-004-5392,5470.557,1,0,1,0.27920371738274696
48655,703-004-5389,1534.8322,3,1,2,0.41728970249377756
48767,703-004-5387,6478.2925,3,2,1,0.9450737390956675
48802,703-004-5385,1538.0889,6,6,0,2.4053268809383197
48835,703-004-5380,5988.184,8,4,4,1.0841928313845235
48884,703-004-5397,3484.639,4,1,3,1.1487516435204204
4921,703-004-5381,1718.1969,5,2,3,0.6950054298516227
49274,703-004-5399,6322.7188,4,1,3,0.7298992806743522
49516,703-004-5394,9927.35,2,1,1,0.41396936477997903
49596,703-004-5397,3681.339,4,2,2,0.4486323487516289
49613,703-004-5385,323.5197,1,0,1,0.27920371738274696
49789,703-004-5388,875.7293,3,0,3,0.27920371738274696
5188,703-004-5380,8438.369,3,1,2,0.8410102858595725
522,703-004-5385,6990.457,1,0,1,0.27920371738274696
5406,703-004-5393,5603.4546,6,2,4,0.7232760362356412
572,703-004-5380,9032.517,"","","",0.27920371738274696
5853,703-004-5397,9838.537,1,1,0,0.8667965644861619
5869,703-004-5384,871.9486,1,0,1,0.27920371738274696
6145,703-004-5393,8415.05,6,2,4,0.6135756365836064
6397,703-004-5399,6787.3413,3,1,2,1.4637026374128133
6520,703-004-5384,5257.128,5,1,4,0.4778623631318895
6664,703-004-5391,7186.8203,4,1,3,0.5251373971992118
6667,703-004-5383,5715.8975,1,1,0,0.8001962401201277
6713,703-004-5389,7127.6943,7,1,6,0.4500510532294496
6781,703-004-5398,402.02438,3,1,2,2.2051965069687203
6826,207-008-2399,2593.1804,7,1,6,0.4945730722410077
7446,207-008-2399,1638.63,1,1,0,0.4294204851835185
7507,703-004-5395,8400.57,6,3,3,2.7453757276372737
7543,703-004-5381,8291.066,8,4,4,1.4437730736158174
7971,703-004-5392,2530.6868,6,4,2,1.250151666251278
820,703-004-5398,3205.4812,7,5,2,0.867918509000206
8640,207-008-2399,5292.641,5,3,2,0.7011197973708345
881,703-004-5391,5264.169,3,1,2,0.4993554615639832
918,703-004-5384,868.1828,5,2,3,1.2344757023154698
9324,207-008-2399,9961.475,1,0,1,0.27920371738274696
937,703-004-5385,465.43597,5,2,3,1.265733937810443
9409,703-004-5398,7263.1694,4,3,1,3.3972751182809944
9514,703-004-5397,9314.217,4,3,1,1.092258828228901
9619,703-004-5380,8025.966,5,4,1,1.8722980081174028
9707,703-004-5383,2663.7615,3,2,1,1.103860367557319
9810,703-004-5391,2258.1267,6,4,2,1.2777668642399769
990,703-004-5393,6541.549,4,2,2,0.6507493952380121
9974,703-004-5396,9545.391,3,1,2,0.5394687402439281
1001,703-004-5396,1335.2537,4,2,2,0.8810600730597327
10147,703-004-5384,6877.6836,3,2,1,0.9140062940477401
10862,703-004-5388,731.2012,5,2,3,0.4422233649438285
10992,703-004-5391,5597.154,9,6,3,1.555957310607494
11031,703-004-5380,8936.634,4,2,2,1.036789815467461
11035,703-004-5392,1629.9749,2,2,0,0.6149737152770108
11288,703-004-5393,6144.216,4,3,1,2.183699653638618
11318,703-004-5399,3070.581,7,4,3,1.5581293757197063
11461,207-008-2399,4709.1997,4,1,3,0.7210179827612114
11488,703-004-5399,2566.288,3,2,1,0.8574244279742727
11533,703-004-5386,123.29996,3,0,3,0.27920371738274696
11547,703-004-5392,2133.1526,3,1,2,0.5211973991291872
11683,207-008-2398,5508.426,4,3,1,1.0338188886156685
119,703-004-5394,4233.9604,6,2,4,2.4605626002351526
11912,703-004-5391,8739.507,5,0,5,0.27920371738274696
12363,703-004-5393,1045.531,4,2,2,0.5978982146241203
12381,703-004-5387,9584.419,4,1,3,0.7473834698507565
12599,703-004-5399,1021.7625,3,1,2,0.48269210362722137
12622,703-004-5384,7503.9814,3,2,1,0.6468044578886059
12839,703-004-5388,9287.847,5,2,3,0.6848991831915471
12962,703-004-5396,7460.546,1,0,1,0.27920371738274696
13015,703-004-5388,3205.1135,9,4,5,2.1361893281013744
13054,703-004-5394,9557.956,5,3,2,1.4789287768765487
13082,703-004-5396,8195.166,2,1,1,0.6173892200625992
13508,703-004-5386,4145.6777,5,2,3,0.5747863237127572
13712,703-004-5385,9527.474,7,3,4,0.7402815036496458
1389,703-004-5398,3454.0505,3,1,2,0.35831143730785864
14012,703-004-5387,4609.265,2,1,1,0.7180333963722937
14605,703-004-5393,3686.502,3,1,2,1.5069003759723198
14828,703-004-5398,4298.561,6,3,3,1.0139801742514691
14934,703-004-5397,4743.0117,1,0,1,0.27920371738274696
14981,703-004-5388,3236.5393,2,1,1,0.33853450732658075
15290,703-004-5394,7426.9897,"","","",0.27920371738274696
15364,703-004-5396,5772.9087,4,4,0,1.3731851674809705
1629,703-004-5385,7619.4424,7,5,2,1.2166168652518625
16584,703-004-5387,2972.6482,4,3,1,1.830513230296209
16610,703-004-5391,6158.3687,9,8,1,3.3745056359584495
16618,703-004-5395,467.91257,9,4,5,1.953935554520812
16679,703-004-5382,3471.4316,6,2,4,1.2756986817137341
16817,703-004-5383,4239.6216,5,5,0,1.5105203648207812
17090,703-004-5396,6243.751,6,4,2,1.1374990314761524
17174,703-004-5394,404.94086,5,4,1,1.8842601878412744
17195,703-004-5384,9719.635,3,1,2,0.36443588923670356
17301,703-004-5392,309.06796,3,0,3,0.27920371738274696
17678,703-004-5399,8435.524,6,2,4,0.6359781656883156
1779,703-004-5397,5270.728,3,2,1,2.2080729718746253
18034,703-004-5391,4191.189,3,1,2,0.47111659197092065
18290,703-004-5387,5310.445,4,1,3,0.46630023322519093
18496,703-004-5397,5380.582,5,3,2,1.3867687977935776
18694,703-004-5383,2917.2998,3,0,3,0.27920371738274696
18758,703-004-5384,748.5479,5,2,3,0.48722338739475696
19235,703-004-5396,3945.1313,3,1,2,1.7101894188777322
19319,703-004-5386,7884.3003,7,4,3,1.611612526687461
19607,703-004-5393,9916.899,5,3,2,0.9776163007884908
19935,703-004-5392,4770.6816,3,0,3,0.27920371738274696
20072,703-004-5399,5620.7686,2,1,1,0.5165268771580819
20180,703-004-5393,1690.2262,4,1,3,0.7536804208329206
20947,703-004-5399,9657.694,3,2,1,0.7862321227145931
20993,703-004-5392,4128.429,2,1,1,0.43163048802507975
21009,703-004-5398,1516.999,3,3,0,0.9182075754585337
2117,703-004-5386,1019.5345,4,0,4,0.27920371738274696
21194,703-004-5386,4147.457,4,2,2,0.9426660210821315
21230,703-004-5383,3092.8416,4,3,1,0.6962942036837798
21692,703-004-5392,4005.9768,4,3,1,1.2055350262127884
21694,703-004-5395,8812.428,"","","",0.27920371738274696
2193,703-004-5399,8140.292,7,5,2,2.9860457285698527
22182,703-004-5398,2672.4834,2,0,2,0.27920371738274696
22483,703-004-5395,2860.7935,2,0,2,0.27920371738274696
22527,703-004-5393,6733.8604,1,0,1,0.27920371738274696
22770,703-004-5384,3792.2515,7,4,3,1.530933659918938
23002,703-004-5391,6032.9854,8,4,4,1.4623167703394253
23081,703-004-5381,3372.7659,3,2,1,0.7526912255724024
2317,703-004-5387,568.79816,5,1,4,0.6063757028924862
23249,703-004-5398,5561.7935,4,3,1,1.5702530034641282
23336,703-004-5384,1751.5618,5,3,2,1.1514460470657322
23354,703-004-5398,4260.8354,4,4,0,0.8168551062642644
23385,703-004-5382,9556.869,5,3,2,0.9586992478923579
23800,703-004-5382,3008.964,4,1,3,0.5165268771580819
23801,703-004-5396,6450.479,5,3,2,1.28369224080562
24134,703-004-5388,7529.8823,2,1,1,0.544752484331078
24316,703-004-5387,5638.0474,2,0,2,0.27920371738274696
24348,703-004-5383,9426.706,5,3,2,1.2836005032790145
24354,703-004-5386,8222.64,2,0,2,0.27920371738274696
24801,703-004-5395,7545.669,"","","",0.27920371738274696
24837,703-004-5395,2477.2896,9,4,5,1.3581088583502163
24916,703-004-5380,9298.554,3,3,0,1.4570947792902593
25270,703-004-5389,1368.5721,1,1,0,0.401885928342064
25392,703-004-5390,1797.4854,4,3,1,1.153081678119212
2543,703-004-5386,1266.3395,3,2,1,1.0117728354396105
25508,703-004-5388,2972.6917,5,4,1,2.471028844419552
25633,703-004-5381,1669.9058,3,3,0,1.2545252557226891
25806,703-004-5390,6841.299,5,4,1,1.6002546864203542
25858,703-004-5389,4916.7603,5,3,2,2.7442722584182646
26049,207-008-2399,1950.68,5,3,2,0.8609375422756297
26106,703-004-5387,1197.1307,1,0,1,0.27920371738274696
26179,703-004-5397,7700.9478,6,4,2,2.9511560690856684
2618,703-004-5391,63.26437,7,4,3,1.2270043851158925
26315,703-004-5381,17.376541,5,2,3,0.5311895738191663
26597,703-004-5392,1917.3717,6,3,3,1.360767861639323
26660,703-004-5387,7620.3687,6,3,3,0.696781981043784
27002,207-008-2399,2336.8125,3,2,1,0.9539297705785843
27318,703-004-5380,7633.419,4,2,2,0.6311115125820608
27338,703-004-5397,9027.346,3,0,3,0.27920371738274696
27367,703-004-5394,3597.4705,5,4,1,1.5469073746601618
28157,703-004-5392,9505.127,1,1,0,0.5132520097049671
28379,703-004-5388,3929.971,3,0,3,0.27920371738274696
28466,703-004-5391,7557.6113,5,1,4,0.4380651313127684
28647,703-004-5387,1975.7885,9,3,6,1.0918039814615779
28873,703-004-5398,5180.468,6,1,5,0.4230808829965438
29272,703-004-5398,6351.037,4,2,2,1.1810065884288843
29298,703-004-5390,9345.207,5,4,1,1.1871767914738638
29406,703-004-5394,6348.0806,"","","",0.27920371738274696
29567,703-004-5394,5445.4087,3,2,1,0.8487607670605163
29661,703-004-5386,7543.055,7,5,2,3.2550042756760913
29676,703-004-5399,1759.5261,4,3,1,1.6997452320954092
29826,703-004-5386,9178.919,6,4,2,2.13102181030607
30363,703-004-5391,4333.3066,7,6,1,5.051306141899471
30919,703-004-5397,9207.566,3,0,3,0.27920371738274696
31070,703-004-5380,2259.7188,2,0,2,0.27920371738274696
31167,703-004-5397,1239.8082,3,2,1,2.649058660683403
31242,207-008-2399,7611.29,7,5,2,1.5035574700125096
31261,703-004-5390,2248.349,6,1,5,0.428397572445243
31444,703-004-5394,4988.6636,4,3,1,1.1018289368683594
31815,703-004-5399,6646.543,5,0,5,0.27920371738274696
31888,703-004-5382,4888.764,2,0,2,0.27920371738274696
32215,703-004-5390,136.26218,5,2,3,0.41764222725169237
32370,207-008-2399,3841.998,4,2,2,2.015826737095377
32591,703-004-5392,2997.5188,2,0,2,0.27920371738274696
3277,207-008-2398,4265.0366,4,2,2,0.8037377125236705
33213,703-004-5385,2991.4487,3,0,3,0.27920371738274696
33262,703-004-5394,8580.246,3,1,2,0.4956480409489323
33349,703-004-5384,9355.393,7,3,4,1.1081589937717258
33516,703-004-5390,7747.491,2,1,1,0.5327400504310549
33896,703-004-5397,7013.3257,3,0,3,0.27920371738274696
33986,703-004-5396,4446.996,4,2,2,1.0455075822039561
3412,207-008-2399,7132.388,2,0,2,0.27920371738274696
3419,703-004-5390,3261.5356,3,1,2,1.603400712440011
34905,703-004-5397,450.34528,2,0,2,0.27920371738274696
35451,207-008-2399,9609.7295,1,0,1,0.27920371738274696
35546,703-004-5391,1406.1135,3,2,1,0.6671186889618107
3573,207-008-2398,4209.9404,6,2,4,1.3277897070143274
36101,703-004-5384,3560.3787,3,2,1,1.0176390165228362
36154,703-004-5390,1570.5479,4,3,1,3.873790301388636
36181,703-004-5390,5628.8784,3,3,0,0.6853553601256822
36418,703-004-5391,7649.699,3,1,2,0.4072732446654146
36467,207-008-2398,3852.0317,2,2,0,1.482694352423749
36790,703-004-5392,4497.7095,6,2,4,1.795858711454068
36867,703-004-5382,4411.489,5,2,3,0.9659107172559633
36916,703-004-5392,9429.83,1,0,1,0.27920371738274696
36943,703-004-5398,156.85022,3,2,1,0.845325271228786
37113,703-004-5398,2849.4263,3,1,2,0.4231667322461462
37232,207-008-2399,6153.9985,4,3,1,2.1429926096630503
37349,703-004-5388,7437.9243,3,2,1,0.7952723948908
37417,703-004-5382,8166.2285,5,2,3,0.5279640760420059
37526,703-004-5386,9388.173,1,1,0,0.4314860782385869
37642,703-004-5387,4569.1704,3,2,1,0.7816967157827008
37669,703-004-5393,8357.493,4,2,2,0.6516838399848839
38070,703-004-5392,5630.8047,7,1,6,0.9363645703966047
38106,703-004-5380,7795.692,3,1,2,0.4758023122224186
38206,207-008-2399,5332.571,4,1,3,0.7137174579600134
38395,207-008-2399,6290.7236,5,2,3,0.8051596307846133
38676,703-004-5395,6849.9673,4,1,3,0.33853450732658075
39367,703-004-5398,7729.2104,3,1,2,0.33243191178950066
3979,703-004-5397,3861.6729,7,5,2,1.4377935731603368
3992,703-004-5399,2656.1755,6,3,3,0.9501530956478519
40051,703-004-5381,3144.3853,5,2,3,1.3754028441540962
40198,703-004-5390,8359.37,5,3,2,1.2033644418329648
40264,703-004-5390,1136.0251,6,3,3,1.4264775804946928
40344,703-004-5387,3904.8804,2,0,2,0.27920371738274696
40651,703-004-5392,7957.9473,3,2,1,0.5747830547991278
40921,703-004-5393,2772.746,2,2,0,0.43741915723297026
40957,703-004-5388,3079.6702,5,4,1,2.1182657554570716
41191,703-004-5393,9488.235,5,3,2,1.275582665873435
41235,703-004-5395,5269.652,8,6,2,2.8981637686231507
41319,703-004-5384,4437.2,3,3,0,0.8885753088589493
41522,703-004-5392,5671.7046,2,1,1,0.33853450732658075
41730,703-004-5381,8449.794,3,1,2,0.43381103618717576
4180,207-008-2399,8448.9795,2,1,1,0.3600518071462111
42189,703-004-5383,6516.5425,3,2,1,1.2344655530667517
42312,703-004-5393,9331.72,4,0,4,0.27920371738274696
42725,703-004-5383,7606.616,8,5,3,2.0980267214438095
42755,703-004-5393,4186.856,4,3,1,1.230182982623157
42844,703-004-5385,1322.3654,7,3,4,0.9594995668347905
43030,703-004-5391,918.3812,3,0,3,0.27920371738274696
43050,703-004-5399,5350.743,3,2,1,1.4066874603318897
43243,703-004-5386,8082.1675,5,0,5,0.27920371738274696
43376,703-004-5385,7171.099,3,2,1,1.159850744983688
43524,703-004-5394,3333.0269,5,4,1,0.9084241511388682
4377,703-004-5388,6012.7437,3,2,1,0.7344760957425751
43872,703-004-5392,1477.2767,6,5,1,2.009074431091377
43909,703-004-5387,4273.6846,5,1,4,0.8867226493903572
43930,703-004-5395,8066.813,4,4,0,3.4424531811879833
43992,703-004-5399,3211.3118,3,0,3,0.27920371738274696
44107,703-004-5386,1457.8218,4,1,3,0.5215112906778673
44172,703-004-5399,717.5249,8,0,8,0.27920371738274696
44179,207-008-2399,5835.616,3,1,2,0.5585129534120601
44242,703-004-5383,6652.7676,1,1,0,0.35485377071613183
44539,703-004-5397,7880.887,7,4,3,1.5824312968801748
44701,703-004-5388,8772.085,4,2,2,0.6901816216686466
44824,703-004-5387,5877.141,5,3,2,0.7920992977827976
44893,703-004-5396,7168.627,4,3,1,0.6094439252749889
45511,703-004-5383,6696.7266,1,1,0,0.9780052019090084
45641,703-004-5389,1543.8342,5,3,2,0.993591322685537
46146,703-004-5388,9313.384,9,5,4,2.7293621999291653
46486,207-008-2398,1257.2188,4,2,2,1.3232567556108628
46537,703-004-5395,7872.8945,5,3,2,2.3668250738330108
46551,703-004-5394,1320.3835,5,2,3,0.6504199852432783
46698,703-004-5381,2530.1777,1,0,1,0.27920371738274696
46748,703-004-5383,9856.8955,7,3,4,1.4301559695661186
46754,703-004-5393,4228.046,4,2,2,0.7706825246834247
46779,703-004-5383,3251.8596,3,1,2,0.7460842016161053
47057,703-004-5382,450.66833,5,4,1,2.226347362834902
47170,703-004-5381,2589.3855,5,3,2,0.677577337006447
47352,207-008-2398,9824.362,4,3,1,1.0325149323410998
47504,207-008-2398,1393.4047,6,4,2,1.1977387209616364
47526,703-004-5384,4621.166,5,3,2,0.7739751232862401
47712,703-004-5388,4055.928,4,4,0,2.157589903317223
47795,703-004-5398,6166.2896,1,0,1,0.27920371738274696
47809,703-004-5394,5268.8843,1,1,0,0.6457533555146364
47977,703-004-5394,3798.1653,3,3,0,0.7897660530417723
48390,703-004-5387,9718.017,2,1,1,0.5508176459169309
48644,703-004-5394,3359.497,4,2,2,0.85624306953161
48709,703-004-5390,4528.4326,5,3,2,0.6684796225142339
48803,703-004-5387,9588.246,3,1,2,1.6903288216143024
49224,703-004-5393,8573.515,7,5,2,0.9839489870641848
49607,703-004-5394,6483.8164,3,1,2,0.40864921770187235
49879,703-004-5393,3983.1907,3,3,0,0.6565251673820864
49896,703-004-5395,6961.3584,4,3,1,2.3294589320618164
49907,703-004-5395,7005.1836,3,1,2,0.8295042801407483
5086,703-004-5388,2724.1575,5,3,2,1.7780845514464108
5106,703-004-5394,8494.864,6,6,0,3.2083805868899873
5750,703-004-5384,9595.165,5,4,1,0.7692384505893642
5761,703-004-5394,5396.5664,3,2,1,0.5941421225450789
6144,703-004-5392,2128.5623,2,0,2,0.27920371738274696
6353,703-004-5388,7027.5537,3,2,1,1.1633308658100137
6488,703-004-5386,726.6402,8,2,6,0.773088225267598
6576,703-004-5384,8565.063,4,3,1,0.6951618267752933
6880,207-008-2399,1929.844,7,1,6,0.42289135408422324
6992,703-004-5397,2402.8933,1,0,1,0.27920371738274696
7470,703-004-5389,5713.801,4,2,2,1.0942043129551535
7862,703-004-5390,8635.037,3,0,3,0.27920371738274696
8087,703-004-5383,5797.232,6,3,3,1.104825909908081
8128,703-004-5399,2837.9197,5,3,2,0.8634182477232856
8190,703-004-5398,791.8948,2,2,0,0.8512814929668673
8443,703-004-5391,3003.4006,3,0,3,0.27920371738274696
8479,703-004-5382,4625.477,3,2,1,0.9187205465661769
8660,703-004-5383,3382.144,5,3,2,1.4781752677331166
8829,703-004-5396,1967.7395,2,1,1,0.4751325060481747
8900,703-004-5390,6572.733,2,1,1,0.5728827092517516
898,703-004-5391,1493.5822,4,2,2,0.7692269949585793
9078,703-004-5389,2947.195,4,4,0,1.7498291165747675
9349,703-004-5392,8683.068,7,4,3,0.9168183444001368
9353,703-004-5388,6579.0596,1,1,0,0.8784158769023274
9541,703-004-5387,8633.263,7,2,5,0.6915474990021339
9578,207-008-2398,6451.7397,2,1,1,0.9856727095911815
9764,703-004-5399,1650.6296,7,6,1,1.8938608072610328
9840,703-004-5387,5730.2393,6,4,2,1.8405051117080202
10051,703-004-5395,5780.0444,4,3,1,1.311023523804493
10129,207-008-2398,8310.101,3,3,0,0.739105682739147
10430,703-004-5384,4137.885,2,0,2,0.27920371738274696
10504,207-008-2398,5499.9727,2,2,0,0.7750960502349371
10761,703-004-5393,8602.366,1,0,1,0.27920371738274696
11072,703-004-5385,6354.2563,3,2,1,0.4867296359862899
11266,703-004-5384,4930.4946,3,1,2,1.0434266655984303
11296,703-004-5380,1327.852,4,3,1,1.5515142100573671
1134,703-004-5381,8072.721,1,0,1,0.27920371738274696
11431,703-004-5388,4114.395,5,1,4,1.684406875283876
11454,703-004-5395,7703.0815,3,1,2,0.7182515629671166
11477,703-004-5388,5388.122,4,1,3,0.5110202382164198
11545,703-004-5392,4704.942,4,2,2,0.9280570417633143
11644,703-004-5381,4198.9185,5,3,2,0.5449503584088895
11827,703-004-5396,7041.0605,2,1,1,0.762108836045189
1196,703-004-5397,8193.784,1,1,0,0.4087021537944691
12190,703-004-5395,9155.961,3,1,2,0.8856590433046325
1271,703-004-5380,1907.3081,5,3,2,0.7009382980506779
12723,703-004-5389,7230.742,2,0,2,0.27920371738274696
13105,703-004-5388,7855.021,3,0,3,0.27920371738274696
13153,703-004-5385,7344.218,7,6,1,1.4221178456519004
1339,703-004-5393,7478.4917,4,2,2,1.0094742351295247
13521,703-004-5380,4712.944,8,4,4,0.9530879744579659
13740,703-004-5383,3285.9915,1,1,0,0.4950815449010418
1404,703-004-5392,7183.297,4,1,3,0.35831143730785864
14262,207-008-2399,5279.4106,5,2,3,0.9561243937262143
14371,703-004-5399,3800.7551,7,3,4,1.2857810735818858
14890,207-008-2398,5076.2666,3,2,1,1.0708448801491532
14919,703-004-5387,7477.784,2,2,0,0.7270959589139321
14925,703-004-5386,3317.5671,3,2,1,0.813855434306957
14948,703-004-5392,6702.7466,5,1,4,0.5389816826022357
15262,703-004-5390,3542.6223,2,1,1,0.7031212245722052
15287,703-004-5391,2100.4355,7,4,3,0.9344964654223634
15507,703-004-5386,54.532288,3,3,0,1.0432111563140734
15557,207-008-2399,5432.462,4,3,1,1.3235589606538085
1577,703-004-5395,1069.1482,6,3,3,1.4666994188472542
16072,703-004-5398,4298.8438,3,1,2,0.5261269616229625
1611,703-004-5388,2870.0686,2,1,1,0.8737404913380679
16289,207-008-2399,22.19677,4,2,2,0.7374517553316537
16358,703-004-5396,4500.564,2,2,0,0.9905518184238302
16443,207-008-2399,1092.1311,2,2,0,1.066800739422798
16696,207-008-2399,8330.885,3,2,1,0.8227971436597363
17484,703-004-5398,2361.3877,3,1,2,0.38997834425528927
1750,703-004-5385,6905.7036,4,2,2,0.4793238926220131
17539,703-004-5394,8252.7295,4,1,3,0.7209106929395134
17710,703-004-5380,1975.438,2,1,1,0.5353013709079859
17796,703-004-5390,2046.4641,4,2,2,1.9157944900513906
17832,703-004-5398,9057.573,6,2,4,0.8968896942385725
18123,703-004-5385,5227.3184,6,3,3,1.2512925552236858
18199,703-004-5399,8508.831,4,1,3,0.5458338241055544
1832,703-004-5380,3979.3276,5,1,4,0.35831143730785864
18503,703-004-5397,7155.4644,4,1,3,0.5426674635645088
18725,703-004-5395,3769.1963,3,1,2,0.5460505636850158
18968,207-008-2399,8786.714,4,3,1,1.2720915748570476
19283,703-004-5391,4.965067,1,1,0,0.39406153440401537
19389,703-004-5397,1164.4542,3,1,2,0.32666834933781397
19437,703-004-5390,8964.496,2,2,0,0.7330925912806011
19983,703-004-5390,2286.6858,3,2,1,2.0002090971682134
20484,703-004-5396,225.33655,"","","",0.27920371738274696
2062,703-004-5383,7018.772,3,2,1,0.9531855225256072
20711,703-004-5384,7759.3843,3,2,1,0.72535081302327
20908,703-004-5385,8256.048,3,2,1,0.7860417850764294
20910,703-004-5397,4828.3516,1,1,0,0.5177823466439362
21423,703-004-5391,2668.897,4,1,3,0.5235422667272255
21875,703-004-5388,3005.817,5,3,2,0.817077263435549
2191,703-004-5395,4391.663,3,3,0,2.01708966855177
21918,703-004-5390,7002.839,3,0,3,0.27920371738274696
21946,703-004-5383,7946.936,3,2,1,0.7339413238629825
22326,703-004-5395,3342.9878,7,4,3,0.7615299158801685
2242,703-004-5388,3404.4058,3,1,2,2.825953987150526
22627,703-004-5386,6002.7285,4,4,0,1.0866856389046338
22646,703-004-5393,4554.586,4,3,1,1.148608873507849
22741,703-004-5385,9555.766,4,2,2,0.9233642726422424
22897,703-004-5393,523.6995,2,1,1,0.46265973247121006
22958,703-004-5386,9574.764,7,4,3,2.670301671255702
22993,703-004-5399,1826.4198,1,0,1,0.27920371738274696
23149,703-004-5386,9877.674,7,5,2,2.748721192702659
23174,703-004-5384,7514.1074,4,2,2,0.7118270898274335
23208,703-004-5397,2294.8862,2,2,0,1.9362286022878992
23593,703-004-5382,7269.3887,1,1,0,0.33853450732658075
23629,703-004-5380,4652.1514,1,1,0,0.4166518974828799
23815,703-004-5397,2191.7856,5,3,2,1.0963518545816833
24326,703-004-5396,5646.5977,4,1,3,0.799650762184767
24366,703-004-5393,9676.85,4,1,3,0.6896274800067674
2459,703-004-5382,3576.7441,4,1,3,1.148914083972346
24753,703-004-5398,2618.6902,5,3,2,1.832040119646169
2512,207-008-2399,5144.597,3,1,2,0.6135152447685632
25195,703-004-5389,7414.819,3,0,3,0.27920371738274696
25354,703-004-5383,8592.441,1,1,0,0.45670166396471623
25551,703-004-5394,6979.6357,2,0,2,0.27920371738274696
26559,703-004-5385,9827.982,5,3,2,1.0090960898214676
26876,703-004-5393,3238.7983,5,2,3,1.5324514325864917
27138,207-008-2398,4779.5474,7,3,4,2.062368807567109
27240,703-004-5395,1506.3542,4,3,1,1.2530544683648375
27253,703-004-5381,3355.6902,4,1,3,1.1362577384026247
27288,703-004-5388,4187.771,5,2,3,0.7667034185214984
27536,703-004-5386,30.244589,"","","",0.27920371738274696
2767,703-004-5396,9658.461,5,2,3,0.7120962250530317
27761,703-004-5382,7356.2666,3,1,2,0.7691120513262633
27822,703-004-5397,9503.131,4,2,2,0.897455623581609
27941,703-004-5392,1467.9313,4,2,2,0.944096933123744
28116,703-004-5396,6834.0015,4,3,1,0.629123461916107
2839,703-004-5393,1405.6301,4,2,2,0.4985244322193742
28486,703-004-5394,9713.182,5,2,3,1.3688899469850588
28662,703-004-5392,3106.8975,4,3,1,0.9805103445159764
28710,703-004-5380,7335.3057,5,4,1,1.5003601667518032
29159,703-004-5395,3814.9517,4,0,4,0.27920371738274696
29433,703-004-5391,772.75574,2,1,1,0.5356206212299375
29504,703-004-5380,3347.2073,9,8,1,1.6022082985292623
2997,703-004-5388,2219.242,4,2,2,1.3112254785014077
30112,703-004-5398,4031.226,4,3,1,0.7828567220909673
30194,703-004-5394,8561.853,6,3,3,1.2457162335794765
30466,703-004-5399,5091.7773,2,1,1,0.5806288514598988
30506,703-004-5387,1908.5479,6,3,3,1.3776925290088142
30780,703-004-5397,9674.233,3,0,3,0.27920371738274696
30989,703-004-5399,5098.5283,2,0,2,0.27920371738274696
30998,207-008-2399,6097.512,5,2,3,1.0277856328032522
31483,207-008-2399,8702.862,2,0,2,0.27920371738274696
31574,207-008-2398,8.695722,1,1,0,0.7804079098942337
31620,703-004-5399,3115.8877,5,5,0,2.279048053900744
31779,703-004-5388,8570.539,7,4,3,1.4181218004865421
31837,703-004-5382,5404.073,3,1,2,0.7639758250838311
32161,703-004-5385,2919.7026,3,1,2,0.44874124363756457
32167,703-004-5398,5457.891,7,3,4,0.9212056990153061
32400,207-008-2398,4590.6333,3,2,1,1.0095060701661276
328,207-008-2398,7935.261,5,1,4,0.6264077027364537
33221,703-004-5392,577.4337,6,4,2,1.8334723212822968
33359,703-004-5384,2111.1821,5,0,5,0.27920371738274696
33848,703-004-5384,4928.3955,4,4,0,0.997374073667294
34203,703-004-5399,5928.139,6,5,1,1.4303985630516076
34331,703-004-5396,245.51154,3,1,2,0.44513930860439904
34351,703-004-5382,1354.6943,6,3,3,0.8132587204275812
34770,703-004-5396,9891.311,1,1,0,0.3978652972704144
34914,207-008-2399,5788.809,1,0,1,0.27920371738274696
35430,207-008-2398,1650.9218,1,1,0,0.33853450732658075
35446,703-004-5382,3403.849,7,1,6,0.46812222299984235
35622,703-004-5398,885.9706,1,1,0,0.3680367426261521
35757,703-004-5383,7131.4307,4,2,2,0.5938674575570325
36370,207-008-2398,3686.0544,3,2,1,0.6167935550689886
36385,703-004-5396,1261.5621,5,2,3,1.1938027431162859
36389,703-004-5393,1789.7266,2,0,2,0.27920371738274696
36566,703-004-5399,8230.881,2,0,2,0.27920371738274696
36705,703-004-5383,6587.47,7,3,4,0.9026294706296505
36994,703-004-5397,5089.106,1,0,1,0.27920371738274696
37249,703-004-5398,8686.817,4,1,3,0.6419320994675651
37370,703-004-5381,2841.6348,8,2,6,1.4317412646195795
37472,703-004-5392,2643.4202,4,2,2,0.49797169792785057
37552,703-004-5399,7433.641,4,3,1,0.8768159886112077
37639,703-004-5399,9349.991,5,5,0,3.76592916326324
37915,703-004-5393,476.43362,3,1,2,0.386878868497659
37952,703-004-5398,6519.226,6,2,4,0.7175413046334662
38152,703-004-5396,9348.311,2,1,1,0.6020613428704201
38523,703-004-5384,7993.582,"","","",0.27920371738274696
38605,703-004-5382,460.0829,4,0,4,0.27920371738274696
38891,703-004-5384,7117.7974,9,4,5,2.144715382013739
38925,703-004-5399,8190.8823,5,1,4,0.3676086234135539
39343,207-008-2398,6213.3096,3,2,1,0.6130422508527144
39530,703-004-5393,2806.3787,7,4,3,2.431437110962268
39538,703-004-5381,8550.895,6,2,4,1.70265582824034
40000,703-004-5380,7218.356,2,1,1,0.5765163772659609
40426,703-004-5387,6006.0923,4,3,1,1.028499016417409
40570,703-004-5381,4580.9443,2,0,2,0.27920371738274696
40586,207-008-2399,6864.041,6,2,4,1.2824067372553734
40756,703-004-5381,1530.8148,6,3,3,1.562084716882324
40872,703-004-5389,3749.4893,5,2,3,2.704424886054711
4109,703-004-5391,4395.979,4,1,3,0.5886199159315113
41487,207-008-2399,2345.541,"","","",0.27920371738274696
41806,703-004-5382,904.6471,2,2,0,1.5387079410436157
41922,703-004-5390,9128.567,4,2,2,0.8824465042060762
41976,207-008-2399,7668.9995,4,3,1,0.8701021575565794
41984,703-004-5393,735.7085,2,1,1,0.33853450732658075
4225,703-004-5385,7512.375,6,2,4,0.7132672821885849
42251,207-008-2399,2573.1235,6,3,3,0.9086060794043554
42573,703-004-5390,2158.6895,5,1,4,0.38464771573292705
42693,703-004-5389,2553.3933,5,1,4,0.5165268771580819
43089,703-004-5391,5111.1396,3,1,2,0.5617609523430744
43141,207-008-2399,4392.462,5,1,4,0.7511701403502704
43180,703-004-5395,3439.1958,8,5,3,2.906517250405267
43281,703-004-5384,9602.206,4,3,1,0.9366228252500145
43526,703-004-5393,7315.4194,2,2,0,0.9751858100557641
43527,703-004-5382,831.8013,6,2,4,1.0622884527184837
43575,703-004-5381,5105.516,3,1,2,0.3804615988868899
43741,703-004-5398,9380.863,1,1,0,0.36951836429724944
43752,703-004-5399,1472.7587,7,1,6,0.48104975520679977
44008,703-004-5394,9640.188,5,2,3,0.7557585998952614
44191,703-004-5391,3319.6074,5,3,2,1.2483189432634068
4456,703-004-5380,2293.2761,5,2,3,4.007259360654865
44741,207-008-2399,6568.831,4,3,1,2.2451370190707722
45093,703-004-5381,1177.659,1,0,1,0.27920371738274696
4530,703-004-5397,6991.46,3,2,1,0.8677058221186219
45503,703-004-5385,772.6014,5,2,3,0.9516516440696182
45528,703-004-5385,5856.4854,6,2,4,0.6020999852406194
4555,703-004-5381,5913.6685,2,1,1,0.5161628245628596
4589,703-004-5398,9225.487,4,3,1,1.4218816787278545
46039,703-004-5398,6103.715,4,1,3,0.7565944789327446
46278,703-004-5398,9744.358,5,4,1,1.1247579444298634
46351,703-004-5391,1420.0104,6,5,1,1.8782494788379602
46384,703-004-5396,3814.5488,1,1,0,0.3924859181577489
46518,207-008-2399,4738.746,2,1,1,0.5770691313551896
46582,703-004-5398,585.686,6,4,2,1.4120693131622155
46889,703-004-5394,5332.6587,"","","",0.27920371738274696
46981,703-004-5388,3797.2473,3,3,0,0.9799494068241452
47227,703-004-5395,5625.3247,1,1,0,0.6371223518803387
47267,703-004-5398,8745.502,6,2,4,0.5874944396620547
47338,703-004-5397,6099.594,3,2,1,0.62249846631745
47398,703-004-5389,7531.2007,4,3,1,1.074590100192505
47498,703-004-5394,6806.8784,3,2,1,0.6590031542374976
47845,703-004-5382,9723.132,2,2,0,1.146575009007113
47868,703-004-5393,7670.9126,2,2,0,0.7864819714025253
47956,703-004-5385,8272.829,6,2,4,0.6879818185002768
48005,703-004-5380,3656.3123,5,4,1,1.1807513597889638
48050,703-004-5391,8379.671,5,1,4,0.356539788081284
48281,703-004-5386,4367.168,6,1,5,0.36951836429724944
486,703-004-5384,8117.315,5,2,3,0.586213228093979
48662,703-004-5394,871.8109,2,2,0,0.6489332696478307
48702,703-004-5396,6460.6064,5,1,4,0.3883204972791438
48925,207-008-2398,1366.8447,5,2,3,0.6846132805027573
49694,703-004-5384,4833.569,3,3,0,1.1088421378653213
49835,703-004-5385,5990.948,2,1,1,0.5501086609810905
501,207-008-2399,8484.005,2,1,1,1.0686763337927838
5051,207-008-2399,9832.366,3,1,2,2.578399049683536
5058,703-004-5396,3804.4114,4,1,3,0.35831143730785864
5110,703-004-5394,7166.208,4,1,3,1.8190220779688333
5194,703-004-5399,7031.1724,7,3,4,0.770800327832997
5289,703-004-5382,9637.18,5,4,1,2.688256867414514
5797,703-004-5398,6686.0723,4,2,2,1.1219294747894706
5924,703-004-5397,2644.4072,4,1,3,0.5005967162576628
5943,703-004-5387,6584.1235,4,2,2,0.6427053893907003
5995,703-004-5398,5525.176,1,1,0,1.2291076770830933
6441,703-004-5389,3687.4277,4,3,1,0.8141675167514466
6811,703-004-5393,3620.1125,4,3,1,0.8111933800315034
7385,703-004-5387,5878.3276,2,1,1,0.41142150850670745
7406,703-004-5395,5943.0234,"","","",0.27920371738274696
7998,703-004-5388,6222.536,3,1,2,0.7907897046682644
8477,703-004-5395,752.61475,6,4,2,1.4921427584402691
8745,703-004-5396,7508.0796,7,5,2,2.2919978575406974
8947,703-004-5380,3180.3845,3,0,3,0.27920371738274696
8972,207-008-2399,9896.282,5,3,2,1.4387809799405928
9216,207-008-2399,3056.6187,2,0,2,0.27920371738274696
9447,703-004-5380,9663.973,2,1,1,0.3978652972704144
9531,703-004-5392,6362.312,5,4,1,2.2324123929628605
9551,703-004-5382,5170.4062,5,2,3,0.6425070553693005
9953,703-004-5381,4312.9146,2,0,2,0.27920371738274696
10067,703-004-5383,8581.7,6,3,3,1.9508159594621295
10204,703-004-5381,3921.6768,7,4,3,2.7728494875526795
10402,703-004-5397,298.29205,7,3,4,1.1071991360430744
10404,703-004-5383,7799.0957,5,2,3,0.6543588945076013
10880,703-004-5394,2202.3552,4,2,2,0.8033711129773209
10973,703-004-5385,8228.036,2,2,0,0.5434680000250778
11167,703-004-5391,9003.206,4,3,1,1.4591789455930897
11168,703-004-5384,8032.1216,7,4,3,1.8430781263303215
11944,207-008-2398,1112.3884,1,0,1,0.27920371738274696
1208,703-004-5397,2113.8716,2,2,0,0.7278505196011903
12400,703-004-5389,8741.094,4,1,3,0.35442614610770856
12548,703-004-5392,7309.6543,4,2,2,0.5463726850438434
12735,703-004-5389,9338.687,6,2,4,1.1658240735656535
13175,703-004-5384,5511.3374,6,3,3,0.7416139333542318
13233,703-004-5389,5022.5366,6,1,5,0.35831143730785864
13315,703-004-5390,3675.6992,7,5,2,1.3428340870703268
13323,703-004-5390,8052.191,7,3,4,2.30753241769683
136,703-004-5396,1724.8916,2,1,1,1.2349980421550149
13622,703-004-5382,3243.2043,5,2,3,1.7036232085577432
13850,703-004-5391,5316.081,5,4,1,1.1106195525701104
13863,207-008-2398,685.4188,5,1,4,0.3713808360772676
13971,703-004-5389,4997.57,6,3,3,1.2445585784346864
14008,703-004-5398,8424.596,3,1,2,1.575675943673664
14344,703-004-5398,2486.7583,5,4,1,2.739811022745287
14566,703-004-5391,3620.3867,7,6,1,1.5202825162627074
14630,703-004-5387,9436.132,3,1,2,0.4661749228168273
14695,207-008-2398,7318.4897,1,0,1,0.27920371738274696
14922,703-004-5391,7703.334,6,5,1,2.2133302657390077
15119,703-004-5385,8097.1797,3,1,2,0.5448829639656926
15397,703-004-5394,8634.233,4,2,2,0.49150327272736793
15673,207-008-2399,6288.989,5,3,2,0.6223496498660634
15701,703-004-5383,9062.24,5,2,3,1.5026261093300592
15704,703-004-5397,5921.5967,6,3,3,1.3097839899573116
16045,703-004-5382,9703.76,3,3,0,1.0071226575396393
16277,703-004-5380,3424.57,6,3,3,0.8757956594402487
16345,703-004-5382,5353.179,6,0,6,0.27920371738274696
16374,703-004-5386,6322.989,4,1,3,1.366954819603461
16492,703-004-5399,670.27094,3,1,2,0.3978652972704144
16804,703-004-5382,4065.3516,8,3,5,0.9587708417046674
17223,703-004-5397,1897.8286,3,3,0,1.3273210718984776
17736,703-004-5385,5358.9478,4,2,2,1.453850703431069
17815,703-004-5388,4931.5156,3,1,2,0.44530695914534696
1796,703-004-5389,5060.565,1,1,0,0.8543388663758122
18079,207-008-2399,8717.493,6,4,2,1.403148406099797
18145,703-004-5385,2671.9636,2,1,1,0.36343234928872314
1847,207-008-2398,7066.9414,2,1,1,0.3978652972704144
18737,703-004-5398,7538.365,3,2,1,1.0094213984002585
18890,703-004-5380,6901.671,6,4,2,1.0462375162287727
19141,703-004-5380,5084.7344,5,3,2,1.9028796388097042
1921,207-008-2398,3792.931,2,2,0,0.5154218537057639
1927,703-004-5387,2122.1365,8,4,4,1.5892818182306796
19306,703-004-5398,3071.8982,4,3,1,0.9042798943630298
198,703-004-5396,6079.531,5,5,0,2.103088771136682
20026,703-004-5392,3717.146,5,3,2,0.8980885612874068
20101,703-004-5393,3732.8225,5,3,2,0.6370232299692921
20754,703-004-5392,8132.1143,3,1,2,0.9378412744816261
20763,703-004-5381,2250.5242,3,3,0,0.6980520017045942
2086,703-004-5384,705.71124,3,2,1,0.7492440203433796
20876,703-004-5385,4388.977,4,2,2,1.4542784329932832
21526,703-004-5385,3119.3518,2,1,1,0.39296707703875455
21881,703-004-5388,555.20416,6,2,4,0.8342858655559239
22361,703-004-5387,8597.646,2,2,0,0.9087028414037984
22439,207-008-2399,499.12393,5,5,0,1.0160078571290445
23146,207-008-2399,9489.094,3,2,1,0.45086746962023927
23355,207-008-2399,2854.1023,3,1,2,0.385263249129161
23616,703-004-5389,3417.6433,1,1,0,0.5353267996798071
23642,703-004-5391,4373.2666,2,1,1,0.35831143730785864
23726,703-004-5399,8456.287,4,1,3,0.7850316191492765
24431,703-004-5393,5548.7065,5,2,3,0.475928393869886
24662,703-004-5390,2505.963,3,2,1,1.2814153643590407
24824,703-004-5385,9869.975,2,2,0,1.0709089279446884
25496,703-004-5395,9331.068,7,4,3,1.8901091970841575
25587,703-004-5380,9704.67,6,4,2,1.4843145079296938
25885,703-004-5391,4791.6616,7,7,0,3.017401117213956
25900,703-004-5395,854.60425,3,0,3,0.27920371738274696
25937,207-008-2399,5007.4277,3,3,0,1.0402519614869867
26008,703-004-5396,7501.1245,2,1,1,1.2349980421550149
26154,703-004-5387,2072.2026,2,1,1,0.5037597165270232
26284,703-004-5386,9581.845,3,2,1,0.7506217034453992
26300,703-004-5394,8523.551,1,1,0,0.33816665642892896
26680,703-004-5388,5489.995,8,4,4,1.2096108393668892
27005,703-004-5396,566.2519,5,1,4,0.3978652972704144
27278,703-004-5380,459.7634,4,3,1,0.857593786481309
27331,703-004-5383,5860.9424,8,5,3,1.863967026181442
27377,703-004-5395,2779.6978,4,2,2,1.113792991110091
27630,703-004-5384,7078.4956,5,2,3,1.0933730617259947
27977,703-004-5386,9005.266,4,2,2,1.2791311375531618
28046,703-004-5391,7862.089,4,3,1,1.2135484067314155
28087,703-004-5399,4225.586,5,3,2,1.7906347026672118
28145,207-008-2398,2416.3037,6,3,3,1.9322461781494966
28211,703-004-5386,4411.9014,1,1,0,1.3597493526261957
28235,207-008-2398,9865.03,8,7,1,2.524054767956789
28289,207-008-2399,9101.702,4,1,3,0.33853450732658075
28389,703-004-5393,1972.1449,2,1,1,1.0005181776905678
290,703-004-5391,7051.8794,"","","",0.27920371738274696
29109,207-008-2399,9440.611,7,5,2,2.0957237471555255
29339,703-004-5395,8096.5776,2,0,2,0.27920371738274696
2940,703-004-5393,9576.36,3,1,2,0.4314860782385869
29453,703-004-5394,5293.7305,2,1,1,0.5960530752032277
29626,703-004-5386,5177.1353,5,3,2,0.9316223796285125
29668,703-004-5383,1978.8271,4,2,2,0.7040248429763658
29688,703-004-5397,6042.5454,4,1,3,0.5165268771580819
29787,703-004-5385,4259.066,7,2,5,1.0512659668721522
29825,703-004-5383,9200.451,4,2,2,0.7444106788123306
29938,703-004-5382,2054.3176,2,1,1,0.658421332962738
30074,703-004-5389,7640.4907,4,1,3,0.6989903490660362
3039,703-004-5391,2826.842,5,2,3,0.6351884570457493
30422,703-004-5383,7443.3857,2,1,1,0.4421583994256712
30424,703-004-5383,442.90604,3,1,2,0.60173851547446
30663,703-004-5382,5186.1484,5,3,2,1.4611321738615821
30762,703-004-5393,3838.7883,2,1,1,0.5669580486103406
31376,703-004-5387,1657.3923,5,3,2,2.059484472026714
31569,703-004-5396,4024.1396,6,0,6,0.27920371738274696
31642,207-008-2399,8221.306,5,3,2,1.5050483371312957
31691,703-004-5383,1003.9443,7,5,2,2.0687777200319206
31952,703-004-5395,7864.325,1,0,1,0.27920371738274696
32195,207-008-2399,6089.6514,4,2,2,0.6529201242465078
32259,703-004-5390,7343.891,7,3,4,1.717926780446342
32491,703-004-5389,8716.361,7,2,5,0.5575601684836596
32751,703-004-5391,8572.901,2,2,0,0.5604216373992537
32762,703-004-5382,9691.67,4,1,3,0.7882080630929748
32764,703-004-5383,7123.3237,6,3,3,1.3943804308033931
33255,703-004-5388,7824.369,3,1,2,0.5978541015194632
33259,703-004-5383,5572.6606,7,3,4,5.237752876009836
33268,703-004-5390,2155.1555,4,2,2,0.8778238774039139
33454,207-008-2399,2839.735,1,1,0,0.6948273703865648
33548,703-004-5381,4475.0967,3,1,2,0.5083515887270711
33924,703-004-5390,9189.433,3,3,0,2.378622951673704
34105,703-004-5385,1756.711,3,1,2,0.4283760997755538
35245,703-004-5389,5643.631,7,4,3,2.3354389469624235
35328,703-004-5389,9657.187,2,2,0,1.1553523777153134
35425,703-004-5384,1554.9845,5,5,0,1.243792749799286
35443,207-008-2399,2021.0343,7,3,4,0.906524083045041
35566,703-004-5380,7799.7476,3,2,1,0.5762454436823815
35706,703-004-5386,7502.927,7,5,2,1.845711149258223
35723,703-004-5384,5125.082,1,0,1,0.27920371738274696
36122,703-004-5389,3416.325,3,1,2,0.35831143730785864
36435,703-004-5386,9379.801,4,2,2,1.1250194897525247
36545,703-004-5381,7537.475,1,0,1,0.27920371738274696
36567,207-008-2398,9801.343,2,2,0,0.6048149139093066
3669,703-004-5396,3207.8892,8,6,2,2.78282977088134
37375,703-004-5399,3172.1567,2,1,1,0.6833473490956031
37415,703-004-5399,3627.8123,5,1,4,0.4161688860774558
37489,703-004-5397,6728.8447,5,1,4,0.5165953405815409
37666,703-004-5384,7748.602,5,1,4,0.755279954831352
3788,703-004-5383,8797.156,3,2,1,1.2629670965485083
38482,703-004-5381,8274.46,6,2,4,1.4293446003803294
38531,703-004-5387,249.81142,4,3,1,1.0305870492986355
38601,207-008-2398,2361.1748,5,4,1,3.355838993145173
3871,703-004-5398,7851.2134,2,2,0,0.8720936611402785
38711,703-004-5386,7539.648,3,2,1,0.8285596260309379
38732,703-004-5385,3534.4612,4,2,2,2.50938095552052
38945,703-004-5392,7619.5527,5,1,4,0.7524526218230835
39019,703-004-5394,4456.438,5,2,3,1.0450278055818152
3903,207-008-2398,6040.996,2,1,1,0.4817110974618143
39091,703-004-5391,7969.0454,3,1,2,0.3978652972704144
39642,703-004-5396,7725.5674,3,0,3,0.27920371738274696
39715,703-004-5398,2242.3118,5,2,3,0.7835862737764437
39906,703-004-5389,9075.621,5,4,1,1.4490495636490706
40110,703-004-5398,4339.8867,3,2,1,0.6570109340538919
4067,703-004-5398,9702.456,7,1,6,0.33853450732658075
40792,703-004-5390,1768.3125,5,2,3,0.8400650910705502
4093,703-004-5394,6209.341,5,3,2,1.1062931013143062
41063,703-004-5382,6473.021,1,1,0,0.576312845506016
41707,703-004-5389,5186.895,5,4,1,1.4878549511802917
42202,703-004-5383,147.78613,3,0,3,0.27920371738274696
42280,703-004-5393,2642.318,4,2,2,0.7777297348938166
42325,703-004-5386,7889.4536,3,2,1,0.7440864295178125
43014,703-004-5386,3334.7488,3,2,1,0.6238657863970687
43127,703-004-5393,1072.6761,6,2,4,0.40627049251245756
43231,703-004-5397,6348.0767,2,1,1,0.41227420339963117
43256,703-004-5386,9050.825,6,2,4,1.690368738471035
43463,703-004-5385,4615.4946,3,3,0,1.144819985405271
43544,703-004-5382,2282.722,4,1,3,0.5728865627708583
43692,703-004-5391,8154.871,2,1,1,0.4196693625747734
43704,703-004-5399,2768.212,3,0,3,0.27920371738274696
43867,703-004-5383,1364.7341,5,3,2,2.7470589677441146
43986,703-004-5388,6395.051,5,3,2,0.5568788261868001
44088,207-008-2399,9617.479,3,1,2,0.475970395515371
44135,703-004-5390,5685.4697,5,1,4,0.4230808829965438
44328,703-004-5393,870.8346,4,1,3,0.4006622118998408
44374,703-004-5392,3645.6812,2,0,2,0.27920371738274696
4441,703-004-5383,5606.3486,4,3,1,0.6662667815012752
44503,703-004-5387,6137.123,9,4,5,1.6731898213386438
44523,703-004-5382,1739.9674,3,2,1,1.2633385061823343
44645,703-004-5398,8412.933,4,1,3,0.9613767901042736
44647,703-004-5381,6686.794,1,1,0,0.32666834933781397
44852,703-004-5392,9930.132,1,1,0,1.3752132724440107
44881,703-004-5391,7678.3228,3,0,3,0.27920371738274696
44986,703-004-5395,6316.4985,"","","",0.27920371738274696
45112,703-004-5385,8108.648,4,1,3,0.5165268771580819
45164,703-004-5388,2641.449,6,3,3,1.1945584772651978
45240,703-004-5389,3315.0608,4,1,3,0.9492351359327081
4525,703-004-5399,139.426,5,4,1,1.020181456818257
45513,703-004-5385,5405.6113,6,4,2,1.6223656320302813
4567,703-004-5384,6964.5654,1,0,1,0.27920371738274696
46124,703-004-5396,1170.3884,2,0,2,0.27920371738274696
46406,703-004-5393,1255.4425,"","","",0.27920371738274696
46692,703-004-5391,3052.8445,9,4,5,1.16734042136328
47117,703-004-5396,6059.134,1,1,0,0.5876546252240652
48635,703-004-5393,4770.991,1,1,0,0.4607945869166548
48751,207-008-2398,6296.2754,4,3,1,0.9888720740538139
48789,703-004-5392,548.0969,2,1,1,0.831942875501567
48905,703-004-5392,5240.954,7,2,5,1.3939478487828738
49421,703-004-5388,7927.3804,3,0,3,0.27920371738274696
49661,207-008-2398,1705.8259,3,0,3,0.27920371738274696
49674,703-004-5399,643.0608,4,2,2,0.4994431146801876
49772,703-004-5384,880.68005,3,1,2,0.42690112663792734
49836,703-004-5388,498.0588,2,0,2,0.27920371738274696
5049,703-004-5381,5150.97,4,2,2,0.9547762291944576
5251,703-004-5392,2342.7112,2,1,1,0.6916366096936892
5361,703-004-5383,2789.6172,3,2,1,0.7859829229197349
5554,703-004-5397,9508.553,2,2,0,0.6938067163994672
5590,703-004-5383,7495.4663,3,3,0,1.0345230001932004
5602,207-008-2398,9343.719,9,5,4,3.3493491379474443
5910,703-004-5392,4476.942,2,1,1,3.1014368030007775
620,703-004-5384,3944.23,2,1,1,0.5683124684826292
6214,703-004-5386,6932.823,1,1,0,0.37392655958620136
6813,703-004-5381,8758.405,3,2,1,0.49822337260534216
7020,703-004-5389,3225.9016,5,4,1,1.3281109308467973
7083,703-004-5389,7444.7573,5,4,1,1.75165696227827
7136,703-004-5387,295.19498,2,1,1,0.7133805877226125
7361,207-008-2399,4280.8335,8,2,6,1.438372959182619
7779,703-004-5393,9247.688,"","","",0.27920371738274696
8276,703-004-5380,7942.653,3,0,3,0.27920371738274696
845,703-004-5393,9799.131,4,2,2,0.6828335793035578
8464,703-004-5391,7885.253,3,1,2,0.44451413086375374
8775,703-004-5390,4333.7964,3,0,3,0.27920371738274696
9056,703-004-5394,6187.909,4,0,4,0.27920371738274696
9266,703-004-5396,7274.354,6,2,4,0.5280050293429318
943,703-004-5395,9628.641,7,5,2,1.4998097512299866
9446,703-004-5382,9185.4795,3,1,2,0.8424307499626564
9568,703-004-5387,1382.2449,5,4,1,2.0681324345873326
10040,703-004-5387,6254.223,7,2,5,2.0082724042975224
10054,703-004-5395,9335.004,1,1,0,0.46741157541600986
10864,703-004-5392,2829.0444,4,3,1,0.9714681279794982
1128,703-004-5397,1992.2667,3,1,2,0.3401166617250829
11619,703-004-5382,4272.567,4,1,3,0.8161576042975871
11928,703-004-5394,2324.8328,5,3,2,0.8876066282231329
12843,703-004-5390,7377.9375,3,1,2,0.7091052339869216
13078,703-004-5388,8512.003,4,2,2,0.6761572901210732
13093,207-008-2399,2969.3293,1,0,1,0.27920371738274696
13184,703-004-5389,4325.627,"","","",0.27920371738274696
13211,703-004-5396,4995.8433,2,0,2,0.27920371738274696
13224,703-004-5387,5098.6426,2,2,0,1.1041424876997956
13287,703-004-5386,5797.136,2,0,2,0.27920371738274696
13325,703-004-5385,8682.711,4,1,3,0.5289419329048903
13341,703-004-5382,6152.458,1,0,1,0.27920371738274696
13570,703-004-5387,143.21744,2,1,1,0.794821621951657
13760,703-004-5391,803.97186,4,1,3,0.6911903865970349
13963,703-004-5393,6376.084,2,1,1,0.33853450732658075
1414,703-004-5396,4032.2012,2,1,1,0.35831143730785864
1464,703-004-5385,8533.132,7,4,3,2.2077911248708935
14647,703-004-5386,8885.557,3,1,2,0.533134785549001
14980,703-004-5389,6892.263,"","","",0.27920371738274696
15104,703-004-5387,4662.048,4,3,1,1.7975027143248734
15415,703-004-5386,9110.066,4,2,2,0.6605356807967676
15597,703-004-5389,130.85306,5,3,2,0.8945965990502347
15851,703-004-5388,7014.3003,1,0,1,0.27920371738274696
16136,703-004-5387,4771.05,3,2,1,0.44929226804868355
16230,703-004-5383,9923.433,5,1,4,0.5958619365070978
16272,703-004-5397,8894.186,5,1,4,0.7729765329154092
16304,703-004-5391,5029.3394,5,2,3,1.2075656126522538
16546,207-008-2398,5755.8647,4,1,3,0.4814365897196228
16553,703-004-5393,5962.3823,2,0,2,0.27920371738274696
16574,207-008-2398,5707.1426,3,0,3,0.27920371738274696
16830,703-004-5398,1094.0027,3,2,1,1.5628874957799868
16849,703-004-5388,4476.605,5,0,5,0.27920371738274696
1698,703-004-5393,7720.246,4,2,2,0.8743277094434446
17020,703-004-5384,8403.838,1,1,0,0.5534660707943164
17249,703-004-5391,7227.051,5,3,2,0.9493283221532635
17402,703-004-5389,7787.085,7,3,4,0.9326438465540597
17426,703-004-5388,4939.637,6,3,3,0.6368210249577306
17531,703-004-5385,7764.199,4,4,0,1.0572282158786979
17620,703-004-5394,798.4787,2,2,0,3.509279187552052
17899,703-004-5390,6451.5894,10,5,5,1.99045776235525
17903,703-004-5381,4784.019,6,3,3,1.5726786575135463
18502,703-004-5385,5841.8325,1,1,0,0.6929472816075285
18972,703-004-5393,300.97186,5,3,2,1.5854023829873698
19091,703-004-5392,4569.174,8,3,5,1.1339809311434308
19343,703-004-5393,2790.264,7,3,4,1.8838831830684484
19764,703-004-5387,8767.72,3,1,2,0.5761807951489997
19846,703-004-5386,7780.669,5,2,3,0.6061065544839878
20452,703-004-5396,3117.7139,7,3,4,1.1238355806362537
20682,703-004-5399,2857.9526,6,4,2,2.9438139632944935
21041,703-004-5393,4998.8604,4,0,4,0.27920371738274696
21059,703-004-5398,5022.732,6,5,1,2.104944508418119
21333,703-004-5380,19.472837,6,3,3,0.8227100725412932
21402,703-004-5383,2530.0134,5,2,3,0.6877901834433429
21472,703-004-5382,9682.853,2,2,0,0.5921405126139693
21757,207-008-2399,331.90668,6,4,2,1.5834679167014127
21852,703-004-5397,9316.655,4,1,3,0.3367545836282657
22693,703-004-5384,8670.014,3,1,2,0.8015534331835037
22965,703-004-5380,3046.1746,1,0,1,0.27920371738274696
23372,703-004-5394,4517.0005,"","","",0.27920371738274696
23509,207-008-2398,1931.6196,3,3,0,1.3514533995424192
24008,703-004-5384,8111.8413,5,2,3,0.6608548231668729
24016,703-004-5395,5398.023,1,1,0,0.6035582401448739
24179,703-004-5395,2509.6113,5,3,2,1.4002827044445614
24385,703-004-5396,8876.853,12,10,2,4.467545285268508
2453,703-004-5388,1648.2639,6,3,3,1.4625636195531593
24589,207-008-2398,6914.5513,7,5,2,1.706392702172883
24988,703-004-5385,6061.055,5,4,1,2.6937242367349494
25011,703-004-5395,1396.1488,4,1,3,0.8331181431254586
25013,703-004-5391,6357.992,2,1,1,0.33853450732658075
25156,703-004-5396,2827.8606,3,2,1,0.6062286162504851
25254,207-008-2398,3319.7783,5,2,3,0.6043187535468331
25583,703-004-5391,6640.777,5,2,3,0.949814105131906
26011,207-008-2399,8014.5,6,4,2,1.6870784062985815
26016,703-004-5395,3828.8213,5,3,2,1.6925672175713615
26421,703-004-5387,2937.9119,5,1,4,0.4532555339154786
26878,703-004-5392,1902.557,6,3,3,1.2607647242955462
2695,703-004-5380,9905.007,8,2,6,1.2537376832200762
27102,703-004-5387,259.74393,4,1,3,0.41597141508089547
27201,703-004-5392,4719.933,"","","",0.27920371738274696
27217,703-004-5391,3437.859,4,4,0,1.1505052478928084
27406,703-004-5387,3621.844,8,3,5,1.0639058781748922
27787,703-004-5397,941.72894,3,1,2,0.6241243347203275
28005,703-004-5384,6833.2954,8,4,4,1.3637004773748769
28221,703-004-5393,8377.015,4,1,3,1.2487800152007698
28433,207-008-2398,2781.4055,1,1,0,0.4321582083056338
28688,703-004-5388,3027.202,4,2,2,1.0562219657655967
29358,703-004-5396,4582.9927,4,3,1,1.205736685928663
29411,703-004-5387,2456.823,7,5,2,1.8731224274261087
29603,703-004-5399,9001.79,1,0,1,0.27920371738274696
29649,703-004-5385,2026.4524,6,2,4,0.8156639343855082
29655,703-004-5395,7196.8613,3,0,3,0.27920371738274696
29828,703-004-5382,4030.8625,5,1,4,0.3187575773453028
29906,703-004-5387,1415.4679,2,1,1,0.35831143730785864
30020,207-008-2399,8095.7227,3,1,2,0.6405832381239333
30068,703-004-5388,5489.469,5,2,3,0.499282050391068
30136,703-004-5386,5230.78,5,1,4,0.5714690146644378
30216,703-004-5399,5499.079,5,2,3,1.0534587168860838
30292,703-004-5389,6221.0024,2,2,0,1.6009494847238028
30302,703-004-5395,6578.3013,4,3,1,1.6024816759833294
30482,703-004-5380,8691.093,3,2,1,0.8234733149567135
3061,703-004-5386,970.9036,1,1,0,0.6055035205243195
30774,703-004-5384,2393.3704,3,2,1,0.6911108174260523
30883,703-004-5388,6704.9883,5,3,2,0.9087009925753465
31120,207-008-2398,3602.29,4,4,0,1.4934816921274554
31122,703-004-5394,9245.118,4,3,1,1.2627408771315778
31272,207-008-2398,3061.2153,2,1,1,0.7413300942992342
31357,703-004-5380,4460.5117,7,5,2,2.666295072124552
31460,703-004-5380,5112.4863,4,3,1,1.1116448013636127
3159,207-008-2399,7973.28,2,2,0,1.002204493429387
31776,703-004-5385,1740.2769,2,0,2,0.27920371738274696
3183,703-004-5390,1898.5558,6,4,2,2.4508151095049233
32024,703-004-5391,1566.6246,4,3,1,2.909548585621885
32027,207-008-2398,5622.335,5,2,3,0.9091614118323254
32117,207-008-2399,2312.0774,1,1,0,0.588405771110658
32336,703-004-5394,8549.875,2,1,1,0.42007759738412787
32675,703-004-5394,5052.531,1,1,0,0.48724306980976634
32726,703-004-5382,3718.7969,6,1,5,0.4775006435413852
32730,703-004-5381,6626.779,2,1,1,0.5722802660844978
32915,703-004-5390,3029.3762,5,4,1,1.7979591246788318
32951,703-004-5389,9298.644,5,2,3,0.6809888912443448
3301,703-004-5390,294.95776,6,2,4,1.0177364665952244
33152,703-004-5396,7184.1562,4,2,2,1.0058630064361658
33189,703-004-5391,750.59174,1,0,1,0.27920371738274696
33367,207-008-2399,5126.1597,2,2,0,0.8628041491521049
34197,703-004-5387,5298.115,6,3,3,0.6376231099327122
34324,703-004-5392,5984.9077,2,2,0,0.8709884984469983
34425,703-004-5387,3047.5032,5,1,4,0.5333337749861062
34441,207-008-2398,9437.344,5,4,1,1.9559590710823311
34515,703-004-5381,83.810684,7,2,5,0.5482850708716456
35029,703-004-5388,8355.366,10,4,6,1.7798872080438273
35085,703-004-5390,962.826,4,1,3,1.5436679664006234
35140,703-004-5388,4933.624,4,0,4,0.27920371738274696
35421,703-004-5385,2040.3862,2,1,1,0.5536526828317228
35849,207-008-2398,5762.644,2,1,1,0.7019763431934448
35865,703-004-5399,8201.963,4,3,1,1.462334687814968
35903,703-004-5398,6458.414,2,2,0,0.6056379115929381
36355,207-008-2399,7310.9185,3,3,0,1.8728400546151547
36633,703-004-5382,9836.038,2,2,0,0.4236867137893296
36733,703-004-5382,9425.595,3,2,1,0.8032665611599611
37138,703-004-5395,7655.151,6,5,1,2.096682190760967
37145,703-004-5394,4030.0537,4,2,2,0.6809849645407418
37212,703-004-5391,8103.5776,4,2,2,1.042932979291483
37410,703-004-5383,2226.1519,1,0,1,0.27920371738274696
37467,703-004-5383,7966.598,4,2,2,0.6260446195850704
37507,703-004-5399,3618.446,3,1,2,0.35831143730785864
38041,703-004-5393,1832.1412,3,2,1,1.1641939314102299
38181,703-004-5385,6136.525,3,2,1,0.6671964728789556
38317,703-004-5384,9790.436,4,2,2,0.8964667716051598
3865,703-004-5393,4443.9487,9,7,2,3.6236788005219918
38971,703-004-5386,1496.8872,2,1,1,0.8061775266887704
39050,703-004-5387,9037.646,4,2,2,0.5095868715657987
39252,703-004-5383,1883.4376,6,4,2,1.7892391073914602
39555,703-004-5399,9502.059,4,3,1,2.3421284423043542
3962,703-004-5380,2737.388,2,0,2,0.27920371738274696
39676,703-004-5382,5250.7266,4,1,3,0.6092299013318538
39937,703-004-5381,8832.587,5,3,2,0.519387373625388
40652,703-004-5381,2046.1923,3,1,2,0.4986097591769866
40836,703-004-5385,9360.1045,1,1,0,0.41029080150928354
41231,703-004-5381,1869.1855,5,1,4,0.5308603495329337
4137,703-004-5396,8271.939,6,3,3,1.06642395386675
41758,703-004-5388,4940.504,2,1,1,1.574672280683704
41865,703-004-5387,4088.0781,6,4,2,1.6112391068645526
41874,703-004-5393,3651.8748,1,0,1,0.27920371738274696
4192,703-004-5386,2348.0737,5,3,2,2.6292572748229195
4212,207-008-2398,2340.8628,3,0,3,0.27920371738274696
42343,703-004-5399,1236.198,8,3,5,1.6314526636595574
42345,703-004-5393,1436.671,1,1,0,0.6707050338398822
42734,703-004-5390,3170.6577,5,4,1,1.4644848804400794
42925,703-004-5391,7212.7227,9,5,4,2.6703581916893917
43006,703-004-5391,7391.765,1,0,1,0.27920371738274696
43107,703-004-5398,1240.6337,1,0,1,0.27920371738274696
43113,703-004-5389,5477.074,1,1,0,0.6622710652282889
43115,703-004-5387,3905.1323,5,3,2,1.0670937659664923
43195,703-004-5390,73.39537,6,6,0,2.583153969226973
43221,703-004-5383,3801.2415,7,3,4,0.8707585257876421
4336,703-004-5386,736.43567,5,5,0,2.8151392996492346
43384,703-004-5385,4653.885,2,1,1,0.657616956130194
43933,703-004-5388,9768.654,8,3,5,1.1917525214222688
43958,703-004-5397,8432.003,4,2,2,0.6794058371070927
4416,703-004-5388,4252.44,6,4,2,1.4650324539811068
44241,703-004-5385,7376.2446,4,2,2,0.8140240171829175
44426,703-004-5386,5942.498,7,3,4,0.6748459246068725
44496,703-004-5380,9863.124,7,3,4,1.3647871865582544
44609,703-004-5384,6459.516,6,2,4,3.3152625956269883
4521,703-004-5397,9186.241,7,3,4,1.1629301748618013
4537,703-004-5392,9999.656,8,6,2,3.4286066897008425
45640,703-004-5399,4355.8784,5,2,3,0.8797173590891472
45916,703-004-5398,2325.4316,4,1,3,0.4655804084353089
46115,703-004-5388,3065.6624,3,1,2,0.7327740434815728
46233,207-008-2399,693.8845,5,1,4,0.5734141587328331
46511,703-004-5393,9171.044,2,2,0,0.6946850071126064
46612,703-004-5386,2084.6123,7,4,3,0.6697459437726896
46643,703-004-5386,8642.458,8,4,4,1.5613098017270506
46831,703-004-5395,6283.8906,4,2,2,0.6245973342843663
47021,703-004-5398,5039.8125,5,3,2,1.026479823395541
47230,703-004-5386,4990.362,9,3,6,1.164760591679383
47249,207-008-2399,570.513,7,3,4,1.2523371412308981
47534,703-004-5382,9831.421,2,2,0,0.7611741036213817
47663,703-004-5385,8770.919,1,1,0,0.6047483982195865
47668,703-004-5396,5210.393,5,4,1,1.3786913796298081
47752,703-004-5384,5752.092,1,1,0,0.6996891584263378
47754,703-004-5381,6405.344,2,0,2,0.27920371738274696
47801,703-004-5394,2666.1174,1,0,1,0.27920371738274696
47992,703-004-5396,9841.192,2,0,2,0.27920371738274696
4827,703-004-5392,3206.4294,1,1,0,0.5543851920472472
48617,703-004-5385,9819.926,5,4,1,0.9482521282792561
4926,703-004-5394,8633.259,2,1,1,0.35831143730785864
49388,703-004-5389,341.5084,5,4,1,1.0425182486392057
49548,703-004-5381,9920.942,1,0,1,0.27920371738274696
49620,703-004-5399,8244.823,2,1,1,2.755633516627536
49634,207-008-2398,6981.0166,4,2,2,0.9601409967552241
49803,703-004-5386,2955.6353,2,1,1,1.2095103099271778
49892,703-004-5393,2766.4424,4,2,2,0.8366604364774916
49975,703-004-5397,6655.1743,1,0,1,0.27920371738274696
5056,703-004-5393,4867.981,6,3,3,1.2522399436305387
5145,703-004-5381,3497.9873,4,2,2,2.178798526674541
5205,703-004-5384,3250.6956,3,3,0,0.7510292260495297
5425,703-004-5395,3923.6658,5,2,3,0.9347550400317433
5563,703-004-5394,5038.587,3,3,0,1.054993865553605
5683,703-004-5394,3937.968,3,0,3,0.27920371738274696
5835,703-004-5392,7320.48,2,0,2,0.27920371738274696
5927,703-004-5383,1585.2732,6,5,1,6.5913907690527695
5988,703-004-5392,6429.705,3,2,1,0.6351884570457493
6062,703-004-5387,9258.778,3,1,2,0.4597797143980357
6155,703-004-5397,4725.683,4,3,1,1.34586722183292
7174,703-004-5382,9729.694,5,3,2,1.4913139001135896
7220,703-004-5393,6457.296,1,0,1,0.27920371738274696
756,703-004-5392,1104.4431,4,3,1,1.1924605821185938
7641,703-004-5380,6360.3823,7,2,5,0.6381110998194006
7731,703-004-5382,3070.4563,4,3,1,1.6332529675061451
7761,703-004-5390,8096.925,4,0,4,0.27920371738274696
7831,703-004-5394,6755.289,5,1,4,0.6934828789369252
798,703-004-5398,5398.5845,5,3,2,0.9585286548007579
8124,207-008-2399,2402.7527,6,2,4,1.0146938099689295
8309,703-004-5383,4014.1023,4,2,2,0.6316439205485924
8353,703-004-5390,9725.862,7,5,2,1.3443564818474212
841,703-004-5384,8483.159,2,0,2,0.27920371738274696
8603,703-004-5392,5508.7046,4,3,1,1.1150747895356392
8788,703-004-5399,444.13626,6,2,4,0.6499939505716321
9113,703-004-5399,8277.174,3,1,2,0.3670132864996209
9225,703-004-5384,1706.934,2,1,1,0.860991974817046
9226,703-004-5388,800.9136,"","","",0.27920371738274696
9240,207-008-2398,5054.782,3,2,1,0.3859991392816477
932,703-004-5386,3195.8186,6,0,6,0.27920371738274696
9702,703-004-5385,136.9238,3,3,0,0.7231956441158933
9817,703-004-5381,2932.98,2,1,1,1.042997795992171
10262,703-004-5398,3639.3494,9,2,7,0.7749063836240027
10341,703-004-5383,2816.344,3,2,1,0.8803349335986146
10400,703-004-5381,8448.747,2,0,2,0.27920371738274696
10518,703-004-5397,3152.9355,6,2,4,0.8657766372788356
10840,703-004-5382,1359.12,4,2,2,0.9582823604336784
1087,703-004-5384,1184.6733,5,3,2,1.2278933998311112
10965,703-004-5382,6561.23,4,3,1,1.4942531668753272
11026,703-004-5392,2361.4167,5,2,3,1.219482770804611
11038,703-004-5396,5804.9883,3,2,1,1.203814364061112
11460,207-008-2398,6639.3857,5,4,1,2.018847394817308
1157,703-004-5391,2474.4236,9,3,6,1.4158239649316393
11672,703-004-5384,9702.917,4,2,2,0.614686681979689
11684,703-004-5383,5474.219,3,1,2,0.894439703438167
12092,703-004-5382,4191.802,2,1,1,0.37842787125381516
12582,703-004-5381,1829.8704,4,2,2,1.2097082790704958
12875,703-004-5396,1867.9124,5,2,3,0.837263540636299
13022,703-004-5391,1032.1927,2,1,1,0.4314860782385869
13536,703-004-5380,4489.1245,7,3,4,0.9614707123717431
13881,703-004-5385,6598.815,1,0,1,0.27920371738274696
14043,703-004-5391,5131.902,3,1,2,0.5669580486103406
14111,703-004-5394,1800.791,1,1,0,0.41629525338929557
14375,703-004-5392,5398.8145,3,2,1,2.51935697474174
14480,703-004-5385,4640.339,1,0,1,0.27920371738274696
14492,703-004-5389,7197.854,5,3,2,1.6219002187519884
14917,703-004-5387,2250.8835,1,0,1,0.27920371738274696
14994,703-004-5396,4967.925,3,2,1,1.6883674187273499
15048,207-008-2399,1119.6053,7,5,2,1.807487963006937
15148,703-004-5384,6104.5713,7,4,3,1.1652674493116468
15226,207-008-2399,1506.4001,4,3,1,0.6683086234865874
15406,703-004-5389,1754.5682,5,1,4,0.43863912738783994
15465,703-004-5386,6961.3936,5,3,2,0.6214117298025634
15733,703-004-5385,1132.1027,1,0,1,0.27920371738274696
15908,703-004-5391,3821.7627,2,1,1,0.44829646872267315
15934,703-004-5388,4452.0747,3,0,3,0.27920371738274696
16179,703-004-5385,687.78754,2,1,1,0.5393759189808974
16376,703-004-5392,9081.144,2,2,0,0.6887710507046138
16525,207-008-2398,7511.4365,4,2,2,0.762202409401519
1654,703-004-5398,8029.7734,4,1,3,0.5449190166117366
16589,703-004-5382,5307.425,5,2,3,0.9525873036668809
16640,703-004-5382,8118.273,3,2,1,0.555351188147995
1738,703-004-5382,4541.1675,2,2,0,1.8539667173950796
17841,703-004-5381,6519.713,4,2,2,0.5615787236554329
17844,703-004-5380,2897.092,7,2,5,0.48234162964669375
18031,703-004-5381,8227.471,6,2,4,0.39608537357209944
18085,703-004-5388,8969.592,4,1,3,0.665021840659579
18191,703-004-5393,294.95477,3,2,1,0.9200550808731076
18235,703-004-5386,118.84511,3,2,1,0.8978205395552039
18316,703-004-5397,2588.4146,7,3,4,0.5172401154895175
18510,703-004-5395,4437.358,6,4,2,2.136295327474158
1857,703-004-5393,5209.3076,8,3,5,0.9867561119499917
18919,703-004-5396,6116.581,4,2,2,0.5023684631126518
18963,703-004-5390,832.85333,4,2,2,1.093403679066332
18974,703-004-5398,5913.143,4,2,2,1.1192680440598506
19093,703-004-5391,108.85239,2,1,1,0.5810555701680832
19355,207-008-2398,9733.817,2,0,2,0.27920371738274696
1942,703-004-5398,5850.893,6,3,3,1.1613075677266087
19464,703-004-5392,897.77826,3,2,1,0.523206433076304
19477,207-008-2399,3061.6582,4,3,1,0.8568083893660325
19651,703-004-5382,5171.954,1,0,1,0.27920371738274696
19815,703-004-5394,1479.5912,6,3,3,1.219242007560508
201,703-004-5394,1613.6097,2,2,0,1.716177598782643
20282,703-004-5396,6192.26,4,0,4,0.27920371738274696
20425,703-004-5380,4631.385,6,2,4,1.7316139126979861
20749,703-004-5380,3173.138,5,4,1,1.8792179418174675
20839,207-008-2399,8097.313,4,2,2,2.4216402313356076
20916,703-004-5391,5350.2524,7,5,2,2.7762420608578657
21077,703-004-5395,8322.507,2,0,2,0.27920371738274696
21092,703-004-5385,4444.9775,5,1,4,0.5342581659188032
21129,703-004-5399,1145.1543,5,3,2,2.8495469920375385
21133,703-004-5381,8477.207,12,2,10,1.2286212313192921
21303,703-004-5384,5744.88,4,4,0,1.3693947084388816
21340,703-004-5388,3794.85,7,3,4,0.8700218504276753
21441,703-004-5382,6636.428,"","","",0.27920371738274696
21523,703-004-5395,8068.4287,3,1,2,0.5778858171497461
2163,703-004-5395,7154.895,7,2,5,1.1503058335615648
21864,703-004-5393,671.68414,1,1,0,0.3902511792276225
22258,703-004-5387,20.371078,3,1,2,0.4986206506781735
22342,703-004-5386,8727.81,2,1,1,0.47136869528852265
22603,703-004-5385,3307.8533,3,0,3,0.27920371738274696
22650,703-004-5390,6798.014,2,2,0,0.5547669145478569
22691,703-004-5384,9772.372,3,2,1,1.3030611476543783
22757,703-004-5390,610.5024,7,4,3,3.0463141889772762
2311,703-004-5381,1367.8098,2,1,1,0.39141071155093826
23869,703-004-5384,2539.8076,4,4,0,1.491901176296611
23907,703-004-5386,5229.73,2,1,1,0.8048335964618973
23936,703-004-5391,4219.8525,4,2,2,0.6674990164026622
23975,703-004-5393,3397.7395,4,3,1,0.8308133507615546
24064,703-004-5399,7493.3555,3,2,1,0.9185257491722658
2412,703-004-5396,1595.9012,1,0,1,0.27920371738274696
24169,703-004-5386,268.92184,6,4,2,1.3519883650509545
24370,703-004-5394,3933.3247,4,2,2,1.4120757644380542
24506,703-004-5393,7489.3735,5,1,4,0.32817961747674373
24516,207-008-2399,2204.2375,5,3,2,1.6793435273383828
24638,703-004-5396,3873.9353,6,2,4,1.1253525448763537
24658,703-004-5394,3009.4182,2,2,0,1.1144194156310603
24744,703-004-5387,7292.685,3,2,1,0.47697301719552604
24938,703-004-5394,9632.039,3,2,1,0.7403116145084986
24992,703-004-5385,3728.2312,5,3,2,1.4239046510703313
25307,703-004-5393,8149.903,3,1,2,0.9346633882118501
25324,703-004-5388,9141.02,3,2,1,0.9647828584511977
25783,207-008-2398,5992.7593,2,1,1,0.32666834933781397
25928,703-004-5386,5790.049,4,1,3,0.35831143730785864
25998,703-004-5386,136.98875,5,3,2,1.2588748486331043
26025,703-004-5383,7908.914,4,2,2,1.9587951493816325
26075,703-004-5381,7060.6143,2,2,0,0.5935534315785903
2613,703-004-5394,3257.7253,7,4,3,1.7740807017379208
26186,703-004-5393,1144.3573,2,0,2,0.27920371738274696
26280,703-004-5388,2594.5747,7,3,4,1.8131810719375359
26506,703-004-5390,9178.67,5,1,4,0.422684959845502
26709,703-004-5393,4790.3584,7,5,2,1.3730142286960696
26795,703-004-5388,7484.534,7,3,4,1.5316678808101503
26821,703-004-5390,5932.7485,2,1,1,0.4284421867134667
26972,703-004-5388,7658.2188,6,4,2,3.227825409012561
27066,703-004-5387,8299.107,4,1,3,0.6042761036494703
27592,703-004-5386,1887.4932,2,0,2,0.27920371738274696
27771,703-004-5398,1727.4421,2,1,1,0.47819350615482453
27945,703-004-5393,4347.069,3,1,2,1.5310210176027244
28105,207-008-2398,7638.347,1,0,1,0.27920371738274696
28527,703-004-5396,7721.8574,5,4,1,2.2002602110109795
28636,703-004-5393,5201.3467,3,2,1,1.1168798197510892
28741,703-004-5396,6555.143,5,3,2,0.9722440302809715
28802,703-004-5389,9237.863,8,5,3,1.8752592500437877
28975,703-004-5388,4424.988,4,1,3,0.5006224016070033
29135,703-004-5392,9301.412,5,2,3,0.515583970819287
29316,703-004-5388,5129.6265,3,0,3,0.27920371738274696
29459,703-004-5389,3234.2148,6,1,5,0.6187284687919729
29577,703-004-5391,4678.35,4,3,1,1.2637691828292814
29618,703-004-5384,5357.9546,8,2,6,0.6864367490475427
29845,703-004-5399,9554.693,1,1,0,0.5622098293840244
29959,207-008-2398,7648.119,1,1,0,1.0447161353622196
30021,703-004-5399,3925.953,2,0,2,0.27920371738274696
30567,703-004-5392,7304.785,7,4,3,4.167872006127542
30582,703-004-5394,5341.5454,1,1,0,0.8092698298748293
30742,703-004-5397,8158.8716,1,0,1,0.27920371738274696
30856,703-004-5398,8903.713,4,1,3,0.3923277568756567
30895,703-004-5395,1918.7462,5,1,4,0.42155954603582785
31135,703-004-5387,1050.2852,5,3,2,0.7715188922761219
31267,703-004-5395,6496.6733,4,2,2,1.3157618684602612
31348,207-008-2398,595.1887,5,1,4,0.35831143730785864
31478,703-004-5387,3166.473,2,1,1,0.48764280101825097
32210,703-004-5394,8331.476,5,2,3,0.6622209146735089
32216,703-004-5395,4815.5605,3,0,3,0.27920371738274696
32280,703-004-5397,5379.577,6,4,2,2.2907792666278772
32393,703-004-5383,7559.125,7,4,3,1.229798879588063
32402,703-004-5384,7989.472,3,3,0,0.9668499472201684
32681,703-004-5380,7730.298,3,1,2,0.5293119859925048
32709,703-004-5384,9361.204,4,2,2,0.5002232705047659
3295,703-004-5390,1390.0029,5,2,3,0.818149792748111
33274,207-008-2399,3866.344,2,0,2,0.27920371738274696
33336,703-004-5395,6180.679,2,1,1,0.4093434494552643
33603,703-004-5393,5809.9614,2,0,2,0.27920371738274696
33806,703-004-5393,4665.087,3,2,1,0.7221088738877257
33854,703-004-5383,1587.4642,4,3,1,2.0451434821000167
34012,703-004-5382,409.9053,6,3,3,1.205019504973816
3409,703-004-5399,3574.4114,3,1,2,1.3483366172331128
34167,703-004-5380,2685.3508,2,1,1,0.35831143730785864
34483,207-008-2399,7869.504,4,2,2,0.9462908120766865
34612,703-004-5395,5704.777,2,1,1,0.7322777505598069
34654,703-004-5392,2692.9753,2,0,2,0.27920371738274696
3487,703-004-5387,7999.451,4,2,2,0.9458613935741534
34901,703-004-5385,5943.4707,4,2,2,0.6218478926011749
35148,703-004-5385,6844.856,6,3,3,1.5502260293510377
35216,703-004-5380,5689.381,3,3,0,1.1014628963685893
35279,703-004-5388,549.37067,1,1,0,0.4002776176136768
3563,703-004-5396,1108.2858,3,1,2,0.35831143730785864
35895,703-004-5384,8775.391,3,1,2,0.573335540963862
35975,703-004-5399,5185.223,6,4,2,1.7628857057142038
36269,703-004-5385,5739.525,5,3,2,1.5162145833850296
36742,703-004-5391,8704.125,4,3,1,1.5999610408951328
37031,207-008-2398,3678.1936,6,2,4,1.0229724770156234
37110,703-004-5395,8796.483,7,4,3,1.3078114429978087
37383,703-004-5384,2566.5664,3,0,3,0.27920371738274696
37525,703-004-5397,3553.7393,3,2,1,0.7623593828253733
3778,703-004-5384,8964.123,6,2,4,0.43361539436657115
37993,703-004-5395,5193.878,3,1,2,0.5669580486103406
3816,703-004-5385,1227.9808,5,1,4,0.5165268771580819
38578,703-004-5391,1498.7981,4,0,4,0.27920371738274696
38581,703-004-5384,1763.5029,6,4,2,0.9996870717559672
3877,703-004-5383,8978.725,4,3,1,1.5663299663820471
38872,703-004-5397,2360.8518,3,2,1,0.4915105064047461
39314,703-004-5380,3154.1484,2,0,2,0.27920371738274696
39359,703-004-5385,213.53065,3,1,2,1.3365625432002803
39463,703-004-5392,6487.54,"","","",0.27920371738274696
39562,703-004-5385,3833.853,7,5,2,1.2489603499206816
40332,703-004-5396,2602.288,3,1,2,1.5785431102657654
40348,703-004-5392,3423.3743,2,2,0,0.6606841888985175
40449,703-004-5385,8385.633,2,2,0,0.6928081150979002
41437,703-004-5398,5973.1396,8,4,4,0.8195222739027539
41460,703-004-5382,8273.449,5,2,3,1.1785310474975819
41866,703-004-5395,7899.9155,7,3,4,1.9976394518578493
41955,703-004-5391,3625.834,7,4,3,4.682358117551122
42083,703-004-5384,446.4084,3,0,3,0.27920371738274696
42095,703-004-5391,8561.812,3,2,1,0.786619302867837
42124,703-004-5396,7900.163,2,2,0,1.8214721144081694
42299,703-004-5384,1443.718,4,3,1,3.525988391772308
42394,703-004-5392,9506.108,1,0,1,0.27920371738274696
42470,703-004-5385,8917.273,5,1,4,0.794253988642247
4257,703-004-5380,8068.2734,1,0,1,0.27920371738274696
42606,703-004-5391,8277.346,4,1,3,0.7303181853937845
42883,703-004-5389,55.895447,2,0,2,0.27920371738274696
43008,703-004-5398,1885.4713,3,2,1,0.6490200727645309
43639,703-004-5388,5214.517,2,1,1,0.443587738430239
43765,703-004-5384,9587.911,"","","",0.27920371738274696
43767,703-004-5398,6096.466,3,1,2,0.3528933825317377
43807,703-004-5384,836.4892,7,4,3,4.578707273581661
43915,703-004-5397,9108.599,6,3,3,0.8253943807935249
44224,703-004-5384,265.54047,7,5,2,2.3308808524681277
44420,703-004-5380,5524.9536,3,2,1,0.7166319267580818
44450,703-004-5385,8484.855,4,3,1,2.0657042847891836
44516,703-004-5386,7401.6416,5,2,3,1.0185827557878184
44625,703-004-5383,2432.0198,6,2,4,0.5021994962868792
44913,703-004-5386,6680.8315,6,4,2,1.7143767095629865
44972,703-004-5382,9318.957,5,3,2,2.0926155232280808
45162,703-004-5382,4489.7256,2,1,1,0.7701189900735176
45881,703-004-5398,9159.463,5,2,3,0.6938147290496394
46001,703-004-5398,6343.8403,3,0,3,0.27920371738274696
46180,703-004-5385,7647.1323,4,2,2,0.5458608013069953
4627,703-004-5397,7252.888,3,2,1,0.8720631459817677
46458,703-004-5390,354.52484,7,3,4,0.8929633581039915
46803,703-004-5398,3048.5754,4,3,1,0.9824194762151012
47341,703-004-5395,3267.9463,3,2,1,1.0301747760513444
47440,207-008-2399,4976.1694,4,3,1,1.1631090864831566
47457,703-004-5383,1887.6398,10,5,5,1.4498048947557545
48108,703-004-5398,7413.819,6,3,3,1.8622837347199583
48339,703-004-5397,6352.104,6,2,4,0.7885729083435464
48557,703-004-5386,9013.367,4,1,3,0.3978652972704144
48564,703-004-5391,7417.589,4,3,1,1.1673926625499447
48765,703-004-5394,9437.499,3,0,3,0.27920371738274696
48823,703-004-5387,2947.0754,2,1,1,0.3367545836282657
49034,703-004-5391,7283.2227,5,3,2,0.8457044353895734
49232,703-004-5381,8019.5312,1,1,0,0.5036850880766492
49261,703-004-5390,9610.203,3,2,1,0.601539362621178
49555,703-004-5395,6836.4946,3,0,3,0.27920371738274696
49782,703-004-5387,1726.0885,4,3,1,1.5847083884627429
5144,703-004-5390,6778.003,3,2,1,0.4689251602219414
5532,703-004-5380,5774.458,5,4,1,1.1153596155581826
6185,703-004-5382,7753.133,1,0,1,0.27920371738274696
6481,703-004-5385,3581.3535,8,6,2,3.4736744449908192
6518,703-004-5391,2123.7815,"","","",0.27920371738274696
6709,703-004-5385,9966.369,4,0,4,0.27920371738274696
6970,703-004-5393,3172.0984,4,3,1,1.189183486948699
7235,207-008-2398,7334.2817,4,1,3,0.6627772743696321
7345,703-004-5381,5058.5444,"","","",0.27920371738274696
7450,703-004-5381,2588.857,4,1,3,0.35831143730785864
7620,703-004-5385,2172.8457,5,3,2,1.8825043190667476
799,703-004-5398,791.2159,4,1,3,0.5442236535650768
8007,703-004-5392,92.73171,5,3,2,1.1644774635449437
8301,703-004-5388,7534.002,4,4,0,2.4741357120621297
8453,703-004-5386,3300.575,2,0,2,0.27920371738274696
8611,703-004-5385,7520.379,5,3,2,1.1288366417724414
8962,703-004-5395,9949.135,6,4,2,1.7082508208333307
9096,703-004-5395,6560.077,4,4,0,0.8568772724557081
9606,703-004-5397,1417.2638,6,4,2,0.6509253290085204
9639,703-004-5399,185.67442,5,4,1,0.78198766406428
967,703-004-5390,4737.7227,1,1,0,0.48202707471774636
9977,703-004-5399,9818.035,5,3,2,0.8282231264374637
9991,703-004-5388,9837.687,5,4,1,3.05079015366264
10080,703-004-5389,6811.408,3,1,2,0.3978652972704144
10201,703-004-5396,9069.973,3,2,1,0.7138372535997723
10209,703-004-5381,4694.446,2,1,1,0.6674954280038665
10277,703-004-5398,3581.1597,1,0,1,0.27920371738274696
104,703-004-5392,4879.0137,3,2,1,0.6353947359877157
10405,703-004-5382,9246.285,5,3,2,0.6613005308924264
10412,703-004-5394,9844.867,4,3,1,0.9644225061428497
10623,703-004-5387,8102.5366,1,1,0,0.5165268771580819
10749,703-004-5395,1178.9482,1,1,0,0.42987488188234124
10764,703-004-5392,5062.255,3,1,2,0.7450967798553848
10788,703-004-5394,6698.7397,2,0,2,0.27920371738274696
11186,703-004-5384,3110.6687,"","","",0.27920371738274696
11265,703-004-5384,1657.2195,3,1,2,0.9530195075297225
11606,703-004-5387,8177.2275,2,1,1,0.7867784597921986
11637,703-004-5387,9618.319,2,0,2,0.27920371738274696
11733,703-004-5396,8138.0737,3,1,2,0.8958171930693645
11846,703-004-5382,9572.984,4,1,3,0.3187575773453028
11918,703-004-5397,3058.7769,4,2,2,0.5698360039419911
12113,703-004-5390,1706.782,5,2,3,0.5422095637620524
12331,703-004-5398,9151.018,3,1,2,0.743153338738999
12460,703-004-5383,8027.5947,4,3,1,1.5340957730215172
12923,703-004-5397,7432.061,8,1,7,0.4886526168888996
12954,703-004-5387,5264.8164,3,1,2,0.41828374002871693
13001,703-004-5380,8242.065,3,1,2,0.49401990899807513
13284,703-004-5398,9267.312,5,3,2,1.4801619166267475
13430,703-004-5398,6810.183,1,1,0,0.6034707925753472
1346,703-004-5389,5140.905,1,1,0,0.3978652972704144
13608,703-004-5386,2703.6606,6,2,4,2.0148549294917695
14173,703-004-5390,4813.489,1,1,0,1.273120200787385
14321,703-004-5381,7793.53,3,2,1,0.5593010973701873
14446,703-004-5381,2944.6738,1,0,1,0.27920371738274696
14611,703-004-5389,3498.0017,9,3,6,1.774747363244047
14817,703-004-5383,6175.029,2,1,1,0.6256065319202868
15132,703-004-5386,4083.5183,3,1,2,0.6401377230892291
15382,703-004-5380,1130.4468,5,1,4,0.4402595867886717
15385,207-008-2399,4519.0586,7,4,3,1.9131388121649229
15581,703-004-5392,8533.684,6,3,3,1.3661595707280034
1566,207-008-2399,9895.124,4,1,3,1.174898341755744
15664,703-004-5393,5826.288,5,3,2,0.9044611397744233
16036,703-004-5387,4856.6045,5,3,2,1.2323140282383003
16236,703-004-5386,7098.98,3,2,1,0.5689593110607266
16263,703-004-5386,8363.392,6,4,2,1.1820365295686412
16297,703-004-5387,8177.422,3,2,1,0.5372845471572283
16368,207-008-2398,9400.168,3,1,2,0.5165268771580819
16370,703-004-5395,9758.336,3,1,2,0.5799951069478398
16621,703-004-5382,3569.1423,7,4,3,2.530176270346965
16667,703-004-5385,2316.1375,3,2,1,0.824090297179215
16693,703-004-5385,3292.5159,5,3,2,1.02953455831831
16744,703-004-5395,8467.793,1,1,0,0.33339250553144845
16768,703-004-5380,7856.03,4,2,2,1.731910761928173
17479,703-004-5388,4270.448,4,3,1,0.7406943844845231
17702,703-004-5381,8693.411,2,1,1,0.5647893706774998
18108,703-004-5397,740.3302,3,1,2,0.4554203136236768
18298,703-004-5399,9192.917,4,2,2,0.8473768477864692
18417,703-004-5397,5027.7275,9,4,5,0.7507351704613655
18688,703-004-5397,8420.201,4,2,2,0.539547215040398
18838,703-004-5380,3831.7246,5,3,2,1.5039846281534395
19048,703-004-5380,4283.468,5,1,4,0.361814271523527
19082,703-004-5389,6769.1826,5,4,1,2.256997111689435
1947,703-004-5381,2679.4023,2,1,1,0.3919322182760311
19583,207-008-2399,8060.9624,4,3,1,0.828381039463231
19889,703-004-5383,3551.6118,4,3,1,0.8893963259110457
20604,703-004-5393,9810.888,5,4,1,2.8574266188711266
21100,703-004-5389,563.1345,1,0,1,0.27920371738274696
21138,703-004-5393,5633.2183,1,1,0,0.35831143730785864
21368,703-004-5387,3197.562,1,0,1,0.27920371738274696
21538,703-004-5391,8190.294,4,2,2,0.7495397060698167
21670,703-004-5385,9435.601,1,0,1,0.27920371738274696
21907,703-004-5396,1087.7054,3,2,1,0.4977939559992748
21990,703-004-5390,6260.4067,4,3,1,2.3750198309889945
21996,703-004-5393,5929.2144,4,3,1,0.9910636145673511
2213,703-004-5394,9880.67,3,0,3,0.27920371738274696
22437,703-004-5396,5135.6973,3,3,0,1.1353195278549584
22445,703-004-5390,4410.7104,7,4,3,2.140580633365322
22481,703-004-5395,2122.8933,5,4,1,1.872553996113498
22528,207-008-2399,9078.142,2,0,2,0.27920371738274696
2283,703-004-5392,952.52155,2,1,1,0.36263695032186855
22857,703-004-5393,5976.5435,8,4,4,1.2118492676903807
229,703-004-5384,8261.145,5,5,0,1.3603290409716633
2290,703-004-5383,8361.718,2,0,2,0.27920371738274696
22952,703-004-5394,739.7312,4,2,2,0.9531948427690989
23057,703-004-5386,3478.3542,6,3,3,0.8999732349013195
23135,703-004-5398,1614.8608,4,4,0,1.3613889290547372
23271,207-008-2398,8627.241,5,3,2,0.8436976940314663
23352,703-004-5380,8058.064,6,2,4,0.7982916278010541
23357,703-004-5395,433.74002,5,3,2,1.294775529242119
23494,703-004-5395,906.07526,3,1,2,0.5165268771580819
23751,207-008-2399,1331.2584,3,3,0,2.2763137431453675
23910,703-004-5385,4012.7378,3,1,2,0.5534409468608363
24292,703-004-5396,9834.826,"","","",0.27920371738274696
244,703-004-5395,5626.2446,3,2,1,1.3143137058180214
24475,703-004-5387,8570.975,2,2,0,1.0937334535057035
246,703-004-5399,6789.079,4,0,4,0.27920371738274696
2470,703-004-5389,992.1157,2,1,1,0.5380972891966762
24822,703-004-5394,450.22726,4,1,3,0.9681222513513441
24919,703-004-5387,4344.534,2,0,2,0.27920371738274696
25162,207-008-2399,3139.6472,3,3,0,2.2291863158838567
25436,703-004-5391,6995.621,1,0,1,0.27920371738274696
2625,703-004-5389,2306.7952,3,1,2,0.3271627725873459
26341,703-004-5393,3365.069,5,3,2,1.1713671244974944
26430,703-004-5381,6644.025,2,2,0,1.0554224407275916
26454,703-004-5387,3709.3032,3,3,0,0.6717543418121126
26681,207-008-2399,2104.2114,7,4,3,1.1344213455111454
26957,703-004-5395,4411.027,2,2,0,0.8513406258491999
26997,703-004-5388,2562.5598,5,4,1,0.8995092985855135
27187,703-004-5396,2048.6003,3,2,1,0.7301487616122629
27434,207-008-2398,1448.4459,7,4,3,1.3341715306853914
27623,703-004-5380,8478.209,4,3,1,1.1538139369158062
27925,703-004-5397,6412.1597,2,1,1,1.150009311239104
28040,703-004-5398,5066.4814,6,4,2,1.4791020858257444
28215,703-004-5383,675.64545,3,1,2,0.35290739119047443
28233,703-004-5388,3738.2888,7,2,5,0.4993868711743077
28571,703-004-5397,981.39703,3,2,1,1.039021274401933
28668,703-004-5384,4579.171,2,0,2,0.27920371738274696
28861,207-008-2399,9238.482,4,4,0,1.606288644423754
29076,703-004-5398,8209.142,4,2,2,1.3604309332491673
29102,703-004-5391,2623.4705,5,3,2,0.767163561399194
29106,703-004-5383,5861.026,2,2,0,0.9303407830260565
29824,703-004-5392,672.9525,3,2,1,1.3750402757021034
30078,703-004-5384,606.3765,2,2,0,0.8726782921561763
30170,703-004-5390,7269.917,3,1,2,0.4775561251235433
30250,703-004-5385,9451.315,3,0,3,0.27920371738274696
30447,703-004-5381,1594.652,3,0,3,0.27920371738274696
30775,703-004-5383,5966.805,7,4,3,1.8645090914340752
31095,703-004-5392,5935.0825,3,1,2,0.5660667071952731
31275,703-004-5385,6672.4746,4,2,2,0.9457717846841417
31382,703-004-5385,2653.0398,3,2,1,0.7165414023893105
31386,703-004-5382,3334.2708,3,1,2,0.7260002452729138
32033,703-004-5387,9509.547,7,5,2,2.0344361777202944
32169,703-004-5392,7168.6016,3,2,1,0.8890761612380708
32263,703-004-5385,5856.206,4,3,1,1.2918546137842346
32276,703-004-5390,3950.693,3,2,1,0.6902780396229061
32473,207-008-2399,5749.6675,3,0,3,0.27920371738274696
32499,703-004-5381,7306.129,3,3,0,1.6143651401420178
33007,703-004-5393,2572.394,2,0,2,0.27920371738274696
33165,703-004-5381,2856.7368,3,1,2,0.8599391399044146
33432,703-004-5382,142.83896,3,2,1,0.4934537921799243
33640,703-004-5394,7886.2563,7,4,3,2.8282284566657516
33939,703-004-5387,3707.8071,5,3,2,1.0129828769286306
34077,703-004-5382,7250.185,4,2,2,0.4108191864081514
34107,703-004-5380,8764.474,5,4,1,1.2248621171729137
34175,703-004-5388,2128.5486,3,0,3,0.27920371738274696
34342,703-004-5392,181.08665,13,5,8,1.2017591597756847
34393,703-004-5382,7393.966,4,3,1,2.759828626625226
34887,703-004-5392,7522.25,3,2,1,0.8484720163672322
34990,703-004-5387,3467.3977,3,0,3,0.27920371738274696
35061,703-004-5399,1252.9016,2,1,1,0.3978652972704144
35138,207-008-2398,2970.4268,2,0,2,0.27920371738274696
35536,207-008-2398,627.231,4,3,1,0.7899252086753351
35599,703-004-5390,3269.605,4,3,1,3.052931047516654
35754,703-004-5384,9480.558,4,3,1,2.1362460815837943
3599,207-008-2399,9194.176,4,2,2,0.5522614815164295
36115,703-004-5389,1123.7043,1,1,0,0.44445839544302035
36216,703-004-5399,4110.6763,9,3,6,1.2205719876243135
36220,703-004-5389,7863.3438,7,3,4,0.6586172282726653
3626,703-004-5385,5865.271,4,1,3,0.9120266883590089
36345,703-004-5388,4969.263,9,3,6,1.1493782654387699
3639,703-004-5388,2051.559,6,3,3,1.9026127208747625
36598,703-004-5384,9675.249,5,3,2,1.1009969619121112
36843,703-004-5385,8173.174,"","","",0.27920371738274696
36849,703-004-5390,8137.1377,7,2,5,0.6393329767111859
37023,207-008-2398,1886.3875,5,4,1,1.646887397951224
37322,703-004-5384,8337.337,4,3,1,1.420239681139815
37344,703-004-5388,6857.0654,6,4,2,1.654795104171998
37474,703-004-5395,5795.6523,3,3,0,0.8101430138340765
37656,703-004-5398,1105.2299,4,1,3,0.6469096805279032
37726,703-004-5394,6385.2935,4,2,2,1.3047935597089102
37747,703-004-5390,6435.9834,7,5,2,1.8641612805603696
38345,703-004-5399,6701.6646,4,2,2,0.515810078221901
3850,703-004-5389,8746.582,5,5,0,3.132459192214956
38558,703-004-5396,7929.269,1,0,1,0.27920371738274696
38791,703-004-5385,8297.496,4,1,3,0.6089942716802736
39155,703-004-5384,3399.5884,3,2,1,1.1702521344198802
39312,703-004-5395,8312.408,4,2,2,0.7652158278483295
3954,703-004-5386,6.198883,1,1,0,0.5554405567355613
39563,703-004-5395,2116.5938,5,1,4,0.5302847227400311
39580,703-004-5388,4044.2026,3,1,2,0.7372099211076765
39878,703-004-5383,6358.985,1,1,0,0.35831143730785864
40120,703-004-5394,7176.7144,9,6,3,1.7341070056751888
40199,703-004-5383,3379.3496,3,1,2,0.4514050901582035
40575,703-004-5399,3694.6921,1,1,0,0.32666834933781397
40737,703-004-5395,7494.6426,5,4,1,1.5955610696702396
4085,703-004-5397,3523.4243,3,3,0,0.5326910688156111
40904,703-004-5382,947.58215,5,3,2,1.4552676935985909
41015,703-004-5386,3447.06,7,2,5,0.8869069535918407
413,703-004-5396,480.86285,2,2,0,1.3200642375837974
41750,703-004-5391,1564.5391,3,2,1,0.7662632627185096
42062,703-004-5394,6763.8726,3,0,3,0.27920371738274696
42078,703-004-5383,1677.4636,2,0,2,0.27920371738274696
42204,703-004-5397,7329.4395,4,0,4,0.27920371738274696
42277,703-004-5399,9356.087,3,2,1,0.7842526700069695
42319,207-008-2398,9007.811,5,3,2,1.3300174626076264
42524,703-004-5392,636.94775,4,1,3,0.4706797356706443
42614,703-004-5388,2852.0852,6,3,3,0.8246792275456698
42813,703-004-5386,1309.582,7,3,4,0.5774398215004178
43223,703-004-5396,8025.6772,3,2,1,0.874971542940842
43425,703-004-5393,3148.9563,4,2,2,0.8310857119490672
43475,703-004-5383,513.2639,6,3,3,1.7738472880525205
43937,207-008-2398,5673.642,2,2,0,1.1633219689331775
44302,703-004-5393,4788.1924,9,3,6,1.034821917325451
44780,207-008-2399,9671.638,8,4,4,0.7883774630404069
44823,703-004-5391,4464.823,5,2,3,3.8837491055963826
44867,703-004-5383,3874.8525,5,3,2,2.0399268343949934
45314,703-004-5383,1633.8212,2,1,1,1.7993690133327762
45349,703-004-5391,463.93515,5,2,3,1.542878198926018
45565,703-004-5390,8778.469,2,2,0,1.160476483168713
45714,703-004-5380,1543.0165,1,1,0,0.5165268771580819
45911,703-004-5387,357.6809,5,1,4,0.42096269990379803
46160,703-004-5395,5314.189,6,4,2,2.6995584905344434
46449,703-004-5392,5790.438,2,1,1,0.6903319349027993
4656,207-008-2398,1238.6196,4,2,2,0.48494964155798215
46679,703-004-5386,3239.5405,1,1,0,0.35831143730785864
4704,703-004-5387,7123.6045,5,4,1,2.118249234070101
4706,703-004-5388,4366.8555,6,2,4,1.2593425743049498
47063,703-004-5395,2733.3992,5,2,3,1.2827450236738625
47481,703-004-5388,9503.047,4,3,1,1.611455342804761
47628,703-004-5397,5734.5625,4,0,4,0.27920371738274696
47675,207-008-2399,8350.464,5,3,2,3.45179719795141
47799,703-004-5394,9234.621,4,2,2,0.8274358661347263
48046,703-004-5383,5643.9907,2,1,1,0.9039053684630691
48259,703-004-5389,6614.5737,6,4,2,1.0423827525050544
48478,703-004-5398,8976.113,6,4,2,2.612791717899694
48560,703-004-5396,3077.243,3,1,2,0.3254817335389373
48570,703-004-5390,1966.6309,6,3,3,0.53824703606874
48694,703-004-5386,2590.5884,5,2,3,0.6982240732050096
48947,703-004-5383,2609.8489,"","","",0.27920371738274696
49095,703-004-5387,5741.4253,3,1,2,0.4398418311556768
49181,703-004-5389,8857.409,5,3,2,0.8218404793415636
49208,703-004-5388,3618.3936,2,1,1,0.4989144404956273
49381,703-004-5385,3341.642,3,2,1,0.9364857412288071
49504,207-008-2399,8417.465,4,1,3,0.6646969528026866
49696,703-004-5390,2807.0457,8,3,5,0.6176661975365846
4983,703-004-5396,3269.2642,4,1,3,0.4684258606779611
5264,703-004-5397,5651.616,7,6,1,3.6534609454880314
5555,703-004-5394,564.0549,3,0,3,0.27920371738274696
5832,703-004-5394,8774.496,3,1,2,0.9596446896170083
5898,207-008-2399,2373.5403,6,4,2,1.718529277130095
60,703-004-5398,3299.9814,"","","",0.27920371738274696
6112,703-004-5381,9299.826,5,4,1,1.458304643551902
6320,703-004-5382,4213.5454,3,2,1,0.6102666037192511
6526,703-004-5394,7911.448,6,4,2,1.8223202680092367
657,703-004-5393,7410.9824,5,4,1,1.481869673743232
6658,703-004-5398,627.1046,4,3,1,1.0545298537065184
6756,703-004-5388,1308.8363,5,2,3,1.145863669645986
68,703-004-5391,6936.8184,5,1,4,0.4104730901334791
6814,703-004-5394,5142.473,3,3,0,0.753506900028324
702,703-004-5393,2563.4216,3,2,1,0.994049122599718
7745,703-004-5396,9793.067,3,3,0,0.8339753342000956
8333,703-004-5388,9962.543,4,2,2,1.4647917696129242
8449,703-004-5390,780.59735,3,1,2,0.3860406708346084
8533,703-004-5394,142.01402,5,2,3,0.6858578813687725
8596,703-004-5380,8852.667,3,1,2,0.5165268771580819
8625,703-004-5383,9811.421,5,4,1,1.8487230284822698
8893,703-004-5389,8172.154,4,2,2,0.45738648136725546
90,703-004-5380,8179.0063,9,6,3,1.581932981508877
9021,703-004-5392,1987.5491,4,2,2,0.5474115747992612
9106,703-004-5396,7278.415,8,6,2,2.418715715770588
978,703-004-5389,1408.6484,"","","",0.27920371738274696
9781,703-004-5390,2736.5535,8,4,4,1.0994710690271494
9838,703-004-5384,8397.613,5,2,3,1.0338610769393242
10109,703-004-5398,7115.5615,2,0,2,0.27920371738274696
10202,703-004-5394,1185.3772,5,5,0,1.4888421578634214
10256,703-004-5394,9598.871,4,1,3,0.5165268771580819
10649,703-004-5390,6190.707,8,5,3,2.222171057673168
11036,703-004-5397,8987.865,6,5,1,3.6635462030880306
11111,703-004-5382,2918.049,6,2,4,0.5267855821932917
1113,703-004-5392,3199.6453,6,3,3,1.1616499715038795
11220,703-004-5389,1970.9128,6,2,4,0.772662017539358
11506,703-004-5387,6980.4204,4,3,1,2.5245787957549357
11569,703-004-5396,6382.017,5,5,0,1.4488702545389769
11905,703-004-5395,9957.02,8,3,5,1.873080057503043
11946,703-004-5398,130.409,3,2,1,0.7626574013347692
12058,703-004-5393,7574.2026,4,4,0,1.0861459103154474
12301,703-004-5389,5209.2876,7,4,3,1.0789345661623584
12322,207-008-2398,6349.655,2,0,2,0.27920371738274696
1234,703-004-5398,8427.083,3,1,2,0.9175338017563471
12560,703-004-5381,2072.0088,1,1,0,0.43425359727536994
12633,703-004-5384,7043.922,2,2,0,0.569267909814203
13509,703-004-5384,4733.7495,5,2,3,0.563126268426468
13510,703-004-5393,311.99335,2,0,2,0.27920371738274696
13523,703-004-5384,8584.653,4,1,3,0.3791588801760325
1358,703-004-5396,3750.4817,2,0,2,0.27920371738274696
1385,703-004-5395,896.86456,5,2,3,1.0048912308721774
14122,207-008-2399,5684.9463,1,1,0,0.5792712913403927
1434,703-004-5399,9504.467,7,4,3,1.5897852360964557
14362,703-004-5396,698.9795,3,2,1,1.9932975582214536
14493,703-004-5386,4932.53,4,3,1,0.9295769634999687
14527,703-004-5389,6819.1265,5,2,3,1.9257055546739674
1472,703-004-5390,1496.6863,4,2,2,0.7609365868468259
14799,207-008-2398,8589.153,4,3,1,1.6112501662188894
14851,703-004-5399,2774.7744,5,3,2,3.2040377520175483
15186,703-004-5395,5231.8984,4,3,1,1.0429293819362304
15323,703-004-5385,4324.3247,9,4,5,1.211178210312072
15370,703-004-5388,4765.1875,6,4,2,1.1981968991272618
15563,703-004-5380,390.94806,5,4,1,0.8411866078082386
15694,703-004-5383,5355.5547,4,2,2,1.342575198318173
15911,703-004-5388,7305.3994,2,0,2,0.27920371738274696
16012,703-004-5380,2236.324,6,5,1,1.707043636991437
16064,703-004-5388,5199.0576,4,3,1,0.8010103898656098
16431,703-004-5385,7581.8726,4,1,3,0.7134485942573776
16488,703-004-5399,5880.9453,4,3,1,0.8592303044452382
16649,703-004-5391,7850.1177,3,1,2,0.874931013303892
16675,703-004-5396,2691.5486,3,1,2,0.6311737402595499
16687,703-004-5387,3432.5212,7,3,4,1.4089381191547328
16811,703-004-5392,1869.4276,6,3,3,1.0466134756415406
17054,207-008-2399,2316.5322,3,1,2,0.5078987588334061
17227,703-004-5387,3794.6702,5,3,2,0.6846166909750933
17339,703-004-5392,150.22694,5,3,2,1.911865997727944
17578,703-004-5389,4031.5251,4,1,3,0.3978652972704144
1759,703-004-5383,2692.7607,3,2,1,1.0557928134472414
18195,703-004-5390,3775.2659,5,1,4,1.0914613492307645
1825,703-004-5390,642.1131,3,0,3,0.27920371738274696
18545,703-004-5393,6001.461,8,5,3,1.3749948681235225
18707,207-008-2399,745.8699,2,2,0,0.9943752784349078
18862,703-004-5392,1771.8721,4,2,2,0.586818151202079
19,703-004-5396,6072.0283,7,3,4,1.1728926600236111
19083,207-008-2398,859.59375,5,3,2,1.4209903646047557
1967,703-004-5388,4624.6167,2,1,1,0.5395079319773617
1968,703-004-5390,2975.1616,8,6,2,1.9102112688230075
19875,703-004-5398,3251.8435,3,3,0,1.4333340745962437
19878,703-004-5391,7886.4087,6,4,2,1.4679122564203242
20076,703-004-5388,7923.6816,3,2,1,0.6684871580395809
20201,703-004-5395,3984.9048,3,3,0,1.5465513615526072
20694,703-004-5394,6068.078,2,2,0,1.3680403312911096
2072,207-008-2398,8788.502,2,0,2,0.27920371738274696
20739,703-004-5390,9447.784,5,1,4,0.4625374210398212
20745,703-004-5390,8733.933,5,1,4,0.4144131970779263
21022,703-004-5391,1395.2112,5,2,3,0.440056081230474
21028,703-004-5394,2728.023,2,2,0,1.5240135106315376
21267,703-004-5395,9430.541,3,1,2,0.7801840529388523
21285,703-004-5393,7905.655,4,2,2,1.2435086783414502
21457,703-004-5399,2073.2463,3,3,0,0.8781414611437995
21618,703-004-5391,183.1448,4,3,1,1.1537828823867202
21664,703-004-5396,6700.1616,3,0,3,0.27920371738274696
21693,703-004-5397,3826.353,4,1,3,0.6020533302896264
21911,703-004-5384,9961.657,6,4,2,1.2556012440247064
22386,703-004-5393,6659.427,6,3,3,1.090712781967901
22556,703-004-5392,5504.197,5,3,2,2.527897412654093
22806,703-004-5394,8586.718,4,2,2,0.4552386381013929
22883,703-004-5389,3787.778,2,1,1,0.6516640302855432
22945,703-004-5399,1818.9829,2,2,0,0.9420851941790953
23119,703-004-5386,6904.4556,4,1,3,0.4103573010060467
23200,703-004-5385,2529.5503,6,2,4,1.2949084790142595
2321,703-004-5389,8228.315,5,3,2,1.140762512482304
2355,703-004-5383,941.4798,6,2,4,1.077931695184644
24352,703-004-5395,4690.4956,7,3,4,1.589008444838659
2465,207-008-2398,9332.984,6,3,3,1.0577799616555834
2475,703-004-5381,809.4531,3,2,1,0.49569517757780246
24834,703-004-5390,8865.929,4,2,2,0.8046140345463401
24844,703-004-5384,8584.215,2,1,1,0.5904150911571272
25035,703-004-5389,2526.4895,3,2,1,1.0107974954772754
25290,703-004-5383,1698.283,2,0,2,0.27920371738274696
25378,703-004-5392,9428.592,4,3,1,1.3760017819719261
25480,703-004-5392,1160.5758,5,3,2,1.6315810738755063
25631,207-008-2398,4480.0903,5,3,2,0.7797967090540032
25896,703-004-5393,8322.266,1,0,1,0.27920371738274696
26574,703-004-5392,7188.631,3,0,3,0.27920371738274696
2661,703-004-5383,901.00525,5,1,4,0.5140834980069803
27273,703-004-5392,2438.5493,3,3,0,1.6837683867877595
27548,703-004-5385,644.84595,4,2,2,0.6880515316547058
27780,703-004-5380,261.53503,4,3,1,1.5676235882741356
27813,207-008-2398,3153.484,3,3,0,2.9282918384195717
28051,703-004-5396,7739.2046,4,2,2,1.2796437701329375
28152,703-004-5398,4144.8765,5,3,2,1.0133084974830124
28182,703-004-5393,2677.557,5,2,3,0.805609817265856
28247,703-004-5385,5956.813,3,2,1,0.9074901569083982
28340,703-004-5393,3881.463,4,3,1,1.1125575246230777
28653,703-004-5385,2349.899,4,4,0,1.7470417441120116
28948,703-004-5386,7137.159,2,2,0,0.7386357173620859
29163,703-004-5388,1578.7065,4,1,3,0.6907837226815847
2958,703-004-5390,8150.148,5,1,4,0.37512182779194486
30799,703-004-5392,2760.288,4,3,1,1.1581203962618571
31019,703-004-5398,242.63203,3,0,3,0.27920371738274696
31195,703-004-5390,8650.987,4,1,3,0.6634672043634363
31225,207-008-2398,3044.7446,6,4,2,0.6950920772769376
31258,703-004-5381,7090.2783,4,2,2,0.8272793019031408
3138,703-004-5381,1794.1749,4,3,1,1.071973529557018
31608,703-004-5392,7736.4463,3,2,1,0.8061762347863308
31678,703-004-5384,6673.1514,2,0,2,0.27920371738274696
3174,703-004-5392,399.86194,7,5,2,1.2886608664967887
31747,703-004-5399,3754.0947,5,2,3,1.773043584402512
32358,703-004-5385,6160.689,3,1,2,0.8651215715016874
32406,703-004-5395,4537.9727,2,2,0,1.2166894147898077
32556,703-004-5386,2459.7751,6,5,1,1.7359518249549508
32661,703-004-5392,6887.6963,2,0,2,0.27920371738274696
33326,703-004-5395,1876.4126,"","","",0.27920371738274696
33344,703-004-5394,7502.638,2,1,1,0.6354941971990816
335,703-004-5392,4587.4165,2,1,1,0.35831143730785864
33505,703-004-5380,1063.9674,"","","",0.27920371738274696
34064,703-004-5381,9755.121,8,5,3,2.2322762448964055
34108,703-004-5391,8804.714,5,1,4,0.7482843968030028
34552,703-004-5381,8867.138,4,3,1,0.7618735832971312
34575,207-008-2398,4004.7366,6,3,3,0.9379179968854361
3459,703-004-5399,4663.167,2,1,1,0.4918023659204424
34595,703-004-5398,4854.093,6,2,4,0.7905761457423476
35050,703-004-5381,5261.323,3,0,3,0.27920371738274696
35100,703-004-5385,1121.6879,1,0,1,0.27920371738274696
354,703-004-5388,3595.395,5,4,1,2.6406951763618673
35462,207-008-2398,7520.2837,5,3,2,0.8703209690054557
35596,703-004-5398,7014.3325,2,0,2,0.27920371738274696
35765,703-004-5395,1169.0844,4,2,2,0.5151825305849393
35870,703-004-5383,1692.5305,1,0,1,0.27920371738274696
36014,703-004-5382,8291.57,2,2,0,0.6688092380139217
36139,703-004-5394,5359.4507,3,1,2,0.45247632414346234
36327,703-004-5397,4666.5303,2,2,0,0.47472250851149583
36349,703-004-5386,3701.7769,2,1,1,0.32666834933781397
36536,703-004-5386,311.3562,2,1,1,0.6280192206059826
36805,703-004-5395,4700.8633,3,2,1,0.5151400274596372
36814,703-004-5397,8552.736,2,1,1,0.32666834933781397
36836,703-004-5383,7623.527,3,2,1,0.5784855758803751
36854,703-004-5381,1291.1671,3,2,1,1.2262671375215162
37008,703-004-5394,2214.3298,1,0,1,0.27920371738274696
37192,703-004-5396,9254.757,1,0,1,0.27920371738274696
3739,703-004-5381,4516.6367,2,0,2,0.27920371738274696
37453,703-004-5394,5072.9624,5,3,2,0.9359782137282449
37660,703-004-5383,4834.0444,2,1,1,0.6028360842611293
37738,703-004-5393,3849.2966,2,2,0,1.8539341385661472
38316,703-004-5387,3206.8938,8,4,4,1.232726592255357
38457,703-004-5383,8703.752,4,2,2,0.593267603868967
38556,703-004-5387,4749.0547,3,1,2,0.8976357486307271
38673,703-004-5389,7146.8247,1,1,0,0.929290289223452
38723,703-004-5394,718.13763,3,1,2,0.3804615988868899
39040,703-004-5397,3009.072,"","","",0.27920371738274696
39338,703-004-5390,1418.5298,3,2,1,0.47054551495161073
39635,703-004-5382,8232.036,3,2,1,2.515227592317541
39669,703-004-5381,4393.496,2,2,0,1.5935539601180273
39752,703-004-5397,7006.261,4,1,3,0.6247657379003917
39813,703-004-5389,4979.1094,5,5,0,2.204722585665428
39921,703-004-5385,8518.819,6,2,4,2.655123649754163
39969,207-008-2398,3374.129,2,1,1,0.3793617818362644
40046,703-004-5392,3811.046,5,2,3,0.7559137501476337
40072,703-004-5390,6708.0986,6,4,2,1.0428645942558052
40097,703-004-5399,1421.6537,5,3,2,1.736936647033497
404,703-004-5383,6704.7183,4,4,0,1.7511335660159755
40537,703-004-5381,2281.121,4,3,1,1.1611024788646496
40612,703-004-5380,2208.5417,2,1,1,0.44829646872267315
4063,703-004-5380,5997.624,1,0,1,0.27920371738274696
40691,703-004-5391,1765.7303,4,4,0,0.7576740024831509
40883,207-008-2398,4202.227,4,1,3,1.1582140918039585
41222,703-004-5383,5323.598,4,2,2,1.1987281148985
41439,703-004-5388,7266.3774,3,2,1,0.4891648294119935
41534,703-004-5392,8827.153,5,3,2,1.858230828270056
41662,703-004-5384,454.60403,3,2,1,0.9639520064057852
42577,703-004-5399,8896.068,1,1,0,0.6319810006717848
42608,703-004-5380,992.41077,7,3,4,0.9505621078383211
42647,703-004-5384,8567.236,6,1,5,0.37512182779194486
429,703-004-5384,8743.439,3,0,3,0.27920371738274696
42966,703-004-5390,1112.5642,6,5,1,2.6884863647587305
4308,703-004-5396,28.743149,6,2,4,1.105183098665503
43273,703-004-5391,4553.889,1,0,1,0.27920371738274696
43502,703-004-5397,4977.4497,6,4,2,1.4258114708293617
43550,703-004-5388,7112.7935,7,4,3,0.8046063082501076
43652,703-004-5387,4436.165,4,3,1,0.7182403838783465
44419,703-004-5397,4461.5854,4,2,2,1.78831378693546
44983,703-004-5391,930.6568,2,2,0,0.7103407909746053
4502,703-004-5393,8061.358,5,3,2,1.2271456882167924
45248,703-004-5394,5198.133,4,2,2,0.8800359500217106
45699,703-004-5395,7770.366,5,1,4,0.3795433023442546
45976,207-008-2398,4229.0186,7,4,3,1.7613014602220929
46547,703-004-5389,8893.117,2,1,1,0.5793137937661843
46742,703-004-5380,1484.294,2,0,2,0.27920371738274696
46793,703-004-5391,5818.8623,3,1,2,0.35831143730785864
46863,703-004-5388,5725.6055,2,2,0,0.4993868711743077
46958,703-004-5396,8456.983,3,1,2,0.4759845431227463
46992,703-004-5386,3204.5479,2,0,2,0.27920371738274696
47041,703-004-5393,3616.3909,4,1,3,0.3733950545929546
47171,703-004-5383,2394.451,4,3,1,1.6504106375271912
47416,703-004-5395,7737.627,3,2,1,1.1973593539049774
47508,703-004-5382,2704.0505,2,0,2,0.27920371738274696
47683,703-004-5382,4519.4785,2,2,0,1.0635037509147391
48190,703-004-5386,6348.5146,5,2,3,1.177915556396491
48255,703-004-5384,1317.8539,3,0,3,0.27920371738274696
48351,207-008-2399,4608.464,5,4,1,1.272888760150845
4842,703-004-5383,7340.908,8,4,4,1.6946111105078099
48429,703-004-5382,7135.7114,6,4,2,1.9049732711776228
48682,703-004-5396,3101.0442,3,2,1,1.4626691135607697
48813,703-004-5381,8250.711,1,0,1,0.27920371738274696
49220,703-004-5383,7756.0063,3,0,3,0.27920371738274696
49371,703-004-5381,3941.6743,3,1,2,0.5800489593713399
49586,703-004-5381,2746.2239,2,2,0,1.1374929442361466
4960,703-004-5393,1416.5873,1,0,1,0.27920371738274696
49906,703-004-5381,970.6128,9,4,5,0.9082031507122363
49929,207-008-2398,9767.582,5,2,3,0.5442145791318709
49944,207-008-2399,5323.1343,6,2,4,0.8271676202606896
49954,703-004-5398,5997.1113,4,2,2,2.211849830647905
5014,703-004-5397,6657.7183,6,4,2,1.9518156917896725
5529,703-004-5384,6069.6665,2,1,1,0.4679156330247362
5562,703-004-5385,9591.342,4,2,2,1.786730035879139
5728,703-004-5394,3292.8013,5,2,3,0.7105878668228531
578,703-004-5392,9139.217,5,4,1,0.7460079389472108
5862,703-004-5396,1786.5718,2,1,1,2.3616292409361983
5973,703-004-5397,1508.695,2,2,0,0.6385714888163605
6244,703-004-5396,5013.0938,3,1,2,0.48280075339086154
6493,703-004-5381,4825.4634,3,1,2,0.4980067287099776
6679,703-004-5399,6300.7837,5,4,1,2.353700760742979
6901,703-004-5381,6898.074,3,1,2,0.9085629968753447
7213,703-004-5395,6631.0166,2,2,0,0.9314968182831919
7545,207-008-2399,6001.06,7,6,1,2.7049356850597515
7582,703-004-5383,8888.956,8,5,3,2.0109965030940113
7675,703-004-5398,3133.9395,4,2,2,1.0319666581151121
7932,703-004-5383,6476.8105,5,3,2,0.6917740241385376
8058,703-004-5389,5351.278,3,1,2,0.33853450732658075
8302,703-004-5393,5159.899,4,2,2,0.6439280631575576
8416,703-004-5395,9504.533,4,4,0,2.3236179267128367
8599,703-004-5394,5157.86,4,3,1,1.4919145960612228
8707,703-004-5396,2919.2908,3,2,1,0.6294757922512568
8941,703-004-5385,1106.2938,4,1,3,0.8659150795889764
9077,703-004-5399,7171.6553,6,2,4,1.3510613880166935
9209,703-004-5383,5049.13,3,2,1,1.0780972334173577
9214,703-004-5384,8521.773,3,0,3,0.27920371738274696
9265,703-004-5399,7354.663,3,2,1,1.5525189271128215
9402,703-004-5396,1077.2294,2,2,0,1.11719507943941
9439,703-004-5387,9168.749,3,2,1,1.0570817376975716
994,703-004-5397,5063.2773,5,2,3,0.5296561204722449
9965,703-004-5383,8851.959,2,0,2,0.27920371738274696
10002,703-004-5384,1574.3649,3,2,1,0.801325769059625
10211,703-004-5382,3331.4766,4,4,0,2.1796743004051917
10352,703-004-5384,515.82697,5,1,4,0.5102374781432694
10390,703-004-5399,8431.079,3,2,1,1.1644527806966152
10591,703-004-5387,992.97406,4,1,3,0.33853450732658075
10717,703-004-5383,1529.8182,4,2,2,1.9262526397365993
11387,703-004-5387,4740.6846,3,3,0,0.9521889007416117
11581,703-004-5387,6181.07,6,2,4,0.5827397008597491
11700,703-004-5398,6190.6846,3,1,2,0.35027013757747105
11726,703-004-5382,5194.235,2,0,2,0.27920371738274696
11780,703-004-5389,1127.2693,4,1,3,0.34445651043902575
11961,703-004-5386,6305.5986,2,1,1,0.5446443132015234
1210,703-004-5384,1126.197,4,1,3,0.41914950321902056
12464,703-004-5382,656.86646,5,2,3,0.5659001109450889
12589,703-004-5391,8553.827,3,0,3,0.27920371738274696
12753,703-004-5384,283.36942,6,6,0,1.809911424667907
12793,703-004-5391,7146.8423,3,1,2,0.35831143730785864
13518,703-004-5389,9309.787,3,1,2,0.566434430872893
13537,703-004-5394,8653.766,4,1,3,0.48255814582805134
14040,703-004-5387,2257.2566,3,2,1,0.9397311743506348
14091,703-004-5389,9382.789,6,5,1,2.4297788401814473
14147,703-004-5384,2460.3015,3,3,0,0.7570050066245969
14302,703-004-5391,3478.766,4,1,3,0.31117642085247954
14318,703-004-5395,4876.714,2,1,1,0.8224279901631352
14499,703-004-5380,7296.7886,4,1,3,0.46823420792512627
14513,703-004-5397,4079.1453,5,3,2,1.2988943100783295
14801,703-004-5382,7641.263,1,1,0,0.5859412822048894
1489,703-004-5389,1559.4238,5,1,4,0.42917688172243185
15004,703-004-5383,4741.754,7,4,3,1.382668051638671
15090,703-004-5383,3641.7139,2,1,1,0.35831143730785864
15401,703-004-5382,3591.7974,2,2,0,0.5510463244094506
1557,703-004-5389,3632.5227,1,0,1,0.27920371738274696
16158,703-004-5385,4170.0864,6,3,3,1.553876788664772
16227,703-004-5397,8976.968,8,5,3,1.2040874276818907
16274,703-004-5391,1946.1334,5,2,3,1.5894345432497683
16518,703-004-5391,4065.8843,2,1,1,0.434193143661107
16890,703-004-5394,5883.3696,3,2,1,0.9295816204926096
17175,703-004-5393,1396.389,2,1,1,0.44892100451868866
17236,703-004-5393,3891.049,5,1,4,0.33853450732658075
17317,207-008-2399,7076.299,4,3,1,2.860564306843513
17444,207-008-2399,777.1045,1,0,1,0.27920371738274696
18051,703-004-5389,3074.72,5,3,2,1.5686307858325177
18151,207-008-2399,9353.364,2,2,0,0.8203399489872635
18307,703-004-5382,3493.7603,4,1,3,0.3807252912866403
18591,703-004-5399,1706.1437,4,2,2,1.698834911101826
18631,703-004-5381,2197.6333,7,3,4,3.273805616970289
18728,703-004-5398,5273.365,1,1,0,0.5640051843531195
1878,703-004-5392,250.22447,5,2,3,1.4903302968350896
18861,703-004-5397,8851.249,3,2,1,0.46065406643942686
1924,703-004-5392,800.3783,2,1,1,0.33853450732658075
19316,703-004-5396,2079.1,2,2,0,0.8035751418837274
19601,207-008-2398,3868.7944,3,1,2,0.6340828881474294
20463,703-004-5396,7227.1206,5,4,1,1.3855467863020607
20727,703-004-5396,3943.2834,3,0,3,0.27920371738274696
20773,703-004-5385,3616.1523,2,1,1,1.3875590570779759
21216,703-004-5393,4869.3765,4,2,2,0.8322511593186228
21758,703-004-5381,5288.718,3,3,0,1.4341118337680854
21936,703-004-5394,8000.513,6,3,3,1.0072608959536664
22227,703-004-5385,1633.5863,7,3,4,1.3108136940812747
22563,703-004-5381,7322.3057,1,1,0,0.33853450732658075
2287,703-004-5386,7305.4985,7,3,4,1.1150973190240918
22894,703-004-5390,9247.089,5,1,4,0.6176665292142264
2293,703-004-5383,7269.854,9,3,6,1.768799527740907
23323,703-004-5380,6104.4067,5,3,2,1.1453406222152045
23518,703-004-5391,9043.97,5,1,4,0.49061765736899265
23571,703-004-5386,6204.6445,4,2,2,0.650930540519257
23709,703-004-5384,8644.849,3,1,2,0.4849579489010795
23767,703-004-5382,3588.409,6,2,4,0.6017495488392938
23852,703-004-5392,1984.0931,"","","",0.27920371738274696
23979,703-004-5384,1959.446,1,1,0,0.6158709082829263
23983,703-004-5399,5173.562,2,1,1,0.6431489613817852
23993,207-008-2399,8984.989,3,3,0,0.9072988800310876
24473,703-004-5388,3896.817,4,4,0,1.921463024830964
24870,703-004-5380,8019.418,1,1,0,1.4006808619871227
25003,703-004-5389,5449.3413,6,3,3,0.8148186870093771
25044,703-004-5385,3776.9526,2,2,0,0.5686631907921639
25159,703-004-5398,3032.9602,2,0,2,0.27920371738274696
2519,703-004-5381,7346.459,4,2,2,0.7360507999502667
2520,703-004-5383,9236.275,5,1,4,0.7956137839515068
25355,703-004-5383,3180.2737,7,6,1,1.5515985062221784
25639,703-004-5398,7499.5576,6,3,3,3.6325934094227232
26003,703-004-5397,8715.309,4,3,1,0.62497134291266
26466,703-004-5385,9893.504,3,3,0,2.699780174253819
26587,703-004-5393,6422.1626,3,2,1,0.5684960027720579
26931,703-004-5385,1530.4595,4,3,1,1.836986481545302
26976,703-004-5381,1847.4543,2,0,2,0.27920371738274696
27279,703-004-5390,4922.0605,3,0,3,0.27920371738274696
27312,703-004-5383,7949.64,2,1,1,0.555129565396105
27321,703-004-5391,4557.435,3,3,0,0.7140405049781938
27378,703-004-5395,8321.581,1,0,1,0.27920371738274696
27613,703-004-5399,3418.5464,2,1,1,0.6294105351302584
2810,703-004-5390,566.04144,7,3,4,1.2160836281622205
28234,703-004-5388,9821.941,1,1,0,0.6121469632539963
28271,703-004-5393,8450.746,4,0,4,0.27920371738274696
28775,703-004-5380,1585.8251,4,3,1,1.4840905644263875
28780,703-004-5384,1573.1233,2,1,1,0.8673752169919424
28843,703-004-5393,9221.79,3,3,0,1.0413798201340503
2899,207-008-2399,187.74509,2,0,2,0.27920371738274696
29473,207-008-2398,3340.342,2,1,1,0.33853450732658075
29572,703-004-5384,7550.239,6,4,2,1.0516477958611514
29724,703-004-5381,1407.1471,1,0,1,0.27920371738274696
29777,703-004-5383,1340.3345,5,2,3,0.5842628623439587
29888,703-004-5391,4334.0225,3,1,2,0.3978652972704144
30831,703-004-5387,9134.9,5,2,3,0.4782039720546245
31144,703-004-5382,7035.7583,7,4,3,1.5528479620278215
31332,703-004-5397,6351.3706,1,0,1,0.27920371738274696
31886,703-004-5381,5781.854,3,1,2,0.4039104118864428
31907,703-004-5385,1079.086,5,2,3,0.734289932204357
32160,703-004-5399,1551.3873,2,0,2,0.27920371738274696
32244,207-008-2398,4210.237,8,4,4,0.95930544880986
3237,207-008-2399,4374.994,3,2,1,0.72477199309083
32389,703-004-5391,9068.373,3,2,1,1.5939636020994186
32463,207-008-2399,2366.8618,2,2,0,1.195289554397548
32656,703-004-5393,4071.4275,2,0,2,0.27920371738274696
32808,703-004-5384,8031.8657,5,3,2,1.2527208613841396
32899,703-004-5385,1394.049,3,0,3,0.27920371738274696
33151,703-004-5394,2520.6357,5,3,2,1.839135860905765
33337,703-004-5392,3687.762,1,1,0,0.5243070262540444
33906,703-004-5388,3719.53,5,2,3,1.0474825523243891
33957,703-004-5399,7620.7896,5,2,3,0.6351884570457493
34045,703-004-5386,738.8276,5,3,2,2.8496512949313098
34299,207-008-2398,8320.912,7,3,4,0.8345501537020518
34434,703-004-5386,6617.455,5,4,1,3.7795838798044086
34467,703-004-5396,6183.0293,3,2,1,1.219469098030793
345,703-004-5381,2663.9443,1,0,1,0.27920371738274696
34547,703-004-5381,8910.113,5,1,4,0.5825748869230918
34695,703-004-5397,9757.79,8,5,3,3.0031771236107754
35232,207-008-2398,4844.64,2,2,0,0.740683351309171
35524,207-008-2398,5208.0605,6,4,2,1.4449717585892978
35993,703-004-5394,6971.6646,4,2,2,0.7978794678064983
36315,703-004-5399,473.97195,1,0,1,0.27920371738274696
36451,703-004-5393,3459.3623,3,1,2,0.7315095877138775
36501,703-004-5391,8935.082,2,1,1,0.4706823053839812
36755,207-008-2399,4344.731,4,3,1,1.4199196384783281
36832,703-004-5380,2951.8657,2,0,2,0.27920371738274696
36964,703-004-5395,3883.3713,6,3,3,0.93479608367002
37097,703-004-5384,4400.859,"","","",0.27920371738274696
37157,703-004-5386,592.9887,6,4,2,1.96354315649289
37188,703-004-5385,4468.125,5,1,4,0.35831143730785864
37319,207-008-2398,8941.225,4,3,1,1.0337707202574489
37442,703-004-5396,9661.482,5,3,2,4.414998726804999
37530,703-004-5388,5992.586,3,2,1,1.6933158922360454
37707,703-004-5384,4295.2065,6,3,3,1.3064372017451569
38950,703-004-5394,4045.9006,3,1,2,0.6927811365612369
39227,703-004-5392,8313.489,7,2,5,0.4453299292254814
3945,703-004-5386,3242.429,5,4,1,1.3951832345822108
40442,703-004-5391,1954.028,5,4,1,1.1285471986123414
40545,703-004-5388,5338.748,3,1,2,0.651348085555965
40644,703-004-5388,9667.162,3,2,1,1.1146435640637977
40819,703-004-5392,5646.7407,5,4,1,1.3226381056392282
40841,703-004-5383,633.3679,3,1,2,0.5484649450161188
40879,703-004-5392,8277.756,3,1,2,0.8837361532055208
41158,703-004-5389,8920.431,6,3,3,1.067695130050057
41310,207-008-2399,4133.1196,3,2,1,0.9583211282184771
4139,207-008-2399,9692.839,2,0,2,0.27920371738274696
41709,703-004-5399,3483.0737,4,2,2,2.346035765572896
41898,703-004-5399,1644.5333,5,3,2,1.2241377143825716
42056,703-004-5395,7931.0415,3,0,3,0.27920371738274696
42167,703-004-5398,3500.9749,5,3,2,1.6129538907327994
42296,703-004-5386,927.8077,3,3,0,1.1662136263173024
42433,703-004-5391,5606.341,3,1,2,0.40092565953448867
42496,703-004-5385,7042.587,6,2,4,1.8111543599088338
42649,703-004-5387,1446.6381,4,2,2,0.8345840912040925
42675,703-004-5399,4634.556,7,1,6,0.4842286783824074
4275,207-008-2399,4479.516,1,0,1,0.27920371738274696
42817,703-004-5380,8183.3916,6,6,0,2.1513583664118876
43150,703-004-5385,2047.7849,3,1,2,0.5602103241100772
4346,703-004-5385,3348.1877,5,2,3,0.934896852634889
43496,703-004-5380,4765.208,3,2,1,0.713336084715352
4368,703-004-5392,7183.6377,1,1,0,0.3187575773453028
43793,703-004-5396,3754.6902,1,0,1,0.27920371738274696
4385,703-004-5389,589.00476,5,2,3,0.8484074274388661
43962,703-004-5389,7843.623,"","","",0.27920371738274696
44173,207-008-2398,6789.2925,3,0,3,0.27920371738274696
44337,207-008-2398,2469.898,4,2,2,0.6957273552513225
44906,703-004-5390,6615.701,10,4,6,1.1752785906220078
45287,703-004-5381,2650.9495,6,2,4,1.150623843718381
45337,703-004-5399,8409.02,3,1,2,0.35831143730785864
45673,703-004-5399,1505.1383,3,2,1,0.7290170609317338
4571,207-008-2399,3631.5579,2,0,2,0.27920371738274696
4596,207-008-2399,6602.3545,1,1,0,0.646115483664243
46046,703-004-5399,9904.892,5,2,3,0.46487480989497904
4616,703-004-5395,9386.766,5,3,2,3.9001370834277425
46238,703-004-5388,9992.205,4,3,1,0.497705832125899
46850,703-004-5395,3597.5825,5,5,0,1.363401219491258
46897,703-004-5383,4051.3052,6,1,5,0.605241073200657
47146,207-008-2399,6193.6147,8,2,6,1.0235098735181445
47286,703-004-5384,987.6919,2,1,1,0.33853450732658075
47450,703-004-5395,4508.6377,2,2,0,0.7130885484034679
47705,703-004-5393,912.326,4,2,2,1.4709974054642139
47918,703-004-5392,1685.3345,3,2,1,1.6681093276520518
47932,703-004-5393,3422.2866,2,1,1,0.33853450732658075
47934,703-004-5380,5604.467,4,3,1,1.0172311284527111
47963,703-004-5386,1783.8037,3,2,1,0.781695661031022
48031,703-004-5382,4906.5938,2,0,2,0.27920371738274696
4811,703-004-5397,4721.4146,6,4,2,1.7499842367422938
48155,207-008-2398,4179.5527,2,1,1,0.40401702121292415
48156,703-004-5390,9235.581,3,1,2,0.35831143730785864
48316,703-004-5385,4890.6343,2,0,2,0.27920371738274696
48385,703-004-5388,5261.2363,4,4,0,1.9292622943768798
48526,703-004-5397,85.48796,4,4,0,1.1742117954944669
48828,703-004-5398,3358.8755,3,0,3,0.27920371738274696
4902,703-004-5387,5278.9155,2,2,0,1.287536591732913
49060,703-004-5399,2931.564,3,1,2,0.7147211614955544
49163,703-004-5380,3321.0623,"","","",0.27920371738274696
49164,703-004-5384,3836.745,4,2,2,0.45508654801624515
49359,703-004-5386,9018.658,2,1,1,0.4849061141282351
49680,703-004-5387,5574.006,6,2,4,0.7026305186947296
49815,703-004-5388,7003.336,7,3,4,0.9326738834720437
49988,703-004-5397,7012.457,5,5,0,2.3779424412697012
5417,207-008-2399,5841.605,4,3,1,0.884105096739975
5483,703-004-5396,4366.809,7,1,6,0.5567344262159342
55,703-004-5391,6494.764,4,2,2,0.6748274709294328
5827,703-004-5384,3656.3723,4,2,2,1.7630177267071272
5865,703-004-5389,929.83545,4,3,1,0.8027418761728983
5963,703-004-5388,8233.987,5,3,2,0.8833889283107873
6050,703-004-5388,4879.2603,4,1,3,0.6474980176776785
6350,703-004-5392,5821.265,8,4,4,2.237698912967262
6623,703-004-5380,1750.5294,5,3,2,1.0815128214279193
6684,703-004-5397,9065.293,2,1,1,0.6592586601530325
6707,703-004-5388,2663.585,3,1,2,0.3978652972704144
7179,703-004-5381,9721.5205,4,4,0,2.5581686364111103
7394,703-004-5389,5556.403,2,1,1,0.4230808829965438
7555,703-004-5391,118.310455,3,1,2,0.6655134004997699
8043,703-004-5389,6728.608,5,3,2,1.2851542166311294
8149,703-004-5380,756.59094,4,1,3,0.46900318669157287
8377,703-004-5394,6379.8184,4,2,2,3.9455605748770277
8619,703-004-5396,8516.418,2,0,2,0.27920371738274696
8938,703-004-5390,1559.087,9,5,4,1.7576097591074196
8940,703-004-5396,8148.0015,3,2,1,1.5199353225945582
8968,703-004-5392,1269.6313,5,3,2,1.4930567973453768
931,703-004-5381,4517.949,3,3,0,1.2394073625067776
9539,703-004-5385,7410.371,2,1,1,0.5669580486103406
9599,703-004-5394,3623.7502,3,1,2,0.3770770784956697
9778,207-008-2399,9041.25,4,1,3,0.4314860782385869
9837,703-004-5382,5769.415,2,0,2,0.27920371738274696
9914,703-004-5394,6621.369,3,1,2,0.38649359469715194
10311,703-004-5391,8708.624,4,4,0,1.743996936096145
1078,703-004-5384,4947.893,6,2,4,0.7970164827725527
10988,703-004-5390,5566.0073,5,2,3,1.1722385734367402
11003,703-004-5398,4342.3696,3,2,1,1.4123859161627232
11005,703-004-5397,533.1421,2,1,1,0.40140179449903685
11062,703-004-5386,3618.9026,1,0,1,0.27920371738274696
1107,703-004-5397,1001.8039,4,1,3,0.5595399290617812
11373,207-008-2399,3135.056,3,1,2,0.9667246160425518
1149,703-004-5392,8993.763,3,2,1,0.49895507486971646
11836,703-004-5382,6693.774,6,1,5,0.5165268771580819
1184,703-004-5388,1038.4553,4,2,2,0.6371604256389035
11913,703-004-5396,9121.66,1,0,1,0.27920371738274696
12749,703-004-5380,4236.389,4,2,2,0.5277861563879384
12887,703-004-5394,4512.4697,3,1,2,2.117099775217925
12984,703-004-5392,8826.506,3,1,2,0.3482416837923913
13186,703-004-5383,483.90686,3,3,0,0.700920876561629
13403,703-004-5393,9963.086,3,1,2,0.5033667908360657
13437,207-008-2399,2845.0679,3,1,2,0.35831143730785864
13514,703-004-5386,8193.934,3,1,2,0.3978652972704144
14221,703-004-5389,1346.6394,4,3,1,1.2392568097356929
1437,703-004-5391,309.94952,7,4,3,1.812150721255134
14534,703-004-5394,3684.2214,3,1,2,0.504354344968382
14576,703-004-5386,9443.197,2,0,2,0.27920371738274696
14710,703-004-5383,8391.031,4,3,1,0.907999615146931
15120,703-004-5398,6124.8745,2,0,2,0.27920371738274696
15162,703-004-5380,9520.038,7,3,4,1.3741120987634305
15263,703-004-5398,2309.5632,2,2,0,1.348896051670292
15501,703-004-5381,7806.232,7,2,5,1.6522134958952568
15506,703-004-5394,218.8307,4,2,2,0.6126814888857426
15600,703-004-5397,6017.5054,"","","",0.27920371738274696
15785,703-004-5381,4780.2676,7,4,3,1.9505506706987614
16113,703-004-5394,420.30515,5,4,1,2.2758818571674055
16270,703-004-5384,4269.057,4,2,2,2.0302396713662696
16593,207-008-2398,8942.942,2,2,0,0.6415401477247364
16646,703-004-5385,6123.912,2,1,1,0.40860252217274995
16773,703-004-5392,5835.2314,8,3,5,0.8997565192847422
16983,703-004-5382,1317.3574,3,2,1,0.7153639756913174
17030,703-004-5389,2765.1196,2,2,0,0.6856652246460111
17079,703-004-5391,3027.1577,7,4,3,2.3877035550483585
17199,703-004-5383,4073.106,5,4,1,2.1055277619192085
17257,703-004-5399,2869.9834,10,3,7,1.3830986725411685
17361,207-008-2398,6514.7524,9,5,4,1.4726385793976362
17432,703-004-5390,4924.888,4,1,3,0.41072809446866093
17442,703-004-5396,3853.6138,5,5,0,3.5397216317221907
17475,703-004-5384,5531.484,3,0,3,0.27920371738274696
17521,703-004-5390,2164.4211,4,3,1,1.307825386530188
17609,703-004-5398,2595.893,2,1,1,0.6644585287311253
17694,703-004-5382,8709.2295,7,5,2,2.8634545021098465
17781,703-004-5387,2839.9575,5,3,2,1.107841810256857
17986,703-004-5388,9596.521,3,2,1,0.8702240270971942
18110,703-004-5392,9431.754,1,1,0,0.6829163085072785
18216,703-004-5398,8106.9937,3,1,2,0.3858384517255498
18390,703-004-5390,555.20294,2,0,2,0.27920371738274696
18614,703-004-5386,2842.685,2,0,2,0.27920371738274696
18835,703-004-5387,4046.6313,2,1,1,0.4314860782385869
18988,703-004-5396,6758.833,7,3,4,0.8536079128539192
19004,703-004-5396,3123.1099,4,1,3,0.5378793985900103
19038,703-004-5388,3645.8916,3,1,2,0.7760601630889059
19393,703-004-5390,8332.072,4,2,2,1.8333738326566988
19434,703-004-5398,6248.391,3,2,1,1.160307407498248
19536,703-004-5397,2190.166,5,2,3,0.8203726472174092
19631,703-004-5388,6553.366,6,3,3,0.705037711354106
19823,703-004-5388,5314.2744,1,0,1,0.27920371738274696
1992,703-004-5389,72.88933,9,4,5,2.325367609783321
2044,703-004-5398,9637.261,5,4,1,3.79351367602208
20505,703-004-5391,9970.171,4,2,2,1.6436401399122906
20535,703-004-5393,7234.359,2,1,1,0.5165268771580819
20695,703-004-5395,1259.4133,6,1,5,0.33473733677017536
20984,703-004-5382,9542.34,3,1,2,0.8492354053347866
21115,207-008-2398,8777.714,3,3,0,1.1611518008209791
2116,703-004-5399,565.44366,"","","",0.27920371738274696
21365,703-004-5397,6320.847,4,1,3,0.42715436548096175
21476,703-004-5388,1733.5587,6,4,2,2.3106417637146524
22355,703-004-5385,7443.6934,5,4,1,1.3738491380720523
22420,703-004-5397,409.4541,5,3,2,0.6730281479366457
22579,703-004-5392,6612.5444,3,2,1,0.5225124473672753
22594,207-008-2399,7191.334,3,2,1,0.56488604236877
22630,703-004-5388,8666.281,"","","",0.27920371738274696
22730,703-004-5388,8982.546,4,1,3,0.3807252912866403
22731,703-004-5396,8849.538,4,3,1,0.7267050147048654
22874,703-004-5383,7909.9473,3,1,2,0.3978652972704144
22898,703-004-5397,202.65758,3,1,2,0.3401166617250829
22980,703-004-5391,5256.9165,3,2,1,0.7140725787074799
23234,703-004-5380,8558.876,5,2,3,0.4908168681824206
23489,703-004-5381,4335.8105,2,1,1,0.8299475391360867
23584,703-004-5393,2712.2546,4,3,1,1.4331011921429964
23585,703-004-5387,4618.497,2,2,0,0.665007839445197
23764,207-008-2399,6544.167,6,4,2,0.9313011034859462
23833,703-004-5392,5506.249,1,0,1,0.27920371738274696
24197,703-004-5386,1349.8849,4,2,2,0.7719571632264555
24412,703-004-5383,6670.183,6,4,2,1.4488763483178178
24519,703-004-5393,346.32504,3,1,2,0.5380868373784218
24570,703-004-5397,644.6552,4,2,2,1.5551580713070536
2467,703-004-5396,6458.297,2,1,1,0.6526002766593176
25807,207-008-2398,68.70032,2,1,1,0.6024596623292424
2581,703-004-5397,6207.2183,6,2,4,0.6430992290382606
25903,703-004-5387,6355.0293,6,2,4,0.9839995104817016
26162,703-004-5390,3282.0027,4,3,1,1.0296271086845672
26642,703-004-5397,3309.7922,3,2,1,0.5165268771580819
26725,703-004-5396,7087.821,4,2,2,0.8836557571530909
27136,703-004-5390,5379.3257,4,2,2,0.5678761865292168
2728,703-004-5392,2753.045,4,3,1,1.0118381628822264
27507,703-004-5393,5463.457,6,2,4,0.9816412451498406
27517,703-004-5380,2435.944,2,2,0,0.5229401544330888
27537,703-004-5390,2935.322,1,1,0,0.7096544970946677
27764,703-004-5396,133.91316,3,1,2,0.7538054278862774
27834,703-004-5391,9585.413,5,2,3,1.7338940015346587
28310,703-004-5391,368.0283,"","","",0.27920371738274696
28912,703-004-5384,4254.869,4,2,2,0.6734902095758021
29220,703-004-5394,2088.7227,1,0,1,0.27920371738274696
29362,703-004-5390,7127.586,4,3,1,0.7396250096462232
29468,703-004-5384,9366.623,7,3,4,2.3323081747392735
30079,703-004-5398,37.57119,6,2,4,1.8386514565739236
3022,703-004-5388,1730.2698,6,3,3,1.9196610030021872
30280,207-008-2399,297.44446,4,4,0,1.853427899001953
30387,703-004-5385,7680.237,4,2,2,1.6358165310292807
30802,703-004-5381,8336.815,4,3,1,0.8516912074976776
3081,703-004-5396,9116.52,4,2,2,1.6654049071106891
30810,703-004-5397,5720.202,3,3,0,0.6747423170083051
31094,703-004-5392,1162.3901,3,1,2,0.9840086805317338
31310,703-004-5385,9637.875,4,2,2,0.7230545093338602
31387,703-004-5388,1057.676,9,3,6,1.0649149693198732
31612,703-004-5386,631.2501,3,2,1,1.353267194016401
3164,703-004-5390,3259.2273,5,4,1,1.164187526385311
31953,703-004-5399,7307.3955,3,2,1,0.6929860037483425
32225,207-008-2399,1263.181,3,2,1,1.8422368446334083
32436,703-004-5394,6075.7227,4,3,1,1.7168096050520882
32600,703-004-5390,1500.2834,2,2,0,0.8760702129255641
32834,703-004-5380,4.6491623,4,4,0,2.497836293555885
33075,703-004-5394,6234.9697,6,2,4,0.6491088707150874
33086,703-004-5394,3253.1392,1,0,1,0.27920371738274696
33734,703-004-5398,7283.0283,2,0,2,0.27920371738274696
33964,703-004-5380,9234.944,9,7,2,2.8408447216197446
34002,703-004-5393,2787.0881,8,5,3,2.9675749570126184
34070,703-004-5387,1171.1788,6,4,2,0.9015648184846852
34450,703-004-5387,6560.397,4,2,2,1.6363921296380455
34571,703-004-5396,1207.4512,5,3,2,1.5037571849420912
3465,703-004-5387,4016.3494,1,0,1,0.27920371738274696
34870,703-004-5399,5307.7407,3,1,2,1.0288682327615772
34888,703-004-5388,2146.6643,1,0,1,0.27920371738274696
35018,703-004-5389,1510.9807,"","","",0.27920371738274696
35071,703-004-5395,881.8448,2,2,0,0.5938898822677099
35080,703-004-5380,8684.356,6,2,4,1.2975812403048208
35144,207-008-2399,6378.9814,4,1,3,0.42898568098105394
35262,703-004-5391,2422.9233,4,3,1,0.9701541975668161
35397,703-004-5388,9841.493,5,4,1,1.717204526863194
35631,207-008-2398,1028.8787,4,1,3,0.40193453544686947
35789,703-004-5391,3484.4636,5,3,2,1.4862630290106134
35876,703-004-5386,1189.5424,4,1,3,0.8160448651700433
35979,703-004-5392,1230.6941,7,3,4,1.3869353846054604
35991,703-004-5394,5551.171,3,0,3,0.27920371738274696
36512,703-004-5385,5767.1533,6,4,2,1.526919549783061
36751,703-004-5397,7553.66,2,1,1,0.45761277283495216
37126,703-004-5381,4895.2446,5,3,2,1.2545503158466134
37185,207-008-2399,7660.2017,2,1,1,0.44829646872267315
37244,207-008-2399,2112.6223,1,0,1,0.27920371738274696
37498,703-004-5396,2839.3542,1,0,1,0.27920371738274696
3791,703-004-5385,7066.582,7,2,5,1.930561215640406
38056,703-004-5393,6990.433,3,2,1,1.1055172435900003
38369,703-004-5388,5988.772,2,1,1,0.7015134047142917
38498,207-008-2399,6658.402,7,3,4,1.2513924570702104
38545,703-004-5394,4898.6865,2,2,0,0.5696998777185187
38643,703-004-5383,4888.394,7,4,3,1.2092486895458168
3881,703-004-5388,6486.637,4,0,4,0.27920371738274696
3894,703-004-5381,3992.0007,3,3,0,0.8777795512913201
38969,703-004-5384,8931.513,"","","",0.27920371738274696
39214,703-004-5391,3141.0159,2,1,1,0.5379722460931743
39240,703-004-5390,2013.6381,4,4,0,1.3963049568634676
3975,207-008-2398,5280.9326,5,0,5,0.27920371738274696
40267,703-004-5384,4765.2085,5,3,2,1.4145763093592187
40483,703-004-5381,6273.155,2,1,1,0.6760367245615944
40598,703-004-5388,889.4616,2,1,1,1.5153939294259338
40739,703-004-5390,8918.632,6,3,3,0.5165268771580819
40826,703-004-5386,4682.902,5,1,4,0.4484355779176338
4110,703-004-5390,5606.874,3,3,0,0.9697835314182806
41331,703-004-5399,5808.632,7,2,5,0.6391635272840951
41418,703-004-5386,767.90094,5,2,3,0.7236505618226369
4161,703-004-5382,6343.6533,4,2,2,0.9190886378517688
4190,703-004-5390,4500.3154,1,0,1,0.27920371738274696
41902,703-004-5387,9132.579,1,1,0,0.7272381175467342
41991,703-004-5381,298.7796,3,0,3,0.27920371738274696
42031,703-004-5387,9531.049,2,1,1,0.41134896592480513
42086,703-004-5399,1514.7985,1,1,0,0.9119556467845165
42330,703-004-5384,5920.7534,2,0,2,0.27920371738274696
42498,703-004-5382,3632.8494,5,2,3,0.4456809595641397
42571,207-008-2398,8967.0,4,1,3,0.685221087212911
42613,703-004-5397,7346.535,7,5,2,2.0595605192336675
42624,703-004-5398,6820.9497,4,2,2,1.066598133968734
42643,703-004-5385,7452.0903,2,2,0,0.9027364257616274
42708,703-004-5380,1384.0437,2,1,1,1.0121204064149947
42898,703-004-5390,2808.246,3,1,2,0.7351237310281757
43418,703-004-5389,203.99869,5,2,3,0.5446656923658321
4357,703-004-5382,6980.536,6,2,4,0.7836376732168407
44058,703-004-5391,2796.114,5,4,1,1.6235323529908248
44090,703-004-5389,6180.1426,2,1,1,0.6925609542133818
4450,703-004-5389,6671.436,3,1,2,0.8887621442576464
45019,703-004-5395,8170.056,2,1,1,1.1747728550372682
4505,703-004-5380,5749.415,5,2,3,1.12796202214557
45480,703-004-5395,4537.674,5,3,2,1.291312516953841
45896,703-004-5385,8066.747,1,0,1,0.27920371738274696
46163,703-004-5381,9120.449,3,0,3,0.27920371738274696
46235,703-004-5393,2213.1748,2,1,1,0.45821237631354367
46322,703-004-5392,6486.8325,"","","",0.27920371738274696
46715,703-004-5381,2452.2854,3,0,3,0.27920371738274696
46773,703-004-5398,3643.53,2,0,2,0.27920371738274696
46800,703-004-5383,2439.2915,4,3,1,1.0110470553589637
46837,703-004-5397,9448.259,2,0,2,0.27920371738274696
46875,703-004-5388,161.90112,4,2,2,0.4262622386316509
47370,703-004-5384,8738.341,3,2,1,0.85861790957199
47661,703-004-5398,8845.794,4,1,3,0.7105452194543689
47896,703-004-5394,3659.5374,3,2,1,0.839363772675498
47913,703-004-5388,283.66745,4,2,2,0.894656002642327
48464,703-004-5394,2840.4038,6,2,4,0.49665561501265915
48649,703-004-5389,3627.1792,6,4,2,1.9282933771582802
48692,703-004-5394,5191.061,3,1,2,0.5479492767417616
48700,703-004-5388,4154.342,4,2,2,0.4961368623473843
48998,703-004-5382,2686.687,4,2,2,0.9104694744288641
49124,703-004-5384,9104.122,6,2,4,0.9533344186077327
4915,703-004-5396,3399.2224,6,4,2,2.231410965074845
49165,703-004-5394,4140.1743,6,2,4,0.948217592624264
49294,703-004-5395,7821.0425,6,2,4,1.603562171513863
4933,703-004-5395,2244.1833,6,1,5,0.47273692033925185
49349,703-004-5399,3555.4927,8,3,5,0.9156612913385673
49476,703-004-5388,3712.6643,6,3,3,0.8895848777262686
4948,703-004-5381,5062.862,6,4,2,2.068223200704881
49582,703-004-5392,1473.9066,5,0,5,0.27920371738274696
49693,703-004-5386,9101.761,4,2,2,0.9395447484820496
49721,207-008-2398,6841.0854,2,0,2,0.27920371738274696
49872,207-008-2398,5824.072,5,3,2,0.8352967414682344
507,703-004-5395,9625.122,5,4,1,0.8598263167650912
5244,207-008-2399,9846.614,2,0,2,0.27920371738274696
5268,703-004-5399,6650.9087,5,2,3,0.7759473106754746
545,703-004-5393,8973.517,4,3,1,0.8596604381796389
5718,703-004-5382,4067.5789,1,1,0,0.4014684067013785
5762,703-004-5398,7153.771,5,3,2,0.7042629965584382
5795,703-004-5398,5440.2075,3,2,1,1.3244043672294745
5805,703-004-5386,9406.514,5,3,2,1.3855009797041256
5837,703-004-5393,2651.7898,1,0,1,0.27920371738274696
5841,207-008-2399,7796.2046,2,0,2,0.27920371738274696
606,207-008-2399,3240.8828,4,1,3,0.35831143730785864
6236,703-004-5392,3776.0532,4,4,0,1.4147216577422435
6387,703-004-5380,9502.861,4,3,1,1.2534935523630586
6436,207-008-2398,1843.4269,3,1,2,0.6120139294902424
6537,703-004-5394,96.71092,3,1,2,0.4991289882477394
6999,703-004-5381,459.0112,3,1,2,0.7425287688594714
7156,703-004-5388,6356.841,3,0,3,0.27920371738274696
7191,703-004-5386,5475.372,6,4,2,0.6191047953475239
7232,703-004-5399,2441.5928,7,3,4,1.2513259854099834
7417,703-004-5389,3961.5178,5,3,2,1.7387116342703257
7654,703-004-5392,7022.7275,5,0,5,0.27920371738274696
7663,703-004-5383,8083.2676,7,2,5,0.8063047854688485
7844,703-004-5384,9631.118,5,3,2,1.074790300221634
8042,703-004-5394,6288.571,3,1,2,0.5255491417754383
8178,703-004-5397,5452.6157,4,3,1,0.6924079674388582
8222,207-008-2398,127.2285,4,1,3,0.9591746941406424
8361,703-004-5393,5862.561,4,3,1,0.8543116676428678
8393,703-004-5399,5751.099,7,3,4,1.826719342607966
8474,703-004-5394,9623.189,3,2,1,0.9759921522693971
891,703-004-5381,7286.4194,3,1,2,0.35831143730785864
9410,703-004-5390,4608.8784,3,2,1,1.0922960537374704
9413,703-004-5388,9467.75,5,3,2,0.7197348327157124
9671,703-004-5382,8695.798,3,2,1,1.6895059988140788
9759,703-004-5380,1438.8108,4,1,3,0.5644318532362942
9821,703-004-5380,4869.46,6,3,3,1.288097975795215
10110,703-004-5391,8835.742,5,2,3,1.1042609980887863
10296,703-004-5396,505.30017,6,3,3,1.1342293381931472
10616,703-004-5384,1871.5477,1,0,1,0.27920371738274696
10831,703-004-5392,5756.979,4,4,0,2.589522747836364
10993,703-004-5380,9888.859,5,1,4,0.39611009473457603
11177,703-004-5382,5219.286,4,3,1,1.6366275403158255
11711,703-004-5399,7398.041,4,2,2,1.1885349446929467
11878,207-008-2399,2683.177,3,1,2,0.33853450732658075
11902,703-004-5392,3250.4177,7,4,3,0.8938465304521274
12067,703-004-5396,1450.3086,6,2,4,1.6501690191653502
12223,703-004-5399,4569.7856,5,1,4,0.5670164180217436
124,703-004-5384,8517.55,4,0,4,0.27920371738274696
12608,703-004-5399,1671.2815,2,1,1,0.389063244966747
12710,207-008-2399,5958.817,8,7,1,1.8319274308183031
12816,703-004-5389,3463.9097,11,6,5,1.3334718802236756
12957,703-004-5384,4225.13,10,7,3,3.2565148405823763
13025,207-008-2399,7597.7505,3,1,2,0.35831143730785864
13027,703-004-5380,2022.1013,8,4,4,1.9444182825930225
13122,703-004-5398,7101.3496,3,0,3,0.27920371738274696
13133,703-004-5397,5303.8477,"","","",0.27920371738274696
13174,703-004-5395,4870.435,6,2,4,0.6518302904036827
13805,703-004-5383,5118.4185,3,1,2,0.3271627725873459
14313,703-004-5391,2449.2007,3,2,1,0.4736840156043495
14340,207-008-2399,1552.6432,2,0,2,0.27920371738274696
14392,703-004-5382,9182.135,4,1,3,1.9243421765246542
14439,703-004-5381,9155.767,3,3,0,1.2823331706695984
14649,703-004-5385,9710.557,4,4,0,1.836532287711376
14697,703-004-5386,6106.797,4,0,4,0.27920371738274696
14839,703-004-5389,1781.9088,"","","",0.27920371738274696
14940,703-004-5388,9006.22,3,2,1,0.589235848331237
14963,703-004-5387,696.64954,1,0,1,0.27920371738274696
15176,703-004-5398,164.45636,5,3,2,1.4786097275760033
15277,207-008-2398,8733.448,5,4,1,2.3158222849968606
1528,703-004-5391,7286.058,5,1,4,0.39968230271244437
15433,703-004-5398,1679.8949,8,6,2,3.969547537203641
16093,703-004-5390,8097.092,7,3,4,0.9379509270621249
16253,703-004-5399,7134.238,6,2,4,0.6876122880750352
16267,703-004-5384,1794.414,3,1,2,0.7263973669777678
16683,207-008-2399,7145.1016,4,3,1,1.2353625026810953
16946,703-004-5390,2921.8877,4,3,1,0.7122058588517678
17128,703-004-5381,4947.442,2,0,2,0.27920371738274696
17545,703-004-5398,4608.813,3,2,1,0.6551704041400388
17584,703-004-5392,8826.268,7,5,2,2.175440557535325
17660,703-004-5399,1981.1588,6,4,2,0.7580059238814155
17715,703-004-5392,8320.126,4,1,3,0.5952468376079157
17718,703-004-5380,523.68463,3,1,2,1.5523765213968819
17886,703-004-5383,4985.013,2,0,2,0.27920371738274696
17947,703-004-5387,4427.582,5,1,4,0.6071772384941234
18211,207-008-2398,2938.0781,6,3,3,1.12991659807972
18564,703-004-5387,8107.534,4,3,1,2.2130460446839124
18637,703-004-5399,8605.55,3,2,1,0.8696202749502907
18714,703-004-5384,306.8191,4,0,4,0.27920371738274696
1903,703-004-5383,3244.0674,2,2,0,1.3393039360321028
19239,703-004-5383,7012.064,3,1,2,0.45835355205613326
19496,703-004-5392,765.50006,2,1,1,0.5521611577482475
1953,703-004-5389,5339.051,2,1,1,0.44803220035034724
20075,703-004-5392,2291.466,3,2,1,0.6560094392072694
20143,703-004-5397,2808.0005,8,6,2,1.425013629403603
20244,703-004-5388,8918.282,3,3,0,1.1842089404568337
20280,703-004-5398,7844.322,7,6,1,2.8554556411145033
2034,703-004-5389,7498.1455,5,3,2,1.1937619332702156
20899,703-004-5383,1124.0608,3,1,2,0.7283893186748592
21086,703-004-5380,8896.935,3,1,2,0.4271927197880031
21556,703-004-5386,5621.1567,4,1,3,0.37655750930277326
21683,703-004-5381,4440.384,6,3,3,3.6577164810507092
21690,703-004-5392,5523.128,4,2,2,0.647080439001032
21833,703-004-5386,5228.811,4,4,0,1.3600818104350323
22026,703-004-5398,9216.778,3,3,0,1.28410482797297
22077,703-004-5382,2335.0596,3,1,2,0.3984761297272529
22107,703-004-5386,9417.571,6,2,4,0.4104730901334791
22154,703-004-5386,489.01797,4,2,2,1.1546653752278042
22335,703-004-5383,6511.4253,5,2,3,1.2545769201655161
22431,703-004-5399,4048.7307,5,3,2,2.6890288231161246
22893,703-004-5391,9598.357,5,2,3,2.702727467262056
22920,703-004-5392,6974.2974,1,1,0,0.32031147898668894
23156,703-004-5397,7501.1807,6,3,3,1.00381009751978
23834,207-008-2399,4970.206,4,4,0,1.9050805046960877
24164,703-004-5394,70.37401,4,3,1,0.911664993951519
24274,703-004-5384,2454.4824,3,2,1,0.5526767773743932
25249,207-008-2398,8033.2173,2,1,1,1.128508113028582
25308,703-004-5386,1349.8354,5,2,3,0.8025304163773458
25385,703-004-5396,5451.314,4,2,2,0.5772130460814142
2550,703-004-5387,1810.8488,2,1,1,0.4745017656735289
25582,207-008-2398,6838.6543,9,2,7,1.1077146491970595
25638,703-004-5384,5107.378,6,3,3,1.072349223772725
25817,703-004-5390,5270.698,8,6,2,3.563134294295748
25835,703-004-5386,2978.8733,4,1,3,0.3978652972704144
26029,703-004-5384,4802.8086,2,2,0,1.136960524430959
26338,207-008-2399,2673.9485,8,4,4,1.4264248448935304
26413,703-004-5382,5956.1055,1,0,1,0.27920371738274696
26541,703-004-5391,3584.4714,2,2,0,0.9213142241127334
26863,703-004-5390,9738.951,4,4,0,1.486884522054754
26914,703-004-5381,7916.897,3,1,2,0.6410180808838193
26988,703-004-5383,7538.855,2,1,1,0.4032545106903127
27032,703-004-5393,7571.2007,2,2,0,1.4840812873486624
27560,703-004-5387,7123.737,1,1,0,0.42328380082179184
27566,703-004-5389,1179.6719,6,4,2,0.9489637548087562
27701,703-004-5396,5960.498,8,3,5,0.9721693860725762
27767,703-004-5391,5829.2886,5,0,5,0.27920371738274696
27967,703-004-5392,9292.6,6,3,3,0.6781798544215655
28053,703-004-5389,3573.8784,2,2,0,0.3598653389492447
28056,703-004-5380,5410.787,7,4,3,0.9804430970837871
28302,703-004-5380,6899.378,3,1,2,0.6579453963746644
28738,703-004-5397,9737.664,4,1,3,0.47270655657144
2888,703-004-5386,5129.817,"","","",0.27920371738274696
2895,703-004-5396,2890.0515,5,2,3,0.49119681824839195
28970,703-004-5382,8213.124,6,3,3,1.0852369589280726
29241,703-004-5386,5871.757,3,2,1,0.8527670812713702
2930,703-004-5385,2012.2654,2,0,2,0.27920371738274696
29431,703-004-5384,570.92664,4,3,1,1.7165623942530268
29444,703-004-5394,8737.908,4,3,1,1.26935681711423
29580,703-004-5396,4859.9956,6,3,3,0.8604424695334563
30557,703-004-5392,1880.5873,2,1,1,1.0654455885724734
30815,703-004-5397,5245.1934,3,2,1,1.741383170850118
30917,703-004-5382,566.76685,5,3,2,0.45064458675854546
31005,703-004-5391,6536.6465,4,0,4,0.27920371738274696
31205,703-004-5385,6361.5786,2,1,1,1.1043714670804607
3121,703-004-5394,5003.74,5,3,2,1.43508253310492
31391,703-004-5380,2754.2686,7,3,4,1.3306962718535955
31429,207-008-2399,9404.628,2,1,1,0.9846438088516263
31785,703-004-5385,4983.6094,4,1,3,0.6726472805580688
31873,703-004-5395,8888.637,5,1,4,0.3978652972704144
32085,703-004-5393,5002.2524,5,2,3,0.8203418642385532
32247,703-004-5387,1579.246,7,3,4,1.0080981377680749
32481,703-004-5386,7588.2744,6,2,4,1.748573498836334
3249,703-004-5383,5611.1074,5,2,3,0.7080943388839491
32497,207-008-2399,5188.027,3,1,2,0.7243944648881169
32606,703-004-5383,8965.848,2,1,1,0.33853450732658075
32657,703-004-5391,2491.048,4,2,2,1.1757930661194222
3266,703-004-5382,2700.0034,3,2,1,0.8898462711150498
3312,703-004-5390,1119.7698,6,2,4,1.4510553786852007
33120,703-004-5385,8204.195,6,4,2,1.4641252981787358
34075,703-004-5390,8646.818,4,0,4,0.27920371738274696
34316,703-004-5393,4696.2563,2,2,0,0.6456653026386153
34400,703-004-5383,7509.067,1,1,0,0.7939554733350045
34958,703-004-5389,705.19806,2,1,1,0.3870758832472951
35054,703-004-5387,5553.2915,3,1,2,0.5201608880421418
35136,703-004-5391,2008.7505,4,1,3,0.7515732005877106
35299,703-004-5386,6735.314,5,1,4,1.003188625427555
35620,703-004-5380,893.42596,8,4,4,2.1941567889221303
36157,703-004-5382,9159.701,1,0,1,0.27920371738274696
36182,703-004-5382,1892.4982,5,2,3,0.9346682525953822
36373,207-008-2398,3131.0593,5,3,2,0.6676136874375668
3652,207-008-2399,6832.1973,1,1,0,0.8168433304688413
36869,703-004-5385,1591.9882,5,2,3,1.467409502027531
37519,703-004-5380,3048.4878,4,3,1,1.4490437466764532
37544,703-004-5399,5504.0425,2,1,1,0.5273053039978784
37607,703-004-5393,6119.684,6,3,3,0.7825719024956702
38968,703-004-5397,2890.904,5,3,2,0.6632829092963235
39218,207-008-2399,460.62708,3,1,2,0.35831143730785864
39301,207-008-2399,9831.452,3,1,2,0.32666834933781397
39425,703-004-5390,8500.167,4,2,2,0.9657733397959183
39488,703-004-5391,1382.6078,4,3,1,2.045610999299533
40099,703-004-5383,782.1524,4,3,1,1.0580168721545946
40117,703-004-5397,6294.337,3,1,2,1.0114834201482013
40130,703-004-5383,6522.3657,3,2,1,0.9516464542315332
41074,703-004-5399,646.51965,5,1,4,0.8584081936281855
41153,703-004-5385,596.65027,3,2,1,0.6711325167631714
41298,703-004-5398,9762.168,2,0,2,0.27920371738274696
41462,703-004-5384,9362.789,4,3,1,0.7142961769708609
41579,703-004-5382,893.00336,3,2,1,2.4952018754565075
41657,703-004-5399,7466.295,3,1,2,0.3978652972704144
41710,207-008-2399,4012.6245,2,1,1,0.7105643901761731
42134,703-004-5385,1339.652,8,4,4,1.5675499060883011
42266,703-004-5380,5158.7827,3,2,1,1.5165113787466236
42273,703-004-5389,5494.0283,4,2,2,0.9237878662890292
42326,703-004-5384,6121.451,3,2,1,0.5340249416791807
4236,703-004-5391,757.9786,4,3,1,2.1808728082066793
4249,703-004-5381,2761.7395,5,2,3,1.4533460315118885
4276,207-008-2398,1999.2191,4,3,1,2.6243148360812327
42937,703-004-5395,4033.7031,4,1,3,0.5167962358542817
43040,703-004-5381,6174.1353,2,0,2,0.27920371738274696
43258,703-004-5391,7209.23,6,3,3,0.8264956270719774
43785,703-004-5386,5467.0615,4,2,2,0.6158602472245324
43831,703-004-5396,2651.763,1,0,1,0.27920371738274696
44132,207-008-2398,976.6638,6,5,1,1.3026515619584522
44199,703-004-5390,3627.9082,8,2,6,1.4608371669202864
44208,703-004-5396,5077.6553,4,3,1,0.48773260886391184
44281,207-008-2398,1364.4409,6,4,2,2.2531089194975267
44475,207-008-2399,1834.951,6,3,3,1.3908043233555802
447,703-004-5396,6320.584,3,1,2,0.9841260499160933
44933,703-004-5392,3656.971,4,1,3,0.7913958385446117
44950,703-004-5381,1403.6893,5,3,2,0.9187468531376861
45047,207-008-2399,6085.107,1,0,1,0.27920371738274696
45518,703-004-5390,3176.927,6,2,4,1.018285625596624
45631,703-004-5388,3842.8206,6,2,4,1.0902629056957935
4583,703-004-5383,8142.525,5,3,2,0.7489121272727488
45840,703-004-5391,8997.28,2,1,1,0.6445587631378112
46067,207-008-2399,1807.5245,1,0,1,0.27920371738274696
46546,207-008-2399,2494.709,4,1,3,0.6010173506709817
46605,703-004-5382,8133.309,3,1,2,0.568308909012598
4665,703-004-5388,4691.68,6,1,5,0.33853450732658075
46785,703-004-5399,4457.345,6,4,2,2.0341929665393366
47052,703-004-5384,3735.6436,6,4,2,0.8347210642618198
47231,703-004-5389,3449.0818,2,1,1,1.9273760400459397
47266,207-008-2399,5036.8584,2,2,0,0.9077432972909574
47342,703-004-5394,3074.4756,7,4,3,1.6974985076484954
47495,703-004-5398,4384.3677,4,0,4,0.27920371738274696
47839,703-004-5389,9656.842,5,2,3,1.050572055227039
47933,703-004-5399,3132.7485,4,3,1,1.9448842363058256
48137,703-004-5399,7021.031,"","","",0.27920371738274696
48330,703-004-5388,8422.036,3,1,2,0.6218082871075915
48466,703-004-5398,5871.1494,4,1,3,0.39829191925544094
48686,703-004-5389,3950.9492,5,4,1,1.5914983981683093
48837,703-004-5396,7652.1187,8,3,5,1.2561675606303129
49036,703-004-5389,8535.04,4,3,1,1.2758810514885934
49147,703-004-5388,8085.8345,4,1,3,0.6934828789369252
49255,703-004-5396,2947.9963,4,1,3,1.142820881139041
4988,207-008-2398,5751.5146,2,1,1,0.32666834933781397
5057,703-004-5394,4931.109,1,1,0,0.5070278750934017
5082,703-004-5381,4496.4927,6,2,4,0.3978652972704144
51,703-004-5391,8864.822,2,1,1,0.7342268551008335
5234,703-004-5391,6985.1553,3,3,0,1.0188407210985972
5297,703-004-5394,4580.3486,5,2,3,0.7248196966702858
5320,207-008-2399,6343.9185,6,4,2,1.4255003994382864
5408,207-008-2399,2265.6643,4,1,3,0.32666834933781397
591,703-004-5388,7779.1465,1,0,1,0.27920371738274696
6106,703-004-5380,3529.008,1,0,1,0.27920371738274696
6143,703-004-5389,708.5526,3,3,0,2.887182581432463
6227,703-004-5396,5776.43,2,0,2,0.27920371738274696
6252,207-008-2399,3991.3362,4,3,1,1.6079940041473995
6380,703-004-5385,4723.2344,5,2,3,0.5926680575860018
6732,703-004-5385,516.5088,3,1,2,1.7194414761720027
6768,703-004-5385,3616.141,5,2,3,0.676393329045334
6820,703-004-5391,7063.8013,6,3,3,0.9682894326002035
6850,703-004-5385,701.1968,5,1,4,0.6270939905437279
7,703-004-5385,891.3684,7,1,6,0.6510902275997682
7054,703-004-5393,9528.691,9,4,5,1.2120719544770968
7249,703-004-5386,8110.111,3,3,0,1.0702620241315857
7616,703-004-5388,9488.497,3,2,1,2.765474842473494
8145,207-008-2398,4522.301,3,0,3,0.27920371738274696
8153,207-008-2398,5930.4434,6,4,2,1.8825261944692144
8258,703-004-5385,9307.507,6,3,3,1.5655550052271143
8409,703-004-5384,6265.596,4,2,2,1.039617062932679
8583,703-004-5381,8703.517,5,2,3,0.4932165924886216
9196,703-004-5395,3554.585,8,6,2,1.5097517564408593
9344,703-004-5388,2247.079,"","","",0.27920371738274696
9544,207-008-2399,7257.8438,4,4,0,2.6873057121818484
9622,703-004-5393,6664.9966,3,0,3,0.27920371738274696
9835,703-004-5387,9117.841,3,0,3,0.27920371738274696
9858,703-004-5382,1780.5427,4,2,2,1.260675674455454
10458,703-004-5387,7050.8687,5,5,0,1.1822297903965495
10706,703-004-5392,3112.3716,1,0,1,0.27920371738274696
10941,703-004-5397,4222.355,5,2,3,0.3978652972704144
11443,703-004-5380,9302.337,7,3,4,2.516091490327413
11527,703-004-5387,607.82074,1,1,0,0.3271627725873459
12009,703-004-5399,1952.4735,4,2,2,0.5019625808647264
12040,703-004-5380,9754.748,3,1,2,0.5670343205312884
12374,703-004-5396,6864.2886,6,3,3,0.6737376226326838
12489,703-004-5381,3840.586,"","","",0.27920371738274696
12836,703-004-5380,1598.0613,3,1,2,0.4230808829965438
12848,703-004-5382,2132.4355,4,2,2,0.49549683230541425
12947,703-004-5381,8749.6455,6,3,3,1.4246408889343367
13075,703-004-5396,674.7091,4,2,2,0.6597011357683141
13115,207-008-2399,360.45908,5,1,4,0.4378122731724071
1323,703-004-5391,8175.2217,2,1,1,0.4575080126735322
13647,703-004-5387,8363.663,3,2,1,0.8949488289128426
13713,703-004-5381,7473.5176,5,2,3,1.0917230872080712
14030,703-004-5385,8259.685,9,5,4,3.1230163194927054
14056,703-004-5386,7606.118,8,3,5,0.8335053662385611
14305,703-004-5398,7549.435,3,2,1,0.5816287328678633
14351,703-004-5383,125.35989,3,1,2,0.4378333170911501
1502,703-004-5397,7991.955,3,2,1,0.5084635755930902
15428,703-004-5395,2812.4214,2,2,0,0.7178395435925066
15430,207-008-2399,347.5505,6,4,2,2.8859356277866866
15524,703-004-5395,8717.879,6,4,2,0.8626597788854797
15639,703-004-5395,7494.76,9,2,7,0.5112321809827193
15647,703-004-5387,5067.936,3,1,2,0.4733378630873035
15853,703-004-5384,8996.078,3,1,2,0.42951138845032166
15976,703-004-5389,2986.4626,3,0,3,0.27920371738274696
16117,703-004-5398,5839.724,5,2,3,0.5792708356011845
16177,703-004-5381,5721.3105,2,0,2,0.27920371738274696
16359,703-004-5384,3747.0132,4,3,1,0.6501253845631665
16430,703-004-5383,2060.4707,"","","",0.27920371738274696
16534,703-004-5396,8893.981,3,2,1,3.6472750006577317
16638,703-004-5383,3285.0164,2,1,1,0.38076711125316315
16655,703-004-5397,8675.304,1,0,1,0.27920371738274696
16686,703-004-5385,7110.3535,2,2,0,0.7630793055877988
16736,703-004-5388,8597.897,2,0,2,0.27920371738274696
16880,703-004-5390,8808.435,4,2,2,0.6394243012967027
16955,703-004-5386,2366.792,3,2,1,0.7755635015807453
17125,703-004-5383,2352.7246,4,2,2,0.7935185183664727
17253,207-008-2398,9931.232,5,1,4,1.3210932765689019
17627,703-004-5398,4866.4917,3,3,0,1.377588075625643
17699,703-004-5388,6837.8813,8,4,4,1.8253713635516393
17754,703-004-5398,7184.27,2,0,2,0.27920371738274696
17772,703-004-5390,4308.652,6,4,2,1.7747854267754624
1799,703-004-5382,957.7602,3,2,1,0.7975255948533329
18176,703-004-5389,5246.873,5,4,1,0.9599646950725049
18291,703-004-5394,7278.948,5,2,3,1.4738697014676296
18699,207-008-2399,9683.391,5,3,2,0.9225460759712552
18914,703-004-5396,4296.959,4,2,2,0.7430260462394245
19468,703-004-5387,7816.1187,3,0,3,0.27920371738274696
19482,703-004-5398,6289.312,3,2,1,1.2530867774573369
19587,703-004-5399,72.09897,7,4,3,1.582141562643272
19602,703-004-5385,7859.1963,3,1,2,0.647797053581296
19706,703-004-5382,219.5847,3,1,2,0.458862044694582
19716,703-004-5387,158.47206,4,4,0,2.056957015235534
19979,703-004-5390,5480.897,3,2,1,0.7243574696621438
20166,703-004-5389,4455.318,2,2,0,0.4737328968335933
20840,703-004-5392,3172.5781,7,5,2,3.727225520893753
21258,207-008-2398,6346.312,6,4,2,2.5256876008422635
21343,703-004-5391,7251.301,1,0,1,0.27920371738274696
21424,703-004-5384,8668.048,3,2,1,0.9539575277406315
21573,703-004-5393,2660.386,4,2,2,0.8894040763352101
21791,703-004-5395,8567.044,5,1,4,0.47483226031244835
2205,703-004-5380,9066.994,5,2,3,2.592961468591059
22157,703-004-5383,6928.439,8,3,5,1.0906734141170615
22185,703-004-5390,2961.5652,6,2,4,1.0471938081746464
22190,207-008-2399,3336.705,5,3,2,1.7182927861263764
2274,703-004-5384,8268.307,2,0,2,0.27920371738274696
22984,207-008-2399,5611.552,3,1,2,0.5230836956119044
23311,703-004-5385,3894.9602,6,3,3,1.3650058166618046
23639,207-008-2398,6039.4575,3,2,1,0.9341605653632336
2376,703-004-5385,7033.85,5,3,2,1.132234230093497
23782,703-004-5395,9352.891,5,1,4,0.6119691811559242
24242,703-004-5394,3718.31,5,3,2,1.324829815934646
24315,703-004-5381,5916.6,3,2,1,0.819480811715392
24339,703-004-5399,2858.5725,7,3,4,1.0073527837561784
24543,703-004-5380,5610.1846,2,1,1,0.5478793419740386
2480,703-004-5386,8911.407,6,3,3,1.0104293857029445
24956,703-004-5394,9906.55,5,2,3,1.0559563503283773
25006,207-008-2398,3491.5305,4,3,1,1.798077704307418
25281,703-004-5387,3738.4744,3,3,0,1.4084700407087065
25332,703-004-5389,9718.617,3,1,2,0.33853450732658075
25658,703-004-5382,8729.931,5,2,3,1.0032155033575776
26327,703-004-5398,7348.3413,2,2,0,1.0866683401299333
26600,703-004-5389,3183.6575,6,3,3,0.8252324601085531
26610,207-008-2399,3778.7927,5,2,3,0.56347315809561
2673,703-004-5389,9624.649,3,2,1,0.6366534963597177
268,703-004-5391,8705.534,5,1,4,0.9054149471118038
26853,703-004-5397,3466.3909,5,4,1,0.7953479102745347
26854,703-004-5393,1011.69464,2,2,0,0.5105937981636984
27241,703-004-5387,8353.586,3,1,2,0.4960588121438541
2744,703-004-5396,1918.4923,6,3,3,0.8878116552079361
27525,703-004-5396,5326.8413,5,2,3,0.5853333233277671
27755,703-004-5396,7135.0796,3,1,2,0.5201608880421418
28002,703-004-5382,4842.606,5,2,3,0.47736855579515164
28470,703-004-5384,407.2541,4,1,3,0.9611015505239991
28483,703-004-5380,4220.9844,9,5,4,3.1366144365286712
28907,703-004-5386,7679.6665,2,1,1,0.44931452080308687
29019,703-004-5392,8126.885,5,2,3,1.5412268943786944
29161,703-004-5382,9945.149,5,1,4,0.3597609987507823
29182,703-004-5381,1355.3392,3,1,2,0.8615641690135304
29429,703-004-5387,3802.548,4,1,3,0.45472927818346964
29529,703-004-5395,8908.518,6,3,3,0.5981067133308532
29726,703-004-5381,5699.191,1,1,0,0.3750913957582559
29813,703-004-5386,6337.689,3,1,2,0.46398184800043474
30092,703-004-5386,7404.671,5,3,2,1.664728552211292
30316,703-004-5397,6531.177,2,1,1,0.4611441168515522
30484,703-004-5397,8922.469,3,1,2,1.0857052900588826
30537,703-004-5395,8940.747,7,3,4,0.619621188610521
30736,703-004-5388,4364.637,5,2,3,1.6626911416641825
30985,703-004-5385,6365.88,1,1,0,0.3805604835367963
31155,703-004-5387,1896.0547,4,2,2,1.1473338006552338
31493,703-004-5391,2965.9653,4,1,3,0.8972481224630309
31602,703-004-5399,8040.4546,5,1,4,0.7533255614491099
31672,703-004-5389,4309.995,7,4,3,1.2950401076034834
31716,703-004-5381,5507.023,4,3,1,1.9340465209970756
31884,703-004-5399,8339.879,3,2,1,0.49321766567912617
3197,703-004-5390,9324.233,3,1,2,0.5408235029368968
32177,703-004-5392,5992.7163,3,2,1,0.9922519544154002
32198,703-004-5384,3723.6196,5,4,1,2.7678656278025224
3233,207-008-2399,9941.002,4,1,3,0.4979399020573739
32626,207-008-2398,8429.963,6,3,3,1.1921205765994163
32729,703-004-5386,662.4204,3,2,1,0.8008165437169598
33042,703-004-5383,3864.1733,5,3,2,2.058491945907475
33050,703-004-5387,9900.098,"","","",0.27920371738274696
33226,703-004-5395,4231.568,3,1,2,0.6153546470344377
33348,703-004-5399,2282.1409,6,1,5,0.5736168447971828
33397,703-004-5389,6975.8403,7,4,3,1.1859257994152836
33472,703-004-5390,7454.2725,2,0,2,0.27920371738274696
3355,703-004-5392,6110.2617,5,4,1,0.84539419631987
3369,703-004-5390,3545.0315,7,3,4,1.910363836337923
33753,703-004-5383,9653.956,6,3,3,1.1647015832511516
34019,703-004-5398,5401.4043,3,1,2,1.3765897392678372
34122,703-004-5381,157.547,6,3,3,0.496749947176804
34286,703-004-5384,1708.042,5,4,1,3.014067246541263
34364,703-004-5382,1456.1433,2,1,1,0.7589482134895781
34582,703-004-5387,2232.126,3,2,1,0.722133717816927
34875,703-004-5380,2874.3196,2,1,1,0.5815002541113564
35181,703-004-5397,4730.5273,1,0,1,0.27920371738274696
35325,703-004-5382,8268.828,5,1,4,0.7931612392990439
35338,703-004-5391,1320.3556,2,1,1,0.5165268771580819
35493,207-008-2399,2519.8835,"","","",0.27920371738274696
35540,703-004-5383,9058.193,4,2,2,1.3314738241988495
35675,703-004-5382,5753.5347,7,3,4,3.9566001511481512
35755,703-004-5396,5425.206,3,2,1,0.5615279293676199
3590,703-004-5383,6960.071,4,3,1,0.799623341769396
3610,703-004-5390,389.32562,3,0,3,0.27920371738274696
36162,207-008-2398,8369.52,"","","",0.27920371738274696
36406,703-004-5380,860.82874,"","","",0.27920371738274696
36468,703-004-5380,9707.438,5,4,1,2.22075197633156
36572,703-004-5382,2195.7302,4,1,3,0.40235792150951455
36595,703-004-5397,8006.616,3,3,0,1.7691148807939112
36645,703-004-5382,4343.502,2,0,2,0.27920371738274696
36774,703-004-5385,2675.1501,5,0,5,0.27920371738274696
36791,703-004-5392,3680.3926,4,2,2,0.8553692735030567
36821,703-004-5383,3194.9841,2,1,1,0.7636921640897574
37158,703-004-5380,2646.113,6,2,4,0.5723978228493276
37583,703-004-5399,8722.792,1,0,1,0.27920371738274696
37631,703-004-5398,1930.8949,4,2,2,0.7291076739153842
38008,703-004-5383,7667.7065,4,1,3,0.4247800444357455
38247,703-004-5397,3879.4475,4,3,1,0.7041750492745976
38393,703-004-5392,2142.9783,3,3,0,2.3412821904558876
38467,703-004-5390,6252.9043,7,2,5,0.9230413386571904
38519,703-004-5392,5730.929,5,4,1,1.1382647435974578
38719,703-004-5388,9563.73,5,1,4,0.5165268771580819
38914,703-004-5393,368.97302,4,2,2,0.9552542305678513
39217,703-004-5382,8236.82,3,2,1,1.6435716972254482
39497,703-004-5395,1135.3225,3,2,1,0.4218801408191091
39655,703-004-5398,6330.173,8,6,2,1.4270786857011901
39720,703-004-5381,4030.7485,1,0,1,0.27920371738274696
39783,703-004-5394,7221.429,5,4,1,1.7616631138169712
39874,703-004-5381,1123.7651,8,2,6,0.6122918058652682
39984,703-004-5399,4613.7383,2,0,2,0.27920371738274696
40235,703-004-5388,9416.557,3,1,2,0.532146926467559
40270,703-004-5386,9298.817,6,2,4,1.1255249757194183
40514,703-004-5387,506.24072,5,3,2,1.4391238055160605
40561,703-004-5388,8517.888,7,4,3,1.2138546053235644
4060,703-004-5391,9903.974,1,0,1,0.27920371738274696
40696,703-004-5393,2266.6062,7,3,4,1.233516689494571
40699,703-004-5384,532.8667,4,1,3,0.40218450853031656
40798,703-004-5384,6464.1675,5,0,5,0.27920371738274696
41058,703-004-5390,4294.5923,2,1,1,2.3236756879346117
41334,207-008-2399,4226.5396,2,2,0,0.7566307232142404
41451,703-004-5381,3767.357,3,0,3,0.27920371738274696
41587,703-004-5390,1406.6356,4,3,1,0.8243386669443448
41717,703-004-5385,5361.4116,"","","",0.27920371738274696
42313,207-008-2399,3509.4124,3,1,2,0.4221333912683776
42505,703-004-5383,9867.585,5,4,1,1.1633881966469655
42645,703-004-5395,721.1888,7,5,2,1.5476838595387405
43075,703-004-5384,104.21276,6,4,2,0.8389143129044861
43096,703-004-5397,5239.588,7,3,4,0.8654897281206173
43097,703-004-5387,2599.6072,10,7,3,4.9418355939029395
43122,703-004-5386,8492.974,2,2,0,0.8063939845851469
43693,703-004-5385,7935.1675,8,2,6,0.8755949019132012
43840,703-004-5384,4703.7114,2,1,1,0.584775046124579
44077,703-004-5399,9516.307,4,1,3,0.4711240007703137
44125,703-004-5383,3201.9407,2,1,1,0.47346261212384927
44804,703-004-5394,5233.5327,5,3,2,2.0407427191559213
44883,703-004-5386,8034.061,5,4,1,2.2987079938349058
45154,207-008-2399,8205.535,3,0,3,0.27920371738274696
45334,703-004-5397,9811.549,3,1,2,0.4338853245690448
45359,703-004-5397,6247.7715,5,2,3,1.037075739127382
45522,703-004-5381,2377.5596,3,1,2,0.69784270959548
45782,703-004-5391,4164.656,4,1,3,0.7131987513936134
46,703-004-5384,5430.6597,5,3,2,1.2946358698563019
46337,207-008-2398,911.8986,3,2,1,0.7541049778611416
4651,703-004-5380,9625.868,3,0,3,0.27920371738274696
46553,703-004-5385,2731.7983,5,3,2,2.4440478087425785
46630,703-004-5385,7063.7866,9,5,4,2.1721647406187037
46736,703-004-5392,3704.862,1,1,0,0.8720610533326851
46971,703-004-5390,299.1569,5,3,2,1.832512569819794
47288,703-004-5384,3954.7664,2,1,1,0.5554029984814386
47442,703-004-5397,3579.9504,7,5,2,2.456249249082539
47952,703-004-5380,3875.72,5,4,1,1.126858110167945
47978,703-004-5382,9328.166,2,0,2,0.27920371738274696
48218,703-004-5395,8280.968,6,3,3,1.6368816936455948
4836,703-004-5389,8292.3,3,3,0,0.8473027175393221
48400,703-004-5386,1705.7979,7,5,2,1.3560449339144618
48525,703-004-5397,7004.7554,4,2,2,0.6996762232862038
4859,703-004-5381,1908.7815,3,1,2,0.8136782628196132
48816,703-004-5385,4095.884,2,1,1,1.5458135809944058
49198,703-004-5385,4195.704,5,2,3,0.5174462736713614
49710,703-004-5391,7924.4644,3,1,2,0.35831143730785864
5068,703-004-5395,6668.6816,3,1,2,0.3978652972704144
5453,703-004-5389,3726.1987,3,1,2,0.33853450732658075
5651,703-004-5390,2204.8396,7,3,4,0.7999861013106491
5710,207-008-2399,4483.6265,3,0,3,0.27920371738274696
5770,703-004-5399,5418.5156,8,4,4,1.1244081235568597
5959,703-004-5399,7645.375,4,1,3,1.7446403339960206
5977,703-004-5394,8557.568,3,1,2,0.5284285282784336
5985,703-004-5399,2441.4343,3,2,1,2.9962414001402236
6181,703-004-5382,4915.9385,4,0,4,0.27920371738274696
621,207-008-2398,2283.5374,5,1,4,0.5512826215461688
631,703-004-5392,2654.7217,5,3,2,2.4266554206596456
6360,703-004-5381,8186.051,4,3,1,0.6904487775824457
7149,703-004-5384,1127.7074,4,1,3,0.4290353316913857
716,703-004-5390,1845.4617,5,4,1,1.489869946381911
7478,703-004-5389,706.40326,4,2,2,1.0071437417915106
7506,703-004-5390,9881.981,5,3,2,4.030949899645785
7605,703-004-5381,1900.6414,4,2,2,0.8196929645130644
7769,703-004-5387,2485.1978,5,0,5,0.27920371738274696
8055,703-004-5390,6691.995,3,2,1,0.7767739708979655
8323,703-004-5389,203.3198,5,3,2,1.9845801109546508
8501,207-008-2399,2557.892,5,4,1,1.610676169523113
8951,703-004-5387,4008.9177,6,4,2,1.0473402446984816
9475,703-004-5389,5425.76,3,2,1,1.1095973518984656
9527,703-004-5383,1831.7062,4,0,4,0.27920371738274696
9540,703-004-5397,4990.6914,5,4,1,1.9581940290810844
9782,703-004-5394,6361.435,3,2,1,1.0901778754482148
9839,703-004-5398,4065.5303,4,3,1,1.3836645108662697
9944,703-004-5382,396.09848,6,4,2,1.3438847143507828
9967,703-004-5387,6759.533,4,3,1,1.515916185390786
10021,703-004-5399,1283.0251,10,3,7,1.232987273882133
10078,703-004-5381,5538.14,2,1,1,0.8831209779141629
10465,703-004-5390,3270.2417,2,1,1,0.45617749386572864
11129,703-004-5381,6812.785,5,3,2,1.4088413257475187
11153,207-008-2399,6771.534,3,2,1,2.004313948243048
11305,703-004-5398,3300.2114,6,1,5,0.5165268771580819
11336,703-004-5394,7240.7817,6,4,2,1.2976902385386717
11341,207-008-2399,8209.573,3,2,1,0.9237235867299731
11349,703-004-5384,9130.571,2,1,1,0.3807252912866403
11371,207-008-2398,4975.1274,4,3,1,2.0341381009794723
11677,703-004-5392,9924.871,7,5,2,2.4918430191584613
12073,703-004-5382,1271.6508,5,1,4,0.5165268771580819
12432,703-004-5388,2069.983,4,3,1,2.2899908244578184
12707,703-004-5380,6605.979,3,1,2,0.3978652972704144
12711,703-004-5392,5215.8774,2,0,2,0.27920371738274696
12824,207-008-2399,6307.8843,6,3,3,0.8798731707542745
13009,703-004-5380,9131.099,3,1,2,0.3807252912866403
13024,703-004-5397,4313.2456,3,1,2,0.4173578022945238
13036,703-004-5382,9037.072,3,3,0,1.393535934568457
13156,703-004-5384,4239.45,6,3,3,0.7477497810777856
13290,703-004-5388,669.2177,4,1,3,0.32666834933781397
14160,703-004-5391,6873.687,4,2,2,2.2297660505225423
14412,703-004-5395,2271.542,4,3,1,0.9492548094972251
15033,703-004-5383,4062.3127,7,2,5,0.9180545238107153
1532,703-004-5386,3125.329,2,1,1,0.4779093262691007
15445,703-004-5388,7025.0825,2,0,2,0.27920371738274696
15660,703-004-5392,110.641716,4,2,2,0.6220604423002519
15706,207-008-2399,173.31601,7,2,5,1.752377802298175
15811,703-004-5392,1490.3295,7,1,6,0.7881955840000674
15950,703-004-5382,9318.436,5,2,3,0.522485979001728
16014,703-004-5385,5794.508,4,2,2,1.202353449734162
16207,703-004-5383,5928.361,2,0,2,0.27920371738274696
16357,703-004-5395,1523.8053,3,2,1,2.020805944528576
16550,703-004-5387,1153.999,5,2,3,1.0375353481274199
16602,703-004-5380,7588.869,4,4,0,3.0209402097055498
16818,703-004-5391,7268.4897,7,2,5,0.7243174739497448
16928,207-008-2399,4593.5366,7,3,4,2.201368736696819
16929,703-004-5380,4435.17,1,1,0,0.4395830829884218
16941,703-004-5399,5062.734,3,1,2,0.3902511792276225
16973,703-004-5394,400.16293,3,2,1,0.9201180057846842
17098,703-004-5383,5154.736,5,2,3,0.9795113792760445
17193,207-008-2398,6806.165,2,0,2,0.27920371738274696
17378,207-008-2399,3660.2986,2,2,0,1.769597867643818
17498,703-004-5390,5977.075,6,3,3,0.8815290728537978
17519,703-004-5391,7728.5977,7,4,3,1.2065281288420822
17896,703-004-5395,9335.6455,4,3,1,1.185648937475611
18382,703-004-5391,9337.206,5,2,3,0.8992027245153573
1844,703-004-5382,5450.385,7,4,3,1.1721077760664316
1892,703-004-5393,196.46167,3,2,1,2.7280770472043794
1933,703-004-5385,1451.3469,7,6,1,1.5575263834804858
19685,703-004-5383,5759.9067,2,0,2,0.27920371738274696
20095,703-004-5383,6548.156,2,0,2,0.27920371738274696
20227,703-004-5390,8490.588,3,0,3,0.27920371738274696
2040,703-004-5381,3642.4458,2,1,1,0.609991975833982
2054,703-004-5384,4816.1895,2,0,2,0.27920371738274696
20716,703-004-5399,8741.366,3,1,2,1.194178302917303
2076,703-004-5399,4028.6462,3,0,3,0.27920371738274696
21214,703-004-5385,8266.213,3,1,2,0.5441679584808475
21272,703-004-5395,7504.8,1,0,1,0.27920371738274696
21277,703-004-5389,3995.1814,1,1,0,0.4287290784178657
21282,703-004-5382,4496.702,7,4,3,1.222226989296637
21491,703-004-5381,7676.1577,2,2,0,1.330761165179581
21853,703-004-5398,1692.0978,3,2,1,1.2232717503764363
2203,703-004-5399,8291.59,4,3,1,1.2664120155135887
22497,703-004-5389,2787.8845,5,3,2,1.9867266816072238
22559,703-004-5394,8924.514,"","","",0.27920371738274696
22571,703-004-5390,4636.371,3,1,2,0.421693557845317
2296,703-004-5385,7773.978,4,1,3,0.4808950531414817
23164,703-004-5383,6674.438,4,3,1,1.1839909948915655
23233,703-004-5392,3274.4675,4,1,3,0.8529137460451519
23855,703-004-5380,8938.714,2,1,1,1.338696080726133
24089,207-008-2398,6395.101,6,1,5,0.3901174756960716
24413,703-004-5389,5626.056,8,4,4,1.4404169240331361
24579,703-004-5392,9059.055,2,2,0,0.841866714455928
24599,703-004-5389,1464.6066,1,0,1,0.27920371738274696
24601,703-004-5384,7898.506,9,3,6,0.9106645865568902
24629,703-004-5397,9809.399,3,2,1,0.48110145132911786
24639,703-004-5382,6205.7217,2,0,2,0.27920371738274696
24792,703-004-5385,5452.895,"","","",0.27920371738274696
24881,703-004-5387,4111.9165,6,3,3,0.8317802897500118
2524,703-004-5393,3337.413,8,4,4,1.1090941558681233
25391,703-004-5383,6753.957,5,2,3,0.9652330203191714
25431,703-004-5385,7576.665,8,3,5,1.4512205123362378
25695,703-004-5394,6367.4497,1,0,1,0.27920371738274696
25761,703-004-5381,1718.4943,7,3,4,0.570735431364031
25882,703-004-5398,2043.9589,1,1,0,0.4812335551895777
26265,207-008-2399,1085.3529,3,0,3,0.27920371738274696
26311,703-004-5387,6058.9346,2,0,2,0.27920371738274696
26340,703-004-5393,9726.34,8,2,6,0.7626202606927063
26350,703-004-5390,1897.853,6,2,4,0.6813806706191283
26767,703-004-5384,9351.097,6,6,0,2.041946067802662
2677,703-004-5397,4805.013,2,1,1,0.660185255667692
26812,207-008-2398,6620.3623,5,3,2,1.4218226966019925
27077,703-004-5396,4309.898,5,2,3,0.442114267363674
27141,703-004-5380,1610.3679,5,3,2,2.5522636268447543
27535,703-004-5382,2755.9006,4,3,1,1.052812236361984
27552,703-004-5381,538.5244,4,3,1,1.133638623527432
27715,703-004-5399,4145.606,7,5,2,1.3672775400492292
27965,703-004-5389,68.13407,5,3,2,0.8102367613405673
28521,207-008-2398,2439.5889,2,2,0,0.6993111234515417
28582,703-004-5387,3502.4797,1,0,1,0.27920371738274696
28638,703-004-5385,1848.0658,6,2,4,1.3262791208133669
28648,703-004-5383,7631.482,"","","",0.27920371738274696
28722,703-004-5399,1060.344,1,0,1,0.27920371738274696
28942,703-004-5382,4066.2056,3,3,0,2.063199568008651
29041,703-004-5398,7257.974,9,5,4,2.237537970422199
29148,703-004-5382,6610.543,3,1,2,0.6756680795610142
29565,703-004-5389,5450.464,4,3,1,1.8284094218104299
29639,703-004-5394,8646.96,3,2,1,1.0922296280559156
30027,703-004-5389,5518.247,5,3,2,0.8746707661191656
30115,703-004-5385,4681.1963,4,1,3,0.39428643046150935
30586,703-004-5380,9183.67,3,1,2,0.3978652972704144
30633,703-004-5398,1816.7085,3,2,1,0.6789613954043111
30715,703-004-5399,1773.222,2,2,0,0.7528744714248666
31017,703-004-5394,6353.989,7,3,4,0.7558208091451741
31154,703-004-5396,8957.516,4,1,3,0.39041947195399374
31220,703-004-5399,9703.26,6,3,3,1.3082682143426632
31331,703-004-5391,7496.3623,10,4,6,1.1655147839541857
31397,703-004-5382,521.9698,5,1,4,0.3799095576293495
31592,703-004-5384,4043.1648,6,4,2,2.4277227393377823
3199,703-004-5380,9266.826,5,3,2,1.2003598932956498
32173,703-004-5383,5573.285,6,3,3,1.2636456455241956
32332,703-004-5389,3219.924,3,2,1,2.532524495747202
3239,703-004-5389,7823.8315,7,6,1,1.7472773596385087
32425,703-004-5396,132.39742,4,2,2,1.1089609814087886
32641,703-004-5380,6051.153,5,1,4,0.48328971077143656
32992,703-004-5390,9065.426,6,3,3,0.7513336002881373
33166,703-004-5382,4619.0967,3,1,2,0.4230808829965438
332,703-004-5380,895.1461,"","","",0.27920371738274696
33396,207-008-2399,7162.1025,3,1,2,0.33853450732658075
33408,703-004-5399,717.2251,4,1,3,1.5546067925310687
33561,703-004-5390,4429.6313,6,3,3,1.2104881850381228
33568,703-004-5398,4292.884,6,3,3,0.6568981517244754
33682,703-004-5381,596.8648,5,4,1,1.473997185515736
33759,703-004-5396,5224.429,6,3,3,1.343946395360699
34060,703-004-5388,9125.515,4,2,2,0.5956345970831934
34173,703-004-5383,4584.1094,3,2,1,1.5363877015375909
34651,703-004-5389,1584.7397,6,2,4,0.4413745432292258
34659,703-004-5387,2634.3394,2,2,0,0.9005976181635349
35207,703-004-5384,6625.574,3,2,1,0.8340984929953141
35698,703-004-5399,2793.7126,8,4,4,1.8308999653390003
35851,703-004-5381,6250.0728,2,1,1,0.6107592655379966
35953,703-004-5389,3270.9473,8,2,6,1.641235378093509
36248,703-004-5392,9375.428,4,1,3,0.5204962108466187
36328,703-004-5386,689.21686,1,0,1,0.27920371738274696
36375,703-004-5390,4825.5254,6,3,3,1.398735524595213
36409,703-004-5387,1543.8813,5,2,3,0.8199234465299291
36677,703-004-5382,7509.919,2,1,1,0.39753897792572335
36691,703-004-5387,8471.536,2,1,1,0.885034354260085
36857,703-004-5394,7858.8325,4,0,4,0.27920371738274696
36971,703-004-5398,1045.99,3,3,0,1.3737724970920429
37230,703-004-5391,9042.429,5,1,4,2.6012119425302993
37379,703-004-5382,7078.893,1,0,1,0.27920371738274696
37432,703-004-5380,7289.154,3,2,1,0.6024830367206345
37629,703-004-5381,3635.488,8,5,3,1.8859379994712666
37647,703-004-5387,4832.4673,1,1,0,0.6083603551346787
37722,703-004-5395,2025.5554,7,4,3,0.8127285930306333
37767,703-004-5394,9331.829,4,1,3,0.4990905162025851
37807,703-004-5394,4866.7817,3,1,2,0.39028882749797744
38260,703-004-5381,5112.391,5,3,2,0.9288764579269673
38282,703-004-5394,2765.692,3,0,3,0.27920371738274696
38302,703-004-5391,4136.4634,3,3,0,1.1648533497531557
38437,703-004-5380,7460.181,3,2,1,0.5458242259953962
38499,703-004-5386,7982.593,6,4,2,2.620695290853351
38525,703-004-5388,8106.3604,4,2,2,0.85937743107456
39478,703-004-5387,9508.425,6,5,1,3.2726878153547667
39706,703-004-5398,7524.409,5,3,2,2.1155841366790478
39709,703-004-5380,7106.766,10,3,7,1.0076889619697593
39758,703-004-5392,1359.1022,3,0,3,0.27920371738274696
39811,703-004-5388,4949.3965,4,1,3,0.5606946602711557
40212,703-004-5384,4705.519,3,1,2,2.210923979531707
40439,703-004-5394,4811.153,5,3,2,1.7528503968986393
40659,207-008-2399,5288.5757,4,2,2,1.1665188164344664
40816,703-004-5382,8042.2847,5,3,2,1.1009001316528284
40891,703-004-5399,3657.9924,1,1,0,0.37210876615711747
41059,703-004-5383,1705.4271,4,2,2,0.7366285452893268
41166,207-008-2399,7693.1953,3,3,0,1.2321017474050748
41245,703-004-5399,1573.5209,9,5,4,3.2131303400329716
41782,703-004-5394,3493.4998,7,5,2,1.5604470422286412
41840,703-004-5395,5009.0845,2,0,2,0.27920371738274696
42304,703-004-5387,7332.1436,4,2,2,1.2700875154722484
42769,703-004-5384,2087.7112,4,3,1,1.1649502563013987
42797,703-004-5389,1466.8256,4,3,1,1.0106206289526765
43072,703-004-5381,3746.4673,4,3,1,1.6592081774480891
43211,703-004-5385,7203.57,4,3,1,1.4481967424975326
43706,703-004-5390,22.54486,10,4,6,1.5265732306000181
43737,703-004-5399,1307.4165,4,2,2,2.9549563140869766
43743,703-004-5395,9026.307,3,3,0,1.575867763789757
43887,703-004-5392,9854.232,1,1,0,0.4611441168515522
44136,703-004-5382,8434.637,5,4,1,1.3301013714517782
44198,703-004-5382,7578.035,2,2,0,0.7943737161058283
44290,207-008-2399,1137.5868,3,2,1,0.5505792109344673
44400,207-008-2398,4556.16,5,3,2,1.057135830754648
44415,703-004-5392,1780.7108,5,2,3,1.247549508293251
4474,703-004-5381,6894.878,8,6,2,1.3983550810031995
45,703-004-5396,219.7206,4,3,1,1.5370729305678588
45837,703-004-5397,8072.7114,6,5,1,2.1740444008824253
46128,703-004-5385,8726.843,8,4,4,3.9396670765630133
46217,703-004-5386,3224.6685,2,0,2,0.27920371738274696
46520,703-004-5381,3950.7144,1,1,0,0.4230808829965438
46691,703-004-5393,3696.5508,5,2,3,0.8308023572893283
46728,703-004-5385,9996.531,4,2,2,0.8072346834704783
47365,207-008-2399,4162.503,3,2,1,0.798615353385682
47597,703-004-5396,5185.361,6,4,2,2.5474415353062123
47696,703-004-5388,4375.233,4,1,3,0.3838169528275135
48126,703-004-5389,703.03735,5,2,3,1.1049111304412806
48409,703-004-5399,3408.9219,3,3,0,1.1453647164724718
48463,703-004-5381,1806.1823,4,1,3,0.6119782369981819
4854,703-004-5383,9254.193,6,4,2,0.9515876267230655
48591,703-004-5381,4131.9424,6,5,1,3.0461206435874257
48696,703-004-5383,8418.474,5,4,1,1.7514856857960117
4888,703-004-5382,9029.687,2,0,2,0.27920371738274696
48911,703-004-5395,4689.7686,1,0,1,0.27920371738274696
49019,703-004-5391,5690.931,2,1,1,0.8639567097699815
49103,703-004-5390,747.1102,1,1,0,0.5530532187560037
4923,207-008-2398,1202.6351,6,4,2,2.959365762418762
49301,703-004-5386,8412.943,5,1,4,1.7804138436896815
49385,703-004-5394,6263.5527,2,1,1,0.4031391452654219
49484,207-008-2399,8594.609,5,1,4,0.5165268771580819
49939,703-004-5397,6178.348,5,2,3,0.6645448120336133
4997,207-008-2398,8654.224,6,5,1,2.503296691273118
5004,703-004-5385,7970.187,5,2,3,0.577790735180761
5298,207-008-2398,3888.9675,2,1,1,0.6946064595772947
542,207-008-2398,8402.74,4,2,2,0.7719928685512284
553,703-004-5386,7310.7163,5,5,0,1.456170020084035
57,207-008-2399,61.71763,7,3,4,1.1005061843477209
5793,703-004-5390,7680.6416,4,3,1,1.3571112695305978
5881,703-004-5395,4645.5054,6,3,3,0.9634229443941973
6087,703-004-5392,5835.0645,5,4,1,1.9360872906906212
6137,703-004-5394,690.6831,4,2,2,0.5525241282854785
6306,703-004-5388,5589.4507,5,1,4,0.9231361328757277
6534,703-004-5392,2592.938,8,3,5,1.4954056992807876
6706,703-004-5381,5709.6045,4,3,1,1.3030471907096826
6858,703-004-5399,3093.757,1,1,0,0.828010839782602
6868,703-004-5382,555.2846,6,1,5,0.895757124636746
6935,703-004-5387,5796.9893,4,1,3,0.3978652972704144
7025,703-004-5399,8066.4956,7,5,2,2.829843843214146
7126,703-004-5390,8419.094,7,4,3,2.576266381735533
7224,703-004-5392,7102.181,5,2,3,0.8443996584972593
7918,703-004-5381,1253.1144,4,3,1,0.6269434335845089
7954,703-004-5391,8526.477,2,1,1,0.4235479838743847
7967,703-004-5381,4550.1055,5,2,3,1.0971574017363035
8188,703-004-5393,1642.229,7,2,5,0.6619143990135896
8407,703-004-5387,8259.337,7,5,2,3.064813770453281
8523,703-004-5394,1308.7833,5,2,3,0.8720469283318549
861,703-004-5399,2844.4946,3,3,0,0.4863950573269671
8675,703-004-5382,8165.974,7,3,4,2.078759928919659
8862,703-004-5380,2328.3315,8,2,6,0.8191721430102881
9394,703-004-5394,6376.7617,4,2,2,0.48504237544532464
947,703-004-5390,7601.26,4,4,0,1.9379132573962767
9616,703-004-5384,7965.152,4,2,2,0.5892263590012736
9921,703-004-5384,6786.048,2,2,0,1.2313773622547228
1040,703-004-5384,5443.6895,4,4,0,1.8919504808810415
10468,703-004-5389,3078.9148,1,0,1,0.27920371738274696
10472,703-004-5381,2282.9204,2,1,1,0.9785962002664937
10654,703-004-5386,1167.1233,4,3,1,0.8001867954615186
11125,207-008-2398,7940.3506,5,2,3,0.7142006573665504
1114,703-004-5399,6560.806,4,1,3,1.117595849971692
1137,703-004-5389,2821.355,1,0,1,0.27920371738274696
11607,703-004-5390,8224.668,4,1,3,0.39246784346302405
11938,703-004-5399,1087.2191,5,1,4,0.3482416837923913
12379,703-004-5391,1353.4755,7,4,3,2.0304510947113292
12487,207-008-2398,5137.3706,2,1,1,0.6684760736524854
12677,703-004-5382,9666.865,2,1,1,0.44445839544302035
1272,703-004-5380,9287.633,5,4,1,1.030596265822445
12722,703-004-5387,7411.543,2,0,2,0.27920371738274696
13777,207-008-2398,9426.19,2,1,1,0.32666834933781397
13900,207-008-2398,8810.894,6,3,3,1.2340880289120482
13920,703-004-5394,5874.7935,2,1,1,0.3958857175137957
14335,703-004-5386,5153.5166,6,4,2,3.3101514165636656
1448,703-004-5382,6917.4517,1,1,0,0.4180377658513179
14495,703-004-5390,3193.7224,3,2,1,0.616065216159768
14789,703-004-5386,4003.8628,4,0,4,0.27920371738274696
15117,703-004-5386,9201.408,3,2,1,0.8893555753417953
15137,703-004-5385,354.10107,2,1,1,1.151287384709664
15257,703-004-5386,8357.5625,3,3,0,1.743041811510584
15369,703-004-5393,8977.138,3,2,1,0.4698038800773128
15500,703-004-5398,3645.5942,5,3,2,1.2013734966379173
15626,703-004-5384,3665.3137,6,4,2,1.2938704070267295
15652,703-004-5395,4404.379,9,2,7,0.5805765249993236
15762,703-004-5388,8698.325,4,1,3,0.41227420339963117
15809,703-004-5388,4634.859,"","","",0.27920371738274696
15841,703-004-5381,1404.0005,2,1,1,0.5858264758706035
15942,703-004-5392,3109.2769,2,2,0,0.9924416264447977
16295,703-004-5380,2827.9866,5,4,1,1.292536325693289
16298,703-004-5391,4863.3667,3,2,1,0.5332072755294788
16715,703-004-5389,3677.842,3,0,3,0.27920371738274696
16996,703-004-5395,5267.4834,3,1,2,0.7347924679880783
17018,703-004-5387,7936.1997,2,1,1,0.5060391364889675
17264,703-004-5399,1160.134,6,3,3,1.521225514452323
17645,703-004-5393,1779.356,5,3,2,1.0134883391026221
17690,207-008-2399,3771.7646,3,3,0,1.5089195876112342
17996,703-004-5383,1051.4879,2,1,1,0.33853450732658075
18185,703-004-5399,7849.289,3,2,1,1.1515211849512235
18236,703-004-5381,2961.3037,2,1,1,0.6877627092994685
18329,703-004-5381,6533.805,4,2,2,1.076732902964487
1854,703-004-5388,4405.912,3,1,2,0.6079845566285569
18727,703-004-5389,632.8827,2,0,2,0.27920371738274696
18769,703-004-5391,9326.515,3,1,2,1.5021996802764173
1884,703-004-5398,8292.924,4,2,2,0.49501946580344214
18909,703-004-5387,3208.7947,1,1,0,0.470311202005032
19076,703-004-5395,1996.5142,5,2,3,1.1183598285753178
1908,703-004-5385,9553.91,5,2,3,1.0960433088442945
19206,703-004-5394,9633.997,2,0,2,0.27920371738274696
19571,703-004-5380,704.7069,5,4,1,2.0084963298117504
19750,703-004-5392,2445.3909,4,4,0,0.935756629096331
19995,703-004-5399,7161.149,4,0,4,0.27920371738274696
2006,703-004-5388,1609.3254,5,2,3,1.3054550661560367
20240,703-004-5380,5214.915,5,2,3,0.81485568563504
20401,703-004-5382,9766.518,4,1,3,0.3978652972704144
20741,703-004-5380,7273.068,3,1,2,0.42235868019868755
21013,703-004-5395,8083.688,3,1,2,0.6674001317527557
21026,703-004-5387,6488.8184,3,1,2,0.37512182779194486
21118,703-004-5395,8234.112,4,2,2,0.5251863462658715
21570,703-004-5395,8161.457,"","","",0.27920371738274696
21704,703-004-5384,4694.333,2,2,0,0.84573569971583
21916,703-004-5389,3575.4263,7,4,3,3.0056009409270126
22734,703-004-5392,6233.966,2,0,2,0.27920371738274696
22829,703-004-5398,9631.271,7,1,6,0.9519506409147469
23230,703-004-5391,6067.1465,6,1,5,0.758940860028373
23471,703-004-5396,2021.7424,2,0,2,0.27920371738274696
23789,703-004-5385,3212.1868,7,5,2,2.7040151420252614
23883,703-004-5396,6901.9263,4,2,2,0.7529541776657337
24390,703-004-5390,4620.477,2,0,2,0.27920371738274696
24465,703-004-5394,9511.924,6,3,3,1.8930632716747144
24890,207-008-2398,4165.105,5,5,0,2.2124271947964194
25017,703-004-5380,9432.156,"","","",0.27920371738274696
25592,703-004-5396,3887.9316,4,2,2,0.7131793659768603
25749,703-004-5399,8157.6953,3,0,3,0.27920371738274696
25784,703-004-5393,3287.7869,5,3,2,0.9704085285997662
25864,703-004-5387,3542.925,2,2,0,0.4542295477170565
26520,703-004-5385,5812.0815,10,8,2,3.1915553173408333
26711,703-004-5384,129.2193,3,2,1,0.47023613418120913
27230,703-004-5393,9594.502,1,0,1,0.27920371738274696
27686,703-004-5397,8027.247,4,1,3,0.6584724031517248
27934,703-004-5385,4825.1743,3,1,2,2.5259598086397625
28075,703-004-5394,3179.1472,2,0,2,0.27920371738274696
28236,703-004-5398,8658.951,3,1,2,0.7450201753396476
28398,703-004-5382,9462.723,5,2,3,0.6922696212042126
28561,703-004-5387,3632.7856,3,3,0,1.5562605790244475
28951,703-004-5388,6994.6074,7,4,3,1.1499235002864556
29146,703-004-5382,430.76456,2,1,1,0.8298870159664958
29224,703-004-5388,1736.9276,3,3,0,1.13850752209293
29283,703-004-5394,1513.9305,6,4,2,1.59096467506632
2933,703-004-5384,9910.645,8,2,6,0.8814479587439342
29441,703-004-5385,9689.102,3,0,3,0.27920371738274696
2971,703-004-5382,2601.753,3,1,2,0.4283363404034911
29789,703-004-5380,5006.849,"","","",0.27920371738274696
3000,703-004-5394,5060.5117,2,0,2,0.27920371738274696
30086,703-004-5389,8017.221,3,1,2,0.8348855830673545
30123,703-004-5396,7904.058,2,0,2,0.27920371738274696
30172,207-008-2398,9326.029,2,1,1,0.43227753826269694
30352,703-004-5386,1253.419,3,1,2,0.5484518918221057
30370,703-004-5388,1609.3832,2,2,0,0.9700757611509966
30433,703-004-5399,5376.522,6,1,5,0.7408475437677631
30508,207-008-2398,4210.4194,2,0,2,0.27920371738274696
30656,703-004-5397,1031.6718,4,4,0,2.5387387507766865
31139,703-004-5384,9008.361,4,2,2,1.3709585581459203
31711,703-004-5396,4570.0776,3,0,3,0.27920371738274696
31802,703-004-5394,1950.2229,2,2,0,1.4201725011457653
3186,703-004-5380,3982.5254,3,1,2,0.5052373777764196
32211,703-004-5398,3627.544,3,0,3,0.27920371738274696
32310,703-004-5388,9874.193,3,2,1,1.008817647818242
32805,703-004-5396,3770.8384,6,3,3,2.0183641439344786
32843,703-004-5389,6098.973,5,2,3,0.5539399802375599
32905,703-004-5394,4743.962,3,2,1,0.7819436630938571
32972,703-004-5394,5854.9023,6,4,2,0.738036535098378
33022,703-004-5399,7330.943,4,2,2,1.6137163442903728
33116,703-004-5388,7423.423,6,5,1,3.5435184864781584
33225,703-004-5391,5139.072,3,3,0,0.7403046575947485
33636,703-004-5385,3755.4014,1,1,0,0.5076802243047329
33876,703-004-5380,3663.5183,4,2,2,0.6463542351216568
33912,703-004-5390,2001.704,3,2,1,0.938417543332295
33931,703-004-5396,7410.039,2,2,0,1.7148496151131372
34025,703-004-5386,2961.3389,1,0,1,0.27920371738274696
34040,703-004-5384,9000.465,4,4,0,1.0688230544213628
34215,703-004-5385,6404.071,6,5,1,1.003372462709176
34479,703-004-5391,4669.149,1,0,1,0.27920371738274696
34740,207-008-2398,5616.515,6,1,5,0.6764383619336259
34815,703-004-5382,1840.2594,5,2,3,0.703988339452793
34985,703-004-5399,6825.5913,4,1,3,0.44084903395721237
35009,703-004-5392,1353.1368,5,4,1,1.4421574856028292
35282,703-004-5383,6144.993,3,1,2,0.5064599695192948
35525,703-004-5395,2966.0522,4,3,1,1.8488706946607767
3566,703-004-5393,4392.948,3,0,3,0.27920371738274696
35729,703-004-5381,5580.762,6,2,4,0.9668233711873245
3576,207-008-2399,6002.632,3,1,2,0.3995540786135181
35972,703-004-5384,7158.786,3,1,2,0.58240051347441
36050,207-008-2399,8513.894,4,1,3,1.0726538271523722
36749,703-004-5385,1904.6616,5,2,3,0.5728590185168398
36757,703-004-5390,5685.0625,6,2,4,1.8263174862168015
37065,703-004-5383,8935.02,5,3,2,0.7480574829740642
37194,703-004-5389,5765.0493,6,2,4,0.9114447403844683
37203,703-004-5385,8489.474,5,2,3,0.6523235906609108
37281,703-004-5386,8478.044,3,1,2,0.6906428757287673
375,703-004-5392,6374.6895,1,0,1,0.27920371738274696
38399,703-004-5396,7696.2236,4,2,2,0.45719608721424815
38514,703-004-5393,1204.6289,4,2,2,0.6659252779526896
38634,703-004-5391,7334.2183,4,1,3,0.5165268771580819
38686,703-004-5389,9967.798,5,3,2,0.8111973414543554
38701,703-004-5393,5034.526,3,2,1,1.5628115567726562
38737,703-004-5396,2777.9346,4,4,0,1.2095307130976927
3882,703-004-5386,4781.896,1,0,1,0.27920371738274696
38917,207-008-2399,8467.783,1,0,1,0.27920371738274696
38977,703-004-5389,3886.9797,4,1,3,0.5815603161711006
39021,703-004-5388,4647.64,5,2,3,1.047045431384833
39024,703-004-5393,5208.5366,5,5,0,1.4584496718477982
39144,703-004-5391,2818.668,5,4,1,1.460466141329973
39177,207-008-2399,8311.363,6,3,3,1.3428489873166611
39207,703-004-5390,4158.681,3,2,1,0.9495952845804759
39322,703-004-5394,1794.9509,4,2,2,0.8856186961859324
39337,703-004-5385,8452.604,2,2,0,0.7102137753455559
39375,703-004-5381,3453.5854,3,2,1,0.9893585330472394
39465,703-004-5393,734.8394,5,2,3,1.1107288154308321
39794,703-004-5388,2928.183,1,0,1,0.27920371738274696
39833,703-004-5398,7056.378,3,2,1,0.43657157451948686
39848,207-008-2399,2691.2373,6,1,5,0.9064838708951801
39980,703-004-5387,7886.013,3,1,2,0.35831143730785864
40049,703-004-5381,452.09467,3,1,2,0.6016425873813482
40238,703-004-5399,5464.7954,3,1,2,0.3439270169014758
4035,703-004-5397,10.714531,3,0,3,0.27920371738274696
40616,207-008-2398,5451.2935,4,4,0,1.3986003210477076
40618,703-004-5388,29.476284,2,2,0,0.6968063076781322
40746,703-004-5383,7746.3525,4,1,3,0.37446671698631506
40776,703-004-5393,9591.371,3,2,1,0.43741915723297026
40931,703-004-5391,7273.9883,6,4,2,1.201932815529887
41228,703-004-5397,4554.8184,3,2,1,0.9009835150625594
41731,703-004-5393,9691.773,7,4,3,1.100912889636007
41747,703-004-5383,3943.5208,3,1,2,1.230986468135147
41809,703-004-5385,8561.406,1,0,1,0.27920371738274696
42003,703-004-5382,8274.229,6,2,4,0.6063576779288414
42396,703-004-5397,4515.8296,9,2,7,1.2567157989295563
42727,703-004-5391,6043.3853,1,1,0,0.3367545836282657
42932,703-004-5398,7774.226,5,3,2,0.6846205899271768
42980,703-004-5399,5092.7734,3,1,2,0.8725000124111025
4312,703-004-5385,2170.1223,6,2,4,0.8124415511425067
43289,703-004-5380,1211.4686,4,3,1,1.3250187489665652
43308,703-004-5395,5693.797,3,1,2,1.130707323051536
43411,703-004-5389,7069.924,4,3,1,1.2456455474512529
4352,207-008-2399,3744.3054,3,1,2,0.9421374607780628
43569,703-004-5385,5962.9077,7,3,4,0.6723769515031733
43775,703-004-5398,2529.006,4,3,1,1.4772731111501518
44044,703-004-5387,4188.2456,1,0,1,0.27920371738274696
44249,703-004-5382,7109.7227,2,1,1,0.5165268771580819
44348,703-004-5385,6879.135,4,3,1,0.6385690144756994
44480,703-004-5382,7355.875,2,1,1,1.1255132789289342
44601,703-004-5392,2859.9668,5,4,1,1.046407463564748
44725,703-004-5385,3078.313,6,5,1,2.2544003272549764
44863,703-004-5393,7949.939,4,2,2,0.692384839119734
44888,703-004-5386,5700.228,5,5,0,3.6488652115279363
45276,703-004-5387,4512.725,3,0,3,0.27920371738274696
45304,703-004-5384,8374.885,8,2,6,1.4001346428762098
45379,703-004-5381,8552.871,4,1,3,0.6945426408762042
45692,703-004-5397,5283.597,2,2,0,2.424073115832207
45770,703-004-5382,8214.443,4,3,1,0.7673515448089406
46139,703-004-5388,756.29236,7,5,2,2.678251409799237
46236,703-004-5398,5212.386,2,2,0,1.376739244111934
4696,207-008-2398,612.59625,5,2,3,3.1772947426088316
47524,703-004-5396,1910.4385,6,2,4,2.1183299239981177
47588,207-008-2399,8788.899,3,3,0,1.1104843678101852
47681,703-004-5393,8037.642,4,2,2,0.571475455650375
47775,703-004-5394,8516.692,2,2,0,2.5659154686492536
48134,703-004-5395,1782.1354,6,2,4,0.7587473596277936
48165,703-004-5385,3718.7017,4,2,2,0.5652789138811464
48220,703-004-5389,5859.4834,2,0,2,0.27920371738274696
48582,703-004-5385,4021.238,3,1,2,0.7583655040628589
4865,703-004-5384,9957.264,"","","",0.27920371738274696
48657,703-004-5389,7853.285,3,3,0,1.2663666971706737
48750,703-004-5389,1526.4506,5,2,3,0.5579183435313981
49049,207-008-2399,9301.027,5,3,2,2.175933733319448
49077,703-004-5398,8010.9507,4,1,3,0.545110707220974
49336,703-004-5397,7066.3604,7,4,3,1.36318318278406
49537,703-004-5390,353.716,4,3,1,0.5947638464218431
49689,703-004-5394,3012.2446,5,4,1,2.129005550263022
49723,703-004-5392,5486.281,1,1,0,0.6241395987143066
49781,703-004-5386,957.3394,5,1,4,0.6878368286990837
49998,703-004-5387,2557.505,3,1,2,0.44544668978660146
5441,703-004-5388,6854.7666,6,4,2,2.4379349629538027
558,703-004-5383,6465.4937,3,3,0,1.2998407356462744
5956,703-004-5399,5502.155,7,7,0,2.8189285792015877
6064,703-004-5380,243.49213,4,1,3,0.4513787782691013
7031,703-004-5387,8638.784,3,0,3,0.27920371738274696
7052,703-004-5393,5199.147,4,3,1,0.6877359096848348
7119,703-004-5391,4089.0479,7,4,3,1.6660291407699932
7153,703-004-5396,1044.4337,5,4,1,2.6523980327827337
7567,703-004-5389,5886.7646,3,2,1,2.4937702863250335
7798,703-004-5395,8701.226,3,1,2,0.33853450732658075
7834,703-004-5398,9958.417,2,1,1,0.7836845267258544
7898,703-004-5391,2588.5076,2,1,1,0.38167194700174406
8099,703-004-5399,9589.006,4,4,0,2.6971816910209196
8505,703-004-5397,2906.7815,6,2,4,0.6069926366632251
8719,703-004-5391,6805.76,2,1,1,0.6706849731782842
8789,703-004-5381,9215.246,4,2,2,0.8758268006752681
9341,703-004-5396,2323.2085,4,1,3,0.5860727820385784
9851,703-004-5391,7333.68,6,2,4,0.9286631194632564
9859,703-004-5381,2309.2007,3,3,0,0.958479589911106
1008,207-008-2399,1674.7249,5,1,4,0.4300920614290924
10228,703-004-5383,6248.906,6,2,4,0.6836392914268009
10346,703-004-5391,3691.9207,2,2,0,0.7343834782423234
10407,703-004-5396,2963.6501,2,0,2,0.27920371738274696
10484,703-004-5395,4678.524,1,1,0,0.35831143730785864
10512,703-004-5395,8858.017,3,3,0,1.2502116588639391
10557,703-004-5385,5911.931,4,3,1,1.2043950540686035
10563,703-004-5397,1250.2545,4,1,3,0.5652647812846929
10676,703-004-5381,3400.9749,3,2,1,1.7985912219149116
11150,703-004-5380,9258.42,6,5,1,3.2347018670259744
11405,703-004-5390,5517.426,1,0,1,0.27920371738274696
11534,703-004-5397,4598.8784,5,3,2,1.9303540896429132
11863,703-004-5391,7702.08,6,2,4,1.781963198544903
11945,703-004-5396,8275.644,5,1,4,0.8001962401201277
12081,703-004-5387,6814.1934,5,2,3,1.3051157023359257
12215,207-008-2399,6074.295,1,1,0,0.4996423624375425
12498,703-004-5394,5903.5166,4,2,2,1.1167084234612743
12680,703-004-5393,7337.8916,5,3,2,1.4959086544091518
12880,703-004-5382,3839.7903,4,2,2,0.6883365816778142
12881,703-004-5380,2804.0378,1,1,0,0.5741481760911991
12937,703-004-5389,9724.396,3,2,1,1.812344048444419
1305,703-004-5380,8617.503,2,0,2,0.27920371738274696
13065,703-004-5392,9092.279,6,4,2,2.578597401457489
13116,703-004-5392,3628.612,4,1,3,0.48262538738998767
13328,703-004-5398,3332.609,6,0,6,0.27920371738274696
13520,703-004-5387,3424.2803,2,1,1,0.4051493877941439
13636,703-004-5390,8926.874,4,2,2,0.9308951204857722
13889,207-008-2398,4043.917,3,2,1,0.49780828085784573
14232,703-004-5391,1149.1644,4,2,2,1.6419859070403107
14331,207-008-2399,6589.8843,3,3,0,1.8778641363940716
1435,703-004-5392,5682.6914,5,1,4,0.5134309631673386
14613,703-004-5399,2547.3643,5,2,3,0.672740888807036
14659,207-008-2399,4118.628,4,1,3,0.41593152280831186
14672,703-004-5384,4788.6997,3,1,2,0.3978652972704144
14868,703-004-5389,2159.6646,9,6,3,2.6381173081517493
1487,207-008-2399,6833.528,8,4,4,1.9548793353472969
14958,703-004-5381,9032.334,9,5,4,2.8700577652524912
15,703-004-5390,5652.423,3,2,1,0.7967075137944387
15100,703-004-5385,1288.9016,4,2,2,1.1337121546681244
15412,703-004-5397,9909.7705,7,4,3,1.3697871135479849
15868,703-004-5389,1539.1016,5,1,4,0.4016725758638022
16085,703-004-5386,8188.95,3,1,2,0.44780851026456914
16194,703-004-5380,781.1922,3,1,2,0.49828471019123993
16251,703-004-5389,3968.0505,2,1,1,0.9765208277729135
16255,703-004-5398,8251.607,4,0,4,0.27920371738274696
16510,703-004-5385,688.3496,7,4,3,1.841410973503927
16597,703-004-5398,1150.8495,4,3,1,1.5310448368128633
16668,703-004-5396,7983.6167,4,2,2,0.4150650020598379
1686,703-004-5386,5529.4507,5,2,3,0.8121005424806197
16980,703-004-5392,5710.1245,5,3,2,0.8961134904866279
17294,703-004-5380,5759.4453,3,1,2,0.4120237354417248
17303,703-004-5396,5813.1133,7,3,4,1.263825655229463
1765,703-004-5389,8428.17,4,2,2,0.6294622222597398
17898,703-004-5382,4465.389,6,3,3,0.8163329597307319
18312,703-004-5382,7736.9585,2,2,0,1.2416031462270185
18504,703-004-5385,666.2864,2,1,1,0.5631603818658694
18577,703-004-5397,62.7923,6,4,2,2.012782625966143
18619,703-004-5391,7693.919,3,1,2,0.6432101074741319
18913,703-004-5398,4857.073,2,0,2,0.27920371738274696
19005,703-004-5391,7676.5894,5,1,4,0.5292359914537104
19085,703-004-5387,42.541027,8,5,3,2.199576998533105
19249,703-004-5391,6643.544,5,3,2,0.8280074051314237
19442,703-004-5399,9003.909,5,2,3,1.4133298889498662
19773,703-004-5384,8102.7056,5,2,3,1.8990878046752975
19866,703-004-5393,8548.144,4,0,4,0.27920371738274696
19896,703-004-5386,2907.3638,2,1,1,0.5734652230199557
20020,703-004-5397,6345.6304,3,1,2,0.4039104118864428
20064,703-004-5394,3963.9705,8,2,6,0.709809596176786
20232,703-004-5393,377.19788,6,2,4,0.5232857734640027
20598,703-004-5386,4914.0386,7,5,2,2.5878275976139244
20776,703-004-5382,4801.928,3,2,1,0.8626050229779625
20914,703-004-5380,2096.2786,2,0,2,0.27920371738274696
21021,207-008-2399,8725.955,1,1,0,0.3704205391732067
21107,703-004-5398,7049.0117,3,2,1,1.035680524187796
21159,703-004-5386,6789.889,1,0,1,0.27920371738274696
21181,703-004-5399,360.03293,10,5,5,3.087726784419453
21221,703-004-5394,4441.955,8,4,4,1.396992077834916
21408,703-004-5385,8239.364,2,0,2,0.27920371738274696
2144,207-008-2398,6317.4766,5,3,2,1.2518149955966922
2199,703-004-5396,9699.791,3,0,3,0.27920371738274696
22014,703-004-5396,8223.709,4,3,1,1.032703138946062
22129,703-004-5390,2197.4604,4,0,4,0.27920371738274696
22168,207-008-2399,1669.9344,4,2,2,1.7096289757683472
22482,703-004-5384,852.6695,3,2,1,0.9058688075511258
22633,703-004-5391,8219.041,5,3,2,0.6342000553449141
22721,703-004-5393,5534.628,7,3,4,2.001423261144664
23111,703-004-5385,5396.7227,3,2,1,0.7993870424492879
23112,703-004-5395,8339.034,4,3,1,1.281422005438781
232,703-004-5392,5624.1333,3,2,1,0.6283839539839206
23371,703-004-5399,7993.675,3,2,1,1.5543452573652106
234,703-004-5385,4648.391,3,1,2,0.35290739119047443
2341,703-004-5389,6621.804,3,2,1,0.4436177827142898
23540,703-004-5391,2174.84,4,2,2,1.2634836995189107
23831,703-004-5381,472.25772,5,2,3,0.8732734864551236
23930,207-008-2398,4036.3384,4,3,1,0.8698640167854916
24035,703-004-5385,8660.118,1,1,0,0.7540810726862033
24526,703-004-5391,1147.0741,1,0,1,0.27920371738274696
24575,703-004-5380,5600.063,3,1,2,0.43398298325914064
25123,703-004-5391,3937.6218,5,2,3,0.5528222908616317
25470,703-004-5380,3033.797,4,1,3,0.9376914585280435
25815,703-004-5387,7886.8623,4,2,2,0.652883800459456
25824,703-004-5380,4884.479,3,2,1,1.3328380637071222
2605,703-004-5380,5799.102,4,3,1,1.2506063473971938
26178,703-004-5380,8947.869,6,2,4,0.6890559337177891
26206,703-004-5380,7366.4004,5,3,2,0.818215519393305
26217,703-004-5380,1107.0442,2,2,0,1.0527520160129664
2628,703-004-5394,1356.8181,4,2,2,0.5523894029245481
26329,703-004-5396,4189.768,3,2,1,0.7892016026231432
26538,703-004-5394,1892.3998,2,1,1,0.32666834933781397
26560,703-004-5390,2831.065,4,0,4,0.27920371738274696
26609,703-004-5398,1142.9662,7,3,4,1.0605995400784907
26673,703-004-5389,5877.1777,2,2,0,0.4130237681753926
26746,703-004-5395,6738.8843,2,0,2,0.27920371738274696
26782,703-004-5386,257.49982,4,4,0,1.4656534206376048
26925,207-008-2398,5219.305,3,2,1,0.6946502498331979
26969,703-004-5382,6408.937,3,2,1,1.4757278670392413
2720,703-004-5382,6792.6484,5,3,2,1.5607148176554224
27202,703-004-5387,2287.665,2,1,1,0.35831143730785864
27245,207-008-2398,8093.2573,4,3,1,0.9421215918037601
2729,703-004-5388,1923.2374,4,3,1,1.4500618160120136
27327,703-004-5391,9957.501,"","","",0.27920371738274696
27697,703-004-5390,3512.77,8,5,3,1.542282382896864
27871,703-004-5390,5530.3516,2,0,2,0.27920371738274696
27900,703-004-5397,6054.691,"","","",0.27920371738274696
27916,703-004-5380,4567.203,6,4,2,2.7755375280746635
27930,207-008-2399,1990.7183,3,1,2,0.7617586470519512
28132,703-004-5383,2120.4932,3,2,1,0.7629008011835575
282,207-008-2399,5813.314,2,0,2,0.27920371738274696
28344,703-004-5395,6350.232,6,3,3,1.6914911618567974
28395,703-004-5393,5104.6094,2,0,2,0.27920371738274696
28401,703-004-5389,8018.9673,2,1,1,0.5669580486103406
28479,703-004-5390,1922.5961,1,0,1,0.27920371738274696
28639,703-004-5389,7215.9653,7,1,6,0.44363584289687685
29134,703-004-5392,9411.738,2,2,0,1.307832967180768
29474,703-004-5393,9867.597,2,1,1,0.4891265419049676
29491,703-004-5393,1233.8329,4,1,3,0.7350350066841354
2953,207-008-2398,8937.825,6,3,3,0.970726068213795
29761,703-004-5385,6625.9897,7,4,3,2.127515783684424
29850,703-004-5394,1807.2576,4,3,1,1.4813873631706123
30469,703-004-5386,9697.899,4,3,1,0.9665571394513105
30513,703-004-5399,3034.962,5,1,4,0.3978652972704144
30589,703-004-5389,7517.7563,5,4,1,2.0882871753064918
30657,207-008-2398,5944.8423,7,4,3,1.9889467551246038
30846,703-004-5388,3903.4807,2,1,1,0.45670166396471623
3089,703-004-5392,6168.856,5,3,2,2.1044036858043906
31027,703-004-5387,2328.1968,1,1,0,0.33853450732658075
31119,703-004-5395,4273.463,1,0,1,0.27920371738274696
31600,703-004-5394,6052.8105,3,0,3,0.27920371738274696
32283,703-004-5380,1865.8865,5,4,1,1.2662220926608856
32284,703-004-5392,4255.2114,4,3,1,1.7394625592239383
32345,703-004-5395,1213.566,3,1,2,0.6048409341500028
32429,703-004-5386,9534.766,8,2,6,0.7788873410460334
3280,703-004-5398,3491.11,7,7,0,3.551287154335433
32874,703-004-5384,6575.0537,11,7,4,2.7824194232102055
32912,703-004-5396,2327.9165,8,1,7,0.4864445866025783
33220,703-004-5380,5747.9346,5,3,2,1.4782125699603903
33470,703-004-5388,639.90594,9,5,4,2.5664454164645436
34021,207-008-2398,1961.7295,8,6,2,2.6462205907413296
34219,703-004-5392,989.2458,3,1,2,0.5319677876025671
34493,703-004-5380,4476.046,4,3,1,1.461193183400615
3454,703-004-5397,5182.1055,4,1,3,0.3978652972704144
34588,703-004-5396,340.96478,"","","",0.27920371738274696
34933,703-004-5391,9989.407,6,4,2,1.626922243922141
35043,703-004-5391,8449.022,4,2,2,1.5628533611981266
35094,703-004-5386,3920.6594,5,3,2,1.2829078352571606
35157,703-004-5391,1028.5228,4,1,3,0.9160338596388368
35447,703-004-5395,5136.579,1,1,0,0.4523558885122994
35484,703-004-5383,5629.346,1,1,0,0.4524718620287372
35511,703-004-5387,669.449,4,1,3,1.4565390312269266
35792,703-004-5391,7856.0757,4,1,3,0.5538838735468854
36156,703-004-5398,1235.5101,5,2,3,1.0129294685822645
36465,703-004-5383,5593.5796,3,2,1,1.3008692037624823
36499,703-004-5391,2135.769,1,1,0,0.4943726734876659
36579,207-008-2399,9602.225,3,1,2,0.44596241697893985
3661,703-004-5396,6688.07,6,1,5,0.49203809360876455
36613,703-004-5381,607.1597,3,1,2,0.37901540630401587
36685,703-004-5395,960.0091,7,2,5,0.9513285136171347
36816,703-004-5394,7410.346,1,1,0,0.7709805258781475
36998,703-004-5388,2443.2783,4,2,2,1.2600318890789632
37268,703-004-5394,9178.775,4,1,3,0.8389189561135877
37282,703-004-5387,8826.791,9,6,3,1.5856462097918966
37353,703-004-5397,8131.3364,4,1,3,0.42298065928366996
37371,207-008-2399,6320.9214,2,1,1,0.3978652972704144
37455,703-004-5395,3100.6707,3,2,1,0.7334536470087485
37811,703-004-5381,1935.3807,"","","",0.27920371738274696
38104,703-004-5395,9386.07,2,1,1,0.3978652972704144
38162,703-004-5386,8815.352,7,5,2,1.0193423428304342
3819,703-004-5393,7248.1494,3,2,1,0.7510724692386367
38249,703-004-5387,9112.518,3,2,1,0.7657161949221835
383,703-004-5381,4844.635,6,3,3,2.73312181764087
39041,703-004-5391,113.43539,5,3,2,1.383544324799434
39368,703-004-5382,102.4133,6,4,2,2.5380159200607584
3953,703-004-5390,1869.9163,6,2,4,1.7210920761565134
39961,703-004-5389,4598.1484,3,2,1,0.7569936186135567
40052,703-004-5385,8057.538,5,1,4,0.4711578495977431
40173,703-004-5399,5894.5674,3,1,2,1.136483252220285
40396,703-004-5399,5723.367,5,1,4,0.9950812216136438
40495,703-004-5381,2739.0044,4,1,3,0.34448232013380015
40585,703-004-5380,6331.834,4,2,2,0.6140945864998999
40640,703-004-5389,9493.6045,3,3,0,0.9137067960775328
40762,703-004-5390,2493.04,3,2,1,0.6649091410503015
40813,703-004-5387,8835.39,5,3,2,1.3427009589461119
41032,703-004-5382,2768.1494,2,1,1,0.40400271474279525
41206,703-004-5390,2343.6147,4,2,2,0.9006555460023986
41219,703-004-5387,9247.834,7,4,3,1.8399578995742154
41223,703-004-5392,1721.8042,11,5,6,1.1347455063657834
41229,703-004-5396,1502.2367,2,0,2,0.27920371738274696
41438,703-004-5394,5995.4814,1,0,1,0.27920371738274696
41881,703-004-5385,3005.29,4,1,3,0.45350827837184643
41897,207-008-2399,5961.762,5,1,4,0.45670166396471623
42120,703-004-5387,4794.986,6,4,2,1.0897350917487727
43190,703-004-5397,2670.3906,4,3,1,1.035071709743834
43192,703-004-5388,3226.6218,1,0,1,0.27920371738274696
4415,703-004-5396,2858.7205,2,1,1,1.0138761334835469
44195,703-004-5382,347.09512,4,4,0,3.5903342475730677
44376,703-004-5384,537.39014,7,4,3,1.8796875632020884
44726,703-004-5381,7197.342,3,3,0,1.104298302425199
44738,703-004-5396,7041.051,4,3,1,0.863592601638536
448,703-004-5390,7683.872,1,0,1,0.27920371738274696
44934,703-004-5382,4944.487,2,2,0,1.0242665533159283
45032,703-004-5385,7396.603,3,3,0,2.2871268508790554
45036,207-008-2399,7483.424,3,0,3,0.27920371738274696
45861,703-004-5382,3687.1797,4,2,2,1.0931276798544196
45972,703-004-5393,4017.5933,4,3,1,1.4985613209978395
46087,703-004-5399,1739.403,1,1,0,0.5120114292558199
46352,703-004-5395,5560.4346,3,2,1,0.5100923431168399
46380,703-004-5397,1941.7727,3,1,2,0.3807252912866403
46664,703-004-5390,409.65796,6,4,2,1.1246234970939446
46766,703-004-5387,2737.3374,6,2,4,0.4978376577248056
47105,207-008-2398,7348.648,3,1,2,0.6175762785141071
47130,703-004-5387,3908.772,6,2,4,0.7834707964730844
47158,703-004-5390,3094.9795,3,2,1,0.4624698096725209
47211,207-008-2398,8335.763,6,5,1,1.2618286644558643
47514,703-004-5389,8631.769,3,1,2,0.43216574768794
47577,703-004-5395,9692.177,3,2,1,1.1600825522613065
47761,703-004-5397,7238.589,5,3,2,0.6756150393782299
4789,703-004-5386,6817.476,5,3,2,1.3501537870226754
47937,703-004-5396,1598.0112,7,4,3,1.765513366281733
48062,703-004-5382,8268.297,"","","",0.27920371738274696
48122,703-004-5380,7690.64,10,6,4,3.3121510533324483
48183,703-004-5380,3855.068,3,2,1,1.276909148485782
48196,703-004-5398,3651.1343,4,1,3,0.505745641994228
48513,703-004-5394,367.45547,4,2,2,0.5501476581262543
4856,703-004-5397,112.87272,4,3,1,1.131553394078219
49013,207-008-2398,3678.596,2,2,0,0.8315543855562372
49053,703-004-5382,8794.272,4,3,1,2.1169515577906117
49057,207-008-2399,5954.835,7,2,5,0.8901822133161478
49083,703-004-5397,8978.326,2,1,1,0.5554445159835337
49639,703-004-5384,7139.1255,7,6,1,3.2628973807608
5079,703-004-5385,3065.443,3,1,2,0.49837745211204476
5170,703-004-5399,2699.5056,1,0,1,0.27920371738274696
5306,703-004-5388,9845.029,6,3,3,0.9587419354124619
54,703-004-5390,6194.745,3,2,1,0.6570617416050427
5412,703-004-5395,164.62148,6,2,4,1.146525088484376
5855,703-004-5399,3077.1208,1,1,0,0.44857389510157714
6069,703-004-5386,585.63055,5,2,3,0.9374110044928632
6091,703-004-5387,59.29589,2,1,1,0.333139800315021
6333,703-004-5394,2078.2678,3,3,0,1.4169557658518241
6407,703-004-5396,6568.853,5,1,4,0.4281004591568425
6612,703-004-5381,1965.9943,1,1,0,0.49378258364086314
700,703-004-5398,1908.499,4,2,2,1.2422390184421586
7256,703-004-5387,1970.9879,4,2,2,0.981035618171928
7434,703-004-5381,7828.6895,3,1,2,0.8619619520066546
7953,207-008-2399,9370.043,2,2,0,0.5627283645480768
7980,703-004-5383,6308.3164,5,3,2,0.7657549137065329
8483,703-004-5386,4835.7256,1,1,0,0.6210637576747422
8682,703-004-5399,3595.649,6,3,3,0.8146287102592563
8931,207-008-2398,6086.5034,3,1,2,1.32708254521782
8952,703-004-5396,787.33325,5,2,3,1.425695403754241
9441,703-004-5398,4019.5173,2,2,0,1.0708347857554492
1034,703-004-5397,1211.1133,4,1,3,1.3186257525913863
10419,703-004-5387,5823.7393,2,1,1,0.35831143730785864
10579,703-004-5398,3798.7412,2,1,1,1.4493801845027492
10647,703-004-5382,7671.8564,3,2,1,0.7879924139645113
10742,703-004-5396,9379.978,5,3,2,1.2875617216852646
1132,703-004-5389,8626.672,5,3,2,0.844801329353908
11322,703-004-5388,792.44434,5,2,3,1.5175886175152211
11421,703-004-5392,7261.1367,3,1,2,1.4281082285351445
11532,703-004-5391,8184.892,3,1,2,0.4722092491862857
1169,703-004-5380,5140.359,2,2,0,1.2649871706787759
1174,703-004-5384,5617.882,4,3,1,1.2985737609553434
11927,207-008-2399,6541.184,4,3,1,1.270225313811444
12001,703-004-5397,1887.6964,3,2,1,0.7682621726195171
12250,703-004-5399,9764.495,2,0,2,0.27920371738274696
12268,703-004-5385,2317.4595,5,2,3,0.8002222717008801
12304,703-004-5399,48.85614,7,5,2,1.4983242921980535
12341,703-004-5382,304.4492,4,1,3,0.4072732446654146
1274,703-004-5390,2585.8188,5,1,4,0.7912905643708465
12776,703-004-5396,2246.0461,7,4,3,1.505761517407876
1289,703-004-5385,4699.741,3,2,1,0.7382975778805552
13016,703-004-5390,8365.108,6,1,5,0.3737466080357567
13080,703-004-5382,3337.0881,4,2,2,0.632687739723397
1313,703-004-5390,7192.0615,2,2,0,1.0697643143571205
13722,703-004-5383,6368.989,2,0,2,0.27920371738274696
13776,703-004-5383,8817.148,5,2,3,0.7967052726398611
1406,703-004-5392,5690.878,3,1,2,0.49052907264925555
14178,703-004-5398,7020.755,6,2,4,0.44302262072766563
14791,703-004-5391,3017.404,2,2,0,1.3109802255393719
14813,703-004-5383,8783.339,3,2,1,0.563668916297062
14818,703-004-5380,5023.824,4,2,2,0.8349847943009706
14932,703-004-5390,8911.927,2,2,0,0.9177741535625917
15081,703-004-5388,2039.0355,5,2,3,0.6155250797785751
15255,207-008-2398,7993.6714,5,2,3,4.85978349187102
15301,703-004-5380,7236.718,2,1,1,0.3912141415094136
1534,703-004-5387,3615.2798,7,3,4,1.1049360798965377
15354,703-004-5390,8393.105,2,1,1,0.4359244601778353
15377,703-004-5393,8227.044,6,4,2,0.6366099238881537
15451,703-004-5392,9262.256,3,1,2,0.7946399177506341
15708,703-004-5392,5216.361,"","","",0.27920371738274696
15993,703-004-5399,6776.3716,3,3,0,1.5622076634927675
16538,703-004-5394,6567.9556,3,2,1,0.9596453717653521
16598,703-004-5384,5515.784,3,3,0,1.4990582367428114
16647,703-004-5399,2890.3716,2,0,2,0.27920371738274696
16834,703-004-5387,2880.256,1,1,0,0.6486996497298441
1715,703-004-5393,4578.122,7,4,3,2.7507741975883078
17362,703-004-5386,3375.8264,2,1,1,0.4180377658513179
17445,703-004-5380,1984.3542,2,2,0,0.8298183952685892
17559,207-008-2398,2089.6672,6,4,2,5.564580213048649
17607,703-004-5385,9547.816,2,1,1,0.8477958781319915
17653,703-004-5384,9862.136,5,3,2,0.9811839475450291
18083,703-004-5397,3622.5205,"","","",0.27920371738274696
1813,703-004-5387,400.1075,4,2,2,0.7342420823519085
18153,703-004-5391,8948.266,3,1,2,0.9017129460095064
18475,703-004-5383,9757.539,"","","",0.27920371738274696
18636,703-004-5394,5274.443,3,1,2,0.5619902275787334
18910,703-004-5391,781.4884,3,1,2,0.5295399224412343
19079,703-004-5399,9295.586,6,3,3,2.0553353822553224
19149,703-004-5399,4302.713,4,3,1,1.0193122367013239
19294,703-004-5380,5627.5767,7,6,1,1.5057492001109074
19297,703-004-5390,4846.4604,2,0,2,0.27920371738274696
19345,703-004-5388,8417.486,7,2,5,0.9745764235159631
19432,703-004-5391,8773.235,5,5,0,2.7047942781991794
19447,703-004-5397,6537.702,6,5,1,2.5169679100864677
19573,703-004-5386,2005.893,2,1,1,0.5738925498572038
19660,703-004-5389,8092.603,2,2,0,1.370057305635014
20235,703-004-5389,9812.355,3,1,2,0.7894481519529695
20376,703-004-5390,1496.1123,8,4,4,1.4896622044160017
20940,207-008-2399,9607.867,3,1,2,0.5302222739845047
21094,703-004-5388,7156.8926,3,0,3,0.27920371738274696
21275,703-004-5387,6664.526,3,3,0,1.686968997498476
21342,703-004-5390,6819.544,4,2,2,0.7446680422496562
21508,703-004-5393,532.3422,2,2,0,0.9624324714365046
21917,703-004-5392,6367.5396,8,3,5,2.3729649733570644
22177,703-004-5385,2874.2832,2,1,1,0.8862497932235491
22359,703-004-5389,6973.0596,5,3,2,1.075633539027296
22395,703-004-5383,1652.1084,6,2,4,1.1452487609424957
22467,703-004-5391,3046.0078,3,2,1,1.1997176012334994
22479,703-004-5393,7270.9854,4,1,3,0.36906813012564443
22552,703-004-5390,5636.118,4,1,3,0.8544794580865731
22567,703-004-5391,4223.2783,5,4,1,1.5835249555644302
22774,703-004-5392,314.3567,3,1,2,0.7532687438529045
22803,703-004-5397,6624.85,5,0,5,0.27920371738274696
23036,703-004-5396,1946.8815,5,4,1,1.233299998084709
23167,207-008-2398,367.0728,7,3,4,1.7286891433213116
23330,703-004-5399,6998.1714,"","","",0.27920371738274696
2358,703-004-5388,296.49078,7,3,4,2.667089115027316
236,703-004-5382,6695.705,3,0,3,0.27920371738274696
23684,703-004-5383,9608.368,2,1,1,0.35534489781066697
23727,703-004-5394,5577.1826,4,1,3,0.33057782460375584
23811,703-004-5398,367.78152,4,3,1,0.911825792834824
23891,703-004-5393,8795.629,3,3,0,0.7155100614214888
24036,703-004-5399,4491.6655,5,4,1,2.0799616422328646
24119,207-008-2398,6014.466,4,2,2,0.5515029381763213
24205,703-004-5387,3666.4414,3,3,0,0.7453547953255052
24276,703-004-5380,2315.287,2,1,1,0.3316724905947
24563,703-004-5395,4156.9526,5,3,2,1.460256151871153
24615,703-004-5392,8437.729,7,4,3,1.3765644888125328
24759,207-008-2399,7976.4087,4,2,2,1.2350988199540864
25212,703-004-5398,4910.4,3,2,1,0.5736352447650006
2528,207-008-2398,1386.5304,3,1,2,0.4123311149211887
2529,703-004-5391,2228.5027,3,1,2,0.48401741995188474
25469,703-004-5394,5482.01,4,1,3,1.0769819052579495
25890,703-004-5392,5832.385,4,4,0,0.9472627562236502
25986,703-004-5395,2471.1423,3,0,3,0.27920371738274696
26391,703-004-5386,8613.391,4,2,2,0.6948895166841773
26432,703-004-5382,2139.181,5,2,3,1.9898719286435194
26449,703-004-5399,8840.207,5,2,3,0.8824259863084164
26679,703-004-5391,9264.811,2,1,1,0.7751312363101556
27097,703-004-5392,8281.445,3,3,0,1.9883158000105088
27237,703-004-5385,3768.89,4,3,1,1.5548001720646698
27618,703-004-5395,1820.2424,7,1,6,0.9776021272690114
27757,703-004-5391,507.98953,6,4,2,1.2384266190763074
27772,703-004-5389,5530.5083,4,3,1,1.7838170506086926
27991,703-004-5387,4327.0063,6,3,3,0.9951249063729838
28488,703-004-5383,5757.5903,3,1,2,0.43208815300476083
28796,703-004-5381,8544.843,6,3,3,1.1850691832676747
28995,207-008-2399,6932.532,8,3,5,1.5645490671112459
29000,703-004-5382,8704.254,3,3,0,0.812174043817899
29317,703-004-5399,2775.0098,5,2,3,0.7515294652744202
29352,703-004-5386,4422.2856,3,2,1,0.9170015870038568
29464,703-004-5397,6202.165,6,4,2,1.4361124495328788
29704,703-004-5391,1834.7573,1,0,1,0.27920371738274696
29769,703-004-5387,997.1714,3,1,2,0.9619123202123946
29830,703-004-5388,997.94806,3,2,1,0.7521487046555105
30032,703-004-5380,4650.21,5,4,1,2.243413191074948
30119,703-004-5384,6343.4575,2,0,2,0.27920371738274696
30143,703-004-5393,2086.0208,5,2,3,0.8749982973780175
30169,703-004-5382,2457.8381,4,3,1,1.1017293015701641
30427,703-004-5386,2825.0444,1,1,0,0.9825748625779674
30678,703-004-5391,3962.3416,3,1,2,0.5687737352783844
30708,703-004-5386,9254.22,5,3,2,0.9780825272768598
31237,703-004-5383,9985.338,1,0,1,0.27920371738274696
31597,703-004-5389,1426.6908,3,1,2,0.40560529941032664
31643,703-004-5381,5548.878,1,0,1,0.27920371738274696
31732,703-004-5388,7984.424,3,3,0,1.0783577020636506
32104,703-004-5393,7990.992,4,3,1,2.281285734531673
3235,703-004-5392,6107.4595,5,2,3,0.5890002652923999
32409,703-004-5381,2365.2595,1,0,1,0.27920371738274696
32629,703-004-5396,9623.966,6,4,2,1.1749179850188336
3289,703-004-5383,5002.9355,4,1,3,0.4230108397028601
32936,703-004-5381,3243.4905,4,3,1,1.3767298623563757
32978,703-004-5389,3928.011,4,2,2,0.589778171858588
33169,703-004-5399,5218.346,6,1,5,0.44829646872267315
33176,703-004-5392,8546.755,3,0,3,0.27920371738274696
33357,703-004-5387,1153.8488,2,2,0,1.1276927222135882
33721,703-004-5388,6010.345,8,6,2,6.307504186919446
3374,703-004-5386,6330.27,3,1,2,0.38415988479338886
33870,703-004-5390,6542.666,2,2,0,2.9482352931581555
34147,703-004-5384,7155.06,5,4,1,1.3343503580678477
34436,703-004-5399,8025.9507,3,2,1,0.9368368406303972
34667,703-004-5386,8783.137,6,1,5,0.5428037021223601
34682,703-004-5384,4742.998,2,1,1,0.5165268771580819
3502,703-004-5398,7897.838,4,3,1,0.6357580352000604
3505,703-004-5383,468.2976,7,5,2,3.8530052744153402
35241,703-004-5388,9734.658,7,3,4,0.9341514324241184
35281,703-004-5381,2969.1655,4,2,2,1.7468047073327024
35329,703-004-5389,9703.623,5,3,2,1.3447647219329524
35357,703-004-5386,1093.6749,1,0,1,0.27920371738274696
35532,703-004-5390,8209.5625,5,2,3,0.927639118903131
35840,703-004-5395,6453.782,1,0,1,0.27920371738274696
36353,703-004-5391,1809.802,2,0,2,0.27920371738274696
36382,703-004-5383,8564.576,4,4,0,2.3281805658120907
36469,703-004-5386,8846.033,4,1,3,0.7480870780424652
36587,703-004-5383,6224.5938,4,4,0,1.0298409640364818
36747,703-004-5381,7188.2207,1,1,0,0.4678256290218321
36762,703-004-5384,6658.163,5,2,3,1.0095176752954966
36778,703-004-5391,584.0468,8,6,2,1.8588291777470622
36911,703-004-5384,3630.0415,4,2,2,1.0133706681732721
37577,703-004-5384,9848.982,4,2,2,2.0415948434268882
37655,703-004-5395,6634.2876,1,1,0,0.5839394064294748
38222,703-004-5384,6657.869,4,3,1,0.7571693396617246
38251,703-004-5381,7566.5396,"","","",0.27920371738274696
38253,703-004-5392,407.33575,3,1,2,0.509883113175661
38293,703-004-5384,8710.862,7,4,3,2.089117673517763
38353,703-004-5395,7938.8315,5,3,2,1.1731044890447377
38625,703-004-5386,4813.905,6,3,3,1.8313009046395916
38815,703-004-5396,7192.116,2,1,1,0.5585606409400601
38927,703-004-5389,3341.6409,4,1,3,0.4014581062170133
39760,703-004-5387,9623.715,6,3,3,1.375109261316319
39950,703-004-5384,7888.0186,3,2,1,1.2994145301001123
39966,703-004-5393,5865.5713,2,1,1,0.4264046290460751
39998,207-008-2399,9794.334,5,2,3,0.5143332310717419
40247,703-004-5395,8820.294,4,3,1,0.6512985195773124
40462,703-004-5399,9970.753,1,0,1,0.27920371738274696
40498,207-008-2398,7633.955,5,1,4,0.44829646872267315
4064,207-008-2399,6991.3853,2,0,2,0.27920371738274696
407,703-004-5387,4920.625,6,4,2,2.0154339473426015
40986,703-004-5391,8552.958,4,2,2,1.0035416962862898
41452,703-004-5388,2847.7888,6,5,1,2.231275611309633
41531,703-004-5389,8535.405,7,3,4,1.4396244365810171
41942,703-004-5387,4575.6714,4,2,2,0.6774347507584836
42230,703-004-5386,8445.109,4,1,3,0.9440757134214803
42290,703-004-5383,4854.871,7,4,3,2.002800856915098
42305,703-004-5382,6774.1455,3,1,2,0.5165268771580819
42531,703-004-5391,8158.0596,7,4,3,1.0710075907265264
42549,207-008-2399,9731.063,2,1,1,0.3187575773453028
42568,703-004-5380,4850.821,2,1,1,0.6922685610384539
42601,703-004-5394,4073.648,6,1,5,0.5389852457910116
42904,703-004-5392,9358.01,3,0,3,0.27920371738274696
4294,207-008-2398,578.6693,5,5,0,0.7405045375146666
43026,703-004-5386,8710.432,5,4,1,1.4116905207302481
43300,703-004-5387,7084.621,3,2,1,0.5675886402787342
43421,703-004-5384,5838.949,5,1,4,0.8211719293913574
43522,703-004-5382,4945.929,4,2,2,0.5200689639021111
4359,703-004-5395,1497.2013,7,2,5,1.1842835176837982
43613,703-004-5392,9983.449,3,2,1,1.8933220330676215
43620,703-004-5397,3906.458,3,0,3,0.27920371738274696
44204,703-004-5391,7749.6523,7,2,5,1.1587860341826004
44370,703-004-5392,4102.508,3,2,1,0.5408496684018533
44451,703-004-5391,8989.902,1,1,0,0.3754490741802288
44501,703-004-5395,1915.2683,4,1,3,0.8116401906254114
44569,207-008-2398,4281.7534,6,4,2,2.1151469379703327
44704,703-004-5395,9421.164,3,1,2,0.5585073203241744
44721,207-008-2398,4828.5454,1,1,0,0.4593090383445672
45147,703-004-5382,347.8253,3,0,3,0.27920371738274696
45178,703-004-5398,8792.2,3,0,3,0.27920371738274696
4528,703-004-5386,364.89307,2,0,2,0.27920371738274696
4545,703-004-5398,5410.835,7,3,4,0.8045293342217705
45836,703-004-5385,9473.881,4,0,4,0.27920371738274696
4618,703-004-5382,3025.686,8,7,1,1.6230309617764158
46216,207-008-2399,6623.9204,3,1,2,0.5776026736734613
46485,703-004-5386,5273.075,2,1,1,0.3978652972704144
4654,703-004-5387,5843.669,7,3,4,1.6972334377144582
46564,207-008-2399,4183.711,5,3,2,1.0366011534947681
46718,703-004-5383,4323.5146,6,3,3,0.8954967550857215
47122,703-004-5397,5945.478,2,2,0,0.4476767915832598
47133,703-004-5387,9609.348,3,1,2,0.3665114117183168
4742,703-004-5394,8545.296,1,0,1,0.27920371738274696
4750,703-004-5384,6134.223,5,1,4,0.4894514379091435
47543,703-004-5386,5518.7295,2,1,1,0.35831143730785864
47829,703-004-5390,2117.8752,2,0,2,0.27920371738274696
47843,703-004-5389,4806.019,5,2,3,1.3059821891323165
4799,703-004-5396,3010.038,5,5,0,2.0454384291842733
48025,703-004-5381,1026.2627,2,1,1,0.5994132269509422
48474,703-004-5397,1899.6608,6,1,5,0.4337975069301488
48701,703-004-5386,904.8456,6,5,1,2.0866553252869164
48739,703-004-5391,8748.705,6,4,2,1.7420724628912927
48907,703-004-5381,8457.49,2,1,1,0.7406750852743785
49475,703-004-5393,7023.7617,5,2,3,0.84623210065897
49478,703-004-5392,5040.2627,7,3,4,0.9509365281956202
49499,703-004-5387,2396.258,"","","",0.27920371738274696
4950,703-004-5398,6718.625,2,0,2,0.27920371738274696
4965,703-004-5382,1277.0409,3,2,1,0.8274612052739723
49846,703-004-5394,975.8228,3,0,3,0.27920371738274696
49871,207-008-2399,3794.1592,4,2,2,1.2743209744486141
547,703-004-5399,5844.3677,4,1,3,0.5406444923888687
5581,703-004-5385,9552.313,6,1,5,0.7781895880952989
5731,207-008-2399,8083.934,4,2,2,0.49927847928033714
6030,703-004-5380,2437.8748,2,1,1,0.5669580486103406
6277,703-004-5389,1364.8999,6,3,3,1.3771667490557546
6414,703-004-5396,9527.024,2,1,1,0.6823075046884539
6442,703-004-5387,5204.606,5,2,3,0.3978652972704144
6470,703-004-5380,590.3363,3,1,2,0.6992873630032321
7042,703-004-5388,3526.835,4,2,2,0.6016500799524989
7604,703-004-5389,9544.718,3,3,0,3.3559542067736934
7705,703-004-5393,8978.342,1,0,1,0.27920371738274696
792,703-004-5383,4675.809,4,1,3,0.3271627725873459
7929,703-004-5386,615.04724,2,2,0,1.9985912116048947
7930,703-004-5394,1912.6057,4,3,1,1.9049333070541163
7974,703-004-5392,892.6374,2,2,0,1.2701904269403406
8063,207-008-2399,4010.1033,4,3,1,1.7816167733885817
8214,703-004-5398,7993.5474,4,3,1,0.6993107788859183
838,207-008-2399,5968.3667,1,0,1,0.27920371738274696
84,703-004-5399,658.499,3,2,1,0.6829129506110306
8468,703-004-5398,8438.111,5,4,1,0.7726799795114251
9373,703-004-5390,9792.378,7,5,2,1.1594453637103157
9613,703-004-5381,3805.1826,5,4,1,1.2301366056977647
9657,703-004-5388,59.93664,2,1,1,0.432561618764311
9669,703-004-5383,8375.916,3,2,1,0.8112989656211437
9733,703-004-5388,6196.4214,2,2,0,1.0983989127401057
9747,703-004-5396,1358.2814,4,2,2,0.8867761996698287
1048,703-004-5385,9245.199,6,5,1,3.7969516909378553
10537,703-004-5399,5669.1147,8,4,4,1.0410632909625144
10595,207-008-2398,1676.994,3,0,3,0.27920371738274696
10707,703-004-5384,7599.8755,2,1,1,0.36514089020291696
10828,703-004-5393,8733.536,4,2,2,0.6787528037289251
10896,703-004-5395,460.7916,2,1,1,0.9534482785544101
11032,703-004-5391,8639.373,5,3,2,2.817828192145377
11082,703-004-5397,7230.765,7,3,4,1.2428817107616579
11088,703-004-5382,6956.304,5,4,1,1.429092772310373
11340,703-004-5393,3357.9968,1,0,1,0.27920371738274696
11496,703-004-5391,7121.236,6,3,3,0.6340936940994524
11803,207-008-2398,9075.569,2,0,2,0.27920371738274696
12091,703-004-5382,943.408,3,3,0,0.6835660135089688
12124,703-004-5387,1015.62024,6,5,1,1.6750952332089433
12309,703-004-5390,4615.757,3,2,1,1.382351887330989
12375,207-008-2398,8349.077,5,4,1,1.0474670071645724
12644,703-004-5382,3960.1624,5,3,2,2.508779567267492
12661,703-004-5399,9492.617,5,2,3,1.5252444018907698
12921,703-004-5385,8366.261,4,0,4,0.27920371738274696
13668,703-004-5390,6437.1924,9,7,2,3.088006992804051
13967,703-004-5386,9720.315,2,2,0,0.6397038929379192
14136,703-004-5384,2704.9805,3,1,2,0.8590619591567954
143,703-004-5384,8041.8403,6,3,3,2.287816553121705
1447,703-004-5387,9381.768,4,3,1,0.8163887417447667
14830,703-004-5386,8004.8154,3,0,3,0.27920371738274696
14855,703-004-5389,5450.9307,4,2,2,1.292278582431945
15079,703-004-5386,7349.5815,2,0,2,0.27920371738274696
15896,703-004-5386,2456.8193,2,0,2,0.27920371738274696
15900,207-008-2398,1346.007,5,3,2,0.9405355646404014
15984,207-008-2398,3257.3975,8,3,5,1.4186357206006097
16010,703-004-5390,5788.3086,4,2,2,0.7329934305945988
16563,703-004-5396,9093.045,6,4,2,1.6053014998719255
16814,703-004-5386,9732.819,6,6,0,2.8223821143928256
16835,703-004-5388,5256.061,5,5,0,1.2997706033979823
16883,703-004-5395,2240.4827,2,2,0,0.548720302927679
1727,703-004-5399,1972.3647,2,2,0,0.6532197793923752
17319,703-004-5386,6676.2925,4,3,1,0.7773167808702905
17626,703-004-5389,3781.6477,5,2,3,0.6760651476004444
17991,207-008-2398,6544.6865,1,0,1,0.27920371738274696
18288,703-004-5392,9875.941,5,1,4,0.44088661224623327
18589,703-004-5398,6076.3203,4,2,2,0.7045496723803827
18672,703-004-5396,9932.345,4,4,0,1.2894076744767273
18711,703-004-5391,4106.1514,2,0,2,0.27920371738274696
18795,703-004-5391,7688.374,1,0,1,0.27920371738274696
19231,703-004-5398,9024.447,5,1,4,0.9666652898252243
1944,703-004-5386,6271.913,3,1,2,1.9865073158779678
19492,207-008-2399,9340.544,3,0,3,0.27920371738274696
19603,703-004-5393,2375.6665,3,0,3,0.27920371738274696
19761,703-004-5386,3053.484,5,4,1,1.3275922370045476
20051,703-004-5385,3773.0957,6,2,4,1.2847610797074493
20269,703-004-5397,8177.06,3,1,2,0.6996891584263378
20701,703-004-5388,7756.283,5,1,4,0.45146977048738174
20772,703-004-5397,2727.9358,3,0,3,0.27920371738274696
20850,207-008-2399,104.6741,4,1,3,0.3902511792276225
20855,703-004-5395,4079.2131,7,5,2,1.0112025937514952
21234,703-004-5389,185.10759,8,3,5,0.8900760027607066
21813,703-004-5397,7849.6694,3,1,2,0.9791972133098364
21903,703-004-5393,7911.9404,6,5,1,1.612078130825946
21981,703-004-5383,7356.344,2,1,1,0.44307864886152437
22015,703-004-5387,2987.318,4,2,2,1.2445292365019345
22096,703-004-5382,4654.6265,5,2,3,1.3524503199192976
22293,703-004-5389,7578.5117,7,2,5,1.5830990751064558
2238,703-004-5389,3757.9102,1,1,0,0.5457096763278099
22403,703-004-5396,8993.475,4,2,2,0.6803498383238421
22410,703-004-5385,355.31223,1,1,0,0.700544618323879
22520,703-004-5385,8307.69,7,2,5,0.9533091491873616
22758,703-004-5397,7561.4053,3,2,1,0.7190214173907531
22767,703-004-5394,279.24896,4,3,1,1.6464655153807788
23131,703-004-5383,1561.3085,2,1,1,0.3978652972704144
23172,207-008-2399,7687.3384,5,3,2,0.7814682586029938
23175,703-004-5385,1548.2616,6,1,5,0.658104516020853
23214,703-004-5387,4439.451,2,1,1,0.6387505167525996
23721,703-004-5399,6952.147,3,0,3,0.27920371738274696
23857,207-008-2398,2751.8516,6,2,4,1.3638570816514528
23896,703-004-5381,9979.689,5,3,2,1.0136239331367067
24298,703-004-5387,6416.683,1,0,1,0.27920371738274696
24425,703-004-5385,9717.024,2,1,1,0.3807252912866403
24469,703-004-5386,3425.8484,7,3,4,1.408741981793935
24542,703-004-5383,3359.676,1,0,1,0.27920371738274696
24566,703-004-5381,28.892756,5,3,2,1.1015627758828548
25033,703-004-5392,4185.862,11,5,6,1.7218289003884752
25087,703-004-5386,9282.419,1,0,1,0.27920371738274696
25133,703-004-5390,884.983,6,3,3,1.1024554495052263
25173,703-004-5394,2601.217,3,1,2,0.8425612591190027
25279,703-004-5384,9237.559,"","","",0.27920371738274696
25443,703-004-5396,6636.737,1,1,0,0.35831143730785864
25800,703-004-5397,223.49417,5,4,1,1.3636643211084307
25922,703-004-5395,18.40651,3,2,1,0.5700504953980098
25944,703-004-5391,5679.0464,3,1,2,0.6047862402753031
26365,703-004-5383,1266.709,9,5,4,2.237421246606541
26433,703-004-5386,2414.4983,2,1,1,0.33853450732658075
26719,703-004-5399,1132.5032,4,1,3,0.4540512806676419
26779,703-004-5393,159.49905,6,3,3,1.3772447088339248
27101,703-004-5395,7436.5723,5,1,4,0.7151072041482308
27153,703-004-5387,6265.8647,6,2,4,0.7489642634687419
27225,703-004-5390,6674.2163,3,2,1,0.9727601010760515
27254,703-004-5380,3517.2422,2,0,2,0.27920371738274696
27292,703-004-5392,9094.453,3,1,2,0.3978652972704144
27777,703-004-5390,8669.506,4,2,2,2.47468920035295
28120,207-008-2398,8870.487,3,3,0,1.6031951490310818
28440,703-004-5395,9637.571,3,0,3,0.27920371738274696
28519,703-004-5381,9818.851,1,1,0,1.8539710267681595
28558,703-004-5388,805.2546,7,4,3,1.863814989628181
2865,703-004-5395,1092.5471,6,3,3,1.191071220014762
28794,703-004-5384,6045.7153,6,2,4,0.7881782212785134
28966,703-004-5392,6711.161,6,2,4,1.1261054993558244
29530,703-004-5391,5111.9478,4,2,2,0.7289219852176925
29921,703-004-5395,2959.5452,6,5,1,1.9601092478445308
30149,703-004-5389,2087.27,6,4,2,0.957609241684433
30208,703-004-5384,1415.9668,5,3,2,1.4413916200667227
30237,703-004-5381,1987.6719,6,5,1,1.4056154038141029
30434,703-004-5394,8030.446,4,2,2,1.1993375710533347
30585,703-004-5384,3576.284,3,2,1,0.7271333947103215
30629,703-004-5381,5283.6543,3,0,3,0.27920371738274696
30655,207-008-2399,5412.4976,3,2,1,0.6214429152280107
30884,703-004-5387,6311.111,1,0,1,0.27920371738274696
30916,703-004-5398,568.5157,2,1,1,0.7667255378911839
30945,703-004-5384,1301.8369,3,0,3,0.27920371738274696
31085,703-004-5385,9264.391,6,4,2,1.4704799307497487
3123,207-008-2398,4903.311,4,2,2,0.9198951892752664
31599,703-004-5384,76.43163,2,1,1,0.36951836429724944
31695,703-004-5396,6632.269,5,3,2,1.7882809059727007
3201,703-004-5386,5924.264,5,2,3,0.6977138418257018
322,703-004-5382,262.49884,5,2,3,0.7360507999502667
32268,703-004-5391,31.622648,2,0,2,0.27920371738274696
32372,703-004-5393,7396.16,3,2,1,1.1744978243514086
32415,703-004-5389,9102.218,5,3,2,1.706438422913666
32633,703-004-5381,307.07956,4,2,2,0.9289738776802633
32776,703-004-5396,9617.341,5,1,4,0.6371856466178544
33552,703-004-5383,9104.495,2,1,1,0.6366821021798151
34080,703-004-5398,8054.246,5,2,3,1.307087357538839
34087,703-004-5389,2507.3801,7,4,3,3.0225149472684882
34192,703-004-5391,4835.7964,3,0,3,0.27920371738274696
3426,703-004-5383,4996.3833,2,2,0,0.6916804726619553
34555,703-004-5385,3049.6675,4,2,2,0.765086110862844
34752,703-004-5390,2398.138,6,4,2,1.6498484874333945
35087,703-004-5391,5670.571,4,1,3,0.419675877197751
35404,703-004-5394,4457.411,1,0,1,0.27920371738274696
35559,703-004-5382,3410.2368,2,2,0,0.9935688984345811
35643,703-004-5391,6484.9346,4,2,2,2.550259664823598
35726,703-004-5396,9998.204,"","","",0.27920371738274696
35740,703-004-5388,4224.7153,7,4,3,2.2891084382837597
36150,703-004-5396,8005.395,3,2,1,0.6934776188792046
3634,703-004-5382,3745.4211,4,3,1,0.8113630161743862
36488,703-004-5383,6462.6777,6,2,4,0.7847374813704268
36583,703-004-5396,5947.344,5,3,2,1.4370017982355927
37277,703-004-5391,8532.674,7,4,3,1.3897832422204275
37485,703-004-5393,6434.8745,1,1,0,0.81033112824633
37496,703-004-5385,1854.5598,1,0,1,0.27920371738274696
37550,703-004-5397,1198.8562,4,1,3,0.4115069840841671
37586,703-004-5396,4626.194,3,1,2,0.5740184126136567
38031,703-004-5388,4564.3086,4,1,3,0.9037661913633336
3841,703-004-5384,2208.5344,2,1,1,0.9063996753646781
38466,703-004-5389,5987.3647,5,4,1,3.0907038136622926
38586,703-004-5381,9624.708,1,0,1,0.27920371738274696
38735,703-004-5388,3382.7292,2,1,1,0.9239587034959406
38867,703-004-5380,3320.994,4,3,1,1.0915725243157008
38870,703-004-5392,3166.2583,2,2,0,0.43741915723297026
39077,703-004-5391,2790.29,1,0,1,0.27920371738274696
39223,703-004-5399,4593.9946,7,2,5,1.8954287117115736
39363,703-004-5399,6028.4863,1,1,0,0.33853450732658075
39740,703-004-5395,6056.2383,6,2,4,1.030556305712532
39802,703-004-5386,5795.4214,5,2,3,1.464214277256587
39866,703-004-5398,9100.714,5,3,2,0.788060112144102
40398,703-004-5384,1374.0146,6,2,4,0.8721627514766548
40539,703-004-5389,6616.694,4,3,1,0.9439390246716737
40566,703-004-5390,9287.548,3,1,2,0.5176275407447674
40763,703-004-5393,1684.8577,4,1,3,0.35062813054411957
40910,703-004-5393,7493.125,4,1,3,0.33853450732658075
41127,703-004-5392,7617.7275,1,0,1,0.27920371738274696
41238,703-004-5387,5435.1978,5,2,3,1.2962484416164248
41481,703-004-5388,9370.056,7,2,5,0.5963646934741949
41574,703-004-5382,3205.1665,3,2,1,1.0366906409528918
41617,703-004-5395,8976.879,5,2,3,1.2911930130325076
41627,703-004-5387,9880.736,1,1,0,0.47863573222171824
41698,207-008-2399,5301.414,5,0,5,0.27920371738274696
41941,703-004-5390,3046.4446,5,1,4,0.37512182779194486
41978,207-008-2399,9652.357,9,5,4,2.8656440731188972
42068,703-004-5388,591.42944,1,1,0,0.3401166617250829
42165,703-004-5381,2936.6611,1,1,0,0.44998579923092
42234,207-008-2398,4943.1724,4,1,3,0.5839394064294748
42291,703-004-5386,1923.5867,3,2,1,1.0511039244086473
42351,703-004-5390,9997.922,5,1,4,0.6170657121526811
42398,703-004-5395,9102.212,1,0,1,0.27920371738274696
42584,703-004-5398,1559.7117,6,2,4,0.7352113726524895
42634,703-004-5384,8925.858,3,2,1,0.5669580486103406
42655,703-004-5395,5302.143,2,1,1,0.46621310750449935
42939,703-004-5381,9943.579,2,1,1,0.6867282311999388
43135,703-004-5386,5205.1665,4,3,1,1.0289971532815756
43365,703-004-5393,998.07324,4,2,2,0.5108997175707791
43458,703-004-5381,3731.6042,6,3,3,1.3919026255762212
43644,703-004-5383,2709.077,1,0,1,0.27920371738274696
43880,703-004-5393,2111.622,4,1,3,0.4384940505908422
44062,703-004-5388,8494.057,2,0,2,0.27920371738274696
44112,703-004-5388,2034.8691,5,2,3,0.7354106065967463
44490,703-004-5384,6537.033,8,7,1,3.7208046632674825
44753,703-004-5395,8770.877,3,1,2,1.648364436575395
45189,703-004-5384,2543.8357,2,1,1,1.1070040782572441
45305,703-004-5382,1799.7456,3,2,1,1.4995638960301891
4536,703-004-5399,9964.536,4,3,1,0.6337551669395161
45588,703-004-5390,1496.8741,2,2,0,0.600901327510744
45647,703-004-5384,9658.871,7,3,4,0.7997732591312777
46112,207-008-2399,6645.0864,5,1,4,0.4101115660222241
46117,703-004-5398,3000.8513,6,2,4,0.6403878473846181
46398,703-004-5383,5287.502,9,4,5,2.3170607440298143
4679,703-004-5385,3575.0962,"","","",0.27920371738274696
46955,703-004-5381,8641.774,3,2,1,0.7924547857167282
47050,703-004-5380,8456.94,11,7,4,2.3245591014934015
47056,703-004-5390,2727.8357,5,3,2,0.9257264468869337
47303,703-004-5381,1183.3644,4,1,3,0.6548710830435607
47323,703-004-5385,397.40204,3,0,3,0.27920371738274696
47475,703-004-5393,9236.943,3,1,2,0.6226740370919139
48194,703-004-5386,4084.1282,10,6,4,2.1878517076158617
48275,207-008-2399,9913.237,7,3,4,1.1656106858138047
48300,703-004-5398,7602.8276,6,4,2,1.1408198010567763
48473,703-004-5396,2627.7656,5,2,3,0.5365706683801202
48598,207-008-2399,782.8104,7,4,3,2.453413506566435
48771,703-004-5398,9503.972,4,2,2,1.0439992911501386
48959,703-004-5388,386.0265,6,4,2,2.9079797310878757
49338,703-004-5389,2055.7124,3,1,2,0.6619029045231293
4938,703-004-5386,5615.798,5,4,1,0.9439320570463958
49570,703-004-5392,7034.7314,5,3,2,1.4670851539637522
49728,703-004-5396,3863.613,5,5,0,1.3706924830494747
49738,703-004-5385,7673.921,4,2,2,0.5459478275025306
4984,703-004-5393,1975.8118,3,2,1,0.868446195773784
49888,703-004-5389,8349.527,3,0,3,0.27920371738274696
5159,703-004-5389,835.917,5,1,4,0.35831143730785864
5564,703-004-5380,1340.4441,1,1,0,0.5323001371675478
564,703-004-5399,7213.827,2,0,2,0.27920371738274696
567,703-004-5385,3272.9094,2,1,1,1.4732950771753184
6017,703-004-5389,2439.6025,1,1,0,0.509883113175661
6042,703-004-5382,5639.9834,5,2,3,0.7190862063881464
6056,703-004-5388,681.1941,5,1,4,0.4830846150289418
6075,703-004-5382,1826.703,3,0,3,0.27920371738274696
6312,703-004-5387,4928.352,2,0,2,0.27920371738274696
648,703-004-5381,2409.3206,5,3,2,1.4345429684082072
6525,703-004-5393,9676.0625,6,4,2,1.4963912134025958
6561,703-004-5380,1408.5167,4,3,1,1.0160528833384357
6587,703-004-5380,3196.1936,8,2,6,0.5143793211626028
7057,703-004-5392,239.65836,2,0,2,0.27920371738274696
7070,207-008-2398,8597.694,7,6,1,2.242514259443215
7619,703-004-5392,1228.6323,3,3,0,1.022921552332854
777,703-004-5396,5794.677,1,1,0,0.8996424324431791
7881,703-004-5385,559.2251,6,3,3,2.162730403765263
8180,703-004-5392,2770.3613,2,1,1,0.4830846150289418
849,703-004-5389,1362.8,1,1,0,0.4230241055822243
8997,703-004-5391,1317.0599,10,4,6,4.952762433003204
9175,207-008-2398,3357.8074,5,4,1,1.357816090251861
9678,703-004-5380,726.50134,4,1,3,1.1485498183990943
9860,703-004-5399,9503.551,5,3,2,0.9825056156294415
9883,703-004-5384,1030.9886,3,2,1,0.6117201928683815
9937,703-004-5388,9987.546,2,2,0,0.6135418883421766
9945,703-004-5395,2948.2263,3,3,0,1.5092203979314174
9959,703-004-5388,1247.1581,2,0,2,0.27920371738274696
101,703-004-5380,8457.54,4,2,2,0.6334357216170544
10212,703-004-5388,593.3887,"","","",0.27920371738274696
1041,703-004-5385,1964.3969,3,3,0,0.8407417707965142
10782,703-004-5385,2958.6494,4,3,1,0.5571684682696081
1093,703-004-5383,4683.726,3,1,2,0.5165268771580819
10975,703-004-5396,8760.282,11,6,5,1.1089583858970748
11,703-004-5392,2906.9407,5,3,2,3.5865916435119516
11306,703-004-5390,4214.08,3,1,2,0.6027658351943723
11604,703-004-5397,9919.298,2,1,1,0.4965144831330909
11738,703-004-5391,3088.0642,5,4,1,1.1213687096547647
11798,703-004-5385,29.274822,4,3,1,1.2574402739843387
1192,703-004-5386,2348.4976,5,3,2,0.48348421642766715
12144,703-004-5397,4728.786,3,3,0,1.057455856505311
12211,703-004-5380,3478.3923,6,4,2,1.149071125706567
12293,703-004-5393,531.013,4,3,1,1.4122630695991603
1235,703-004-5393,8698.98,3,2,1,1.0696590323213753
1259,703-004-5385,7955.141,1,0,1,0.27920371738274696
12696,703-004-5394,3012.8987,8,3,5,1.7461946491468163
12862,703-004-5385,6192.5303,7,6,1,3.7120723046809925
12918,703-004-5381,2968.9634,3,2,1,0.5463244158994223
12941,703-004-5383,2458.9849,5,1,4,0.5811715799063127
13246,703-004-5388,5349.256,5,2,3,1.7801389949018538
13640,703-004-5393,3173.9043,4,0,4,0.27920371738274696
14115,703-004-5384,9720.295,2,2,0,1.841078620270637
14217,703-004-5380,6748.0005,2,2,0,0.9228222038767739
14317,703-004-5380,8416.371,2,1,1,0.35831143730785864
14615,703-004-5383,3344.7444,1,0,1,0.27920371738274696
14776,703-004-5390,1281.2704,4,0,4,0.27920371738274696
14811,703-004-5383,170.18915,3,2,1,1.1660081770719835
14904,703-004-5396,1437.9352,3,1,2,0.3870758832472951
1518,703-004-5380,9201.03,3,2,1,0.6160966972586002
15223,703-004-5380,19.462109,5,3,2,0.724214567968995
1539,703-004-5391,5730.1377,6,2,4,0.7382763889827259
15608,703-004-5382,8387.033,6,3,3,0.8538108301792456
15895,207-008-2399,8563.78,7,3,4,1.6995332000498973
1624,703-004-5382,2897.9253,3,2,1,1.455944487497999
16437,703-004-5387,9971.465,2,1,1,0.4856863231010235
17380,703-004-5383,8598.47,6,3,3,1.8543467425229918
17383,703-004-5390,2706.5427,6,3,3,1.36646875858077
17834,703-004-5387,2530.5225,5,3,2,0.8079604908255642
17900,703-004-5395,2652.4146,7,3,4,1.53170296194987
17904,703-004-5383,3504.6882,3,2,1,1.1799461473916633
1793,703-004-5397,1862.4806,7,1,6,0.5040620848005768
17932,703-004-5384,9337.159,5,3,2,0.7347716860593021
18114,703-004-5393,96.01057,4,1,3,0.5669580486103406
18138,703-004-5396,7433.139,3,0,3,0.27920371738274696
18224,703-004-5388,4296.0327,4,2,2,0.7892984842225904
18411,703-004-5396,9530.473,4,2,2,0.5432951343569786
18538,703-004-5390,1991.0818,4,1,3,0.39658262602133704
18668,703-004-5382,7323.7373,3,1,2,0.9524813286518448
18846,703-004-5397,7332.2417,4,1,3,0.81293472262334
18882,703-004-5396,984.1651,9,1,8,0.33853450732658075
19383,207-008-2399,5722.5967,1,0,1,0.27920371738274696
19512,703-004-5398,9011.311,4,3,1,1.497570682510394
19517,703-004-5389,5878.0483,4,2,2,0.6553358746963865
1958,703-004-5390,695.8842,3,1,2,0.35831143730785864
19714,703-004-5399,4356.7656,5,2,3,0.5928812899621665
19731,207-008-2399,5372.5234,4,4,0,1.796746321908776
19961,703-004-5396,1903.28,4,2,2,1.4591139247383629
19996,703-004-5386,6084.163,3,1,2,1.329479944530451
20383,207-008-2399,9043.155,2,1,1,0.4080549618718091
20479,703-004-5399,84.82575,4,3,1,0.851796013272125
20502,703-004-5392,7845.302,1,1,0,0.5976376218570181
20580,703-004-5380,9729.589,1,0,1,0.27920371738274696
20680,703-004-5391,295.2987,2,1,1,0.9382826279586218
20699,703-004-5394,3525.616,3,1,2,0.32666834933781397
20719,703-004-5382,8319.976,4,2,2,0.5460632379757091
20731,703-004-5389,2938.1125,1,1,0,0.35114230018964543
20858,703-004-5382,8412.785,4,1,3,0.7083894672164526
20985,703-004-5395,9541.035,6,4,2,2.2953996165869963
20986,207-008-2399,7498.6475,3,1,2,0.7174570889907578
20987,703-004-5385,2904.4385,3,1,2,0.35831143730785864
21148,703-004-5395,5900.8564,7,5,2,3.1780591727841343
21228,703-004-5395,8636.815,5,3,2,1.2885205599411453
21376,703-004-5385,6659.616,4,2,2,0.66996759689304
21540,703-004-5394,7333.5693,3,2,1,1.3374011185396995
21779,703-004-5398,5743.6333,7,6,1,2.6686383896528487
21838,703-004-5391,6609.478,8,1,7,0.6242140457946624
22158,703-004-5389,3503.4746,4,2,2,0.6773469854632742
22433,703-004-5383,3995.5796,3,1,2,0.42555299924420353
22447,703-004-5391,6180.9487,8,2,6,1.4616545458776848
22677,703-004-5380,2039.6047,4,3,1,2.991598511988581
22748,703-004-5385,5713.689,2,1,1,0.3919322182760311
22788,703-004-5389,6026.7866,6,5,1,0.985889018680842
22839,703-004-5396,1380.13,3,2,1,0.7197521604136887
22907,703-004-5389,2317.8555,2,1,1,0.534644300875013
22940,703-004-5383,1299.5499,1,1,0,0.5695659325434026
23262,703-004-5386,8170.727,4,4,0,1.3792135643973784
23455,703-004-5390,6364.7046,3,0,3,0.27920371738274696
23521,207-008-2399,8786.547,4,2,2,2.487307522089127
2354,703-004-5384,5405.7563,6,3,3,1.2440054242308154
23805,207-008-2399,3224.8645,6,3,3,1.1808698711990924
23823,703-004-5393,8059.301,4,2,2,1.0757363708063001
23962,703-004-5399,1347.5322,5,4,1,1.3486115563786307
24201,703-004-5387,3095.0977,4,2,2,0.857746694125794
24574,703-004-5389,4944.189,10,6,4,3.3327842215157757
24752,703-004-5386,5077.7705,3,2,1,1.2343275405290426
24897,703-004-5396,324.26596,7,4,3,1.1182829253517093
25278,703-004-5386,5078.1377,4,2,2,0.3746274045424129
25737,703-004-5387,9658.963,4,3,1,1.1135779245436037
26074,703-004-5390,3269.3362,5,1,4,0.37175974969512765
26080,703-004-5394,7305.595,4,3,1,3.556765615991582
26192,703-004-5395,6650.1553,7,4,3,1.4819184565541537
26261,703-004-5398,9346.8125,"","","",0.27920371738274696
26312,207-008-2399,2415.9485,"","","",0.27920371738274696
26572,703-004-5387,4660.0386,4,1,3,0.49653468841674425
26695,703-004-5388,9352.049,6,4,2,1.716748955053398
26696,703-004-5386,595.8837,5,3,2,1.5855913062291587
2683,703-004-5381,654.9913,2,1,1,0.6535231045380374
26855,703-004-5380,110.84974,4,1,3,0.596093497447147
27047,703-004-5380,5834.4805,4,2,2,0.7372391854811302
2714,703-004-5392,6269.641,4,1,3,0.32666834933781397
27266,703-004-5397,8635.531,2,1,1,0.35831143730785864
27351,703-004-5394,7010.727,5,3,2,0.6567227542203956
27385,703-004-5391,8084.0967,1,1,0,0.6274699192124602
27976,703-004-5397,2725.8176,2,1,1,1.5636069333625509
28019,703-004-5383,4112.8145,6,4,2,2.121899913047682
28079,703-004-5396,1593.1696,1,0,1,0.27920371738274696
28106,703-004-5385,3667.7986,5,2,3,0.43748004110705674
28538,703-004-5388,2856.5728,"","","",0.27920371738274696
28599,703-004-5387,6435.2017,3,2,1,0.532685314359038
28772,703-004-5395,8717.3,4,2,2,0.9648276066458171
28887,703-004-5382,6682.786,2,1,1,0.5837684390944268
29481,207-008-2398,2299.6592,4,3,1,2.7319130778901157
29592,703-004-5396,2068.6484,5,4,1,1.600328001819013
29607,703-004-5391,1305.9342,5,1,4,0.781566066296792
29614,703-004-5396,9920.177,2,2,0,1.9162806716578067
29701,703-004-5393,1846.3337,5,3,2,1.8750146565533437
29782,703-004-5386,2712.8655,4,1,3,0.7950830324148704
29946,703-004-5383,465.3424,2,1,1,0.4737732200338168
30095,703-004-5391,3773.814,5,3,2,0.7638073041315918
30130,703-004-5391,514.8989,2,1,1,0.9844168835692608
30139,703-004-5383,9987.474,4,3,1,2.6884727610139474
30198,207-008-2399,8790.235,6,3,3,0.6632048388098227
30212,207-008-2398,8696.986,5,3,2,0.7014005934508651
30840,703-004-5396,5214.331,6,3,3,1.3842297404255255
30858,703-004-5394,6553.108,6,0,6,0.27920371738274696
31047,207-008-2398,4908.8867,6,3,3,0.7966133134210812
31079,703-004-5391,5676.4585,6,4,2,1.8388750826997846
31633,703-004-5388,8289.345,4,0,4,0.27920371738274696
31696,703-004-5393,2334.7783,4,2,2,0.5046607191693151
31885,703-004-5380,1685.3845,6,1,5,0.832564257527338
32306,703-004-5394,3855.7756,3,3,0,0.9348595738687535
32610,703-004-5381,2002.4597,2,0,2,0.27920371738274696
32802,703-004-5387,9622.7705,2,1,1,0.4905690522625719
32887,703-004-5382,3250.761,2,0,2,0.27920371738274696
32927,207-008-2399,2198.87,3,2,1,0.8677105210068504
33159,207-008-2398,8499.59,3,2,1,2.003482898625496
33167,703-004-5389,6113.963,4,3,1,1.1551107063174577
33278,703-004-5381,8955.042,2,0,2,0.27920371738274696
33302,703-004-5380,9499.74,3,0,3,0.27920371738274696
33372,703-004-5390,5666.3613,2,1,1,0.5038544639202273
33573,703-004-5392,7289.289,6,2,4,0.8192854514950059
34411,703-004-5393,9715.298,3,2,1,0.41764222725169237
34477,703-004-5397,136.50597,8,4,4,2.388171154532439
34506,703-004-5394,971.058,2,2,0,0.7505798665741972
34706,703-004-5388,75.18113,5,4,1,0.5925008807247539
35152,703-004-5381,7410.473,8,5,3,2.1528476683586484
35208,703-004-5398,4176.461,3,2,1,0.8418061594152199
3521,703-004-5398,3609.4075,5,2,3,1.190917156075081
35271,703-004-5386,1535.5068,2,0,2,0.27920371738274696
35680,703-004-5389,4932.696,5,2,3,0.7843214343356054
35681,703-004-5388,9119.837,7,1,6,0.4925918476482402
35762,703-004-5394,2862.7288,5,4,1,0.9248401374934219
3578,703-004-5388,7884.4707,3,1,2,0.427686080080102
3584,703-004-5390,6743.008,3,2,1,1.558710878649952
37043,703-004-5397,59.159996,4,3,1,0.7781861725748473
37079,703-004-5383,2576.8018,4,2,2,1.678726024343972
3742,703-004-5396,7031.653,1,1,0,0.3896005611942858
37486,703-004-5393,3382.755,2,2,0,0.5326276170336336
37506,703-004-5384,2912.6663,3,3,0,0.7037983197532963
37670,703-004-5386,6556.165,5,4,1,1.731806474562864
37675,703-004-5390,2473.286,9,4,5,2.1228945947192193
37940,703-004-5385,337.4219,6,2,4,1.1209354288731446
38049,703-004-5392,1356.6124,7,2,5,0.7463175465592968
38133,703-004-5398,4186.676,3,0,3,0.27920371738274696
38142,703-004-5389,8073.4893,3,1,2,0.38773342300523805
38235,207-008-2399,9693.309,2,1,1,0.35831143730785864
38284,703-004-5384,589.6974,2,1,1,0.48792965779271524
38449,703-004-5389,2053.0247,2,1,1,0.40620489181768066
38591,703-004-5390,5209.5503,6,2,4,1.0892892781838248
39219,703-004-5387,7066.839,6,4,2,3.0387758964750615
39274,703-004-5389,6654.0273,4,2,2,0.6730856428818254
39381,703-004-5387,3648.0063,7,4,3,1.8318745695517067
39475,703-004-5387,6525.3984,3,1,2,0.4595317701229348
39493,703-004-5384,4400.843,5,1,4,0.5774145077757602
39682,207-008-2398,3942.403,5,3,2,1.360041599937909
39697,703-004-5385,8098.944,3,0,3,0.27920371738274696
39853,703-004-5394,6775.526,2,0,2,0.27920371738274696
40690,703-004-5391,646.42725,4,1,3,0.4220786276159599
40917,703-004-5392,1949.5249,6,4,2,1.2120005792307358
40935,703-004-5384,756.3943,4,1,3,0.44343719131152826
41159,703-004-5381,8699.388,4,2,2,0.8823480024041753
41311,207-008-2399,1152.187,5,1,4,1.266128746453359
41329,703-004-5383,7373.6445,2,1,1,0.47481204053456616
41786,703-004-5383,5486.636,2,2,0,1.3997255774055988
41895,703-004-5390,1748.1678,4,2,2,0.6243991528944632
42453,703-004-5384,7472.937,2,0,2,0.27920371738274696
42787,703-004-5382,3786.3225,3,2,1,0.544738447990823
43304,703-004-5388,4837.6245,2,1,1,0.9766046238296601
43404,703-004-5388,1861.5425,3,0,3,0.27920371738274696
43499,703-004-5399,1665.4712,4,1,3,0.9469610028270495
43592,703-004-5383,8302.423,4,1,3,0.6501987322274398
43720,703-004-5389,5622.3594,2,1,1,0.5519519467464982
43735,703-004-5381,445.7724,4,2,2,0.824340369385316
43771,703-004-5380,806.7441,5,0,5,0.27920371738274696
43975,703-004-5397,9172.807,3,2,1,1.3227163162188997
44429,703-004-5382,8019.9487,4,2,2,0.8608857155700402
44464,703-004-5393,1558.9464,3,3,0,1.246746802306387
45001,207-008-2398,2342.7976,4,2,2,1.079443522204499
45080,703-004-5384,4172.7383,1,1,0,1.2505525773674893
45090,703-004-5389,1312.7166,7,3,4,0.9111824572463514
45254,703-004-5380,3901.006,3,1,2,0.6183778141298999
46401,703-004-5394,6449.1294,8,6,2,3.828304290525193
46403,703-004-5382,2733.7075,8,6,2,1.442819412461799
46462,703-004-5382,6694.5146,2,1,1,0.45890017187967663
46492,703-004-5394,5643.686,3,1,2,0.5102265713037245
46722,703-004-5397,8269.353,5,2,3,0.7226390100303286
47187,207-008-2398,5312.29,2,2,0,0.49952466153744235
47313,703-004-5384,3930.241,8,4,4,1.5492492585846447
47355,703-004-5389,3849.1785,2,0,2,0.27920371738274696
47372,207-008-2398,9945.546,4,1,3,0.5188701652477854
47420,703-004-5387,5797.3145,3,1,2,0.3850298225009403
47621,207-008-2399,3300.9988,4,2,2,0.8524987105939049
47736,703-004-5389,7869.203,3,1,2,1.306427511878152
48128,703-004-5395,6025.196,2,0,2,0.27920371738274696
48142,207-008-2398,5215.9233,2,2,0,0.4132305709999937
48244,703-004-5391,7046.8374,4,2,2,1.3529897818425005
48476,703-004-5382,878.8979,1,0,1,0.27920371738274696
48624,703-004-5382,8611.845,5,2,3,2.8326074364488436
4864,703-004-5388,3857.6902,3,0,3,0.27920371738274696
48661,703-004-5399,8353.67,7,2,5,0.595080159591865
48741,207-008-2398,8418.126,3,2,1,1.0992477215543526
49038,703-004-5382,2204.1006,"","","",0.27920371738274696
49230,703-004-5385,6013.6235,4,1,3,0.8998037801952476
49397,703-004-5395,816.41315,4,2,2,0.5525177412092868
49422,703-004-5393,1681.227,6,4,2,1.9998416238528278
49473,703-004-5389,6606.985,4,2,2,1.3605168294445338
49590,703-004-5391,1768.1176,5,2,3,1.213697002506274
49648,207-008-2398,9376.466,6,3,3,0.7412941402259678
49769,703-004-5399,5142.6567,3,0,3,0.27920371738274696
49857,703-004-5398,2224.853,4,1,3,0.5349881105322466
49978,703-004-5398,8761.411,4,2,2,0.505523941214915
5045,703-004-5399,9884.239,8,1,7,2.130270315824522
5076,703-004-5381,4128.1045,2,0,2,0.27920371738274696
5475,703-004-5381,5919.2944,4,1,3,0.7120164690042512
5520,703-004-5389,7363.6724,5,3,2,1.9959113811693103
5714,703-004-5381,8542.363,4,1,3,0.35831143730785864
5872,703-004-5382,610.78253,2,1,1,1.4361191461856062
6094,703-004-5395,6914.0356,5,1,4,0.3978652972704144
6621,703-004-5380,4703.755,6,3,3,0.7668355081981887
672,703-004-5391,5397.2363,6,2,4,0.4801484505156451
6841,703-004-5393,8987.953,4,1,3,0.3978652972704144
7337,703-004-5388,5149.912,7,5,2,1.9924181098815075
7508,703-004-5393,4221.8667,6,3,3,1.5125014744884193
7652,703-004-5385,1851.3011,4,1,3,1.7979478079746236
7702,703-004-5390,755.1098,3,1,2,0.6640221475744069
7754,703-004-5384,7898.5264,4,1,3,0.35534489781066697
7799,703-004-5385,816.21765,5,4,1,0.789287841723555
7813,703-004-5393,1431.4884,4,2,2,0.5270244413773901
8257,703-004-5395,7700.7,7,3,4,1.9504700649457518
854,703-004-5389,9811.549,1,0,1,0.27920371738274696
8697,703-004-5388,3799.3628,6,3,3,1.2626356341818379
8847,703-004-5394,8111.7266,2,2,0,1.1668006294458664
8897,703-004-5381,7745.997,7,3,4,1.7884347373144716
8906,703-004-5382,7090.6055,3,1,2,0.48999282943320066
9258,703-004-5391,1121.7474,2,1,1,0.3719501068994391
938,703-004-5397,6769.8228,5,1,4,0.4980744002790507
9766,703-004-5385,3815.1448,6,3,3,1.774742949073692
986,703-004-5390,244.20976,4,0,4,0.27920371738274696
10084,703-004-5393,4365.3745,3,3,0,0.926368747020439
10102,703-004-5390,3362.435,4,2,2,1.3694887299747378
10225,703-004-5395,1170.9165,6,4,2,1.1530551248241343
10276,703-004-5399,3183.7522,5,1,4,0.396982921727992
10438,703-004-5395,3232.6216,3,1,2,0.5898136599522484
10503,703-004-5390,7679.586,3,2,1,1.2503973373113288
11013,207-008-2399,7362.0654,4,1,3,0.38511319447654213
11270,703-004-5398,7316.166,1,0,1,0.27920371738274696
11292,207-008-2398,8854.242,5,1,4,0.3637500930527101
11412,207-008-2399,9793.682,5,3,2,1.5793154896761015
116,703-004-5381,9318.117,1,0,1,0.27920371738274696
11729,703-004-5393,687.25885,1,1,0,0.5793838400813912
11752,703-004-5380,9753.289,4,2,2,1.6681593581920169
12185,703-004-5383,8324.259,8,5,3,2.435023237176488
12377,703-004-5390,2664.2173,4,1,3,0.37512182779194486
12912,703-004-5386,144.00542,6,2,4,1.06182207073128
13064,703-004-5388,8479.997,3,0,3,0.27920371738274696
13500,703-004-5392,3830.0293,3,2,1,0.612432263251904
13526,703-004-5388,3261.416,5,2,3,1.3455771107086019
1353,703-004-5399,7847.735,1,0,1,0.27920371738274696
13780,703-004-5380,4757.232,4,2,2,0.5544288486744614
13829,703-004-5380,3628.4065,1,0,1,0.27920371738274696
13830,703-004-5380,2124.53,2,1,1,0.5165268771580819
14137,703-004-5393,6513.1543,5,0,5,0.27920371738274696
14453,703-004-5393,5162.701,7,2,5,1.8987962613216884
14523,703-004-5393,868.0385,5,4,1,2.3956134885187197
14692,703-004-5384,1808.3972,4,3,1,0.6904741359796406
14713,207-008-2398,4453.57,3,1,2,3.425508786846738
14846,703-004-5382,6955.31,5,2,3,1.3564461713892075
14863,703-004-5396,7620.6826,2,1,1,0.7221032105884294
14901,703-004-5384,7345.972,3,1,2,0.38922759066629237
14950,703-004-5390,8519.269,2,1,1,0.5669580486103406
15089,703-004-5398,5606.824,3,1,2,0.37556640983026657
15140,703-004-5386,9674.741,5,1,4,0.5165268771580819
15193,703-004-5385,3988.0354,6,1,5,0.5907340606291897
15459,703-004-5397,8434.533,"","","",0.27920371738274696
15565,703-004-5396,7501.617,8,6,2,2.2919498690599105
15596,703-004-5386,8657.794,4,3,1,1.3260556509031822
15705,703-004-5395,2766.5842,5,1,4,0.4446047751261679
15831,703-004-5380,6657.0205,4,1,3,1.6050959962779483
15912,703-004-5382,570.65546,7,4,3,1.1087466764300764
15962,703-004-5395,2797.9534,5,3,2,1.0691804994238032
16000,703-004-5380,9037.642,4,2,2,0.9010977450574216
16138,703-004-5392,3140.1497,3,1,2,0.4328015901786165
16287,703-004-5399,5302.295,6,1,5,0.9973654312957485
16382,703-004-5384,5606.1665,2,1,1,0.6786150201770064
16397,703-004-5383,126.7004,3,1,2,0.7052241382381503
16463,703-004-5391,4687.3687,"","","",0.27920371738274696
16475,703-004-5391,1704.5587,2,0,2,0.27920371738274696
1653,703-004-5395,5750.6206,3,1,2,0.4788789490434548
16581,207-008-2398,1403.6852,6,4,2,2.9278561583480713
16684,703-004-5386,9617.89,6,4,2,0.9374280817841139
16738,703-004-5386,4880.282,5,2,3,0.9085235624322182
16871,703-004-5392,9937.907,3,2,1,0.6560743197911095
16962,703-004-5394,9370.603,3,0,3,0.27920371738274696
17051,703-004-5392,527.15,5,1,4,1.0981931556839124
17147,703-004-5380,730.325,2,1,1,0.7281242276959011
17342,703-004-5387,4980.333,5,1,4,0.7619888009317315
17470,703-004-5394,640.372,3,1,2,0.40272256277423135
17501,703-004-5386,7538.0986,5,1,4,0.45421165821167014
1752,703-004-5383,293.7591,4,2,2,0.40287874902066834
17824,703-004-5382,6588.985,4,2,2,0.47464124550514214
17867,703-004-5399,8749.152,3,3,0,0.79958070696667
18481,703-004-5388,4137.7163,3,1,2,0.8806178648014199
1867,703-004-5384,5790.041,6,3,3,1.648626847293885
18670,703-004-5398,2032.9446,2,1,1,0.7858893811574893
18751,207-008-2398,6678.2163,5,4,1,1.7176254637522257
18876,703-004-5392,286.5368,3,1,2,0.35534489781066697
18975,703-004-5387,7100.5566,4,1,3,0.4780408159159825
19061,703-004-5399,3579.2488,4,2,2,1.0760623541377559
19065,703-004-5387,7491.086,7,2,5,0.7620628990189919
19325,703-004-5382,6176.1167,3,2,1,1.5014170309764143
19397,703-004-5388,1907.8416,2,1,1,0.35114230018964543
19506,703-004-5396,1771.6628,2,2,0,0.6362366182762447
19580,703-004-5398,5677.2085,7,4,3,0.7163001816306868
19865,703-004-5398,5610.265,2,1,1,0.5165268771580819
19948,703-004-5395,1749.3015,2,0,2,0.27920371738274696
19950,703-004-5397,1699.2921,6,5,1,2.6621198073776173
20019,703-004-5397,2752.974,4,1,3,0.5165268771580819
20047,207-008-2399,9633.821,1,1,0,0.3978652972704144
20370,703-004-5385,5652.4844,3,2,1,0.5626042153260578
20576,703-004-5386,8279.38,4,2,2,0.6975055634167561
2071,703-004-5381,1832.6342,3,2,1,0.8813282688459755
21029,703-004-5381,7838.3447,2,1,1,0.33853450732658075
21147,703-004-5380,7795.264,5,4,1,1.5025407237113382
21154,703-004-5394,3238.4973,2,2,0,2.091459302693423
21196,207-008-2399,8177.5884,5,3,2,1.846386294298823
21269,703-004-5387,2937.839,2,1,1,0.4813057279599285
21662,703-004-5385,9818.609,3,1,2,0.5441487734486558
21814,703-004-5386,6849.394,2,0,2,0.27920371738274696
21857,703-004-5391,9722.08,6,2,4,1.7224645858564533
22465,703-004-5394,765.28845,3,3,0,1.6389566101105268
22861,703-004-5397,9377.684,4,2,2,1.095725337365906
23137,703-004-5383,4601.9526,1,0,1,0.27920371738274696
23199,703-004-5386,4122.9224,1,1,0,1.0447161353622196
23463,703-004-5381,7815.8975,3,1,2,0.4409413048568235
23691,703-004-5393,342.69333,3,1,2,0.8415878385173636
24007,703-004-5387,5831.698,6,1,5,0.35831143730785864
24173,703-004-5384,9270.765,4,3,1,0.7514863366650011
24262,703-004-5386,7575.174,3,2,1,1.0114367403959286
24329,703-004-5397,6795.722,3,1,2,0.36951836429724944
2434,703-004-5391,1700.0282,1,0,1,0.27920371738274696
24702,703-004-5385,948.50836,6,5,1,1.32593630356171
24925,703-004-5390,9226.003,3,1,2,0.46599451397086866
2526,703-004-5383,6114.5312,6,4,2,2.1762394970966747
25271,703-004-5399,6884.8906,6,4,2,1.309086431015605
2549,703-004-5389,3906.5688,2,2,0,1.0299921862303252
25544,703-004-5381,2806.7268,2,0,2,0.27920371738274696
25977,207-008-2398,160.75015,7,3,4,1.8934647407248215
26033,703-004-5395,5818.2036,5,1,4,1.2825164949686605
26113,703-004-5395,2712.6836,2,0,2,0.27920371738274696
26252,703-004-5388,9176.06,5,3,2,1.7043904984222082
26330,703-004-5381,6774.254,2,1,1,1.6298804775034157
26399,703-004-5385,2814.1165,4,2,2,0.8747314305763952
26401,703-004-5380,9415.047,4,2,2,1.0204000856734492
27151,207-008-2398,9936.603,2,1,1,0.7539784200964934
27389,703-004-5387,6030.361,3,0,3,0.27920371738274696
2753,703-004-5394,8814.364,2,1,1,1.2316787398265265
27545,703-004-5384,4954.664,7,4,3,2.0230469522678307
27689,703-004-5386,1810.0214,5,4,1,1.5021846263492344
28008,703-004-5393,3035.1262,5,3,2,1.527218358087837
28119,703-004-5398,1410.9641,5,2,3,0.8854248191930816
28300,703-004-5398,4174.675,5,5,0,1.9431120082471116
28447,703-004-5386,4793.57,5,4,1,1.5606089927770317
28748,703-004-5389,1707.806,2,1,1,0.5169952928140887
28976,703-004-5392,2541.8223,6,4,2,0.9400243957237854
28991,703-004-5392,4902.3555,3,1,2,0.5165268771580819
29177,703-004-5382,5386.0537,3,1,2,0.37175974969512765
29222,703-004-5380,7881.3374,3,1,2,2.069350381073972
29291,703-004-5381,1647.29,6,4,2,1.347304911123165
29610,703-004-5391,5554.2944,4,1,3,0.8237613662524119
29805,703-004-5395,7581.7974,4,2,2,1.4498930123637528
29937,703-004-5391,8997.801,4,2,2,0.7762351006233197
30094,703-004-5399,3437.0137,5,2,3,0.7075057649853855
30497,703-004-5390,929.50165,5,3,2,0.6590045020064684
30523,703-004-5395,8679.315,3,2,1,1.318408728165891
30548,703-004-5385,407.27197,7,4,3,0.954522520221531
30608,703-004-5390,5418.7095,4,3,1,0.8448838433894362
3064,207-008-2398,5669.6323,2,1,1,0.5516293326170707
30673,703-004-5388,8065.6475,6,5,1,2.6160027603468303
30699,703-004-5391,8313.081,"","","",0.27920371738274696
30852,703-004-5382,4353.883,3,2,1,0.6845337008951802
30932,207-008-2399,3675.1992,4,2,2,0.41467568775450064
31528,703-004-5383,1117.3267,5,1,4,0.5165268771580819
31625,207-008-2398,5171.677,2,0,2,0.27920371738274696
31920,703-004-5381,2972.967,3,3,0,1.9989252119773964
31945,703-004-5381,3485.5176,2,1,1,0.9328198554704286
31988,207-008-2399,5700.137,4,3,1,1.9607533415270666
31999,703-004-5394,7216.3247,"","","",0.27920371738274696
32,703-004-5389,4110.1416,2,0,2,0.27920371738274696
32006,703-004-5384,5774.112,3,1,2,0.8332310846278028
32205,703-004-5380,3522.0212,5,3,2,0.9361267014054419
32382,703-004-5389,5.5217743,2,0,2,0.27920371738274696
32677,703-004-5392,8775.443,3,1,2,0.4083803780451922
32720,703-004-5397,3315.301,3,1,2,0.39907663423176776
33301,703-004-5389,359.24792,2,1,1,0.6259171867641522
3356,703-004-5394,5149.412,4,1,3,0.8424102812486185
33560,703-004-5386,5829.8696,3,1,2,1.1266322208759612
33591,703-004-5381,4993.1494,7,2,5,1.7700788428802936
33969,703-004-5397,9762.909,3,1,2,0.3313303485615256
33994,703-004-5387,5274.302,4,4,0,0.9676285803218517
3400,703-004-5383,4836.912,4,1,3,0.6388578946891732
34298,703-004-5385,9380.658,3,0,3,0.27920371738274696
3430,703-004-5394,170.57419,5,4,1,5.541405924164667
34480,703-004-5392,9577.687,2,0,2,0.27920371738274696
34485,703-004-5387,8630.949,6,4,2,2.1976753490226715
34877,703-004-5396,1959.4603,5,0,5,0.27920371738274696
34913,703-004-5380,4020.2993,"","","",0.27920371738274696
35358,207-008-2399,2006.6356,3,1,2,0.655613441227389
35366,703-004-5384,6318.257,5,3,2,1.0055030159356613
35408,703-004-5393,5362.3076,3,3,0,1.0081400012683637
35448,703-004-5396,927.76416,5,2,3,1.3226384374211664
36474,207-008-2398,104.35581,7,4,3,6.1074293229515275
36494,703-004-5387,4928.08,3,2,1,1.0767902973333514
36569,703-004-5397,5944.444,5,1,4,0.5967743420678401
36669,703-004-5392,8882.109,4,3,1,1.3601781699324802
36696,703-004-5392,8906.237,2,1,1,0.4314860782385869
37170,703-004-5389,6762.006,3,1,2,0.4856891219327298
37310,703-004-5389,392.12762,6,3,3,0.8032621380434496
37548,703-004-5380,9343.919,2,0,2,0.27920371738274696
3783,703-004-5390,3738.4827,4,1,3,1.1983226520325618
3830,703-004-5382,7733.9546,4,3,1,1.250704298196026
38568,703-004-5384,6829.4565,4,1,3,0.33853450732658075
38809,703-004-5382,4624.911,4,3,1,1.0315743013808107
39154,703-004-5385,7638.6045,4,0,4,0.27920371738274696
39224,703-004-5395,1374.5588,1,0,1,0.27920371738274696
39306,703-004-5391,1120.7808,6,3,3,1.404893716912598
39440,703-004-5391,1554.6351,4,3,1,0.6645865758838885
39671,703-004-5384,2652.3477,5,3,2,0.98878794459202
40061,703-004-5397,545.98035,7,3,4,1.2535492737693779
40223,703-004-5381,9421.537,5,4,1,1.5980104636238004
40320,703-004-5395,4710.3594,5,1,4,1.1869904481798874
40382,703-004-5399,2878.8357,3,1,2,0.6246482876129467
40447,703-004-5383,6303.86,3,2,1,1.4606919360208095
405,703-004-5383,6958.043,5,3,2,0.9565490409227175
40745,703-004-5387,9329.11,5,2,3,1.361658212102685
40755,703-004-5393,5988.107,4,4,0,1.9729153655467886
41170,703-004-5399,5959.867,4,3,1,2.8742609509591204
4134,703-004-5392,1397.7688,3,2,1,0.784704562463987
41380,703-004-5393,9991.624,5,1,4,1.5031738991686658
42149,703-004-5396,2302.308,4,3,1,0.9529649491536456
42590,703-004-5382,4831.9883,6,2,4,0.5334427127531282
42911,207-008-2398,4829.4355,3,2,1,0.5933822245019924
43175,703-004-5396,6263.5244,5,1,4,0.3506231557776368
43316,703-004-5387,7098.124,4,4,0,1.9916163046121778
43363,703-004-5395,6138.0537,5,4,1,1.14761643400911
4351,703-004-5393,425.09854,4,4,0,0.8611882963601407
4451,703-004-5386,724.2918,2,1,1,0.33853450732658075
44763,703-004-5395,136.98459,4,3,1,1.5608422883444677
44945,703-004-5397,4630.2603,10,4,6,1.1231177351079524
45186,703-004-5399,9051.217,5,2,3,0.7258903339701038
45223,703-004-5390,2038.3799,3,0,3,0.27920371738274696
45600,703-004-5399,1824.0732,5,4,1,2.138044666571585
45684,703-004-5397,4109.7285,4,4,0,3.2104236862075437
4588,703-004-5391,6719.243,2,1,1,0.5942445823837074
46013,703-004-5394,4276.9067,2,1,1,0.7793661919921064
46048,703-004-5383,9855.012,3,3,0,2.0565119707762207
46051,703-004-5390,6388.205,8,4,4,1.5685723757651597
4611,703-004-5397,6453.5684,4,1,3,0.3781048826279685
46282,703-004-5394,5090.8403,7,2,5,0.6492462584299722
46570,703-004-5399,7258.1826,5,0,5,0.27920371738274696
46942,703-004-5399,371.33096,2,1,1,0.8530995371698528
47072,703-004-5385,6293.3413,7,2,5,3.192459404688674
47155,703-004-5398,8379.75,6,2,4,1.1730044383295062
47184,703-004-5384,2467.122,2,1,1,0.46439341696883324
47300,703-004-5386,1991.4221,4,2,2,1.1478341431788488
47486,703-004-5394,3486.5076,1,1,0,0.3978652972704144
47496,703-004-5383,4642.67,4,2,2,0.5934087560505372
47596,207-008-2398,5465.4507,2,0,2,0.27920371738274696
47755,703-004-5397,8286.922,1,1,0,1.2776738915138712
48374,703-004-5384,820.9127,6,3,3,1.1073991246890569
48394,207-008-2398,1341.3596,2,2,0,0.5345486046035214
48755,207-008-2398,2791.6116,7,4,3,1.4999493742267667
48840,703-004-5380,5050.4033,9,4,5,1.6267482987718298
49197,703-004-5383,1624.4573,4,2,2,0.7059578683441627
49214,207-008-2399,4638.4287,8,2,6,1.0956322068110154
49258,703-004-5388,797.75275,4,3,1,2.8272429288116006
49419,703-004-5396,9624.054,3,2,1,0.5074381713594568
49792,703-004-5383,4997.6235,4,1,3,0.7156158478515505
509,703-004-5389,9883.893,1,1,0,0.5184000413313702
5242,703-004-5397,8674.156,1,1,0,0.48263593918159187
5302,703-004-5391,2188.5657,5,1,4,0.35114230018964543
5671,703-004-5392,6778.5264,3,1,2,0.5046609725612307
5685,703-004-5381,4502.5977,3,2,1,1.7157214075328762
5772,703-004-5398,9717.042,4,2,2,0.5858202955799844
624,207-008-2398,2890.9504,4,2,2,0.5844178004925142
6743,703-004-5398,2312.4497,3,1,2,0.7827007263864582
7158,703-004-5383,4741.6953,2,0,2,0.27920371738274696
7270,703-004-5391,4301.05,5,2,3,0.7351426787077949
7692,207-008-2398,3132.3267,7,3,4,0.9066617082419859
7807,703-004-5389,963.72186,2,0,2,0.27920371738274696
781,703-004-5393,5426.2964,6,3,3,1.0065785488292174
8075,703-004-5390,6092.383,5,3,2,1.8533021895394648
8141,703-004-5389,5525.0303,5,4,1,3.2859837612224756
8207,703-004-5382,4759.6396,1,1,0,0.4362818601060239
8335,703-004-5385,2913.9673,1,0,1,0.27920371738274696
8508,703-004-5392,1094.3759,4,2,2,1.7678125739439705
8843,703-004-5394,9810.528,4,1,3,0.789541771837905
9040,703-004-5389,9586.653,6,4,2,1.200057459866959
9574,703-004-5380,8050.982,9,5,4,2.1525490419283493
9760,703-004-5390,6211.3013,4,1,3,0.6781125196729261
10244,703-004-5392,4700.011,5,3,2,0.9420661992354928
10589,207-008-2399,9236.671,3,1,2,1.4150921115733481
10700,703-004-5387,4285.6206,4,1,3,0.3615196508894215
10703,703-004-5392,6814.394,2,2,0,1.0775512174766428
10855,703-004-5392,9360.861,7,3,4,2.1997794664814805
10904,703-004-5392,5243.6543,5,2,3,0.7507344828073783
10918,703-004-5385,5197.9185,4,1,3,0.8430332815516576
1100,703-004-5394,6197.269,1,1,0,0.6199878320640895
112,703-004-5383,8755.894,4,1,3,0.7897273217093791
11249,703-004-5392,4496.3105,3,0,3,0.27920371738274696
11500,703-004-5380,7086.29,4,0,4,0.27920371738274696
11872,703-004-5381,5978.8823,5,3,2,1.2942686005933155
12125,703-004-5384,8377.754,6,4,2,2.2442490143242377
12603,207-008-2398,2533.7278,10,9,1,2.470878588304573
12967,703-004-5382,6855.4224,7,5,2,1.1423259351756894
13059,703-004-5394,2796.1118,2,1,1,0.4523381704630113
13160,703-004-5384,66.63621,5,4,1,2.238683995238674
13404,703-004-5386,3852.6875,1,0,1,0.27920371738274696
13419,703-004-5384,1517.6927,1,1,0,0.8695450773238925
13661,703-004-5399,3418.1465,2,2,0,0.9922121421809341
13769,703-004-5383,8494.71,3,2,1,0.6308183487216091
13806,703-004-5390,3546.5396,3,2,1,0.975081994650432
13902,703-004-5398,2859.146,1,0,1,0.27920371738274696
13938,703-004-5397,7537.609,2,2,0,0.5557127073023876
14419,703-004-5383,423.9297,6,2,4,0.9511189696723421
1470,703-004-5384,5483.3286,3,0,3,0.27920371738274696
14876,703-004-5383,562.69525,6,4,2,2.7100526290871274
15071,703-004-5381,5474.8003,4,2,2,0.7590833202011942
15180,703-004-5393,8061.477,6,3,3,1.1726374754665416
15306,703-004-5397,7544.1895,5,2,3,0.9403885662285
15494,703-004-5381,9130.026,5,3,2,1.0486984075771015
15544,703-004-5396,6717.3433,8,2,6,0.4601230728514773
16178,703-004-5380,2964.2808,6,4,2,1.2175266437975514
16386,703-004-5397,8837.049,4,2,2,1.8057069177927936
16690,207-008-2398,6919.93,3,2,1,0.5569934663537652
16978,703-004-5381,4528.626,3,2,1,1.208295932418848
17071,703-004-5395,6736.893,5,3,2,1.909597796427882
17138,703-004-5390,5127.632,4,2,2,1.0126015417987213
17145,703-004-5380,8936.975,3,1,2,0.8360307181678033
17220,703-004-5392,1804.0043,6,2,4,1.4589420190618214
1728,703-004-5382,3283.6355,3,1,2,0.4031806927841333
17283,703-004-5383,5653.095,6,2,4,1.545035165789457
17390,703-004-5380,8643.087,5,3,2,3.3449160631556767
17587,703-004-5385,9224.065,5,3,2,2.374641261014117
17977,703-004-5381,1025.6046,3,2,1,0.47697301719552604
18174,703-004-5383,8987.845,1,0,1,0.27920371738274696
18395,703-004-5383,4326.5044,2,0,2,0.27920371738274696
18618,703-004-5382,5389.1045,3,1,2,0.3978652972704144
18710,703-004-5380,7191.784,3,0,3,0.27920371738274696
18734,703-004-5393,6170.965,4,2,2,0.6270624607488198
18761,703-004-5399,7315.6396,1,0,1,0.27920371738274696
18799,703-004-5394,3072.8882,3,2,1,5.085832045078467
19311,703-004-5395,9267.002,4,1,3,0.6242140457946624
19376,703-004-5396,6054.7197,8,5,3,2.6955210053223215
19408,703-004-5382,2035.4199,1,0,1,0.27920371738274696
19530,703-004-5394,7059.7334,2,2,0,1.3048384157024155
19662,703-004-5393,4257.686,3,1,2,0.33853450732658075
19680,703-004-5394,9020.955,4,2,2,0.7667034185214984
19843,703-004-5381,8310.323,2,0,2,0.27920371738274696
20182,207-008-2398,7853.8013,6,5,1,2.0951835013749474
20249,703-004-5381,4919.5464,5,4,1,2.352087757107711
20389,703-004-5385,2065.069,5,1,4,0.7303550441156587
20969,703-004-5381,3984.0334,4,2,2,1.6067931625587106
21701,703-004-5397,6507.045,2,2,0,0.6761172872746426
21978,703-004-5382,4721.405,1,1,0,0.5507781919571136
22685,703-004-5384,1359.9313,6,3,3,1.4598421637711958
22687,703-004-5394,167.045,5,3,2,1.0706395558324298
22776,703-004-5397,6529.566,2,2,0,1.4516623125699057
23278,703-004-5380,9443.088,4,3,1,0.9115939065569285
23657,703-004-5389,6201.243,2,1,1,0.3919322182760311
23841,703-004-5395,9565.397,3,3,0,1.461940213455842
24130,703-004-5391,3583.5857,6,3,3,2.025214002992067
24511,703-004-5382,3335.7393,3,2,1,0.7245455709336582
24562,703-004-5381,2141.1992,4,3,1,1.4787764067432478
24740,703-004-5390,6776.2314,5,2,3,0.8427265004652574
24830,703-004-5394,8967.367,7,4,3,1.2696773487898774
24840,703-004-5390,1225.2855,5,3,2,1.6815099475741209
24982,207-008-2399,2699.8926,1,1,0,0.5808770519311639
25370,703-004-5387,811.8171,5,3,2,1.5682886118877932
25449,207-008-2399,451.9099,2,1,1,0.9899660808988787
25605,703-004-5397,4892.9946,3,0,3,0.27920371738274696
25656,703-004-5390,8320.897,7,5,2,1.6626785917200253
25754,703-004-5396,120.69464,5,2,3,0.4668050537691032
2587,703-004-5387,8216.004,6,3,3,1.2033953388918954
25918,703-004-5399,5432.0513,3,2,1,0.923197930392023
26000,703-004-5394,858.9077,2,1,1,0.35831143730785864
26125,703-004-5385,3485.9573,6,4,2,1.513600447797872
26317,703-004-5383,3098.2607,4,1,3,0.9128702111156295
26361,703-004-5389,2020.6666,3,1,2,0.6199741374744187
26605,703-004-5382,9011.317,4,0,4,0.27920371738274696
26706,703-004-5384,7175.649,6,5,1,2.3088623082966726
26707,703-004-5391,559.30853,5,1,4,0.623010568037715
26758,703-004-5388,4686.4434,2,1,1,0.8411168416565229
27090,703-004-5397,1102.1119,3,2,1,0.5086485738480445
27410,703-004-5394,1519.9429,5,1,4,0.5213062305072761
27489,703-004-5380,368.88004,1,0,1,0.27920371738274696
27878,703-004-5396,4846.969,8,2,6,2.124333068980451
27888,703-004-5389,4244.0645,5,2,3,0.980653217217777
2799,703-004-5382,8105.5474,1,1,0,0.3978652972704144
28228,703-004-5386,866.3559,5,2,3,1.1761499296389717
28245,703-004-5385,2850.0813,2,1,1,1.1696429197021667
28324,703-004-5391,8625.682,3,1,2,0.6702464660958329
28330,703-004-5395,4744.216,6,4,2,1.7469094978645965
28348,703-004-5393,2180.0728,3,2,1,0.5447902732030447
28513,703-004-5390,9422.647,3,3,0,0.6473641349759065
28750,703-004-5383,8299.564,7,2,5,1.161157910998782
28812,703-004-5397,823.46857,4,3,1,1.0019745985186088
2896,703-004-5390,6689.027,2,1,1,0.3919322182760311
28961,703-004-5381,3192.2053,4,3,1,1.5306322374142192
29575,703-004-5393,4449.563,4,2,2,0.776715758316819
29677,703-004-5387,5880.662,1,0,1,0.27920371738274696
29917,703-004-5395,3239.404,10,7,3,3.2217528367247934
29983,703-004-5393,1348.8871,2,0,2,0.27920371738274696
3074,703-004-5394,2178.3125,3,2,1,0.5967508535657557
31050,207-008-2398,3553.0132,2,1,1,0.4944717480314563
31913,703-004-5389,3154.3018,5,3,2,1.3991439579203115
32012,703-004-5383,7390.8174,3,2,1,0.6886921428131972
32321,703-004-5387,7770.335,1,1,0,0.4789739680341691
32780,703-004-5393,2990.2673,7,4,3,1.8886440843823646
33109,703-004-5391,3436.6577,4,2,2,0.7528611904343528
33294,207-008-2399,6386.6562,3,1,2,1.8239156675789592
33782,703-004-5390,740.17645,3,3,0,1.2667297356114395
33845,703-004-5390,7934.166,1,0,1,0.27920371738274696
33897,703-004-5391,1450.1215,3,2,1,0.8133468855744689
34067,207-008-2398,129.43924,6,3,3,1.048621945504578
34148,703-004-5396,7168.4355,3,3,0,1.5672901679552464
34214,703-004-5382,9196.592,3,2,1,0.5473689297065674
34871,703-004-5381,7793.3467,5,1,4,0.3805041752952334
3494,703-004-5388,519.14154,4,3,1,2.6071531560410075
34980,703-004-5392,3872.3958,4,2,2,0.6918054520031169
35078,703-004-5381,7233.7896,5,2,3,0.45719608721424815
35096,703-004-5392,843.77466,2,1,1,0.47337795893597145
35101,703-004-5385,4495.2554,4,1,3,0.5962367766717978
35210,703-004-5385,7157.5146,2,1,1,1.1874364853634354
35320,703-004-5393,5437.2866,5,2,3,1.179282197657699
35396,703-004-5383,1560.9855,3,2,1,0.7392929755928036
3550,703-004-5389,2247.1858,4,3,1,1.3950334832369182
35578,703-004-5389,3222.0955,5,3,2,1.1683615112934302
35639,703-004-5392,2256.9739,4,1,3,0.7156125200531901
35834,703-004-5399,8610.897,3,0,3,0.27920371738274696
35894,703-004-5388,4525.4116,1,0,1,0.27920371738274696
36146,703-004-5399,9295.01,4,3,1,1.2033423900165925
36570,703-004-5390,7114.98,4,1,3,1.0017780398450118
36873,703-004-5384,8015.09,1,0,1,0.27920371738274696
36891,703-004-5394,8292.828,6,3,3,0.8282257978808443
37072,703-004-5395,2838.3071,8,5,3,1.9918123873821239
37174,703-004-5385,4374.81,"","","",0.27920371738274696
37204,703-004-5386,7605.836,4,1,3,0.8441235190859464
37209,703-004-5399,2665.6675,3,2,1,0.7567230228423609
37219,703-004-5394,9113.16,2,1,1,0.576560332018608
37454,703-004-5399,3065.9407,8,6,2,2.1306362088052757
37657,703-004-5397,9013.594,8,6,2,3.3524285701002734
37931,703-004-5391,9186.671,2,2,0,0.8599934510276405
38051,703-004-5390,4343.9883,1,0,1,0.27920371738274696
38171,703-004-5398,5635.062,2,0,2,0.27920371738274696
38303,703-004-5389,4761.762,1,0,1,0.27920371738274696
38432,703-004-5383,805.82916,3,2,1,1.0139980627195049
38520,703-004-5394,3679.6147,5,3,2,1.876074896132356
38571,703-004-5380,1410.7275,4,3,1,1.4478092890217005
39063,703-004-5386,2539.6191,2,1,1,0.37594025277718573
3922,703-004-5394,5257.225,7,3,4,1.3448080992706009
3933,703-004-5391,9862.479,7,3,4,0.9771351465897377
39587,703-004-5383,4656.885,2,1,1,0.37512182779194486
39703,703-004-5396,6646.777,7,5,2,1.527214670710635
39844,703-004-5388,7169.139,3,1,2,0.5295350353417972
39994,703-004-5380,2573.6375,7,4,3,1.8686223488760487
40196,703-004-5383,9457.624,9,6,3,2.2113174319534066
40446,703-004-5384,2164.2,1,0,1,0.27920371738274696
40456,703-004-5385,5157.2915,5,3,2,0.8984302303431659
4059,703-004-5389,4254.856,4,2,2,1.9454062928681843
40728,703-004-5383,1507.9933,2,1,1,0.43808481451064746
40800,703-004-5389,2990.8257,5,1,4,0.6222553800366724
40911,703-004-5386,1560.2697,5,0,5,0.27920371738274696
41112,703-004-5381,3377.368,5,2,3,1.063584358509659
41131,703-004-5398,147.08997,5,3,2,3.5337410517444567
42,703-004-5380,2139.6147,3,2,1,2.37713108367455
42393,703-004-5384,5783.985,8,4,4,2.0204459185904775
424,703-004-5393,2623.5974,3,2,1,1.4263373077496155
42497,207-008-2399,9695.314,2,1,1,0.5219534501929978
42665,703-004-5386,1455.6014,7,3,4,1.6976968888161201
42683,703-004-5395,2047.8434,2,1,1,0.9751968976666507
4272,703-004-5398,2456.0862,6,3,3,1.637724641033075
43002,703-004-5380,2590.466,4,2,2,1.8297868758378975
43056,703-004-5380,6663.4106,1,0,1,0.27920371738274696
43071,703-004-5397,3127.035,2,0,2,0.27920371738274696
43485,703-004-5389,2172.979,8,4,4,1.087148483371602
43674,703-004-5390,5494.6714,3,0,3,0.27920371738274696
43749,703-004-5389,6966.3667,6,3,3,1.830786617257431
43945,703-004-5380,1200.381,3,0,3,0.27920371738274696
44084,703-004-5384,3484.8362,6,4,2,1.2050989888683656
44174,703-004-5386,6151.719,6,3,3,1.2785075068307632
44188,703-004-5387,787.8381,3,0,3,0.27920371738274696
44306,703-004-5386,3036.3672,1,1,0,0.33853450732658075
44317,703-004-5387,9849.507,6,1,5,0.7628928419431288
44532,207-008-2398,8567.804,5,3,2,1.7911927360420534
44688,703-004-5386,5114.7524,9,2,7,0.7145871896886427
44833,703-004-5387,1129.2815,6,3,3,2.12968798441362
45562,703-004-5392,5263.421,2,1,1,0.5925635247404089
45627,703-004-5394,887.31946,7,3,4,2.3104690135281176
4573,703-004-5383,4653.2144,7,2,5,0.8252873875272684
45924,207-008-2398,5402.3003,2,2,0,0.7636331944277106
45988,703-004-5383,2766.763,4,1,3,0.7539815226163392
46091,703-004-5395,5684.5923,3,2,1,0.5760245349486327
46145,207-008-2399,1609.9346,2,0,2,0.27920371738274696
46254,703-004-5396,2690.7468,6,4,2,2.0050652122039296
4626,703-004-5393,86.326004,6,3,3,1.2771057570296607
46480,207-008-2399,6481.4077,2,1,1,0.6277302949363004
46757,703-004-5380,3964.6172,4,4,0,1.3984727591261172
46895,703-004-5395,8269.365,5,4,1,0.9356464780480521
47339,703-004-5380,7041.2505,6,0,6,0.27920371738274696
48103,703-004-5387,7867.789,3,1,2,0.5094252635741041
48132,703-004-5397,289.86038,4,0,4,0.27920371738274696
48234,703-004-5386,7564.5,3,2,1,0.927870739176855
48289,703-004-5389,9770.518,3,2,1,2.1577520580590304
48306,703-004-5394,7963.907,4,4,0,2.895457304088023
48324,703-004-5385,7101.0425,4,3,1,0.6124774757393106
48501,703-004-5393,7828.8345,7,5,2,1.8864875735497018
48742,703-004-5394,8424.144,4,1,3,0.5685642372866873
48887,703-004-5397,4574.955,5,1,4,0.4813594160320801
49092,703-004-5395,5657.2485,5,3,2,0.8155629773687939
49310,703-004-5380,3794.855,4,3,1,1.0095286391846887
49438,703-004-5381,3315.1245,6,2,4,0.43445261773577853
534,703-004-5390,9107.63,6,1,5,0.80243276096274
5727,703-004-5381,7261.8657,1,1,0,0.4564293063101202
5809,703-004-5386,3220.443,6,4,2,1.6639225811973104
586,703-004-5397,1474.7262,5,3,2,0.796492302721448
6249,703-004-5384,3007.7505,2,1,1,0.33853450732658075
6571,703-004-5384,3109.0808,6,3,3,0.9410698503091244
6831,703-004-5396,3273.2178,3,2,1,1.306117436111123
6851,703-004-5392,4741.883,3,1,2,0.5394639611630696
7280,703-004-5391,7832.963,5,2,3,0.45719608721424815
7720,207-008-2399,9208.583,4,2,2,0.7695609370601347
8267,703-004-5398,7396.122,5,2,3,0.6966697730825467
8444,703-004-5392,1827.7943,2,0,2,0.27920371738274696
863,703-004-5381,4414.2544,6,2,4,1.4822826686701478
8635,703-004-5390,4855.383,4,2,2,0.6052595550828007
9250,703-004-5396,1473.369,3,1,2,0.5819957692944145
9293,703-004-5389,544.09503,1,1,0,0.7099063172459407
9420,703-004-5399,4074.8608,1,0,1,0.27920371738274696
9537,703-004-5393,7101.122,2,0,2,0.27920371738274696
9545,703-004-5395,5650.265,3,1,2,0.3477373720778687
991,703-004-5392,2350.681,4,2,2,0.5593439305675486
9962,703-004-5384,315.9219,5,1,4,0.6734538097216937
10130,703-004-5395,3978.8413,6,2,4,1.3742608777394767
10325,703-004-5382,3201.4846,6,2,4,0.5480673123761343
10334,703-004-5399,9563.756,2,0,2,0.27920371738274696
10339,703-004-5392,9233.211,6,3,3,1.46965558557358
1042,207-008-2398,8586.685,5,1,4,0.4661586392775217
10466,703-004-5396,8555.289,5,2,3,0.6332433863320439
105,703-004-5390,7204.3916,5,4,1,1.6704406759153267
10506,703-004-5388,3601.7883,7,4,3,1.2580960222599442
10806,703-004-5388,8209.033,3,1,2,0.5204962108466187
11076,703-004-5397,1280.8639,7,3,4,0.9451745587689004
11093,703-004-5390,8086.569,3,0,3,0.27920371738274696
11132,703-004-5394,8736.708,2,1,1,0.3978652972704144
11142,703-004-5388,9019.86,5,2,3,0.9427867645894251
11159,703-004-5392,872.4922,2,1,1,0.5675988783853712
11174,703-004-5391,4328.506,3,2,1,1.0261844972494794
11235,703-004-5389,1893.273,4,2,2,0.6237254629713033
11323,703-004-5398,4252.62,8,5,3,2.1433198657738286
11392,703-004-5386,3411.0452,7,2,5,0.8610770927666531
11468,703-004-5394,269.2586,2,1,1,0.693299879663735
11594,703-004-5389,1807.245,8,6,2,0.8813044212967317
1168,207-008-2399,3279.9893,5,2,3,0.7980825078782029
11804,703-004-5386,5489.517,3,2,1,0.5165268771580819
11823,703-004-5387,1271.903,2,1,1,0.33243191178950066
12027,703-004-5381,9048.937,2,0,2,0.27920371738274696
12187,703-004-5393,1155.091,5,1,4,0.4851215510430012
12233,703-004-5384,3917.2488,5,4,1,2.239276876038468
12295,703-004-5384,9712.726,8,3,5,1.0491436392932694
12686,703-004-5393,9917.013,7,3,4,3.5044490777419726
13150,703-004-5385,6583.316,5,2,3,0.7564115751952771
13176,207-008-2399,8032.115,9,5,4,2.2191373986708145
13422,703-004-5382,8496.17,1,0,1,0.27920371738274696
13586,703-004-5386,6952.927,6,2,4,0.6543308227674102
13674,703-004-5392,8699.539,6,3,3,1.2389161677568523
14017,703-004-5385,9944.59,1,1,0,0.5039307462907889
14575,703-004-5390,7511.158,3,2,1,0.47372960067859654
14767,703-004-5383,7872.6704,9,3,6,0.7510880379930858
15008,703-004-5380,8190.006,4,1,3,0.33556796782938897
15165,703-004-5391,8086.9443,3,2,1,1.1414190498889691
15189,703-004-5383,9643.261,4,2,2,0.8662812252259228
15264,703-004-5396,8703.696,3,1,2,0.3978652972704144
15668,703-004-5387,5213.2124,3,1,2,0.3613718843467488
16034,703-004-5392,847.47614,4,3,1,1.8033760668796415
16078,703-004-5388,3788.6853,5,4,1,0.9943537844648856
16395,703-004-5392,2083.9011,5,3,2,1.1957928045327644
16400,703-004-5387,3238.5486,2,2,0,1.7587183602882615
16720,703-004-5397,3906.4307,2,0,2,0.27920371738274696
17635,703-004-5392,657.8064,2,1,1,0.7743198036605257
17732,703-004-5383,3181.5671,7,4,3,1.8957533414079648
17776,703-004-5385,241.07396,5,2,3,1.3348065709733987
1780,703-004-5385,8394.879,2,0,2,0.27920371738274696
18196,703-004-5388,4422.238,2,2,0,2.033533770764033
18358,703-004-5391,376.52136,2,1,1,0.5165268771580819
1859,207-008-2398,5546.7393,5,1,4,0.5698870390023694
18759,703-004-5381,6127.2354,4,1,3,0.5469368996599587
1896,703-004-5390,1765.2106,5,3,2,1.7618613438595525
18969,703-004-5398,6454.2427,1,1,0,0.8719966057415052
19009,703-004-5397,570.51184,8,6,2,1.8289187778508225
19113,703-004-5383,1348.6553,4,1,3,0.32666834933781397
19348,703-004-5382,3003.1406,3,1,2,1.0707347030862526
19669,703-004-5390,4728.5557,1,0,1,0.27920371738274696
19932,703-004-5392,5169.571,7,3,4,0.9002638722300532
20188,703-004-5396,704.0751,5,4,1,2.8649748377291573
2021,703-004-5390,7563.9976,6,2,4,0.5479361234830167
20288,703-004-5386,4197.8506,5,4,1,3.364705536187291
20729,703-004-5381,1989.6525,6,3,3,0.6745843782165749
20998,703-004-5398,626.15454,3,1,2,0.633598914600279
21596,207-008-2399,4693.908,1,1,0,0.5857730546615808
21605,207-008-2399,3580.6907,5,2,3,0.9922772162462237
21736,703-004-5383,5832.014,3,0,3,0.27920371738274696
22005,703-004-5390,6373.915,9,5,4,1.5993856207569668
22188,703-004-5396,8755.133,2,1,1,0.6031969806555315
22223,703-004-5391,6129.216,5,3,2,1.851278143619631
22610,207-008-2398,2800.8855,3,2,1,0.9759475394223985
22771,703-004-5386,8272.725,6,2,4,0.45719608721424815
22837,207-008-2399,1300.689,6,3,3,0.9954322605355707
22879,703-004-5387,4870.8164,3,0,3,0.27920371738274696
22966,703-004-5394,209.8155,5,4,1,1.41580826740624
23016,703-004-5392,479.3036,3,2,1,1.213407222707255
23130,703-004-5386,2416.7854,3,1,2,0.5774711446925398
23345,207-008-2399,1899.15,2,0,2,0.27920371738274696
23502,703-004-5396,3311.0422,5,2,3,0.575737064263492
23637,703-004-5399,9442.923,2,2,0,0.8158476406070363
237,703-004-5389,2533.444,6,4,2,1.416594217834008
23830,703-004-5398,7797.932,5,4,1,2.1949435432164597
23905,703-004-5386,5336.7847,5,1,4,0.4541741636328488
24060,703-004-5385,3306.1003,4,3,1,1.1939185303922
24250,703-004-5385,9105.258,3,1,2,0.5163978430037922
24389,703-004-5396,1754.2166,3,1,2,0.8112893419465588
24802,703-004-5386,4168.159,3,2,1,1.1087275005422967
24858,703-004-5386,3237.686,7,1,6,0.5622358626683505
24886,703-004-5397,3636.4138,5,4,1,1.7295432605398355
2492,703-004-5395,9482.347,9,3,6,1.1043683639208808
25004,703-004-5387,7363.276,1,0,1,0.27920371738274696
25223,703-004-5394,1834.0992,4,2,2,1.5838673298810468
25498,703-004-5391,5841.827,6,3,3,1.061724030238914
25548,703-004-5388,5840.3706,3,1,2,0.7819502180275978
25742,703-004-5394,4049.5432,1,1,0,0.3978652972704144
25745,703-004-5388,7229.2993,5,1,4,0.5010690539107101
25801,703-004-5383,4170.019,2,1,1,0.4798853900506104
25904,703-004-5396,6960.336,3,2,1,0.984230391663647
26060,207-008-2399,5588.611,3,3,0,1.3235611922851376
26322,207-008-2398,974.375,3,1,2,0.5628642429802623
26395,703-004-5383,7522.87,4,2,2,1.0795632640609094
26527,703-004-5390,8407.379,5,2,3,0.921109984555092
26702,703-004-5387,4717.6133,4,2,2,1.3055010008820662
26736,703-004-5398,8466.637,2,1,1,0.4936872927176388
26743,703-004-5398,2403.5728,3,2,1,0.7673351256889889
27031,703-004-5387,4480.4375,3,2,1,0.5094442641085367
27149,703-004-5387,7300.6235,2,1,1,0.36241505826327547
27209,703-004-5384,2100.2585,1,1,0,0.8605419495290468
27220,703-004-5388,3112.871,7,2,5,0.9259911758255557
27267,703-004-5386,1928.0046,6,3,3,1.6133445863770777
27303,703-004-5386,9403.686,5,2,3,1.0209484029036355
27500,703-004-5389,7460.5205,5,2,3,1.4021188814431713
27820,703-004-5387,7403.9487,6,3,3,0.7527670142208819
27955,703-004-5384,9624.194,4,2,2,0.615887082578347
28149,703-004-5385,8228.932,2,0,2,0.27920371738274696
28261,703-004-5387,2893.1458,3,1,2,0.7764785652594401
28621,703-004-5388,9788.049,6,1,5,0.3325110195094258
289,703-004-5380,6199.0903,1,1,0,0.8402931693380966
28938,703-004-5383,9119.293,2,2,0,1.9175948180363371
29274,703-004-5396,5963.3584,3,2,1,0.6956826438209198
29447,703-004-5389,3152.606,5,1,4,0.5899687459545748
29638,703-004-5389,2518.6301,3,1,2,0.7625774824633396
29651,703-004-5398,1056.6598,3,1,2,0.44829646872267315
29799,703-004-5393,9160.489,6,3,3,2.1427931790721155
29811,703-004-5392,9171.857,5,3,2,1.4002333470959039
30229,703-004-5383,1897.2665,7,3,4,1.1153310304017894
30479,703-004-5381,8404.023,4,3,1,1.3584661663914435
30491,703-004-5383,9130.406,2,2,0,1.1049927394501502
30532,703-004-5384,4183.7905,6,1,5,0.5668222418742269
30601,703-004-5395,552.6352,4,2,2,0.7421175068872887
30756,703-004-5385,435.31836,7,4,3,1.361277911709323
30834,703-004-5392,7867.1597,12,6,6,1.814871193271097
31124,703-004-5397,3097.695,2,1,1,0.4225645906985267
31172,703-004-5387,466.64716,4,1,3,0.525978617591119
31203,703-004-5382,206.303,4,3,1,1.1088382977464517
31280,703-004-5381,9748.353,3,1,2,0.35831143730785864
3132,703-004-5393,6447.3765,2,1,1,0.3187575773453028
31335,703-004-5388,986.6017,1,1,0,0.41357716838951086
3189,703-004-5389,7064.524,2,0,2,0.27920371738274696
32782,703-004-5395,7593.9004,1,1,0,1.9242595780002651
32958,703-004-5397,9014.899,"","","",0.27920371738274696
33617,703-004-5388,5347.109,8,6,2,2.829240934310478
33666,703-004-5388,8029.093,7,4,3,1.4712319170716444
33756,703-004-5393,3706.6143,1,1,0,1.5139352389150125
3387,207-008-2399,7527.2705,1,1,0,0.8317705760599059
33974,703-004-5393,5048.1953,2,1,1,0.783129766551407
3411,703-004-5380,2301.2363,7,1,6,0.33853450732658075
34190,703-004-5394,4920.609,6,2,4,1.7359913480956262
3439,703-004-5399,496.0978,4,2,2,0.7767249742204818
3442,703-004-5395,8124.786,4,1,3,0.4180377658513179
34442,703-004-5396,2224.5073,4,2,2,1.0152864220682483
34454,703-004-5389,6826.0537,7,1,6,0.4524145674117556
34647,703-004-5394,7838.9966,3,2,1,0.593467172411827
34701,207-008-2398,8871.652,2,2,0,1.3286942165923383
3492,703-004-5399,4739.4453,1,0,1,0.27920371738274696
35902,703-004-5395,8096.194,1,0,1,0.27920371738274696
35974,703-004-5394,9573.279,4,3,1,1.5743919001016233
36125,703-004-5393,4913.517,8,5,3,1.6048352028270243
36279,703-004-5394,8414.893,4,1,3,1.2508853578553463
36318,703-004-5380,1096.0388,7,5,2,2.122808466014672
3632,703-004-5389,6541.7563,3,0,3,0.27920371738274696
36423,703-004-5397,2915.0188,6,5,1,1.2052510100935498
36429,703-004-5380,5903.7437,4,0,4,0.27920371738274696
3644,703-004-5386,8569.823,12,6,6,1.4357299174455411
36458,703-004-5398,4075.6829,1,1,0,0.5165268771580819
36681,703-004-5387,5457.537,5,3,2,1.1641544033706772
36723,703-004-5383,2995.277,5,3,2,1.492216387799496
3694,207-008-2398,3629.2083,5,0,5,0.27920371738274696
36965,703-004-5380,9340.983,4,2,2,0.9378339785590982
37024,703-004-5398,9433.919,5,4,1,1.5497013320104331
3768,703-004-5383,4454.992,6,2,4,1.6602706882093816
3787,703-004-5380,5300.653,3,2,1,0.7063062972584245
37989,703-004-5398,9653.807,4,2,2,1.137492704702948
37997,703-004-5383,5938.056,5,3,2,3.0685301112424397
38013,703-004-5392,9378.421,3,1,2,0.729660982873914
38462,703-004-5383,2427.1548,4,2,2,1.008779010048987
38635,703-004-5398,9840.838,4,2,2,0.6307293748061827
38775,703-004-5380,4045.7112,3,2,1,0.6579827470802221
3878,703-004-5388,7602.8823,3,0,3,0.27920371738274696
38992,703-004-5393,1999.9009,4,3,1,2.3131567198425147
39071,703-004-5380,5106.6235,1,1,0,0.3889656787788394
3948,207-008-2399,3197.4917,6,4,2,3.078312775055777
39577,703-004-5382,2606.8335,6,2,4,0.6368571355129197
39660,703-004-5398,2576.478,4,0,4,0.27920371738274696
39940,703-004-5383,685.9207,5,4,1,1.941877113253282
39990,703-004-5390,3966.9014,4,2,2,0.9506652585852314
40100,703-004-5383,3662.0684,3,2,1,0.712861336603104
40318,207-008-2398,541.87,4,1,3,2.1544399186847825
40384,703-004-5394,7815.967,6,1,5,0.670340146595029
40397,703-004-5393,7528.4453,7,2,5,0.6013105759878202
41140,703-004-5390,9184.329,4,4,0,1.6587832356663108
41176,703-004-5394,1358.8094,3,2,1,0.5758576671019155
41201,703-004-5391,7032.4805,1,1,0,0.703359158318418
41277,703-004-5392,5715.8765,1,0,1,0.27920371738274696
4135,703-004-5387,4023.3213,5,4,1,2.0876335286140253
41432,703-004-5396,1721.4329,4,1,3,0.4942114845002978
41622,703-004-5381,7911.261,3,0,3,0.27920371738274696
41963,703-004-5381,9947.72,2,0,2,0.27920371738274696
4211,703-004-5392,6083.5464,2,1,1,0.41321601367308164
42116,207-008-2398,5858.8545,4,2,2,1.0486560389425224
42263,703-004-5391,5778.75,6,5,1,1.7387621046979587
42516,703-004-5399,7427.8687,3,2,1,1.5314656135538802
4274,703-004-5395,5016.7085,6,2,4,0.49895507486971646
42788,703-004-5381,9904.37,5,2,3,2.8678033830703624
43068,703-004-5385,7036.9824,5,3,2,0.7177102452401608
43095,703-004-5385,4367.2725,5,4,1,1.8708315211869402
43287,703-004-5390,5036.959,5,2,3,0.6012616641378119
43479,703-004-5381,4711.951,3,1,2,0.4819172496908456
43583,207-008-2398,7064.7627,5,3,2,1.6954990708674136
43590,703-004-5385,4404.543,1,1,0,0.8556562707448646
43851,703-004-5381,3905.7922,2,1,1,0.49772830171437116
43853,703-004-5386,384.53043,4,3,1,2.7317743825265324
43950,703-004-5387,7553.455,1,1,0,0.42211180665403436
44086,703-004-5393,1092.6968,5,5,0,1.3878687008161013
44340,703-004-5389,7353.224,4,1,3,0.3946526689012526
44344,703-004-5386,2004.4196,9,3,6,4.5184155668363895
44353,703-004-5383,8550.967,1,1,0,0.3822662437476815
44410,703-004-5397,5502.2266,5,1,4,0.5016452071078396
44728,703-004-5388,8382.923,6,1,5,1.4676896734044187
44748,703-004-5398,8935.562,4,1,3,0.33853450732658075
44978,703-004-5398,1904.0417,9,5,4,2.1628272673791105
45052,703-004-5390,5339.0054,6,5,1,1.9649314350135616
45137,703-004-5394,2851.938,5,1,4,0.3637500930527101
45152,703-004-5390,510.80405,5,1,4,0.5165268771580819
45357,703-004-5398,1804.0907,5,3,2,1.4300513764285319
45758,703-004-5397,9720.487,7,3,4,1.8687717811047395
45835,703-004-5382,1518.2698,"","","",0.27920371738274696
45902,703-004-5397,1662.8724,1,1,0,1.009690488762239
46536,703-004-5394,5997.203,3,2,1,0.8502676763071558
46543,703-004-5381,2121.477,2,1,1,0.4662275519056985
46940,703-004-5387,3926.3523,3,0,3,0.27920371738274696
46985,703-004-5397,9864.746,5,2,3,0.4184995277364254
47173,703-004-5392,1925.078,3,3,0,1.6111083326485125
47177,703-004-5381,6840.49,4,3,1,0.7249344946938417
47293,703-004-5391,1757.1085,3,2,1,1.1386720366895449
47318,207-008-2398,3262.9465,6,4,2,1.0236416206161505
47383,703-004-5393,2110.1094,1,1,0,0.42617308097350837
4743,703-004-5398,3631.9006,4,0,4,0.27920371738274696
47478,703-004-5382,603.8588,3,2,1,1.179960943095957
48246,703-004-5388,6028.6475,4,1,3,0.3978652972704144
48371,703-004-5382,9465.256,5,2,3,1.082366393779507
48427,703-004-5385,5612.5806,3,3,0,1.5821448924241868
48523,703-004-5389,2642.8765,3,1,2,0.3811903583617409
48594,703-004-5386,7601.952,4,2,2,0.7728424901319186
4913,207-008-2399,421.7887,4,2,2,0.36622220930036975
49135,703-004-5388,9410.739,5,4,1,2.0213886189497536
4939,703-004-5397,5817.1396,3,2,1,0.8051477788120408
49396,703-004-5380,7902.7866,2,2,0,0.7996176240492876
49435,703-004-5387,4566.917,3,1,2,0.782622206360323
49724,703-004-5380,3515.5774,3,1,2,0.789541771837905
49797,703-004-5387,9685.06,3,1,2,0.3131070259220805
49876,703-004-5390,1930.2625,2,1,1,0.49252040348868303
49936,703-004-5391,6209.1636,2,2,0,0.9789346909090133
5245,703-004-5389,3298.887,1,0,1,0.27920371738274696
5405,207-008-2398,6979.046,3,2,1,1.2095512549776422
550,703-004-5380,3854.5264,1,1,0,0.4973806887499929
5626,703-004-5381,5432.899,4,2,2,0.9791876744499807
5725,703-004-5384,8059.76,4,1,3,0.6409541381122656
5876,703-004-5390,8055.6826,3,1,2,0.5343687030659311
5917,703-004-5381,8635.768,6,5,1,2.4279725206174034
5992,703-004-5382,4862.1445,4,1,3,1.0515287590316083
6065,703-004-5394,2848.8337,3,3,0,1.2049302864285814
6454,207-008-2398,9030.662,5,4,1,1.2604500859646761
646,703-004-5397,2833.848,7,1,6,0.5323268137889564
6873,703-004-5380,2275.2917,5,1,4,0.3468408179187174
6977,703-004-5387,5968.882,3,1,2,0.5254888910909039
7410,703-004-5399,7497.8286,6,3,3,0.722228417044044
7426,703-004-5390,6948.931,3,2,1,0.47697301719552604
774,703-004-5384,8844.076,5,2,3,0.524320067224564
7819,703-004-5391,2217.4639,3,2,1,1.4481927455617685
8018,703-004-5384,9687.917,2,2,0,0.6501376601580432
8544,703-004-5380,1937.688,8,1,7,0.5248238792815053
8616,703-004-5396,8845.815,8,6,2,2.676352661392631
8694,703-004-5381,7328.0293,3,3,0,0.8356072716192317
8973,703-004-5391,4708.093,5,2,3,1.948420907557886
9454,703-004-5384,7159.051,4,3,1,1.2502267470427593
9529,703-004-5395,9777.23,3,2,1,1.8148622335828974
9649,703-004-5383,1327.3143,6,3,3,1.3183488956419604
9845,207-008-2399,3251.236,1,0,1,0.27920371738274696
9850,703-004-5386,6647.6987,5,2,3,1.0116238859359206
10233,703-004-5394,7586.6675,4,3,1,0.9584790851494205
10497,703-004-5387,7834.1577,1,1,0,0.40622105018750443
10524,703-004-5391,7944.442,4,1,3,0.6846307819989441
11071,703-004-5387,1633.9934,4,3,1,1.4624047971573537
11145,703-004-5383,7808.4346,5,1,4,0.5472763627253414
1165,703-004-5380,6713.8696,2,1,1,0.49809437911401166
1171,703-004-5397,8452.067,3,1,2,0.3624893137664036
11769,207-008-2398,7071.2207,5,2,3,1.426853267537636
11776,207-008-2399,2613.0999,7,4,3,2.9530010233549784
12033,703-004-5385,3355.1787,2,0,2,0.27920371738274696
12107,703-004-5398,199.03839,7,4,3,1.108259117277091
12504,703-004-5396,6123.528,5,3,2,2.27222336986223
12534,703-004-5387,248.80052,5,4,1,1.4994718510838045
12586,703-004-5393,7332.669,3,1,2,0.44044850559882404
12607,703-004-5387,2787.3342,3,1,2,0.9665791728817749
12718,207-008-2398,6795.666,4,0,4,0.27920371738274696
12774,703-004-5386,7060.8403,7,3,4,1.2136729215098743
12853,703-004-5386,4610.764,6,3,3,1.0803026683931891
13139,703-004-5396,8350.245,5,2,3,0.5663097662412725
13167,703-004-5393,9994.981,7,1,6,0.3978652972704144
13458,703-004-5390,1279.118,3,2,1,0.7356918727914074
13577,703-004-5396,9838.764,6,3,3,2.4821120598749604
1391,207-008-2399,6308.227,3,2,1,0.5630376842609268
13980,703-004-5391,8643.18,3,2,1,1.0214785648157063
14132,703-004-5380,9162.857,4,3,1,0.7351447335503536
14557,703-004-5399,812.26886,2,1,1,0.8328038906864702
14834,703-004-5385,4269.134,4,1,3,0.5336437882456022
15207,703-004-5393,7354.696,4,1,3,0.5613233840987127
15213,703-004-5395,7865.7197,5,0,5,0.27920371738274696
15594,703-004-5388,9200.152,5,1,4,0.4296536428823082
15969,703-004-5398,4895.486,1,1,0,0.9574719989990597
16025,703-004-5381,1290.651,3,3,0,0.6884928762905104
16026,703-004-5380,120.992065,6,5,1,2.086773127573773
16039,703-004-5388,50.236584,1,1,0,0.6572973125727741
16848,703-004-5396,5454.802,4,3,1,0.7290621668521503
16944,703-004-5381,9451.33,3,3,0,0.9559264920323709
17013,703-004-5380,2612.447,5,3,2,0.789866681819309
17209,703-004-5383,5149.484,7,5,2,2.0765280023535038
17229,703-004-5395,5239.1196,2,0,2,0.27920371738274696
17511,703-004-5381,6544.492,6,4,2,0.9698575168057991
17541,703-004-5386,5148.2188,5,3,2,1.2004190060219317
17617,703-004-5381,9146.652,6,3,3,0.9327719160815927
1771,703-004-5382,3598.0713,5,3,2,1.142900410298375
17719,703-004-5392,3253.9492,7,6,1,1.3975868715399762
17873,703-004-5391,9667.614,1,0,1,0.27920371738274696
17925,703-004-5394,9325.105,3,1,2,0.3254817335389373
18101,703-004-5383,4204.027,1,1,0,1.374286329027198
18425,703-004-5380,2132.237,5,3,2,1.0653126085103206
18477,703-004-5386,7335.588,2,1,1,0.4474843541575039
18588,703-004-5393,7473.6123,6,3,3,0.7323314794246453
18599,703-004-5387,3323.5503,4,2,2,1.4498934569977944
18655,703-004-5384,283.6734,5,3,2,1.5490282358359815
19140,703-004-5393,2533.3489,4,2,2,0.4714769025645356
19454,703-004-5384,9544.863,1,0,1,0.27920371738274696
19765,703-004-5383,6649.2217,2,2,0,0.7150853586288646
20099,703-004-5396,7609.208,6,2,4,1.7511557791320795
20365,703-004-5396,5503.394,3,3,0,0.6401326895410688
2038,703-004-5393,8651.11,2,1,1,0.35831143730785864
20380,703-004-5395,6870.231,2,1,1,1.1723669826234804
20534,703-004-5399,3290.77,4,3,1,0.7538500369334169
21204,703-004-5389,973.0059,5,2,3,1.8891876174797924
21716,703-004-5384,9412.416,1,1,0,1.6821717439142236
22736,703-004-5392,7143.865,3,2,1,0.4736768621986464
22868,703-004-5397,1390.8082,1,1,0,0.5109448716324161
2297,703-004-5388,5524.7188,4,1,3,0.6110090260786424
23046,703-004-5397,832.5857,9,3,6,0.8579406101559598
23143,703-004-5392,5188.804,2,1,1,0.44829646872267315
23442,703-004-5395,4263.3516,2,0,2,0.27920371738274696
23549,703-004-5384,8360.861,5,5,0,1.7923366658232665
23824,703-004-5399,2505.967,7,5,2,1.8265262369024489
23863,703-004-5384,9315.82,8,3,5,1.5200439060542077
24284,703-004-5387,1111.7893,2,1,1,0.35831143730785864
24311,703-004-5399,1631.4178,7,2,5,1.5407738813257073
24606,703-004-5381,5817.6816,2,0,2,0.27920371738274696
24821,703-004-5382,3329.6758,8,4,4,1.7838586649302215
24836,703-004-5392,4633.297,4,2,2,0.589288790855458
24958,207-008-2398,4942.0547,3,0,3,0.27920371738274696
25038,703-004-5392,6404.422,7,5,2,3.023171389085558
25093,703-004-5382,9393.488,10,1,9,0.6020613428704201
25273,703-004-5388,6926.4966,4,4,0,1.6286173999942444
25288,207-008-2399,9727.153,4,3,1,1.6057447323354637
25579,703-004-5394,6749.563,4,3,1,1.3869999984805546
25581,703-004-5380,5033.6157,7,2,5,1.3072541362786279
25616,703-004-5387,2405.8325,4,2,2,0.7580022767313958
25730,703-004-5398,2286.6506,6,2,4,1.4855442057633
26056,703-004-5399,2521.7234,5,2,3,0.670435589907011
26463,703-004-5380,155.44832,5,1,4,0.5367499082974474
26889,703-004-5383,6890.8667,5,3,2,0.8390263798604
26954,703-004-5395,8353.856,5,3,2,2.0321693960117715
27148,703-004-5398,2159.1926,5,4,1,1.601438247822107
27206,703-004-5391,6156.9272,"","","",0.27920371738274696
27648,703-004-5395,3538.698,4,2,2,0.8465180281622793
27957,703-004-5389,3582.5986,3,3,0,1.3352371843949826
28038,703-004-5389,9982.85,1,0,1,0.27920371738274696
28089,703-004-5395,9353.057,1,1,0,0.3641563441560755
28248,703-004-5385,6183.536,5,3,2,1.1545948334927232
28335,703-004-5381,3171.1333,3,0,3,0.27920371738274696
28363,703-004-5382,6315.4595,2,2,0,0.9568554763415583
2844,207-008-2399,6230.5796,3,1,2,0.7431351478327134
28690,703-004-5390,8116.9243,2,1,1,0.3366419649992056
28784,703-004-5382,497.52295,3,3,0,1.0650164025276647
28785,703-004-5387,6845.9067,6,3,3,0.9861984504724267
29559,703-004-5383,3883.6372,6,5,1,0.6586046717590822
29709,703-004-5390,778.7418,5,3,2,1.3705606363263856
2976,703-004-5392,1858.9299,3,1,2,0.39543778421428455
29872,703-004-5387,8043.1675,5,3,2,1.3745290739439882
29936,703-004-5381,1687.473,4,3,1,1.9634337762420573
30162,703-004-5384,619.2553,9,5,4,2.14244416911697
30165,703-004-5380,5483.312,2,2,0,0.6966135107594068
30191,703-004-5391,4453.9707,3,2,1,0.5820614747078693
30314,703-004-5392,284.12222,3,2,1,1.6175130372375046
30334,207-008-2399,9047.886,4,3,1,1.0195755087854548
30850,703-004-5382,7811.9087,1,0,1,0.27920371738274696
30896,703-004-5387,7586.538,7,2,5,1.4604450005149223
30973,703-004-5391,6974.943,5,3,2,0.8416076865184987
31028,703-004-5386,559.268,2,1,1,0.7793447937978415
31097,207-008-2398,3056.9536,4,2,2,0.7374122796654523
31209,703-004-5383,9826.595,3,2,1,0.5870422008382964
31740,703-004-5388,2567.6775,6,3,3,1.0448015210861832
31859,207-008-2399,9987.05,2,1,1,0.5165268771580819
32438,703-004-5388,8431.414,8,2,6,0.550827628278371
32468,703-004-5380,3703.2432,3,2,1,1.2136956742187697
33118,703-004-5392,3443.8938,5,4,1,2.935957798414891
33146,703-004-5396,5134.718,2,1,1,0.33473733677017536
33198,703-004-5395,2395.1167,6,3,3,0.7353604614881077
3330,703-004-5392,2409.407,6,4,2,1.1957383726253668
33943,703-004-5399,1621.4275,5,2,3,1.126071238097098
34288,703-004-5384,1928.1262,3,2,1,1.0350499466761682
34317,703-004-5382,51.500202,2,0,2,0.27920371738274696
34352,703-004-5392,3095.4158,7,3,4,2.413415252897523
3469,703-004-5395,2675.529,6,4,2,1.4456580308890776
34811,703-004-5389,8691.2705,5,2,3,1.0346777665533247
35179,207-008-2398,1134.1906,7,3,4,1.1999662819879287
3540,703-004-5387,9491.233,3,0,3,0.27920371738274696
35562,703-004-5391,8336.442,5,4,1,1.2876525727040493
35602,703-004-5386,1976.0376,6,3,3,1.1453099018169968
35737,703-004-5394,2627.6719,1,0,1,0.27920371738274696
3585,703-004-5388,2996.8853,6,6,0,2.473469694463214
35886,703-004-5399,1121.5287,5,1,4,0.3600518071462111
35967,207-008-2399,4577.5806,3,0,3,0.27920371738274696
3603,703-004-5398,5466.8516,4,1,3,0.5121715941122635
3608,703-004-5393,1511.4891,1,1,0,0.9380693785291743
36334,703-004-5393,293.2459,6,4,2,1.697586879041635
36502,703-004-5388,9748.843,6,2,4,0.65071834130294
36523,703-004-5385,8883.406,5,2,3,0.41028760903235456
36573,703-004-5383,3736.8704,5,4,1,1.0931670223494507
36772,703-004-5384,2539.5935,2,1,1,0.35050693770154023
36980,703-004-5380,43.728947,8,5,3,2.3059804376196817
37000,703-004-5386,7143.4287,3,1,2,0.4926889725940044
37090,703-004-5391,6274.0444,8,3,5,1.3902790543891912
37114,703-004-5381,9679.988,"","","",0.27920371738274696
3713,703-004-5399,6828.182,4,4,0,0.8268715139191675
37267,207-008-2399,4099.9077,7,3,4,1.4225735367614711
37341,703-004-5390,7813.4854,5,3,2,0.8098431835432574
37365,703-004-5381,2741.3357,5,3,2,0.6401326895410688
37699,703-004-5390,7138.2095,4,3,1,1.2954891658432042
37875,207-008-2398,4466.9736,5,5,0,2.28065900349483
38014,703-004-5397,8098.7007,6,3,3,1.0006139382872978
38187,703-004-5381,4188.4307,3,1,2,0.7144253927017487
38242,703-004-5380,5301.949,5,3,2,1.3186096688431017
38332,703-004-5388,4031.0098,8,2,6,0.42014895312681927
39059,703-004-5391,4770.8867,1,0,1,0.27920371738274696
39320,703-004-5398,9251.157,2,1,1,0.3978652972704144
3963,703-004-5391,943.5171,5,1,4,0.35831143730785864
40102,703-004-5388,8880.62,7,5,2,2.1347013538030652
40408,703-004-5397,4309.6704,5,2,3,0.41659948882443915
40453,703-004-5399,3656.0088,5,3,2,1.0685920195580358
40583,703-004-5391,7631.0093,5,2,3,0.5470924900464705
40590,703-004-5389,7177.062,2,1,1,0.3978652972704144
40711,703-004-5392,7565.1235,4,2,2,0.8317508659723257
40714,703-004-5380,935.96875,6,2,4,1.1687885282019563
41134,703-004-5398,4399.821,3,2,1,0.49922206342446374
41249,703-004-5392,4742.1113,9,5,4,2.290533221268994
41369,703-004-5382,5631.48,1,0,1,0.27920371738274696
41395,703-004-5390,9563.679,4,4,0,0.7387217274089001
41554,703-004-5382,9520.881,2,2,0,0.5998983977917426
41729,703-004-5380,9509.268,7,3,4,0.9442983588718914
42409,703-004-5391,3206.2078,5,2,3,1.0968937816050106
42489,703-004-5385,6635.726,6,3,3,1.8915580197567778
42499,207-008-2398,6227.45,3,0,3,0.27920371738274696
42748,703-004-5386,8337.365,2,1,1,0.4926889725940044
42976,703-004-5385,7159.699,6,2,4,0.988123493684074
43092,703-004-5397,7227.58,5,3,2,0.7672352770413544
43153,703-004-5396,9263.229,4,3,1,2.922871187772268
43160,703-004-5391,2414.8179,2,1,1,1.654517810002361
43173,703-004-5399,8661.856,3,1,2,0.35041302589658574
43441,703-004-5394,1921.2722,5,4,1,1.3785970006770434
43450,703-004-5381,6364.381,5,1,4,0.6073643767272019
43498,703-004-5399,8949.343,4,2,2,0.566244455002749
43513,703-004-5384,4608.9243,5,1,4,0.62448135590994
43519,703-004-5398,6298.471,5,3,2,0.5363038071393598
43629,703-004-5383,6280.722,5,1,4,0.8627013781999201
43892,703-004-5383,8598.558,2,2,0,1.535179800262895
44314,703-004-5380,529.657,1,0,1,0.27920371738274696
44433,703-004-5394,7609.021,3,1,2,0.5466372530545774
44467,703-004-5393,9027.822,3,0,3,0.27920371738274696
44541,703-004-5399,5060.8374,3,2,1,1.053448165773074
44882,703-004-5398,9621.451,3,2,1,0.6181618198408028
45098,703-004-5398,4876.191,5,2,3,0.9102968622029786
45159,703-004-5385,4272.589,4,2,2,0.7104472980873296
45222,703-004-5394,7879.5005,4,0,4,0.27920371738274696
45258,703-004-5390,8821.955,2,1,1,0.9605577831136958
4535,703-004-5393,2445.1184,4,0,4,0.27920371738274696
45435,703-004-5380,9771.02,5,3,2,0.6812181269051358
45801,703-004-5392,1521.1642,2,1,1,0.4200503150757104
46118,703-004-5380,1911.2944,3,0,3,0.27920371738274696
46434,703-004-5396,122.5853,10,8,2,1.2971169607046584
46730,703-004-5380,4489.7007,6,5,1,3.076755624490003
46867,207-008-2399,7228.5483,6,3,3,1.736503746271097
46893,703-004-5389,5877.905,4,2,2,2.078219538119942
46920,703-004-5385,7771.5454,3,1,2,0.42992265600086377
46983,703-004-5384,1626.3986,1,0,1,0.27920371738274696
47099,703-004-5381,1666.8362,3,1,2,0.49222696258082066
47310,703-004-5381,4476.5405,2,0,2,0.27920371738274696
47812,207-008-2398,1718.5044,5,3,2,1.0982342544472845
47834,703-004-5383,9667.572,"","","",0.27920371738274696
4785,703-004-5392,9518.792,2,1,1,0.7642583987902128
48299,703-004-5398,6737.2793,3,1,2,0.4353281777068632
49233,703-004-5394,4796.534,4,1,3,0.33853450732658075
49507,703-004-5396,3018.4197,2,0,2,0.27920371738274696
4959,703-004-5396,5202.4307,4,3,1,1.3780932013491318
49914,703-004-5398,5771.441,3,1,2,0.3907726921501734
49932,703-004-5383,3281.5308,3,1,2,0.44780851026456914
49965,703-004-5383,1981.343,8,3,5,1.344163399974492
5416,703-004-5396,2907.6833,3,1,2,0.33853450732658075
5569,703-004-5392,7506.829,3,3,0,1.401057653904906
6361,207-008-2399,2295.2456,7,3,4,0.8147332000771765
6506,703-004-5399,488.4666,3,0,3,0.27920371738274696
6601,703-004-5382,4390.679,7,5,2,1.7919966331710486
6703,703-004-5384,2793.8818,4,4,0,2.1874950375088913
6796,703-004-5381,1342.2603,4,2,2,0.464569860621851
6982,703-004-5387,3716.243,2,1,1,0.8016858509644431
7147,703-004-5397,5001.934,5,4,1,1.740071647598354
7515,703-004-5383,24.502872,4,3,1,0.9701780913493211
7734,703-004-5385,6282.407,6,2,4,1.5957771923906916
7846,703-004-5386,5461.1606,7,4,3,1.900836922233583
8129,703-004-5388,8207.299,5,5,0,0.9783274574630576
8727,703-004-5385,8381.194,2,1,1,0.5691385696708695
8858,703-004-5381,9030.709,5,1,4,0.3676354821074616
8881,703-004-5395,4498.239,4,2,2,0.6120309169923787
8923,703-004-5399,9848.861,3,1,2,0.35831143730785864
8996,703-004-5389,9900.151,2,1,1,0.6065540570719374
9141,703-004-5389,8141.0664,5,2,3,1.482357338613423
9313,703-004-5386,730.1426,4,1,3,0.4464197437738441
9640,703-004-5392,3523.4421,4,2,2,1.6422747771231208
10104,703-004-5381,3878.2126,4,3,1,0.7616935668695987
10530,703-004-5390,8033.9097,5,5,0,1.6741738285170067
10639,703-004-5385,8676.719,6,3,3,1.40385088146767
11068,703-004-5397,6249.2563,3,1,2,0.6142847732829143
11069,207-008-2399,3778.581,2,2,0,1.0349388628332294
11118,703-004-5397,6290.232,8,2,6,1.0879818091444764
1136,703-004-5382,5470.625,1,1,0,0.3670184882442254
11472,703-004-5392,8169.8696,3,2,1,0.7882988017024598
11608,703-004-5380,2782.5803,1,0,1,0.27920371738274696
11759,703-004-5381,3895.8496,3,2,1,1.3643679702006166
11810,703-004-5387,7883.9277,5,3,2,1.4434293078566536
12255,703-004-5394,5048.9873,"","","",0.27920371738274696
12403,703-004-5394,4708.6846,6,2,4,0.6831678340259308
12665,703-004-5394,4299.1416,7,4,3,2.7958629170190648
12786,207-008-2398,394.72998,3,2,1,0.5165268771580819
12830,703-004-5381,9771.357,1,1,0,0.5026610625955772
12852,703-004-5385,3421.5952,2,1,1,0.38336208974740926
13007,207-008-2398,9962.286,5,2,3,1.9546376261729592
13084,703-004-5390,260.7161,6,2,4,0.7754640766186768
13171,703-004-5383,4639.48,3,1,2,0.7235490641360467
13181,703-004-5386,9648.344,6,5,1,1.4200500308473467
13343,703-004-5397,1551.8575,2,2,0,1.2504881419173315
13444,703-004-5388,6736.5303,5,2,3,1.9311331778444616
13447,703-004-5383,525.22656,6,3,3,0.8016031881340889
13596,703-004-5397,7030.8984,3,2,1,0.9218207487948795
13626,703-004-5388,8253.572,5,4,1,1.1706945066812366
13839,703-004-5387,2562.9353,3,0,3,0.27920371738274696
13932,703-004-5383,9987.292,8,3,5,0.5100328337851672
14708,703-004-5388,5057.29,5,2,3,0.8285700081883522
14715,703-004-5389,3078.8403,5,3,2,0.9316951879645438
14783,703-004-5395,3545.3076,1,1,0,0.7992158599999029
14957,207-008-2399,7250.443,3,1,2,0.4870444187884918
15020,703-004-5396,9575.788,2,0,2,0.27920371738274696
15064,703-004-5385,7764.582,2,0,2,0.27920371738274696
15121,703-004-5385,2441.6084,2,1,1,1.8976469905227034
15238,703-004-5388,5762.5264,4,3,1,1.1501387975275714
15249,207-008-2398,1275.8899,4,2,2,0.3937492237180609
15511,703-004-5386,419.58807,4,2,2,0.8340478807900221
15728,703-004-5381,3169.198,5,4,1,1.047840683293779
15890,703-004-5380,2281.3188,6,3,3,1.1021982176181582
16098,703-004-5397,7846.0737,3,3,0,0.8706979422991841
16100,703-004-5393,2789.4927,6,4,2,1.2674967142560494
16306,703-004-5386,8133.932,7,4,3,1.6672855222353355
16458,703-004-5390,5298.8813,3,1,2,0.7802294035468671
16831,703-004-5384,1600.1326,6,3,3,1.1594173250708335
16986,703-004-5382,2126.658,2,2,0,0.6501270435109825
17364,703-004-5395,4388.5864,3,2,1,0.8550806917080126
17436,703-004-5395,6027.7974,3,2,1,0.6545444771326868
1758,703-004-5389,5192.191,"","","",0.27920371738274696
18131,703-004-5388,4461.407,5,0,5,0.27920371738274696
18281,703-004-5387,733.2087,7,3,4,0.9748583366417585
18473,703-004-5395,1986.0428,4,4,0,2.6847881830640192
18629,703-004-5396,797.0077,3,3,0,1.5120484903136089
18753,703-004-5386,7218.566,"","","",0.27920371738274696
18889,703-004-5388,5894.9204,2,1,1,0.38194150570719015
18912,703-004-5394,2568.485,4,3,1,2.1451890158823255
19371,703-004-5389,370.26404,6,3,3,0.7684681001708461
20029,703-004-5390,7306.108,2,1,1,0.9004622166403554
20070,703-004-5380,5362.084,4,2,2,1.4541525448621297
20285,703-004-5385,7297.4336,4,2,2,1.03211846109407
20459,703-004-5391,7248.215,4,2,2,1.3215273956381728
20508,703-004-5391,7650.6875,3,2,1,0.7821035239124203
20614,703-004-5381,7333.067,5,4,1,3.0399245004014444
20668,703-004-5385,9107.366,3,1,2,0.6633960136219402
20804,703-004-5380,8638.091,2,1,1,0.6299985888997718
2085,703-004-5391,1964.159,2,1,1,0.42880320214941975
21296,207-008-2399,2865.2817,2,1,1,0.4314860782385869
21328,703-004-5392,3086.2778,7,6,1,1.9380770213285872
21569,207-008-2399,5103.786,5,2,3,1.561517605672437
21582,703-004-5383,5516.5547,4,2,2,1.9913166154027937
21638,703-004-5389,4519.478,4,2,2,0.9084976777253895
22143,703-004-5395,5577.087,6,3,3,1.414178765812765
22234,703-004-5386,5533.32,4,3,1,1.1300523264290374
22458,703-004-5393,2601.1074,7,4,3,1.794352107605691
22484,703-004-5397,5713.746,1,0,1,0.27920371738274696
22607,703-004-5391,5502.1377,4,1,3,0.5453446894165154
22658,703-004-5387,3300.7068,3,3,0,1.701466964776726
22779,703-004-5391,8284.921,1,0,1,0.27920371738274696
22813,703-004-5382,6333.0376,4,3,1,1.3003743369089829
22962,703-004-5383,1991.1027,5,5,0,2.374590134671691
23006,703-004-5394,2374.7505,5,5,0,2.319489607406175
2305,703-004-5384,6557.556,5,1,4,0.45149747114004773
23157,703-004-5396,8229.066,7,5,2,1.2867127133967846
23202,703-004-5387,7733.3374,3,0,3,0.27920371738274696
23291,703-004-5391,5353.3066,6,2,4,0.8333906306266253
23391,207-008-2399,9568.976,4,0,4,0.27920371738274696
23434,703-004-5382,7651.653,2,1,1,0.418830456627198
23901,703-004-5393,475.82864,3,1,2,0.33853450732658075
24170,703-004-5396,7802.3086,2,2,0,1.77196790863595
24794,703-004-5380,7901.126,6,4,2,1.0414689316450285
24839,703-004-5395,7057.674,8,5,3,2.4411062741115734
24999,703-004-5387,5245.3076,3,2,1,1.0760196820945835
25413,703-004-5397,56.55229,1,1,0,0.5208092948507664
25467,703-004-5381,8670.661,3,2,1,0.6753444965969094
25706,703-004-5391,7990.6313,4,4,0,0.9992533235569722
25721,703-004-5384,6796.3423,1,1,0,0.8226645596323385
25771,703-004-5390,6058.6655,5,3,2,0.9428063543279012
2578,703-004-5389,677.33527,3,2,1,0.5276818652426215
25902,207-008-2398,6496.911,3,2,1,1.3329511847721787
26662,703-004-5388,3356.3733,2,1,1,0.8880683987158182
26993,703-004-5397,8170.2173,3,3,0,1.0487800693133038
27298,703-004-5394,1935.9725,2,1,1,0.33853450732658075
2738,207-008-2399,6458.2896,3,1,2,0.38700117040069915
27412,703-004-5388,9372.788,5,4,1,2.4779887263501967
2778,703-004-5386,2856.8237,4,2,2,1.0706628653635684
27800,703-004-5385,113.850235,3,2,1,0.8502012525841225
27951,703-004-5380,3134.7085,6,1,5,0.3131070259220805
28011,703-004-5397,2584.3037,3,1,2,0.35831143730785864
28371,703-004-5390,9637.261,3,2,1,1.3253993496688778
28853,703-004-5393,4677.3315,2,1,1,0.6986745472727476
29330,703-004-5380,3305.0554,3,1,2,0.5093740730941873
29488,703-004-5384,2401.5278,3,1,2,0.36010784178115807
29615,703-004-5390,333.8486,4,3,1,1.0060263788828223
29678,703-004-5388,5423.076,6,6,0,1.9242786085764474
29980,703-004-5396,8985.884,5,3,2,1.1550848203516182
30206,703-004-5399,442.03937,2,0,2,0.27920371738274696
30277,703-004-5384,9652.989,8,4,4,1.4349542356052314
30367,703-004-5393,2670.3704,4,1,3,0.5443204561620197
30376,703-004-5386,7516.378,3,0,3,0.27920371738274696
3072,207-008-2398,7846.294,6,3,3,1.0243287360799391
30887,703-004-5388,7875.044,2,1,1,0.44946605174353327
30891,703-004-5388,1941.9307,6,3,3,1.545212045729028
30902,703-004-5389,5164.573,2,2,0,1.5146692428153883
31098,207-008-2399,1517.6725,1,1,0,0.47351205444880246
3131,207-008-2398,8894.468,4,4,0,1.2502723817340544
31533,703-004-5392,63.8932,7,3,4,1.5882461712347407
31811,703-004-5384,1030.8445,4,1,3,0.33853450732658075
31827,703-004-5393,3828.6763,6,3,3,1.0655643121585716
32589,703-004-5384,6561.8247,4,3,1,0.6664843168607139
32892,703-004-5387,7525.102,1,1,0,0.8676408649927644
33181,703-004-5380,7633.7686,8,1,7,0.5165268771580819
33541,207-008-2399,207.18634,1,0,1,0.27920371738274696
33655,703-004-5382,2858.432,2,1,1,0.6363441992494276
33832,703-004-5388,3143.913,1,0,1,0.27920371738274696
33991,703-004-5383,2788.0674,3,3,0,0.6027696950739677
34,703-004-5389,3403.3005,7,5,2,2.013269367919285
34186,703-004-5393,9984.1045,5,5,0,1.6748715903058886
34254,703-004-5385,1905.9813,2,2,0,0.8020964604437503
34709,703-004-5381,6512.858,6,5,1,1.3332688377424078
34775,703-004-5383,4288.965,3,1,2,0.40587689701465773
35180,703-004-5384,317.1313,5,0,5,0.27920371738274696
3529,703-004-5384,8947.229,3,1,2,1.5983357517562682
3532,703-004-5395,2516.0874,3,1,2,0.46412921137533186
35383,703-004-5396,4422.9966,3,2,1,0.7955537491618966
35613,703-004-5398,3256.1028,6,3,3,1.0981395327904064
35798,703-004-5391,1839.9978,2,1,1,0.6703297919379971
35862,703-004-5391,5761.5166,4,3,1,2.0350320660319317
35954,703-004-5389,8585.764,3,2,1,1.9755185267387487
36160,703-004-5391,7289.871,2,0,2,0.27920371738274696
36539,207-008-2398,4524.1255,3,2,1,0.7040524598266525
36632,703-004-5398,8662.561,6,2,4,0.9704190093573669
36647,703-004-5381,6953.068,2,1,1,0.9517275840023557
36887,703-004-5399,1993.1364,2,2,0,0.730660965094011
36927,703-004-5381,5352.9995,5,3,2,1.0472910235421637
37217,703-004-5398,7898.963,5,1,4,0.6210637576747422
37227,703-004-5386,1711.6517,2,0,2,0.27920371738274696
37339,703-004-5383,2457.9792,4,2,2,0.41317032918943264
37693,703-004-5384,9883.786,2,0,2,0.27920371738274696
37754,703-004-5395,1072.6428,5,3,2,1.7730451362715403
37839,703-004-5389,3038.9475,4,0,4,0.27920371738274696
37935,703-004-5391,7275.2954,4,1,3,0.3367545836282657
38064,703-004-5386,1446.2537,6,3,3,1.1193440064434126
3814,703-004-5387,7891.0635,2,1,1,0.7439544686551847
38819,703-004-5397,6207.6704,4,2,2,1.9256703186794888
3889,703-004-5398,3469.0845,5,2,3,0.9242136508630718
38940,703-004-5382,3768.2944,7,6,1,3.6659942293660355
39102,703-004-5393,5930.7964,10,3,7,0.9045716628040692
39191,703-004-5391,9464.439,2,1,1,0.35831143730785864
39438,703-004-5382,7447.9844,4,1,3,0.32666834933781397
3944,207-008-2398,9380.065,4,2,2,0.8419389959153001
39523,703-004-5384,9184.651,3,1,2,1.1868684987993952
39600,703-004-5383,3663.6274,4,2,2,0.5388100076897842
39609,703-004-5388,904.48676,7,5,2,1.6206698448148005
39643,703-004-5390,3207.6997,3,2,1,1.3905554039779
39780,703-004-5398,955.87134,3,2,1,0.7064133312445465
40078,703-004-5395,3879.3958,4,3,1,0.7955100837155015
40777,703-004-5390,5751.051,6,4,2,1.3845866449527553
40785,703-004-5396,9685.867,4,1,3,0.34146149296380984
40790,703-004-5386,1077.8195,4,1,3,0.3793617818362644
41040,207-008-2399,9810.273,2,1,1,0.35831143730785864
41052,703-004-5397,9821.412,6,3,3,1.0383897930003037
4117,703-004-5383,6459.228,7,3,4,0.6544953776912382
4131,703-004-5395,6885.5522,2,1,1,1.3507686669954106
4163,703-004-5392,9497.827,1,1,0,0.4713049554354144
4182,703-004-5393,815.4297,6,4,2,0.8184011778826432
42178,703-004-5384,6185.321,5,2,3,0.6052171603492501
42179,703-004-5389,7862.8765,2,0,2,0.27920371738274696
42332,207-008-2399,997.3347,4,1,3,0.35858567740359903
42511,703-004-5384,4665.0737,5,3,2,3.686773006151799
42582,703-004-5390,8603.746,4,2,2,1.295012512142382
43339,703-004-5386,2523.2761,3,1,2,0.36951836429724944
4366,703-004-5395,8511.167,7,3,4,1.3644200506888415
43661,703-004-5398,5527.362,"","","",0.27920371738274696
43713,703-004-5388,237.17165,4,1,3,0.7671136689295058
43724,703-004-5381,900.17975,3,1,2,0.35831143730785864
44182,207-008-2399,2818.609,6,3,3,1.1119548800117296
44185,703-004-5389,5572.3853,4,2,2,1.4975443161337867
44269,703-004-5387,2337.1553,6,4,2,1.81377176507903
443,703-004-5390,1645.7338,3,0,3,0.27920371738274696
44406,703-004-5386,1017.63367,1,1,0,0.4619774250918726
44468,703-004-5387,2615.8733,4,2,2,0.5288200484807141
4484,703-004-5382,5748.4233,8,3,5,0.7333468569184317
45108,703-004-5387,2203.3125,3,2,1,0.9407873391387311
45548,703-004-5385,1756.6311,5,2,3,0.8365285481980392
45747,207-008-2398,3463.0186,4,2,2,0.6324121944448745
45877,207-008-2398,6771.324,3,1,2,0.3978652972704144
46162,703-004-5398,9906.676,4,2,2,0.45719608721424815
46295,703-004-5397,2006.1952,4,3,1,0.6692951849186385
46604,703-004-5391,6039.4497,3,2,1,0.6987802910645751
46726,703-004-5389,5141.901,3,3,0,2.2371158090355974
46899,703-004-5399,9959.08,6,5,1,1.99598205095006
47417,703-004-5385,6795.7466,1,0,1,0.27920371738274696
47433,703-004-5394,7340.241,3,1,2,0.9182053433885876
47525,703-004-5386,4322.1055,6,4,2,2.5500058966074737
47650,703-004-5390,7335.1797,7,6,1,1.42680363250257
47798,703-004-5390,6424.1094,3,2,1,0.711747102666417
47822,703-004-5380,944.5947,2,1,1,0.33853450732658075
47925,703-004-5393,6858.3286,2,0,2,0.27920371738274696
4808,703-004-5391,2970.423,5,3,2,2.61056238444837
48083,703-004-5388,2794.524,4,1,3,0.35831143730785864
48221,703-004-5384,2338.9285,6,2,4,1.087664243079148
48302,703-004-5381,1311.9805,7,4,3,1.1588426936765566
48666,703-004-5381,4456.4956,5,3,2,0.9736087771651417
48752,703-004-5396,8330.052,"","","",0.27920371738274696
49395,703-004-5383,3119.3186,4,3,1,1.0690691381851034
49637,703-004-5397,5972.6,2,1,1,0.35831143730785864
49667,703-004-5386,92.02063,4,3,1,1.6171882571162874
49731,703-004-5399,7740.7183,5,3,2,1.2519480668761283
49744,703-004-5383,4526.6904,4,4,0,1.458146659395856
49764,207-008-2399,176.87381,3,2,1,0.9137340182235562
49858,207-008-2399,48.341156,2,2,0,0.783576543705231
5730,207-008-2398,5900.961,5,3,2,1.4575221411335209
5896,703-004-5387,4466.7983,6,2,4,0.6465075843934531
6003,703-004-5394,63.69114,2,2,0,0.5366993457389854
6127,703-004-5385,7992.4087,4,2,2,0.910393677029472
6176,703-004-5396,5659.749,2,1,1,0.5517032331840833
6405,703-004-5389,1370.1564,2,0,2,0.27920371738274696
6459,207-008-2398,4335.244,7,5,2,1.2290394965540699
652,703-004-5382,3504.4592,4,3,1,1.323197419316291
6548,703-004-5394,5525.1743,2,1,1,0.9302673636712303
6805,703-004-5381,9719.929,2,0,2,0.27920371738274696
6807,703-004-5393,8574.475,6,3,3,2.831637071028464
7437,703-004-5395,3876.3147,5,1,4,0.4864100447231127
7662,703-004-5388,4296.8267,4,3,1,1.068118512308352
786,703-004-5389,6332.2554,5,2,3,0.6155221542665542
8166,703-004-5396,2326.8635,3,0,3,0.27920371738274696
8181,703-004-5386,4105.8574,6,0,6,0.27920371738274696
8325,703-004-5391,5904.3364,2,1,1,0.538666178510046
8500,703-004-5395,1063.8606,5,3,2,1.2874267748018418
8576,703-004-5394,5991.879,7,3,4,1.659232111690153
8600,703-004-5392,8552.277,2,2,0,0.5959993743802118
880,703-004-5398,1829.2147,4,2,2,0.6636218349741401
8856,703-004-5393,1182.4435,5,2,3,0.9322119252967289
910,703-004-5385,1323.7494,7,3,4,1.1305234521682792
9229,703-004-5380,3070.1519,4,3,1,2.3153691873068154
924,703-004-5396,2781.2832,6,3,3,1.581038183698107
9525,703-004-5381,4521.913,1,0,1,0.27920371738274696
9552,703-004-5380,6047.2373,7,3,4,2.03256331352001
9595,703-004-5381,2738.7612,5,2,3,0.6521134414881503
9626,703-004-5395,9194.015,2,0,2,0.27920371738274696
9701,703-004-5384,3057.9316,7,4,3,1.1641203549135306
9956,703-004-5381,9915.054,4,2,2,0.9750948654559233
10015,703-004-5381,4620.8604,5,2,3,0.7822148138219172
10035,703-004-5399,6162.3306,6,2,4,0.8888969546060024
10107,703-004-5380,7623.2397,6,2,4,1.367646519386673
10218,703-004-5397,7729.301,1,1,0,0.5902083779004736
10315,703-004-5393,7762.2534,3,1,2,0.6755767556131428
10456,703-004-5398,7331.81,4,1,3,0.9983577703010437
10660,703-004-5392,4727.656,3,2,1,0.6225074586403008
10666,207-008-2399,8970.555,4,3,1,0.6951032725339608
10811,703-004-5393,6722.694,7,3,4,1.0831094747847994
11099,703-004-5381,3283.3755,4,3,1,0.9851377754694756
11223,703-004-5380,5974.7603,7,5,2,1.528863572081543
11372,703-004-5383,48.978924,4,3,1,1.3444638686305266
11473,703-004-5387,3561.9546,1,0,1,0.27920371738274696
11676,703-004-5380,2651.509,8,5,3,2.876338966168121
12015,207-008-2398,2913.7666,4,2,2,1.5675096553542074
12156,703-004-5387,6539.7803,1,0,1,0.27920371738274696
1312,703-004-5390,2486.4895,8,5,3,2.5313658492343194
13121,703-004-5392,4995.6675,7,4,3,2.0877662273112643
13527,703-004-5392,2168.1804,2,0,2,0.27920371738274696
13942,703-004-5397,2204.8867,5,3,2,0.8443067366855705
13969,703-004-5393,3801.0247,5,2,3,0.8688694027657969
1432,703-004-5387,9710.461,8,4,4,0.9535787104622683
14420,703-004-5392,2292.0496,4,1,3,0.48493144609570044
1451,703-004-5399,5852.377,4,3,1,1.5506150277305804
14586,703-004-5382,2964.7566,4,2,2,1.0182624156890812
15060,703-004-5389,6195.347,3,1,2,0.43959900884524844
15099,703-004-5389,4931.2876,3,1,2,0.4457749101500602
1538,703-004-5396,9722.397,2,0,2,0.27920371738274696
15463,703-004-5397,7861.7295,1,0,1,0.27920371738274696
15561,703-004-5390,9193.789,5,3,2,0.9083854265093902
15712,703-004-5387,2302.287,5,3,2,0.7519422980264814
15766,703-004-5384,9888.431,4,0,4,0.27920371738274696
15816,703-004-5391,9685.885,1,0,1,0.27920371738274696
15928,703-004-5383,8755.471,3,1,2,1.0511821965013908
16068,703-004-5398,6989.0957,1,0,1,0.27920371738274696
16444,703-004-5382,7359.257,3,1,2,0.46283325389378666
16482,703-004-5393,496.28735,8,2,6,0.8486931022701886
16531,703-004-5384,9716.474,3,2,1,0.6286099797013791
16782,703-004-5393,7339.6904,5,5,0,1.6843610460210925
1683,703-004-5388,6837.949,4,3,1,0.6019155370032232
17146,703-004-5399,3463.5706,3,2,1,0.9323516776154772
1716,703-004-5389,5237.116,1,0,1,0.27920371738274696
17415,703-004-5380,1494.453,3,1,2,0.6318295919385608
17452,703-004-5391,7047.5596,5,5,0,2.201291792732847
18212,703-004-5387,1016.2336,5,1,4,0.40358484815762813
1839,703-004-5390,2934.2693,1,0,1,0.27920371738274696
18474,703-004-5390,8355.503,3,1,2,0.3187575773453028
1852,703-004-5392,2398.9624,8,3,5,4.115346389988184
18638,703-004-5399,8866.321,5,4,1,1.501609557742877
18690,207-008-2399,1156.5763,2,1,1,0.3919322182760311
18881,703-004-5389,388.83148,2,1,1,0.4525558826282161
19006,703-004-5393,4179.4746,5,2,3,0.7780347255808775
19008,703-004-5389,4699.183,4,2,2,0.6411477609527437
19205,703-004-5385,9635.897,3,0,3,0.27920371738274696
19462,703-004-5393,137.12943,1,0,1,0.27920371738274696
19545,207-008-2399,9808.731,8,3,5,0.9271717551343395
20121,703-004-5398,257.40802,4,3,1,0.7763335264192435
2022,703-004-5398,686.8076,2,0,2,0.27920371738274696
20413,703-004-5389,6271.635,5,3,2,3.316020604256046
20648,703-004-5384,7411.48,6,4,2,1.5182249720406926
2066,703-004-5380,4690.0273,3,2,1,0.5432369313004435
20845,703-004-5394,9301.248,3,0,3,0.27920371738274696
20971,703-004-5382,4341.714,8,4,4,3.7140883356718386
21843,703-004-5382,565.67847,5,3,2,0.5664128460168486
22176,703-004-5398,9063.26,2,0,2,0.27920371738274696
22324,703-004-5392,5261.6987,1,1,0,0.5165268771580819
2257,703-004-5387,950.17194,5,4,1,1.5599972380124796
22835,703-004-5395,7265.326,5,2,3,0.43741915723297026
23096,207-008-2399,9656.268,3,0,3,0.27920371738274696
2315,703-004-5381,9504.224,7,3,4,0.642703690438635
23388,703-004-5387,8348.991,5,5,0,2.6374912092415905
23567,703-004-5381,2802.2253,2,1,1,0.5233567826652129
23570,703-004-5399,5713.926,4,4,0,1.4938732533217587
23897,703-004-5381,3615.9868,7,4,3,2.5864526851176612
23952,703-004-5393,52.142143,2,1,1,0.47700601813911325
24072,703-004-5393,1013.83984,3,1,2,0.4007820740289193
24240,703-004-5383,2818.5005,2,0,2,0.27920371738274696
2428,703-004-5384,5830.298,2,0,2,0.27920371738274696
24804,703-004-5393,3080.0403,8,4,4,0.9153338819964787
24829,703-004-5387,137.46143,2,2,0,0.625366236558465
24912,703-004-5382,6486.1216,3,1,2,0.35905776920302707
25018,703-004-5397,7663.0537,1,1,0,0.5472317455097179
25199,703-004-5387,8388.067,4,4,0,1.2079744502091068
25450,703-004-5397,3619.3438,6,4,2,2.200082825016035
25485,703-004-5384,1155.6083,3,2,1,0.5285495088749074
25494,703-004-5385,1403.221,5,2,3,0.43938567114232796
25594,703-004-5384,273.35645,5,2,3,1.1992205670328009
25646,703-004-5386,7630.7456,4,1,3,0.4314860782385869
25927,703-004-5390,941.5436,4,1,3,0.35831143730785864
26007,703-004-5387,7680.757,"","","",0.27920371738274696
26083,703-004-5382,5169.5815,5,3,2,1.5920109096831625
26104,703-004-5389,6347.242,5,2,3,0.8881594192523464
26345,703-004-5380,5886.511,4,3,1,0.7243733652285005
26561,703-004-5388,8878.827,3,0,3,0.27920371738274696
26826,703-004-5383,5030.3335,7,4,3,2.0142485073898495
2686,703-004-5389,6664.204,6,6,0,2.2210816038735484
26973,703-004-5388,626.9187,2,1,1,0.5191718006726886
27006,703-004-5380,8908.661,1,1,0,0.5860891724615925
27019,703-004-5398,3612.7478,5,3,2,3.077889248286104
27033,703-004-5387,8385.7,2,1,1,0.508609197955055
27302,703-004-5388,6141.5513,6,1,5,0.3553783949858227
27368,703-004-5395,2503.5166,3,2,1,0.5848190884996822
27521,703-004-5394,5446.805,5,4,1,3.7606570205986243
27607,703-004-5394,7415.774,7,1,6,0.8910999851712806
27720,703-004-5382,4105.735,"","","",0.27920371738274696
27808,207-008-2399,4701.216,1,0,1,0.27920371738274696
2820,703-004-5394,5241.4395,4,0,4,0.27920371738274696
28209,703-004-5396,8106.3887,1,1,0,0.3978652972704144
28510,703-004-5399,7330.0107,3,0,3,0.27920371738274696
28530,703-004-5391,1740.1904,1,1,0,0.4657313250795166
28935,703-004-5380,1663.1085,7,0,7,0.27920371738274696
29137,703-004-5392,8973.996,4,2,2,2.6022444539005303
29322,703-004-5392,3951.2192,6,5,1,1.8090976333830986
29644,703-004-5395,9991.656,6,3,3,1.1904101902221942
29910,703-004-5383,5898.1777,1,0,1,0.27920371738274696
29970,703-004-5399,9142.207,4,2,2,0.5657987496719536
30241,703-004-5394,9960.93,6,3,3,0.7964653504724167
30315,703-004-5386,2080.8977,1,0,1,0.27920371738274696
30421,703-004-5382,6862.6147,4,1,3,0.40795153156086617
30706,703-004-5393,8706.352,5,2,3,0.49714548577642953
30751,703-004-5398,8147.3916,1,1,0,0.37512182779194486
31041,703-004-5396,5588.8438,7,5,2,4.899824761302239
31043,703-004-5398,6203.6943,5,2,3,1.1540042124735646
31281,703-004-5389,6035.1895,5,3,2,1.1564184308441234
31637,703-004-5387,7689.7197,7,5,2,1.9991613128522001
31702,703-004-5385,8587.042,4,3,1,1.175851649173257
31854,703-004-5386,4643.0327,2,1,1,1.1807651930374563
31981,703-004-5386,1313.8992,5,3,2,1.81062721946142
32038,703-004-5396,7457.762,5,3,2,1.6531495308624695
32546,703-004-5395,4338.6636,6,4,2,1.2348598807530486
32568,703-004-5388,9409.108,4,1,3,0.40587689701465773
33161,703-004-5389,8923.4,6,4,2,3.5288198085848617
33234,703-004-5396,2973.9011,6,3,3,0.7289766627278564
33265,703-004-5394,4557.0986,5,3,2,1.9715743916159818
33340,703-004-5395,1444.7874,7,1,6,0.5306961267191379
3361,703-004-5392,9800.861,3,0,3,0.27920371738274696
34183,703-004-5393,5082.3174,6,4,2,3.3446926360044476
34257,703-004-5381,6245.125,4,4,0,0.9774917681108564
34361,703-004-5397,6718.1963,"","","",0.27920371738274696
3473,703-004-5382,3031.0874,8,0,8,0.27920371738274696
34963,703-004-5391,8824.982,3,1,2,0.5319677876025671
35362,703-004-5382,3240.5913,7,3,4,0.6609658288699767
35384,703-004-5381,7687.427,5,4,1,1.3459914855179984
35410,703-004-5384,8542.1045,3,2,1,1.7180557377270715
36003,703-004-5383,2000.4696,9,2,7,0.9956670377568254
36022,703-004-5385,1333.5288,2,0,2,0.27920371738274696
36398,703-004-5392,175.01294,4,3,1,1.307748024436832
36437,703-004-5393,9092.899,6,4,2,1.177782433528523
36738,703-004-5386,6569.5903,6,3,3,1.0618516550355805
37306,703-004-5385,9356.9795,4,3,1,0.9965570415210596
37538,703-004-5396,3542.975,5,2,3,0.671625653778621
37558,703-004-5386,2579.3218,4,2,2,1.9169635683325
37592,703-004-5388,2325.716,7,3,4,1.2226044287502755
37651,703-004-5397,1446.8896,5,4,1,1.679997165610518
3769,703-004-5396,6014.2646,5,2,3,1.174089908386986
37829,703-004-5392,4169.362,5,2,3,1.2347710464249901
38091,703-004-5399,8133.81,8,3,5,1.101043462471199
38255,703-004-5384,4792.7983,3,1,2,0.5648225933936746
38573,703-004-5380,9265.674,3,1,2,0.6428617555090153
38784,703-004-5383,3091.718,3,2,1,0.869941567572159
39047,703-004-5387,767.8485,4,2,2,2.2683030725043767
3907,703-004-5380,7314.2686,"","","",0.27920371738274696
39204,207-008-2399,3931.1235,4,2,2,1.3482029368515906
39232,703-004-5393,4722.1255,6,3,3,0.6617449985327736
3924,703-004-5390,5274.8286,5,3,2,1.0154442524709448
39253,207-008-2398,6701.5176,2,0,2,0.27920371738274696
39265,703-004-5399,7460.4624,2,2,0,0.7738215405566483
39880,703-004-5381,1563.8715,4,1,3,0.5040466878408278
39909,703-004-5382,4255.624,6,3,3,1.21662455873221
40214,703-004-5385,3068.5835,6,4,2,2.398431242734976
40281,703-004-5386,2652.613,2,1,1,0.3978652972704144
40444,703-004-5381,9004.832,3,0,3,0.27920371738274696
40685,703-004-5392,4991.677,2,1,1,0.4011819283748361
40854,703-004-5390,977.45,2,2,0,1.089544730449048
4101,703-004-5394,9128.867,6,4,2,0.9809676724242247
41230,207-008-2398,5650.3643,2,1,1,0.4180377658513179
41417,703-004-5399,7131.587,5,2,3,1.7094516545559946
41802,207-008-2399,1610.474,2,1,1,0.3793617818362644
42014,703-004-5381,4258.46,6,4,2,4.069760558265314
42222,703-004-5386,5817.4893,5,5,0,4.191509282153516
42469,703-004-5389,9776.155,4,3,1,3.8979476093613754
42625,703-004-5381,2807.9158,3,1,2,0.5669580486103406
42703,703-004-5385,1281.1368,4,2,2,0.5969973758858784
43100,703-004-5395,2233.826,3,0,3,0.27920371738274696
43159,703-004-5399,3388.2058,2,1,1,0.9920672355431648
43186,703-004-5393,6880.267,4,2,2,1.1712558566811968
43370,703-004-5397,9279.066,3,3,0,0.5807144708061142
43456,703-004-5398,2688.7202,4,3,1,0.8375424171390655
43484,703-004-5387,6894.852,5,3,2,0.7812938429799549
43636,703-004-5383,8463.768,2,2,0,1.2921393625400828
43697,703-004-5390,7816.205,4,3,1,0.6384246783092004
43759,703-004-5380,2796.7744,5,3,2,1.1360063705863572
43860,703-004-5395,7568.807,4,1,3,0.4756507529209138
44193,703-004-5383,9471.114,3,2,1,0.6380607471000511
44892,703-004-5386,3646.7795,6,5,1,1.4376368410486815
45120,207-008-2398,684.5474,8,5,3,1.202368570981657
45306,703-004-5388,6896.0947,5,4,1,1.4329431688862708
45321,207-008-2399,6237.55,5,2,3,0.4853674381309232
4647,703-004-5396,7791.9863,2,2,0,0.5021886029216555
46515,207-008-2398,755.0448,5,1,4,0.7055720189287792
46822,703-004-5383,6041.312,4,2,2,0.6126160658074712
46903,703-004-5387,4426.6226,2,1,1,0.48773630060655826
47101,703-004-5393,3828.5046,3,1,2,0.7219457345493073
47247,703-004-5388,7951.7456,5,3,2,0.5497430732721585
4745,703-004-5398,1140.0544,9,4,5,1.4504295373390985
47641,703-004-5394,7095.085,4,4,0,0.7576146482277228
47965,207-008-2399,8783.317,6,3,3,0.974736820431228
48066,703-004-5397,3093.5515,5,1,4,1.0928597218614426
48084,207-008-2399,3338.4187,8,6,2,3.39055618054752
48090,703-004-5384,9918.639,5,3,2,0.803865671295609
4810,703-004-5393,8413.023,3,1,2,0.5107197054541761
48256,703-004-5381,544.0706,2,2,0,0.6342745775797968
48472,703-004-5380,5041.5586,1,0,1,0.27920371738274696
48508,703-004-5399,9566.109,5,4,1,2.131969071409009
48571,703-004-5392,578.6413,4,1,3,0.3800548811984942
4858,703-004-5392,1191.606,7,2,5,0.5758576671019155
49052,703-004-5394,7035.4614,4,1,3,0.7191893838724074
49271,703-004-5395,8016.543,5,3,2,1.0112288819356512
49296,703-004-5387,4615.948,4,1,3,0.3966299455538024
5276,703-004-5392,433.10046,6,2,4,0.9430955806190662
5300,703-004-5381,8569.483,4,2,2,0.5870942724692579
5334,207-008-2399,4773.8887,4,1,3,0.5357002811594311
5589,703-004-5396,4654.572,2,0,2,0.27920371738274696
5754,207-008-2399,1235.5,2,1,1,0.4284392302369871
5821,207-008-2398,584.9957,2,1,1,0.5771376052891414
6044,703-004-5391,6621.986,3,2,1,0.8768997645132729
6550,703-004-5388,2424.3552,4,1,3,0.3978652972704144
6647,703-004-5389,8853.609,4,2,2,0.4372994546682941
6930,703-004-5391,2331.5728,5,3,2,1.7042162665128486
7047,703-004-5395,7635.9214,2,1,1,0.41396936477997903
7143,703-004-5382,9977.551,4,4,0,1.8156448185843008
7253,703-004-5391,1514.4879,6,2,4,1.0367101958970433
7583,703-004-5388,5760.7466,4,2,2,0.9037899607483998
7895,703-004-5395,4306.779,5,1,4,0.429811631500172
7934,703-004-5389,8323.369,3,3,0,1.0010917617383002
7992,703-004-5390,3422.0398,4,1,3,0.6672649800509186
819,703-004-5389,5134.2837,4,3,1,0.9976265603401714
822,703-004-5380,1391.834,2,2,0,1.061336031090778
8581,703-004-5396,7962.5703,6,3,3,1.3961524012003381
8633,207-008-2399,4680.838,8,4,4,2.49528054619981
8647,703-004-5389,2218.8706,2,2,0,1.3347217177317405
927,703-004-5389,5243.778,4,2,2,1.532132636756116
9280,703-004-5388,7901.925,3,0,3,0.27920371738274696
9383,703-004-5399,7895.796,3,1,2,0.5165268771580819
9442,703-004-5386,7553.484,3,2,1,1.2406798024604402
9725,207-008-2399,8691.598,8,3,5,2.9204476882409627
982,703-004-5396,946.04016,6,4,2,1.341045927058209
9852,703-004-5389,1377.2583,3,2,1,0.912158619489468
10146,703-004-5398,1315.741,6,4,2,0.9864732584852522
10415,703-004-5395,7292.65,4,0,4,0.27920371738274696
1059,703-004-5383,170.77565,5,1,4,0.35831143730785864
10765,703-004-5392,760.892,4,2,2,0.6460904592018233
10977,703-004-5392,1876.3214,4,3,1,0.8284525346872067
11180,703-004-5383,443.6499,6,4,2,0.8137725496506008
11430,703-004-5380,3934.762,4,1,3,0.4420241902716802
11553,703-004-5392,5724.311,6,2,4,0.5979376381982465
11570,703-004-5396,2703.9302,5,0,5,0.27920371738274696
11699,703-004-5380,2376.082,2,0,2,0.27920371738274696
11841,703-004-5386,3748.0093,2,2,0,0.6155299926337177
12468,703-004-5396,5369.8784,6,4,2,1.4278904822259548
12767,703-004-5391,9992.554,6,6,0,2.753203220526716
12820,703-004-5395,4961.994,3,1,2,0.38070128679362736
12879,703-004-5381,7084.9414,3,2,1,1.1468439361549603
1297,703-004-5394,5831.9814,7,1,6,0.3978652972704144
13074,703-004-5393,9717.295,4,1,3,0.5192238583736655
13511,703-004-5385,8818.631,2,1,1,0.42938364879112256
13630,703-004-5386,1101.02,5,3,2,1.4239146408068712
13779,703-004-5395,3967.9922,4,2,2,0.9201683484810592
14146,703-004-5384,6089.9253,5,1,4,0.5472820150665705
14202,703-004-5397,6688.0303,5,3,2,1.9079953912850676
14421,703-004-5395,412.16672,5,2,3,1.0845117889523714
14614,703-004-5391,9140.489,3,0,3,0.27920371738274696
15026,703-004-5390,1866.0546,4,2,2,0.7227888771218063
15869,703-004-5382,2588.5283,7,4,3,1.7392088593176813
16076,703-004-5388,5467.613,2,1,1,0.3978652972704144
16352,703-004-5398,3091.7317,7,4,3,2.8303063916883766
16362,703-004-5399,7273.652,5,3,2,0.559371197991705
16448,703-004-5392,173.34341,1,1,0,0.5837218296003285
1667,207-008-2398,4940.904,3,1,2,0.7825879140170782
16750,703-004-5386,6325.047,9,4,5,0.9463205834548177
1682,703-004-5392,2191.7903,4,1,3,0.41566414400219803
16865,703-004-5398,8300.346,4,4,0,1.8376782773902591
16895,703-004-5383,2705.2493,6,3,3,1.5662382228768996
17007,703-004-5388,8188.4204,5,3,2,0.593482962051259
17035,703-004-5380,3948.7988,3,2,1,0.7748847061881606
17170,703-004-5395,87.783936,5,5,0,2.7198099457963467
17471,703-004-5396,7844.967,4,2,2,1.0263264646754373
17512,207-008-2398,3748.4736,6,5,1,2.5753635607536935
17784,703-004-5382,3627.8247,5,2,3,0.5917705410182614
17810,703-004-5393,9784.017,4,3,1,0.7433857214101919
17926,703-004-5397,3103.8171,6,2,4,0.45876242006876533
18140,703-004-5381,4446.293,3,2,1,1.8552988620487862
18747,703-004-5393,494.57788,3,2,1,1.2545198384519138
18845,703-004-5395,1346.7234,5,2,3,0.9988259939867503
18976,703-004-5390,20.822884,5,3,2,1.349704728830251
19192,703-004-5395,7587.4116,7,2,5,0.8237762064401416
19194,703-004-5386,7196.204,4,1,3,0.4838530361983817
19216,703-004-5387,9899.277,3,1,2,0.42712823734814376
19222,703-004-5387,9218.074,8,6,2,2.6909039766301888
19263,703-004-5393,6446.4053,3,0,3,0.27920371738274696
19809,703-004-5394,8839.676,2,2,0,1.3445372374809121
2008,703-004-5390,5141.5806,6,4,2,0.8273692409039946
20253,703-004-5398,2901.0945,4,2,2,0.8635057668982208
20436,207-008-2399,543.72845,3,0,3,0.27920371738274696
20661,207-008-2398,6210.49,3,1,2,0.8013418458296087
20765,207-008-2398,8708.549,7,2,5,0.49518417501198575
20954,703-004-5391,104.650856,4,2,2,0.7665057803387755
20996,703-004-5391,5573.6284,3,1,2,1.369410755809576
21050,703-004-5397,9380.165,6,2,4,0.6473668926099997
21542,207-008-2399,9866.926,4,2,2,2.306398920613587
21839,703-004-5383,5401.633,3,2,1,0.5970017391710555
22105,703-004-5391,3236.4463,2,0,2,0.27920371738274696
22169,703-004-5395,9949.356,3,0,3,0.27920371738274696
22348,703-004-5382,8551.569,5,2,3,0.7434549792411231
22949,703-004-5388,4905.321,3,2,1,0.5422886367972426
23748,703-004-5395,4821.819,6,5,1,1.112133161533512
23842,703-004-5390,1965.6354,5,2,3,1.6255685232052706
24107,703-004-5399,3332.9492,2,2,0,0.8119319232416137
24168,703-004-5396,7144.1577,7,2,5,0.6628761590195384
24510,207-008-2399,1961.0095,1,0,1,0.27920371738274696
24803,703-004-5386,6856.986,"","","",0.27920371738274696
2484,703-004-5399,2735.4473,2,1,1,1.6300705390586125
24856,703-004-5388,5080.1587,4,3,1,1.335536586373116
24875,703-004-5389,851.9864,5,1,4,1.0994150768707203
24915,703-004-5389,47.15681,2,2,0,0.46561371917786876
25072,703-004-5387,5738.102,8,4,4,1.802927114154454
25203,703-004-5388,1996.5398,4,1,3,0.6000619267008256
25534,703-004-5389,8344.883,4,3,1,0.7537817939435719
25652,207-008-2398,7445.7607,2,2,0,1.4533926824791628
25759,703-004-5397,1368.6418,3,1,2,0.4951648201723722
25812,703-004-5386,1353.6626,3,2,1,0.8777219255398558
2584,703-004-5399,5012.356,1,0,1,0.27920371738274696
25851,703-004-5389,6472.608,6,2,4,1.1267648721103478
25949,703-004-5387,7978.0894,5,2,3,2.1249089104108987
26023,703-004-5398,8535.258,7,5,2,1.9346289998822515
26064,703-004-5384,2127.105,6,5,1,3.8325780422191964
26119,703-004-5383,825.93085,5,2,3,0.6329840676892075
2636,703-004-5387,171.76271,3,3,0,1.1955131307971716
2658,703-004-5395,8588.575,2,1,1,0.381926033464075
26580,207-008-2399,9154.368,4,3,1,1.4518713607481506
26640,703-004-5387,1454.3057,4,2,2,0.8255358458539921
26730,703-004-5390,3402.8572,3,1,2,0.8657236285240579
26895,703-004-5397,3021.1157,4,2,2,1.37372968005116
26985,703-004-5394,5308.7524,4,2,2,0.6610404607638769
27207,703-004-5393,2205.3652,4,3,1,1.5694680448835847
27490,703-004-5396,2562.2915,2,0,2,0.27920371738274696
27921,703-004-5398,3223.924,4,3,1,2.331053457250856
28260,703-004-5394,8521.7295,5,2,3,1.3494740602248327
28418,703-004-5382,5920.1094,3,2,1,0.8154717901536914
28459,703-004-5399,8512.509,2,2,0,0.9916742050319314
28669,703-004-5384,5369.5913,4,1,3,0.6541748533336511
28711,703-004-5385,1899.3151,4,1,3,0.4880863425898346
29319,703-004-5397,3050.2456,3,2,1,1.1188910559369822
29755,703-004-5383,9516.7,6,4,2,1.0586501915069162
29796,703-004-5398,6163.4697,5,4,1,1.5344904094751837
29894,703-004-5387,1768.3088,5,2,3,0.8978521124809642
30695,703-004-5385,9703.63,7,3,4,1.5614595904760105
30793,703-004-5391,9041.533,5,2,3,1.7852334959262541
31090,703-004-5390,3708.452,2,0,2,0.27920371738274696
31424,703-004-5387,9487.272,4,3,1,3.5390178966955186
31426,703-004-5390,4930.9385,3,0,3,0.27920371738274696
31487,703-004-5399,2570.5015,3,1,2,0.786114941082169
31489,703-004-5384,4113.7827,7,4,3,0.8992481317647394
3152,703-004-5387,3013.534,4,3,1,2.2671368643737497
31545,703-004-5388,7716.3687,4,2,2,1.7578120293218118
31554,703-004-5387,6459.9395,2,2,0,1.4047687275142766
31601,703-004-5386,9764.899,6,3,3,0.9281494596761914
31858,703-004-5389,2756.5903,2,1,1,0.5942585428120302
31942,703-004-5381,2773.471,4,3,1,1.7448184277180376
32044,703-004-5392,6178.3145,4,2,2,0.45719608721424815
32075,703-004-5385,322.74426,1,0,1,0.27920371738274696
32689,703-004-5391,9439.393,2,2,0,0.7310761010444681
32840,703-004-5393,9754.581,1,0,1,0.27920371738274696
32867,703-004-5387,5294.618,5,1,4,0.9805835559145756
32902,703-004-5390,2296.765,2,0,2,0.27920371738274696
33083,703-004-5380,5413.91,2,1,1,0.7174828181856838
33108,207-008-2399,3314.95,3,1,2,0.33853450732658075
3335,703-004-5390,9662.539,10,5,5,2.213115610506292
33572,703-004-5392,3212.6616,2,2,0,0.889754736204544
33587,703-004-5380,414.05975,8,5,3,1.9361762877667892
34145,207-008-2399,2954.6475,2,0,2,0.27920371738274696
34421,703-004-5389,5724.4404,6,3,3,1.1031783563479023
34691,703-004-5380,8592.251,1,0,1,0.27920371738274696
34993,703-004-5380,4225.5684,2,0,2,0.27920371738274696
35083,703-004-5385,6481.4414,2,1,1,0.5155976005499554
35352,207-008-2398,7904.3384,7,5,2,1.4991313870613348
35429,207-008-2398,6098.1685,4,4,0,1.271908845212951
35761,703-004-5384,3059.9058,2,0,2,0.27920371738274696
36095,703-004-5397,3615.0378,2,1,1,0.5758920647249833
36277,703-004-5381,4530.3945,2,2,0,0.5321979897313068
36534,703-004-5394,8000.1636,3,1,2,0.3805292617015212
36770,703-004-5389,1297.1067,4,1,3,0.9733718717359979
36919,703-004-5391,8731.147,3,1,2,0.9792998845606471
36946,703-004-5386,743.28,2,1,1,0.35831143730785864
37262,703-004-5398,9687.099,3,2,1,0.4335637153650129
37531,703-004-5394,4896.1123,"","","",0.27920371738274696
376,703-004-5386,1184.4205,3,2,1,0.6403429642834165
38107,703-004-5385,2852.7075,2,0,2,0.27920371738274696
38127,703-004-5383,5935.3076,6,1,5,0.6604215405334484
38416,703-004-5399,8769.487,4,2,2,0.7268385216149706
38426,703-004-5386,2347.058,4,2,2,0.577730831275204
3874,703-004-5399,6943.6196,3,0,3,0.27920371738274696
3901,703-004-5392,8576.239,3,1,2,0.8570340412007509
39200,207-008-2399,7511.754,2,1,1,1.5994929724660265
40671,703-004-5386,9112.289,3,2,1,0.672713602262874
40695,703-004-5397,181.96284,2,2,0,1.0582466312550014
41161,703-004-5384,5765.664,4,1,3,0.3900473298577316
41240,703-004-5398,8293.985,2,1,1,0.6388224679298091
41461,703-004-5390,9948.01,7,4,3,1.5578560692448462
41958,207-008-2399,4151.5435,3,1,2,1.063389948365056
42057,703-004-5398,5178.898,8,4,4,1.8205298526988685
42169,703-004-5384,3347.3438,4,1,3,0.8804475126507028
42316,703-004-5390,5619.1123,"","","",0.27920371738274696
42594,703-004-5383,6540.701,5,3,2,1.4857757080942413
42678,703-004-5393,795.13074,5,0,5,0.27920371738274696
42721,703-004-5388,7918.504,5,3,2,1.2148068919475856
42856,703-004-5382,6190.0703,5,2,3,2.994162694607998
4342,703-004-5397,3466.0947,8,4,4,2.992690425747608
43449,703-004-5384,2434.4475,5,2,3,0.6856196284980081
43546,207-008-2399,3390.6646,5,3,2,0.8141917294127077
43824,703-004-5396,8141.3276,5,1,4,0.48371911342085855
43990,703-004-5391,7397.718,3,2,1,0.7057218236525094
44034,207-008-2398,2801.8254,5,4,1,1.056774566332844
44301,703-004-5396,3916.4697,5,3,2,1.407838423786335
44878,703-004-5396,7961.326,4,2,2,1.7414434613456937
45135,703-004-5381,1757.4048,4,1,3,0.36951836429724944
45392,703-004-5386,7629.7754,3,2,1,0.5148501333356609
45524,703-004-5398,8246.222,2,1,1,0.9300045151582955
45846,703-004-5392,9654.508,4,4,0,1.2996984630572492
45887,703-004-5386,4324.7437,5,2,3,2.151325209218913
46070,703-004-5393,1674.0525,3,2,1,1.0609792905028534
46127,207-008-2398,3327.1462,"","","",0.27920371738274696
4622,703-004-5393,8065.289,5,1,4,0.4822956343105927
46307,703-004-5396,2106.6743,3,1,2,0.6098245443447605
46610,703-004-5385,1475.805,2,1,1,0.42211180665403436
46611,703-004-5382,8613.549,5,1,4,0.35831143730785864
46668,703-004-5393,2932.1926,3,2,1,0.9276381592579995
47399,703-004-5398,4823.069,6,4,2,0.8091531985849345
47453,703-004-5393,516.1351,3,2,1,0.587130517191244
47465,703-004-5384,8959.891,3,0,3,0.27920371738274696
47541,703-004-5393,7291.232,6,3,3,4.263832577184706
47560,207-008-2398,2011.7175,2,1,1,0.32666834933781397
47575,703-004-5393,9746.102,8,1,7,0.6644658354195963
47687,703-004-5395,7153.206,6,2,4,1.091805993975183
47791,703-004-5380,714.74194,2,0,2,0.27920371738274696
48310,703-004-5388,7149.558,3,2,1,0.48234946458198324
48430,703-004-5384,4751.1704,6,3,3,0.7875783367117901
48868,703-004-5387,3773.9153,4,1,3,0.5359965435229265
48904,703-004-5381,8311.784,4,3,1,1.2677393661481384
48968,207-008-2399,1506.6915,4,2,2,0.6884763939615206
49226,703-004-5399,5783.3535,5,4,1,1.2930090728348134
49428,703-004-5382,7061.3657,5,3,2,3.2535141679065247
49505,703-004-5394,9659.285,3,0,3,0.27920371738274696
49558,703-004-5391,6578.876,5,3,2,0.65406665938556
49640,703-004-5398,5449.876,4,3,1,0.77443712655268
506,703-004-5386,7514.6294,5,2,3,1.0086251200967151
5552,703-004-5397,533.59625,7,4,3,1.6104228303173227
5708,207-008-2399,4887.9365,6,5,1,1.712924304114457
5781,703-004-5386,823.1616,6,2,4,0.786503464076084
582,703-004-5393,5003.173,5,0,5,0.27920371738274696
585,703-004-5384,3777.6697,4,1,3,0.3978652972704144
5914,703-004-5391,8242.61,5,4,1,1.6258931026566532
5940,703-004-5391,2806.16,5,2,3,0.721124651025648
6055,703-004-5395,7782.6006,4,3,1,2.005129343164237
6196,703-004-5381,4830.72,3,1,2,0.5014799862501207
6578,703-004-5387,9768.469,2,1,1,0.5430659974009383
6599,703-004-5398,7818.441,1,1,0,0.43801580978551946
6638,703-004-5396,9895.491,3,2,1,0.5144739137147715
6752,703-004-5397,9623.735,5,3,2,1.298987034002901
7142,703-004-5383,9425.697,5,2,3,0.49895466285034185
7229,703-004-5398,9940.386,6,3,3,0.7329594851962895
7308,703-004-5388,3118.7957,4,4,0,1.3045011706117084
7674,703-004-5395,3418.9165,6,3,3,0.5844048002862678
7771,703-004-5390,6104.5576,2,2,0,0.9154625861410847
8157,703-004-5387,6514.404,1,1,0,0.42007759738412787
8162,703-004-5385,9335.223,4,2,2,1.142227700319488
8839,703-004-5395,1897.6605,3,1,2,0.4858511999881002
8851,703-004-5388,2834.5103,3,1,2,0.5333164663902169
913,207-008-2399,5896.115,8,7,1,2.012399080283834
9273,703-004-5391,4909.992,4,2,2,0.5869703336721811
977,703-004-5381,4674.588,2,1,1,0.5543541974127236
9820,207-008-2399,3986.847,4,3,1,1.0679855646485623
10057,703-004-5390,9734.056,9,2,7,1.7577745821867772
10477,703-004-5394,7860.42,4,1,3,1.521321677889397
10705,703-004-5385,9156.573,4,1,3,0.6716278727273568
10905,703-004-5383,5327.8936,4,2,2,0.4697791589148363
11064,703-004-5394,2701.8696,3,1,2,0.5624429630412106
11105,703-004-5387,2248.9011,3,2,1,0.737351206187481
11256,703-004-5394,1284.0295,3,3,0,1.059707734325725
11286,703-004-5390,7848.421,7,3,4,0.5424019937570552
11309,703-004-5383,4821.8394,4,2,2,1.3943145734757356
11358,703-004-5387,4039.7817,5,4,1,2.05254043313548
11507,703-004-5399,4433.442,2,2,0,0.49028591243265895
11583,703-004-5386,7127.1313,9,4,5,1.1959054659857737
11622,207-008-2398,3486.6882,3,3,0,1.2591497281273416
11710,703-004-5392,6107.717,7,2,5,1.2615805111044
1201,703-004-5383,8386.092,4,3,1,0.8516489191806107
12414,703-004-5382,533.16534,5,3,2,1.5643709104749481
12451,703-004-5387,8879.609,2,1,1,0.874112666820996
12459,703-004-5392,5573.464,3,2,1,1.0071755491016325
13324,703-004-5382,867.4783,7,0,7,0.27920371738274696
13357,703-004-5383,6980.94,3,0,3,0.27920371738274696
13427,703-004-5380,165.03691,1,0,1,0.27920371738274696
14208,703-004-5380,7520.591,3,1,2,2.3099703148714537
14522,703-004-5397,3296.367,3,2,1,0.6177059034858047
1465,703-004-5391,2828.8806,7,2,5,0.7529622811146937
15319,703-004-5387,5023.95,6,3,3,0.5238049953977145
15493,703-004-5383,3293.5493,8,5,3,3.940752874799374
15518,207-008-2399,9620.525,1,1,0,0.35831143730785864
15775,703-004-5398,321.50388,4,1,3,0.3923882915832162
16126,703-004-5386,1341.9044,2,2,0,0.42258645974701176
16292,703-004-5393,3450.0085,6,3,3,1.9786871638868135
16406,703-004-5390,3469.7068,9,3,6,2.3081172917215818
1693,703-004-5390,3222.342,3,1,2,0.5899359236385305
17245,207-008-2398,2592.687,6,3,3,1.2577663576369527
17327,703-004-5381,7820.171,2,1,1,0.3978652972704144
17387,703-004-5392,943.77277,4,1,3,0.3661776185035527
17549,703-004-5399,6834.236,7,1,6,0.7117968525993688
17567,703-004-5391,6074.4805,2,2,0,0.798720740026421
17850,703-004-5391,7863.754,2,2,0,0.9081606350883121
18027,703-004-5388,5630.6465,2,1,1,0.9183497947757762
18109,703-004-5389,5822.132,3,3,0,0.7707316891377153
18132,703-004-5386,2735.0027,3,2,1,0.4551400132050637
18209,703-004-5380,5835.458,2,1,1,1.6378720482403113
18375,703-004-5386,8966.538,2,1,1,0.3978652972704144
18841,207-008-2399,7924.844,1,1,0,0.35287166911069573
189,703-004-5392,2182.144,5,1,4,0.42866913990371397
19111,703-004-5385,1069.4116,5,1,4,0.633694062774039
19242,207-008-2399,5400.1826,2,0,2,0.27920371738274696
19300,703-004-5392,5853.174,2,1,1,1.0452511774427902
19513,703-004-5397,6740.714,5,2,3,0.7226063470486005
19622,703-004-5386,9038.572,6,4,2,2.1629525729860104
19807,703-004-5380,8985.215,4,3,1,0.8231264221241563
19819,703-004-5383,7170.636,2,1,1,0.47095037062257333
20274,703-004-5383,7998.712,"","","",0.27920371738274696
20789,703-004-5387,8040.12,2,1,1,0.3963021810826233
20976,703-004-5394,5761.039,5,2,3,1.4170252599405042
21197,703-004-5389,6418.073,5,1,4,0.33853450732658075
2122,703-004-5393,5517.717,5,2,3,0.6933988927307076
21320,703-004-5396,684.191,5,1,4,0.35831143730785864
21371,703-004-5390,864.799,6,3,3,1.1758301964073692
21737,703-004-5382,5848.7476,4,3,1,2.868888660163018
21939,703-004-5397,5233.391,3,1,2,0.5311461428132773
21952,703-004-5397,1356.6912,4,3,1,1.5392187852986432
22062,703-004-5393,8553.993,2,1,1,0.381926033464075
22151,703-004-5391,7928.1987,6,2,4,1.8392652339998599
22336,703-004-5392,5115.0913,"","","",0.27920371738274696
22346,207-008-2399,2558.819,2,1,1,0.8198719494175257
22540,703-004-5396,1841.5814,1,1,0,0.8837750951743885
22623,703-004-5389,4421.349,4,2,2,0.6182660386867609
22846,703-004-5384,364.1957,5,2,3,0.7075251082733747
22853,703-004-5390,4304.464,1,0,1,0.27920371738274696
22961,207-008-2398,1049.6343,3,2,1,0.4392155617062697
23163,703-004-5386,3059.0208,4,1,3,0.4337975069301488
23460,703-004-5399,3667.0547,4,2,2,0.6298663342356635
23661,703-004-5385,9888.472,1,0,1,0.27920371738274696
23850,703-004-5397,4089.8691,5,1,4,0.5343878737787008
24783,703-004-5384,891.79395,2,1,1,0.5185582987181448
24790,703-004-5383,8569.368,3,1,2,0.5568718143198889
24846,703-004-5394,8034.686,4,4,0,2.4977567987653417
24901,703-004-5380,4644.4434,8,6,2,1.1274815326332805
24997,703-004-5392,6233.259,3,2,1,1.0458380108610268
25021,703-004-5382,1091.7043,5,3,2,0.9801451930577784
25031,703-004-5395,8080.5684,3,2,1,1.0857774163611225
25090,703-004-5383,5237.232,5,3,2,1.3772327533354842
25732,703-004-5385,42.633415,4,1,3,0.7083224866982576
2600,703-004-5395,1352.911,6,2,4,0.6842842307862123
26690,703-004-5392,9972.4,5,3,2,1.7705723448174773
270,703-004-5382,5926.8887,5,1,4,0.412079965694458
27068,703-004-5392,971.97235,3,0,3,0.27920371738274696
271,703-004-5382,5353.088,6,1,5,0.4819673607652222
27158,703-004-5398,9257.096,4,1,3,0.35831143730785864
27277,703-004-5391,8122.7656,7,1,6,0.3401166617250829
27297,703-004-5382,6620.526,3,1,2,0.6598740891814662
27843,703-004-5383,2765.5286,5,4,1,1.317361548742759
27946,703-004-5385,8529.367,7,3,4,0.8379645478691611
28307,703-004-5398,4877.2334,2,1,1,0.6018694990655246
28328,703-004-5381,7569.8774,3,0,3,0.27920371738274696
28368,703-004-5382,4193.4155,5,3,2,0.9991980561622213
28456,703-004-5393,1269.1599,1,1,0,0.6504993184502114
28475,703-004-5382,377.40646,4,3,1,1.110953699258025
28713,703-004-5395,3092.2305,5,1,4,0.43534843712704513
28793,703-004-5399,5775.3823,7,4,3,1.997675757943684
29047,703-004-5392,2259.5144,7,3,4,1.152355653256977
29127,703-004-5388,8475.572,11,8,3,2.056230971777072
29195,703-004-5388,2873.0278,4,4,0,2.0931333626055078
29335,703-004-5389,1572.0355,7,3,4,1.2835730743019784
29420,703-004-5387,9957.66,1,1,0,0.4600637420615335
29694,703-004-5383,194.39995,9,4,5,1.9331088351236074
29702,703-004-5388,9085.211,10,4,6,1.477728543413232
29892,207-008-2398,7508.231,5,4,1,0.9631143442800184
29971,703-004-5389,6478.8916,9,5,4,2.156873377743397
30080,703-004-5395,4699.39,3,2,1,0.5347031478896305
30226,703-004-5394,4002.5508,1,0,1,0.27920371738274696
30383,703-004-5399,2478.4983,2,2,0,0.7117144459324156
30691,703-004-5383,6690.0063,5,3,2,2.037055182804524
30907,703-004-5389,9930.562,4,2,2,1.3153292880653777
30931,703-004-5397,2671.885,7,3,4,1.4176996704871672
3094,703-004-5388,8807.404,5,4,1,0.9269488530840225
30952,703-004-5392,7775.4595,6,4,2,1.7197569954935361
30990,703-004-5383,1582.213,4,3,1,1.8858201603203792
31229,703-004-5388,7654.2725,4,3,1,0.8640536212490638
31375,207-008-2398,7798.1504,3,1,2,0.5165268771580819
31497,703-004-5382,8471.684,4,3,1,0.8497479836985029
31562,703-004-5388,5761.222,10,7,3,3.0581196663881007
31611,703-004-5386,5280.5654,4,3,1,2.518957336043905
31956,703-004-5381,36.997795,3,1,2,0.5199586346247347
32016,703-004-5397,4984.6147,3,2,1,0.8234648304675151
32080,703-004-5397,95.35074,3,2,1,0.5876463115833988
32140,703-004-5389,3141.917,3,0,3,0.27920371738274696
32515,703-004-5381,5675.903,4,3,1,0.9141638991378124
32526,703-004-5382,7208.27,3,2,1,0.7966643551662917
32674,703-004-5397,974.86255,5,3,2,1.1114729289100733
32749,703-004-5381,8524.794,6,3,3,0.733411676682969
32862,703-004-5384,8861.666,2,1,1,0.35831143730785864
32872,703-004-5391,9488.884,3,2,1,0.8042812083856756
33092,703-004-5394,1546.1189,4,4,0,1.7436129871348673
33264,703-004-5398,3107.8208,1,1,0,1.1515837641092703
33767,207-008-2399,8750.5205,4,2,2,0.5744155301024273
34061,207-008-2398,313.24805,2,1,1,0.7982093275759574
34241,703-004-5393,247.27524,4,2,2,1.7191843208192952
34557,703-004-5388,5078.2295,4,3,1,1.7068434820843847
3497,703-004-5395,4347.438,4,1,3,0.6594149706352143
3508,703-004-5387,5272.4185,5,2,3,0.5945864197941858
35206,703-004-5394,242.65886,2,1,1,0.3978652972704144
35529,703-004-5389,44.90793,3,1,2,0.5384300806129948
35925,703-004-5388,6963.6416,3,0,3,0.27920371738274696
36447,703-004-5395,196.58148,2,1,1,0.3978652972704144
36771,703-004-5384,9031.951,5,3,2,0.839321421458797
36811,703-004-5384,4832.8525,7,3,4,2.25191855423748
37316,703-004-5383,5076.4556,2,2,0,1.6810158999183051
37419,703-004-5396,8310.502,7,3,4,0.8774602750530651
37781,703-004-5394,635.184,5,4,1,1.358867701357989
37876,703-004-5382,1710.3142,3,2,1,0.4291006351762739
38125,207-008-2398,5772.4595,1,0,1,0.27920371738274696
38156,703-004-5398,5386.944,6,4,2,1.3056850237290456
38357,703-004-5397,9606.848,8,2,6,0.6722212065635018
38429,703-004-5392,5268.9365,6,5,1,1.2379816975243771
38604,703-004-5387,8172.8047,4,1,3,0.4438068393211827
38983,703-004-5382,6425.0635,1,0,1,0.27920371738274696
38999,703-004-5388,7796.9155,5,2,3,1.4408740828256499
39043,207-008-2398,6546.0415,3,2,1,0.6001321448604722
3925,703-004-5383,9286.6045,2,1,1,0.48335504229389853
3943,207-008-2399,6199.633,4,1,3,0.45106743635671664
39500,703-004-5398,5017.222,5,2,3,1.5426810334811667
39541,703-004-5382,1598.2485,5,3,2,1.4658090833740227
39818,703-004-5395,206.97653,5,3,2,1.3186480534903413
40096,703-004-5380,1677.3987,2,2,0,0.7039121089866616
40121,703-004-5394,4676.0337,3,2,1,0.5970612282906983
40390,703-004-5390,4547.3726,4,2,2,0.7505875509844715
40542,703-004-5382,1403.3818,1,0,1,0.27920371738274696
40747,703-004-5392,2011.385,"","","",0.27920371738274696
40968,703-004-5392,4024.6272,4,2,2,1.0762248170501947
41169,703-004-5390,4364.1274,2,2,0,1.2196602468146942
41514,703-004-5397,4008.0422,8,5,3,2.1636838447885047
41573,703-004-5395,7238.632,5,3,2,2.3064311175174046
41868,703-004-5388,5939.871,7,5,2,1.6836363245827755
43042,703-004-5382,3233.1365,3,1,2,0.5485597297274709
43283,703-004-5391,6597.198,5,3,2,1.1425938604394927
43292,703-004-5390,8422.972,3,1,2,0.49061765736899265
43446,703-004-5393,8820.11,6,3,3,2.1014616107889217
4348,703-004-5381,4847.725,1,1,0,0.4608228511077748
43624,703-004-5382,1739.2958,1,0,1,0.27920371738274696
43657,703-004-5395,3245.3293,4,2,2,0.6589949365107126
43665,703-004-5381,5479.415,7,3,4,0.8521639745703183
44256,703-004-5384,5351.7847,5,3,2,0.8932275201935538
44288,703-004-5380,7064.4854,5,1,4,0.4163738256069556
44790,703-004-5383,2159.437,2,2,0,1.001371031056856
44896,703-004-5386,6075.0903,3,2,1,0.9550171094052847
45103,703-004-5398,3735.5806,8,6,2,2.9051894045817526
45173,703-004-5396,3444.479,5,2,3,1.0699658146421427
45320,207-008-2399,252.39944,7,5,2,1.5804651503566607
45429,703-004-5392,2715.5703,6,3,3,2.3353849356077565
45593,703-004-5384,921.32745,4,2,2,1.4868016949311007
45882,703-004-5386,3077.9182,1,0,1,0.27920371738274696
46197,703-004-5380,2472.7493,3,2,1,1.2316511749475816
46373,703-004-5388,3233.5454,4,0,4,0.27920371738274696
46805,703-004-5387,6262.8174,5,2,3,4.39500259131531
47396,703-004-5384,9387.3545,5,2,3,0.7091245097807568
47479,207-008-2398,3119.443,5,1,4,0.8186185278191183
47659,703-004-5398,6505.3325,7,2,5,0.5085023403825981
47832,703-004-5389,8759.608,4,3,1,1.0852526267690632
48010,207-008-2398,2400.5735,6,2,4,0.8775572777649381
48404,703-004-5388,1454.4279,4,0,4,0.27920371738274696
48480,703-004-5392,6911.283,7,3,4,1.9902332306342438
48496,703-004-5398,6749.248,3,2,1,0.6978111222960799
48554,703-004-5396,2335.8518,1,1,0,0.40538053066330004
48619,703-004-5385,8216.402,7,4,3,3.6160893507013294
48670,703-004-5389,8650.185,1,1,0,0.41060571195982704
48804,207-008-2399,1652.5918,4,2,2,2.0086547385325004
4883,703-004-5387,3565.9187,5,4,1,1.5992318260394114
48894,703-004-5398,8429.272,2,2,0,1.0415205645616235
49254,703-004-5396,402.2497,3,2,1,0.6346063220164657
49321,703-004-5392,2080.8,4,0,4,0.27920371738274696
49426,703-004-5394,8752.255,3,2,1,0.5174489472328838
49544,703-004-5388,5034.528,4,3,1,1.6366696035499502
49824,703-004-5387,7332.907,4,1,3,0.6588967306148479
5119,703-004-5398,4240.6816,7,5,2,1.391895316106315
5333,703-004-5384,9296.271,6,3,3,1.3537479881066339
5382,703-004-5398,1770.0374,1,0,1,0.27920371738274696
5618,703-004-5387,9008.934,2,0,2,0.27920371738274696
5737,703-004-5387,6817.217,5,3,2,1.3484704090629693
5976,207-008-2399,6032.9844,2,1,1,0.9058647976169009
6072,703-004-5389,3622.365,5,3,2,1.081804149295734
6483,703-004-5395,3946.904,3,2,1,0.8552185086848457
6692,703-004-5394,3195.3818,2,0,2,0.27920371738274696
6914,703-004-5381,9137.488,2,2,0,0.600363012264814
7050,703-004-5380,6949.9805,2,0,2,0.27920371738274696
7464,703-004-5396,6731.778,4,3,1,0.5989889511730797
7476,703-004-5393,7710.6577,4,2,2,0.7951570598501947
7845,703-004-5389,6867.028,3,3,0,1.1261245429655682
7917,703-004-5396,9420.537,2,0,2,0.27920371738274696
7923,703-004-5384,3699.9238,1,0,1,0.27920371738274696
8009,703-004-5387,5394.7573,5,2,3,0.8765781015237722
8379,703-004-5384,7926.6997,6,4,2,1.0328187453003688
8405,703-004-5391,6672.679,4,1,3,0.5844606316437716
8466,703-004-5390,735.27454,7,2,5,1.0175826217574337
8545,703-004-5394,516.1482,2,1,1,0.7702797215153634
8615,703-004-5398,8080.3057,2,0,2,0.27920371738274696
8801,703-004-5390,2568.4846,10,5,5,1.2771754948375362
8994,703-004-5389,3836.3545,2,1,1,0.6309832695919697
9184,703-004-5397,8420.189,1,1,0,0.4217064550327408
9389,703-004-5391,2867.0781,2,0,2,0.27920371738274696
9572,703-004-5388,9893.234,6,2,4,0.7969565179451679
9715,703-004-5387,628.1447,5,4,1,1.3184543268031488
9942,703-004-5397,8036.706,4,2,2,0.5153838094400325
9976,703-004-5389,346.44485,5,3,2,0.9979452360795834
10182,703-004-5393,4131.766,1,0,1,0.27920371738274696
10293,703-004-5388,7380.6875,3,2,1,0.6032324804944461
10329,703-004-5389,890.33185,1,1,0,0.8820828793704137
10794,703-004-5393,8556.491,2,0,2,0.27920371738274696
10795,703-004-5388,5821.0747,5,2,3,0.6486383897006424
10956,703-004-5399,6956.7246,8,3,5,1.328949742246218
10983,703-004-5388,7848.9404,6,3,3,0.7382684510495148
11228,703-004-5383,7646.5845,6,5,1,1.6645536058118993
11399,703-004-5399,8305.246,2,2,0,0.8432346689189208
11739,703-004-5397,6484.224,3,2,1,0.6131108079467339
11747,703-004-5390,1350.9185,10,7,3,3.3326886173177566
12007,703-004-5383,3061.028,4,2,2,4.403882371527372
12019,703-004-5389,4306.7324,2,1,1,0.3978652972704144
12063,703-004-5385,4480.783,7,5,2,3.7317610383195245
1209,703-004-5392,8744.146,2,1,1,0.41985471326294643
12271,703-004-5391,6000.4263,3,2,1,0.70382287581067
12485,703-004-5391,3808.6694,8,5,3,1.4734775515536134
12740,703-004-5397,4880.212,6,4,2,1.6835272792375453
12752,207-008-2398,5601.4053,6,2,4,1.8164357437168472
12791,703-004-5393,1239.4816,5,1,4,0.575799778379783
14106,703-004-5387,6969.6826,5,2,3,0.7213704532999927
14274,703-004-5383,3267.4116,8,5,3,2.980954094746066
14562,703-004-5392,6036.5415,8,3,5,2.953409000962387
14718,703-004-5395,2920.5806,7,2,5,0.7367085300656044
14905,703-004-5390,3226.1885,6,1,5,0.7692379010451894
14941,703-004-5381,6002.613,3,1,2,0.5230887923844169
14985,703-004-5383,9367.257,6,2,4,0.7558580656526089
15276,703-004-5382,7329.4824,2,1,1,0.3807252912866403
15284,703-004-5390,7039.208,2,2,0,0.5690187372691071
15304,703-004-5396,1116.6388,3,1,2,0.7215009374323754
15308,703-004-5387,9413.171,3,2,1,1.4797944932203986
15378,703-004-5392,7914.5547,2,0,2,0.27920371738274696
15483,207-008-2398,3902.9766,4,2,2,1.2304424623404908
15609,703-004-5392,8266.779,8,2,6,2.0024374935029603
15688,703-004-5395,3404.307,5,3,2,1.8819218923994518
15989,703-004-5390,9606.636,1,1,0,0.6963486914927322
16016,703-004-5383,5315.104,5,2,3,0.6799293408545319
16120,703-004-5382,310.3751,3,0,3,0.27920371738274696
16143,703-004-5381,5277.171,3,3,0,1.2687511923643398
1617,703-004-5384,4460.5835,6,3,3,0.9152090441152986
16375,703-004-5385,4035.372,4,3,1,1.1357863561452293
16607,703-004-5398,1530.838,2,0,2,0.27920371738274696
16661,703-004-5392,6707.5454,4,2,2,0.7423597523924205
16861,703-004-5383,661.1222,6,3,3,1.1803561131333002
17105,207-008-2398,4193.258,3,2,1,0.8317062380364019
17140,703-004-5396,4231.127,2,0,2,0.27920371738274696
1723,703-004-5391,3983.426,4,2,2,1.9645379427640062
17240,207-008-2399,1953.463,3,1,2,0.35635222875013944
17473,703-004-5380,8888.673,4,2,2,0.8277515106851534
17474,703-004-5382,1933.2648,6,3,3,0.9943257133028471
17675,703-004-5381,248.71588,2,1,1,0.47107767537841183
17798,703-004-5388,9469.37,4,2,2,1.1057255145399276
17891,703-004-5381,6790.2563,2,2,0,0.8335377720746635
18022,703-004-5399,1276.4209,2,1,1,0.5508176459169309
18461,703-004-5390,5593.23,4,2,2,0.5244289364801702
18512,703-004-5388,6270.483,6,2,4,0.7083781717105625
18536,207-008-2398,3194.152,5,4,1,1.7876664196268062
1872,703-004-5381,7528.8027,6,3,3,2.2445917174663665
18807,703-004-5380,9587.743,4,0,4,0.27920371738274696
1963,703-004-5388,1689.412,3,1,2,0.5165268771580819
19695,703-004-5398,9315.346,4,2,2,1.0590825521647182
19999,703-004-5394,6037.7407,3,1,2,1.3356877568117589
20000,207-008-2399,2217.5156,1,0,1,0.27920371738274696
20362,703-004-5395,1775.3011,3,2,1,1.9829805298488177
20386,703-004-5392,6435.807,6,4,2,2.8322438637582588
20406,703-004-5398,3659.1929,2,0,2,0.27920371738274696
20618,703-004-5390,9341.023,6,3,3,1.9503727836695897
20740,703-004-5396,8593.478,5,3,2,1.6803000787475229
20830,703-004-5387,5736.4966,4,3,1,1.4088275979913731
20892,703-004-5399,4130.8765,7,4,3,1.2872351339392158
20992,703-004-5392,4225.006,7,3,4,1.2407777390499
21053,703-004-5397,6111.1,5,1,4,0.5874850447402169
21676,703-004-5382,9784.361,4,1,3,0.6464858452850507
21775,703-004-5383,8649.704,1,0,1,0.27920371738274696
2190,703-004-5391,8598.84,5,2,3,1.7126448690885487
21995,207-008-2399,6094.9814,2,1,1,0.48401741995188474
22565,703-004-5383,2144.3577,2,2,0,1.4587834189015347
2261,703-004-5393,279.70374,5,2,3,0.4993868711743077
22787,703-004-5397,395.92444,9,3,6,1.1172937344175808
22830,703-004-5389,154.03926,10,3,7,1.5033675624508667
23349,207-008-2399,2248.0427,5,2,3,0.8644622477417161
23465,703-004-5386,696.81165,4,3,1,1.0895258990411578
23551,703-004-5396,9006.776,7,3,4,0.969203168210089
23675,703-004-5387,4153.866,5,3,2,1.0183005023046274
23758,703-004-5384,5933.637,4,3,1,1.3730709011524804
23783,703-004-5382,8516.682,5,2,3,0.4791461852844409
24140,207-008-2399,1602.9788,4,2,2,1.154629992942721
24216,703-004-5380,4721.1694,2,1,1,0.5360728376129064
24268,703-004-5394,4628.0723,3,1,2,0.8097251094919784
25082,207-008-2399,4278.918,5,3,2,1.3347110072592943
25161,703-004-5398,9746.339,6,3,3,1.8388901639236288
25571,703-004-5392,6314.454,2,1,1,0.43611846150965156
25657,703-004-5392,2050.4724,3,3,0,2.065678869541967
25877,703-004-5386,9276.662,3,2,1,1.408440924903918
26076,703-004-5399,5548.677,6,4,2,1.7337790134235533
26256,703-004-5390,7174.431,6,2,4,0.6307836717533823
26268,703-004-5384,5968.522,5,2,3,1.7539071192749094
26292,703-004-5399,8793.848,4,2,2,0.7238549540356197
27035,703-004-5398,2130.773,6,5,1,1.3545766421123038
27079,703-004-5394,4295.319,2,1,1,0.3978652972704144
27221,703-004-5390,7761.795,4,1,3,0.7482843968030028
27250,703-004-5392,6172.426,"","","",0.27920371738274696
27275,703-004-5381,88.32336,1,0,1,0.27920371738274696
27668,703-004-5394,8660.436,6,3,3,1.5586056600627949
27794,703-004-5392,5988.591,4,1,3,0.5402979409826763
27831,703-004-5386,2656.449,2,0,2,0.27920371738274696
2788,703-004-5390,3903.2446,7,2,5,0.7710026595156826
28026,703-004-5398,5973.7573,3,1,2,0.5863839197809333
28090,703-004-5393,826.35046,5,2,3,0.6837475040196415
28109,703-004-5399,747.2897,6,3,3,1.4469211001273898
29095,703-004-5383,7381.266,5,3,2,1.478535694652119
29440,703-004-5385,14.363527,7,3,4,1.3412767980321816
29510,703-004-5388,1542.8918,4,1,3,0.364995033928984
29740,703-004-5393,936.358,6,2,4,0.932402008644858
29749,703-004-5391,6300.7085,3,2,1,0.7658928610998265
29964,703-004-5398,8076.841,5,3,2,0.7686400593345845
2998,703-004-5392,5383.738,5,3,2,2.001103564482964
3001,703-004-5386,8584.161,3,1,2,0.3978652972704144
30166,703-004-5380,3747.095,3,2,1,0.6811961157021059
30493,703-004-5380,8660.452,7,4,3,1.54894586517291
30500,703-004-5380,452.24548,2,1,1,0.6793081548339498
30684,703-004-5388,8268.328,4,3,1,0.8823123669836443
31231,703-004-5398,6466.1167,2,1,1,2.9598929968235117
31371,703-004-5391,74.022415,2,2,0,1.0212852618699784
31639,703-004-5389,8772.794,5,4,1,1.5061881568073714
31751,703-004-5388,9903.528,2,2,0,0.8062516943938973
32114,703-004-5390,5062.8306,3,3,0,1.0354308672805328
32287,703-004-5399,3066.873,1,0,1,0.27920371738274696
32450,703-004-5394,5918.798,5,2,3,0.6147046894535528
3256,703-004-5380,4512.8574,6,5,1,1.4810075151819835
32684,703-004-5398,5193.3174,4,2,2,1.2377268401805344
32798,703-004-5384,1732.902,6,2,4,1.0530728776140343
32959,703-004-5390,6089.955,3,3,0,1.5036951287891223
33094,703-004-5389,4139.5024,6,3,3,0.9824207171378357
33126,703-004-5392,5116.8643,1,0,1,0.27920371738274696
33194,703-004-5387,8016.2466,4,2,2,3.2916548983084186
33364,703-004-5386,2775.9915,2,1,1,0.6471535805512181
33520,207-008-2399,2237.1763,6,2,4,1.3680869845206733
33576,207-008-2399,3715.6917,6,2,4,2.371949152855745
33624,703-004-5393,8941.185,3,1,2,0.3383696995767367
3397,703-004-5387,5858.7896,8,3,5,1.3217427699045887
3398,703-004-5399,8714.288,4,1,3,0.3615196508894215
34234,703-004-5394,9425.21,3,2,1,1.0379426859650158
34423,703-004-5393,9694.975,2,0,2,0.27920371738274696
34426,703-004-5397,3566.7205,1,0,1,0.27920371738274696
34429,703-004-5384,1305.0288,3,1,2,0.6173892200625992
34573,703-004-5386,7593.587,10,5,5,2.623470299516916
34769,703-004-5397,6332.423,7,5,2,3.007574685539663
34895,703-004-5388,1661.7572,5,2,3,0.39608537357209944
35063,703-004-5397,3962.651,7,4,3,1.271182443389962
35195,703-004-5389,6496.874,2,2,0,2.09369572965408
35506,703-004-5398,9447.21,3,3,0,0.857658028121636
35567,703-004-5381,1357.3396,3,3,0,1.2980796077983874
35645,703-004-5385,8407.446,3,1,2,0.6209020895495684
35827,703-004-5393,6179.7104,2,2,0,0.9096190084886195
36680,703-004-5385,4554.9785,5,4,1,1.627552301838783
37020,703-004-5394,2806.9763,7,3,4,1.075263482299142
37255,703-004-5386,7979.59,3,2,1,0.9269046214325747
37617,703-004-5380,2722.8933,3,1,2,0.5812023343916147
37808,703-004-5391,3538.6777,2,1,1,0.3187575773453028
37899,703-004-5398,3751.083,1,0,1,0.27920371738274696
37918,703-004-5397,936.71027,6,4,2,1.167398484971722
37950,703-004-5385,7338.0903,5,2,3,0.6585399827000901
38020,703-004-5398,4250.598,"","","",0.27920371738274696
38262,703-004-5385,1923.1552,3,2,1,1.4504049747162033
38324,703-004-5392,8172.367,3,1,2,0.363065297232138
38453,703-004-5396,1128.7015,1,0,1,0.27920371738274696
38671,703-004-5399,9723.431,5,2,3,1.0274072749300285
3870,703-004-5380,307.58142,2,0,2,0.27920371738274696
38714,703-004-5399,8307.75,5,4,1,5.564725946510477
38840,703-004-5389,9128.616,5,2,3,1.14471810210091
38892,703-004-5381,7454.4404,6,2,4,2.2998554099673525
39013,703-004-5385,5419.805,3,1,2,0.6849405522087755
39297,703-004-5394,1363.6577,6,2,4,1.1046332370449008
39392,703-004-5386,9258.044,5,3,2,1.3001096600677087
39803,703-004-5384,4446.192,3,1,2,0.37512182779194486
40054,703-004-5384,5769.7407,4,3,1,0.9948449277074466
40183,703-004-5394,7962.936,5,1,4,0.3391401758072573
40249,207-008-2398,4341.326,3,2,1,1.2912522049996147
4029,703-004-5385,1204.3601,8,4,4,1.4006662419809073
40531,703-004-5381,4423.984,4,1,3,0.4332394934737561
40543,703-004-5393,9550.328,4,1,3,1.7936292298915937
40581,703-004-5399,8187.7666,1,0,1,0.27920371738274696
40702,703-004-5396,6052.1953,7,5,2,2.470620338467514
40979,207-008-2398,5602.9,3,1,2,0.4748934281273129
40985,703-004-5390,3136.682,3,2,1,0.9945305682528222
40999,703-004-5384,1468.7073,2,1,1,0.35114230018964543
41294,703-004-5385,2759.1438,6,4,2,1.3567464219686585
41424,703-004-5386,2597.7964,2,0,2,0.27920371738274696
41690,703-004-5391,5742.3037,1,0,1,0.27920371738274696
41737,703-004-5381,3477.7778,5,2,3,1.7077187190825098
41957,703-004-5390,2718.389,4,1,3,0.4010798724311213
42024,703-004-5384,3360.0574,15,8,7,3.07301207127809
42045,703-004-5397,802.99554,4,1,3,0.43875868944474034
42129,207-008-2399,5379.4966,3,2,1,0.7509703622284838
42450,703-004-5392,9299.262,2,0,2,0.27920371738274696
42451,703-004-5383,8319.192,3,2,1,1.1735382503100285
43217,703-004-5384,3045.187,5,4,1,3.51340536525412
43271,703-004-5397,3614.511,1,0,1,0.27920371738274696
43331,207-008-2398,6211.769,2,2,0,0.8806858589682592
43663,703-004-5390,450.49606,5,4,1,2.7048266056905264
43756,703-004-5384,2302.4487,5,4,1,1.1303296682874768
4401,703-004-5381,8430.608,2,2,0,0.7051256887118398
44215,703-004-5388,1736.8645,2,0,2,0.27920371738274696
44274,703-004-5384,6564.4697,8,2,6,0.7955961064080931
44494,703-004-5381,9851.673,1,0,1,0.27920371738274696
44754,703-004-5391,5255.0703,5,2,3,1.5599140303703634
4480,703-004-5380,3710.2837,3,1,2,0.659655654591655
44952,703-004-5392,736.711,4,2,2,0.5982285015247312
45084,703-004-5398,6018.3687,2,2,0,1.4012300508263489
45126,703-004-5395,3667.283,5,3,2,2.180162130644931
45200,703-004-5382,9412.943,4,3,1,1.4647216921351551
45414,703-004-5394,2526.3203,5,1,4,0.38330255487870046
46716,703-004-5387,1914.6013,5,2,3,0.44792729715577595
46755,703-004-5387,5792.674,4,2,2,1.749430708921997
47037,703-004-5394,6699.8154,"","","",0.27920371738274696
47561,703-004-5398,1312.5544,5,5,0,2.8568897285056654
4760,207-008-2398,4642.7275,4,1,3,0.40444662008085086
47757,703-004-5396,1979.6735,5,3,2,0.7781365413365666
47973,703-004-5397,219.0572,8,2,6,0.6283641531205093
47981,703-004-5395,7258.6177,2,2,0,1.168252237636669
48191,703-004-5396,5440.944,"","","",0.27920371738274696
48264,703-004-5393,798.17236,4,4,0,1.6450892725232809
48426,703-004-5380,6062.971,4,3,1,0.7027059451445679
48444,703-004-5382,1581.1581,1,0,1,0.27920371738274696
48519,703-004-5387,2985.5508,2,2,0,1.0703351544266557
48524,703-004-5394,2180.2883,4,2,2,1.4415182504379846
49028,207-008-2399,2007.9136,7,3,4,1.8986647307904752
49315,703-004-5393,6960.3574,1,1,0,0.4540906508655392
49332,703-004-5397,4630.791,1,0,1,0.27920371738274696
49509,703-004-5389,5380.6333,3,1,2,0.35831143730785864
49533,703-004-5390,2549.7495,6,3,3,1.3034640420262407
49711,703-004-5391,2340.2017,2,1,1,0.4313752546776924
5018,703-004-5396,6948.7715,3,1,2,0.4699821635645838
5597,703-004-5397,6008.525,4,2,2,0.6484101785732216
5620,703-004-5388,4054.29,6,3,3,1.3898073744170418
6172,703-004-5384,686.1377,7,4,3,1.5457797317014126
6198,703-004-5395,9623.642,3,1,2,0.42712823734814376
6427,207-008-2398,7983.4795,3,1,2,0.5395079319773617
650,703-004-5395,4207.1685,4,1,3,0.7546557322866368
6595,703-004-5383,4778.197,4,2,2,0.7227827753940532
6678,703-004-5384,9287.523,1,1,0,0.4450827369621925
7797,703-004-5396,586.3959,6,4,2,1.3251965356039068
8004,703-004-5384,3030.4229,5,3,2,1.2855819747892867
805,703-004-5386,9556.633,1,0,1,0.27920371738274696
8467,703-004-5395,7812.625,7,1,6,0.6139638490439528
852,703-004-5392,2482.9746,4,2,2,0.607808485218584
9194,703-004-5397,9731.056,8,4,4,1.0522553697395445
9418,703-004-5381,9605.849,2,0,2,0.27920371738274696
9427,703-004-5391,9221.914,3,1,2,0.3338475952168463
9488,703-004-5396,1484.8906,6,2,4,0.5210240027786606
965,703-004-5395,7669.341,4,3,1,0.6707063602186827
9726,703-004-5397,4339.317,1,1,0,0.5407237896159204
9898,703-004-5399,9978.22,"","","",0.27920371738274696
9922,703-004-5380,8242.47,3,2,1,1.3534242358072814
10004,703-004-5384,1982.3712,3,1,2,0.3957412549854037
10140,703-004-5382,7504.5938,4,3,1,1.5648021113874935
10242,703-004-5399,5817.9253,2,2,0,2.0123540144298335
10482,703-004-5391,7729.078,3,2,1,0.6298610035139963
10604,703-004-5398,6170.0796,7,3,4,0.7201137786822708
11410,703-004-5395,159.2046,4,3,1,0.8515450940912156
11485,703-004-5389,7970.0415,2,1,1,0.49191926076988846
11552,703-004-5384,8915.587,1,1,0,0.5173094214544549
11723,703-004-5382,8514.477,5,5,0,1.3438033613183626
12096,703-004-5394,9246.574,6,2,4,0.7752254138544595
1262,703-004-5382,1234.0355,6,1,5,0.44445839544302035
12692,703-004-5381,9418.238,2,1,1,0.5172510007093377
13061,703-004-5392,5504.504,3,1,2,0.6480464516635178
13709,703-004-5399,5967.2246,5,5,0,1.6473737003456028
14152,703-004-5398,2890.9595,3,2,1,1.7868150119804493
14229,703-004-5390,4683.278,6,3,3,0.8912974434447996
14270,703-004-5381,6045.968,5,3,2,1.323144946715644
14511,703-004-5398,105.86143,2,0,2,0.27920371738274696
14569,703-004-5388,5958.5996,4,3,1,1.9213569686171905
14703,703-004-5394,3712.0264,4,2,2,1.2132643057626804
15129,703-004-5389,4679.0234,3,1,2,0.5658621824813097
15170,703-004-5397,2298.7651,6,4,2,2.324387757706707
15356,703-004-5399,6326.478,6,4,2,2.189689347722174
15540,703-004-5388,457.5181,6,3,3,0.889336833231201
1558,703-004-5396,605.033,4,2,2,1.3202390686855492
15587,703-004-5398,1443.7496,5,4,1,1.97274276349618
15818,703-004-5386,2191.7576,2,1,1,1.5302101329586117
15901,703-004-5381,9066.179,1,1,0,1.2612264669614741
17354,703-004-5380,5447.609,3,2,1,1.0537770906215456
17441,703-004-5386,3542.5776,4,2,2,1.0893636768064472
17575,703-004-5394,2573.1707,2,1,1,0.45207530441690835
17577,703-004-5387,4398.5474,4,4,0,1.8829362502204439
17606,703-004-5389,1379.1907,5,4,1,3.677167917724604
17642,703-004-5387,275.03253,6,2,4,0.9308302578835611
17978,703-004-5395,313.76242,2,1,1,0.4936747432344577
18300,703-004-5388,6590.399,6,2,4,0.6363915536196104
18324,703-004-5397,4235.977,3,2,1,0.5574821528864541
18731,703-004-5384,3890.612,2,1,1,0.5064404710549787
18809,703-004-5383,196.16365,5,1,4,0.5165268771580819
19116,703-004-5389,598.7102,4,3,1,0.8029630925230602
19265,703-004-5395,6662.6704,8,5,3,2.7083361233489467
19577,703-004-5395,4758.9346,2,1,1,0.5049901494105447
19739,703-004-5399,6810.889,4,2,2,1.462468897645636
19829,703-004-5396,1990.7594,4,2,2,0.9321328613286707
19978,703-004-5393,3102.414,8,5,3,4.229374369253137
19986,703-004-5392,4022.9058,7,3,4,1.740026766870089
20138,703-004-5395,8544.799,4,1,3,0.3637500930527101
20270,703-004-5380,7782.2827,1,1,0,0.3978652972704144
20838,703-004-5382,1215.5933,5,2,3,0.5796700274392649
20927,703-004-5383,1126.6255,6,3,3,1.1021880049330126
20942,703-004-5390,1141.1548,2,0,2,0.27920371738274696
21169,703-004-5394,2204.4802,9,3,6,1.0924109962043833
21973,207-008-2399,4314.7188,2,2,0,1.1698126323172537
22331,703-004-5392,2195.732,6,4,2,1.3169466130401712
22378,703-004-5383,330.2008,5,3,2,0.8178474444428561
22849,703-004-5384,4336.327,1,1,0,0.7939554733350045
22852,703-004-5398,6432.8647,1,1,0,0.4314860782385869
22955,703-004-5381,662.4377,4,3,1,0.6467023313772903
231,703-004-5387,8192.32,4,1,3,0.3514985026793696
23443,703-004-5380,9439.234,"","","",0.27920371738274696
23456,703-004-5390,5305.9165,4,3,1,1.0528180193737573
23510,703-004-5398,979.0963,1,0,1,0.27920371738274696
2356,703-004-5387,7408.6255,2,2,0,0.9539681583726551
23652,703-004-5392,8313.321,3,3,0,3.623135494900242
23761,703-004-5388,672.4894,2,2,0,0.6217229391091685
24359,703-004-5395,3432.9426,4,1,3,0.5277290659246646
24450,207-008-2398,4873.1855,5,3,2,1.0151964984240096
24600,207-008-2399,3921.0974,5,4,1,2.4461152599366685
24643,703-004-5394,4694.2075,4,2,2,0.8990887682835275
24865,703-004-5394,6921.9756,5,4,1,1.707211041192151
25109,703-004-5393,7854.9346,4,2,2,1.7994002596112935
2523,703-004-5385,7617.971,2,2,0,0.7521982861295522
25393,703-004-5380,8133.3496,1,1,0,0.5250251004483215
25519,703-004-5393,5018.264,4,2,2,0.4918708858076411
25917,703-004-5389,6379.351,"","","",0.27920371738274696
26020,703-004-5393,7255.6685,4,2,2,1.1462909806552988
26053,703-004-5395,1813.7229,4,1,3,0.4261337890039236
26247,703-004-5394,8208.86,6,1,5,1.1870016017568616
26523,703-004-5383,632.09595,3,1,2,0.7408475437677631
26645,703-004-5398,4355.9927,3,2,1,0.8270620870300486
26728,703-004-5386,7353.633,5,2,3,1.2174602699628767
26749,207-008-2398,5366.9014,5,1,4,0.7313569433885101
26952,703-004-5398,560.45654,4,3,1,0.8777578717586061
26984,703-004-5384,8000.3228,3,1,2,0.44505996153225497
27049,703-004-5395,2469.5063,5,2,3,0.5050903735643995
27050,703-004-5393,6209.2773,4,2,2,0.8543365566121939
27593,703-004-5389,2378.3076,3,2,1,0.4578017556949248
27788,703-004-5394,6192.4214,3,2,1,1.767323277561547
28204,703-004-5393,2789.281,1,0,1,0.27920371738274696
28441,703-004-5391,8976.251,3,1,2,0.5816628474353889
28718,703-004-5398,8414.548,6,2,4,0.988313450396331
28795,703-004-5399,669.4561,4,3,1,1.2068803297117798
28922,703-004-5390,5453.727,4,1,3,0.4031391452654219
29022,703-004-5383,8766.329,5,2,3,0.6463489992318997
29154,703-004-5384,4490.7544,5,3,2,2.29723344119083
2922,703-004-5394,8522.412,7,5,2,1.0182817745231492
29235,703-004-5394,9425.375,3,2,1,3.2498660091221936
29426,703-004-5385,1826.5963,5,3,2,0.8687052649802707
30097,703-004-5387,1072.2924,1,1,0,0.8842185446565374
30182,703-004-5382,3147.736,6,5,1,2.362520611702244
30936,703-004-5385,726.45306,3,2,1,1.2758754095581042
31273,703-004-5380,2918.6672,3,2,1,0.592821377127971
31472,703-004-5384,6603.3765,3,2,1,1.4693035078541705
31841,703-004-5391,1132.5348,2,2,0,0.9378849222822563
31864,703-004-5384,2378.555,3,1,2,0.35027013757747105
31941,703-004-5398,3220.3025,2,1,1,0.5927821450469603
32439,703-004-5385,5836.6094,3,1,2,0.44885718033876326
32549,703-004-5394,8299.581,6,4,2,2.019979504290436
3270,703-004-5389,7918.84,2,2,0,1.133283056419884
3318,207-008-2398,3224.8496,2,1,1,0.5165268771580819
3332,703-004-5392,5376.2627,1,1,0,0.4013232764955931
33450,703-004-5399,8997.354,4,0,4,0.27920371738274696
33629,703-004-5393,1262.2542,7,4,3,3.4568099007871798
33841,703-004-5388,3092.9607,2,1,1,0.9681505056886572
35049,703-004-5390,9602.116,1,1,0,0.4153301805310686
35069,703-004-5395,3725.8691,4,4,0,0.8871239324270177
35115,207-008-2398,7775.1704,4,2,2,0.8544354757889454
35308,703-004-5389,9425.234,7,1,6,0.6966127846426368
35313,703-004-5395,5802.2847,1,1,0,0.45986983565894235
35372,703-004-5382,9808.001,3,0,3,0.27920371738274696
35456,703-004-5387,4143.136,2,1,1,0.37053868907653353
35517,703-004-5383,8694.482,6,2,4,0.8216701117351106
35542,703-004-5386,3023.1626,5,2,3,0.9836909485169358
35571,703-004-5392,4300.3447,6,4,2,2.7643869316935126
35614,207-008-2399,7227.5454,5,0,5,0.27920371738274696
35818,207-008-2398,8645.966,5,5,0,2.6026352039942524
35838,703-004-5398,5489.367,4,2,2,1.6207790302510388
3593,703-004-5387,7451.6494,4,2,2,0.9404098964726096
36186,703-004-5395,5359.368,6,1,5,0.32666834933781397
36372,703-004-5384,4655.13,1,1,0,1.2159146933233722
36413,703-004-5399,7576.2104,3,3,0,1.6453235711727283
36524,703-004-5387,103.327034,5,3,2,1.439725905964354
36950,703-004-5383,521.46375,7,4,3,1.71811290969016
37175,703-004-5384,8989.688,2,2,0,1.09878789165442
37703,703-004-5382,4774.484,7,2,5,0.5684615080440413
37841,703-004-5397,1575.4915,3,2,1,1.15646531998252
38010,703-004-5388,7250.812,7,4,3,2.6581524837783177
38174,703-004-5380,3384.6396,3,2,1,0.594225985245277
38364,207-008-2398,7301.496,4,3,1,1.6219483860935828
3840,703-004-5384,8052.098,3,1,2,0.5970011969736093
3846,703-004-5386,2747.6753,5,1,4,0.3691084050195126
38546,207-008-2398,6514.131,4,3,1,1.2879979156887358
3887,703-004-5393,9683.091,4,2,2,0.7623877804220385
38902,703-004-5396,3990.2068,6,3,3,1.8430806297212516
39260,703-004-5387,7383.4336,5,4,1,1.9136025356871385
39528,703-004-5397,6536.709,4,3,1,0.6470809224715849
39534,703-004-5388,3053.854,4,1,3,0.5837684390944268
39560,703-004-5399,6642.691,7,6,1,3.9484155645017567
39647,703-004-5386,2494.6184,6,3,3,0.8937835959738532
39742,703-004-5396,1393.829,4,3,1,1.1674444642767041
39781,703-004-5397,4942.1885,3,2,1,2.6615268804540704
398,703-004-5385,1768.2474,5,1,4,0.5228757432626011
39815,207-008-2398,8912.866,4,3,1,1.573577155201049
39991,703-004-5399,5879.2393,1,0,1,0.27920371738274696
40204,207-008-2399,4737.9453,6,5,1,1.9496113971670181
40311,703-004-5391,7848.021,3,0,3,0.27920371738274696
40433,703-004-5392,308.3962,6,4,2,2.237770761535119
40521,703-004-5399,7269.8843,5,4,1,1.0095976533678668
40522,703-004-5385,8701.857,3,3,0,0.8485957536663744
40744,703-004-5385,8069.4634,1,1,0,0.36268718607106
4108,703-004-5396,2668.5923,1,0,1,0.27920371738274696
41091,703-004-5382,7395.2144,2,0,2,0.27920371738274696
41475,703-004-5384,8024.594,3,3,0,2.153311453045172
41593,207-008-2398,8401.666,5,2,3,1.9804075726027242
41661,703-004-5390,7503.46,4,2,2,0.5284872750434766
4193,703-004-5389,7182.185,5,1,4,0.9146579066671734
42276,207-008-2398,5888.078,5,2,3,1.2727617636627746
42452,703-004-5386,5532.5835,4,3,1,1.9274712104930054
42712,703-004-5392,6961.025,9,4,5,0.8971189810224907
42760,703-004-5393,420.30453,2,1,1,0.34693970256862383
42818,703-004-5398,8205.309,5,3,2,0.9769755751478535
4288,703-004-5397,4015.9917,7,3,4,0.8225195490718021
42901,703-004-5381,7087.574,"","","",0.27920371738274696
42903,703-004-5384,9689.046,5,3,2,2.050734031431045
43041,703-004-5392,2226.1929,7,3,4,1.7915657821560511
43200,703-004-5385,1919.021,4,4,0,1.7800403805139566
43323,703-004-5389,6594.6597,3,1,2,1.598850142405325
43335,703-004-5398,6047.465,2,1,1,0.43597214463998096
4353,703-004-5397,1992.8098,3,1,2,0.37512182779194486
43733,703-004-5387,4594.406,"","","",0.27920371738274696
43845,703-004-5393,536.8596,4,1,3,0.7286652248249718
43849,703-004-5391,9374.392,4,2,2,1.6547027471195372
4406,703-004-5391,4151.538,3,3,0,0.925004953131003
44270,703-004-5390,528.38086,4,2,2,0.6364122799014663
44342,703-004-5392,8266.63,5,4,1,1.908783926253365
44386,703-004-5399,766.6731,3,2,1,0.9596877408521166
44411,703-004-5388,3135.6436,5,5,0,2.132244753801857
44657,703-004-5383,5648.422,7,4,3,1.379876701661008
44861,703-004-5389,8362.094,3,1,2,0.36363505352418346
44904,703-004-5382,1124.6621,3,3,0,1.4035421107835926
44921,703-004-5399,5278.0312,5,1,4,0.4045517605298771
450,703-004-5384,9305.67,11,4,7,2.303557669554886
45361,703-004-5396,9719.153,4,1,3,0.33853450732658075
45405,703-004-5399,3950.594,5,1,4,0.47654451704593176
45636,207-008-2398,5051.0376,2,2,0,0.6596403893406114
46009,703-004-5382,2818.929,3,1,2,0.5545420009236
46042,703-004-5387,4432.981,1,1,0,0.3978652972704144
4610,703-004-5386,4145.051,4,2,2,0.6751013211189858
46204,703-004-5394,3679.9175,6,4,2,2.498368141013369
46345,703-004-5390,2764.1565,2,1,1,0.4651068592067593
46638,703-004-5398,8953.999,8,6,2,4.306675911549547
47060,703-004-5391,583.8942,1,1,0,0.6941846559749225
471,703-004-5385,1797.0717,2,2,0,0.7250746038106575
47175,703-004-5388,4374.2007,2,1,1,0.8806490762043654
47354,703-004-5383,7621.6626,2,1,1,0.5393449250865477
47614,703-004-5386,7119.4062,2,0,2,0.27920371738274696
47749,207-008-2399,7414.4507,4,2,2,1.1636641315006315
47762,703-004-5392,4431.607,1,1,0,2.0614580729952925
47991,703-004-5384,4519.3735,2,0,2,0.27920371738274696
48337,703-004-5389,1964.5369,4,0,4,0.27920371738274696
48346,703-004-5382,5195.9165,6,2,4,0.5109300059733802
48363,703-004-5381,3876.7732,5,4,1,1.2960197499804693
48818,207-008-2398,340.01767,4,3,1,1.388746282979732
49513,703-004-5387,6308.567,2,2,0,0.9193695750206514
49814,703-004-5383,7185.2856,4,1,3,1.3346575005872683
49885,703-004-5381,9834.561,5,0,5,0.27920371738274696
5020,207-008-2398,8163.21,3,2,1,0.7384707327568473
5428,703-004-5387,476.7084,4,4,0,1.7574737664027282
6545,703-004-5387,1224.3218,2,0,2,0.27920371738274696
6562,207-008-2398,6109.1484,12,7,5,3.6840264192898444
6719,703-004-5394,1525.5195,5,2,3,1.0670899101466325
6947,703-004-5388,567.5983,5,3,2,1.1968050626360238
6974,703-004-5397,6877.8657,2,2,0,0.6018842852517566
7005,703-004-5389,5431.722,2,2,0,0.45648598447616245
7089,703-004-5380,8898.88,3,0,3,0.27920371738274696
7259,703-004-5388,2527.206,2,0,2,0.27920371738274696
7598,703-004-5381,3402.9407,5,2,3,1.3005457243687115
7808,703-004-5385,4663.445,6,2,4,0.9157759752735817
7832,703-004-5384,70.68276,5,2,3,1.8017552287842358
7870,703-004-5381,168.1769,4,2,2,0.7369890091386023
7924,703-004-5385,9870.728,3,1,2,0.39657116849562796
8101,703-004-5399,5934.9863,5,5,0,2.120479906622004
8247,703-004-5396,3080.6196,11,4,7,1.158003820380726
834,703-004-5392,7794.4736,7,3,4,1.474573733266468
8513,703-004-5385,1302.256,2,1,1,0.39611009473457603
8679,207-008-2399,9765.435,8,2,6,0.960266077752421
8736,703-004-5387,7598.9395,5,1,4,0.32666834933781397
8757,703-004-5394,8330.171,5,4,1,1.5380633778629225
8957,703-004-5397,7670.6143,3,1,2,0.7099063172459407
9010,703-004-5390,3717.9082,2,1,1,0.6078097996301192
9048,703-004-5385,1714.9222,2,0,2,0.27920371738274696
9136,207-008-2399,1465.2968,7,4,3,2.0708763780468367
9147,703-004-5387,2758.2234,3,1,2,0.6638349520520556
9150,703-004-5380,8416.253,4,3,1,1.409780257782359
9199,703-004-5387,950.8437,4,3,1,2.025593271368338
92,703-004-5388,4334.0845,4,0,4,0.27920371738274696
10516,703-004-5387,4144.082,4,3,1,1.430202032768094
1057,703-004-5399,8166.0225,2,0,2,0.27920371738274696
10617,703-004-5392,7811.6465,2,1,1,0.728089507744256
11006,703-004-5395,9604.385,5,2,3,0.8008239713411247
11045,703-004-5382,3606.3623,2,1,1,0.8793959822246915
11347,703-004-5381,4058.646,4,3,1,1.1829020535185117
11444,703-004-5397,5277.63,5,3,2,0.9893700959927887
11497,703-004-5380,8442.748,3,2,1,1.4359597487272626
11883,703-004-5390,3792.5042,1,0,1,0.27920371738274696
11959,703-004-5399,5909.5977,2,2,0,1.638500116856225
12017,703-004-5394,9068.035,3,1,2,0.5075877048065442
1244,703-004-5382,8201.129,3,0,3,0.27920371738274696
12570,703-004-5389,9798.375,4,2,2,3.36955636401118
12628,703-004-5388,3112.535,1,0,1,0.27920371738274696
12650,703-004-5385,2441.5051,3,3,0,0.9529519306197456
12905,703-004-5396,5235.782,3,2,1,0.7178582090528749
12952,703-004-5399,535.7277,3,1,2,0.5998889039465218
14051,703-004-5385,127.1981,6,5,1,1.3168765438554924
14074,703-004-5380,8211.323,4,2,2,0.8073985834158383
14869,703-004-5398,5283.2515,4,3,1,1.371855900469535
15116,703-004-5388,3310.6936,3,3,0,0.9944124985368058
15361,703-004-5384,6167.5005,3,0,3,0.27920371738274696
15449,703-004-5390,2721.0415,4,4,0,1.8673674386401269
15510,703-004-5390,8796.689,2,1,1,0.5165268771580819
1578,703-004-5391,6231.778,7,3,4,1.5128988379115138
1591,703-004-5395,2495.3281,4,2,2,0.4594320133554127
16063,703-004-5398,1371.0839,8,6,2,2.543288336199084
16077,703-004-5380,7893.4277,3,2,1,2.312846559804994
16116,703-004-5390,9343.827,5,5,0,1.824409947211737
16191,703-004-5394,4545.9116,5,2,3,0.7241411130484829
16283,703-004-5389,5471.148,4,3,1,2.889012833203728
16293,703-004-5394,4353.713,2,2,0,0.7342472601872099
16446,703-004-5398,9053.399,9,3,6,1.4736264174741152
16697,703-004-5388,7936.8735,1,0,1,0.27920371738274696
16706,703-004-5380,2132.647,4,2,2,1.5565480591464762
16969,207-008-2398,1564.0002,6,2,4,0.47697301719552604
16975,703-004-5380,6456.769,7,4,3,1.7733606052733424
17252,703-004-5380,2641.244,3,2,1,1.7353020382525188
17297,703-004-5396,9375.535,2,0,2,0.27920371738274696
17308,703-004-5387,3265.2778,4,2,2,1.307142014196597
17367,703-004-5386,4466.14,8,4,4,1.3154906460764209
17439,703-004-5384,7642.056,6,5,1,1.2374377166643145
17625,703-004-5391,6076.863,2,1,1,2.003158397765146
18464,703-004-5393,6676.4956,2,1,1,0.3978652972704144
1886,703-004-5399,3156.402,2,2,0,0.5561795610712613
1925,703-004-5384,4263.221,2,2,0,0.8413989968798106
19374,703-004-5395,6547.146,3,2,1,0.9890983907440284
19429,703-004-5389,9037.005,9,6,3,1.6852686269769204
19557,703-004-5389,9343.879,5,1,4,0.7353106440415864
19588,207-008-2398,5844.21,3,1,2,0.6448467990067441
19647,703-004-5398,5869.7163,5,3,2,1.073827647747871
19914,703-004-5388,5084.036,6,1,5,0.44149485288661194
20045,703-004-5394,9227.304,3,2,1,0.9502764376895535
20081,703-004-5385,2151.2126,6,3,3,1.554555754206502
20214,703-004-5382,4936.825,2,2,0,0.49692919859475365
20271,703-004-5399,6457.6914,4,4,0,0.8138032325537377
20301,703-004-5393,133.12877,3,3,0,1.1770896989647166
2043,703-004-5390,9977.867,6,2,4,1.0567858064763214
20715,703-004-5385,8262.952,2,1,1,0.9176639277797902
20816,703-004-5386,6185.452,3,2,1,0.5375225886251912
21505,703-004-5388,6471.1987,3,2,1,1.0139105316508825
21506,703-004-5387,5648.792,8,4,4,1.9156728149472744
21719,207-008-2399,2253.1462,7,6,1,3.736935761709268
2175,207-008-2398,1320.2435,1,0,1,0.27920371738274696
21753,703-004-5397,3176.8525,6,3,3,1.0327357903533267
21774,703-004-5399,477.60605,5,3,2,1.525323232554531
21964,703-004-5380,4161.873,2,0,2,0.27920371738274696
22210,703-004-5387,2327.6812,6,2,4,0.7203705588682876
22246,703-004-5392,8016.654,1,0,1,0.27920371738274696
22399,703-004-5381,8021.5884,2,1,1,0.5233183121306461
22499,703-004-5399,3780.2976,4,1,3,0.5294967835490069
22580,703-004-5388,6027.4043,6,5,1,4.169878713265335
2259,703-004-5387,4519.286,5,2,3,2.7005371361186548
23467,703-004-5383,7202.1323,2,1,1,0.5201608880421418
23781,703-004-5380,7869.65,7,3,4,0.7752713103245913
23804,703-004-5397,4890.6064,4,0,4,0.27920371738274696
2413,703-004-5388,19.169449,4,2,2,0.813855434306957
24451,703-004-5387,7459.7896,3,1,2,1.4851140983072795
24492,703-004-5386,3818.808,6,2,4,1.9416749748244633
24582,207-008-2399,2570.4695,6,1,5,0.5651662274419949
24659,703-004-5396,9282.616,3,2,1,0.8778815281407916
25055,703-004-5396,2458.7148,5,3,2,1.1541059503536513
25178,703-004-5388,3315.3289,11,4,7,1.2797873567353
25366,703-004-5387,5949.996,6,1,5,0.3978652972704144
25610,207-008-2399,7464.518,5,2,3,0.9045906867590511
25621,703-004-5388,5885.316,4,1,3,0.3970978186274115
25630,703-004-5380,40.388107,6,1,5,0.6872964305299053
25711,703-004-5392,7233.19,9,4,5,1.0868773151923523
2574,703-004-5399,3632.908,7,5,2,2.0240690700909223
2608,703-004-5383,2365.9163,3,1,2,0.6388224679298091
2632,703-004-5387,8249.932,4,2,2,1.2241630618168746
26436,207-008-2399,5749.464,5,3,2,2.3252085460416105
26445,703-004-5389,3375.2065,4,2,2,0.4700468685034891
26448,703-004-5383,738.2941,"","","",0.27920371738274696
26900,703-004-5385,4857.381,5,2,3,1.0941766089578369
27257,703-004-5390,978.3095,2,1,1,0.5287570599601469
27602,703-004-5392,4236.003,2,1,1,0.38464771573292705
27621,703-004-5388,1924.628,4,2,2,0.6195439223979017
27629,703-004-5398,657.9375,4,1,3,2.8299600652372185
27973,207-008-2399,1019.1077,4,4,0,0.878707885535194
28241,703-004-5391,7705.435,2,0,2,0.27920371738274696
28404,703-004-5389,7047.584,2,1,1,0.5004008249108681
28415,703-004-5388,3114.0483,5,2,3,1.9438403285167225
28940,703-004-5382,8978.719,4,1,3,0.35831143730785864
2908,703-004-5388,9127.86,3,1,2,0.3978652972704144
2918,703-004-5381,3877.7488,6,3,3,1.6096335947103466
29254,703-004-5394,8715.576,5,4,1,1.0598722984731832
29258,703-004-5388,505.75076,6,2,4,0.5862958181493843
29911,703-004-5393,6808.9927,5,4,1,1.3256198172915978
30003,703-004-5381,949.02576,7,6,1,2.1965070521391357
30045,703-004-5381,7355.0903,3,1,2,0.32666834933781397
30051,703-004-5382,4364.625,5,2,3,0.7341816957335005
30181,703-004-5395,2644.7617,2,1,1,0.5292359914537104
30289,207-008-2398,9203.847,4,2,2,1.7988640772903464
3065,703-004-5389,8581.411,3,1,2,0.3227129633415584
30901,703-004-5398,9390.0205,4,2,2,1.0622261556667427
3099,703-004-5393,1933.31,6,3,3,3.787884561121423
31036,703-004-5397,2139.2805,2,1,1,0.5037597165270232
31654,703-004-5399,1556.9335,2,0,2,0.27920371738274696
31773,703-004-5381,3092.8855,3,0,3,0.27920371738274696
31781,703-004-5387,6395.656,4,2,2,0.7092921668074321
3192,703-004-5395,1376.3862,1,0,1,0.27920371738274696
32010,703-004-5387,9285.282,3,1,2,0.7843476033298272
32059,703-004-5396,7006.2544,1,0,1,0.27920371738274696
32408,703-004-5385,4825.767,4,2,2,0.8347660347684702
32791,703-004-5387,7127.5615,6,3,3,2.4227173206657517
32848,703-004-5381,9593.066,4,3,1,0.685225207342751
33117,703-004-5382,6938.6016,4,0,4,0.27920371738274696
33173,703-004-5380,5200.111,3,2,1,1.1786326731451446
33456,703-004-5384,8778.184,6,4,2,1.490492091550747
34088,703-004-5395,2583.94,2,0,2,0.27920371738274696
34371,703-004-5384,6890.0005,3,0,3,0.27920371738274696
34689,703-004-5388,4795.0293,6,1,5,0.5872249330714898
34920,703-004-5398,2884.2158,1,1,0,0.5808683631063704
35428,703-004-5385,422.41095,9,4,5,2.706798556679181
35936,703-004-5384,2749.334,4,1,3,0.34890555227583814
36011,207-008-2398,4420.2583,8,6,2,2.97335935817352
36110,703-004-5388,1350.5488,2,1,1,0.4812133572890667
36167,703-004-5394,7669.886,4,0,4,0.27920371738274696
3668,703-004-5392,7939.9585,3,2,1,0.8889244899202873
37037,703-004-5398,8504.065,3,1,2,0.7029562934929879
37088,703-004-5398,1949.2615,6,4,2,3.7254566720920383
37369,703-004-5394,8151.7593,5,4,1,1.8216050367595435
37428,703-004-5394,7853.7095,2,1,1,0.7781628550796642
37640,703-004-5393,6104.139,3,1,2,0.49344066259461533
37663,703-004-5399,6911.4463,1,1,0,0.7914958744914193
37988,703-004-5389,1462.037,5,2,3,1.0236316762257083
38120,703-004-5392,9462.485,5,3,2,0.7910231453018067
3843,703-004-5382,2352.9333,4,0,4,0.27920371738274696
3873,703-004-5385,2.0128489,2,2,0,0.7815540411404612
38845,703-004-5396,8210.307,1,1,0,0.4505924878896246
39246,703-004-5386,4759.4043,6,3,3,1.6293658537777322
394,703-004-5387,7488.0654,3,1,2,0.42678268439979633
39405,703-004-5380,7300.243,3,2,1,0.45719608721424815
39410,703-004-5381,692.6715,9,4,5,1.637186650166225
39529,703-004-5394,6134.134,5,3,2,0.5501476581262543
39702,207-008-2398,8580.415,5,5,0,2.802742340323555
39770,703-004-5388,4749.409,6,3,3,1.5574897614022565
40312,703-004-5399,6242.9375,3,0,3,0.27920371738274696
4062,703-004-5399,7363.1265,3,0,3,0.27920371738274696
40705,703-004-5397,3096.847,3,2,1,1.4322186182942127
40914,207-008-2398,5769.7754,6,4,2,1.1242195002738864
40940,703-004-5391,5902.529,2,0,2,0.27920371738274696
41012,207-008-2398,8069.8145,4,2,2,0.39229232320944013
41208,703-004-5399,4655.6704,"","","",0.27920371738274696
41733,703-004-5383,5129.4155,6,1,5,0.5687705464516849
41792,207-008-2398,2387.5051,6,3,3,2.039401142887073
41878,703-004-5393,1832.878,2,1,1,1.0041241354367534
42025,703-004-5399,5328.5996,11,6,5,1.391373410876738
42080,703-004-5399,1924.9004,11,5,6,2.476485402196637
42338,703-004-5399,7338.757,5,0,5,0.27920371738274696
4248,703-004-5389,4903.646,2,1,1,0.8700149788120131
42692,207-008-2398,3332.8892,8,6,2,2.027458849367218
42715,703-004-5398,8327.879,1,1,0,0.3672522577368947
43093,207-008-2399,8690.781,5,3,2,0.8479691439417361
43516,703-004-5390,7501.763,2,0,2,0.27920371738274696
43914,703-004-5386,5293.2524,5,3,2,2.0604790607580585
4398,703-004-5386,1464.1755,5,3,2,0.7236829611421097
44202,703-004-5383,9071.51,2,1,1,1.1449312155055296
44534,207-008-2399,759.7798,2,1,1,0.41916537042976104
44579,703-004-5399,1457.988,2,2,0,0.6124647644972611
4507,703-004-5393,4927.269,6,4,2,4.155345015700217
45130,703-004-5380,634.4318,2,1,1,0.5165268771580819
45233,703-004-5383,5331.364,6,3,3,1.0668269542925142
45331,703-004-5382,3416.328,5,1,4,1.1968623246308205
45371,703-004-5391,9177.526,3,1,2,0.401885928342064
45430,703-004-5390,4583.994,1,1,0,0.3766058118110338
45504,703-004-5386,5770.1284,5,4,1,0.858801204982723
45683,703-004-5387,9428.3545,4,2,2,0.7562082757778957
45706,207-008-2399,9776.769,4,0,4,0.27920371738274696
45925,703-004-5381,3341.7095,5,3,2,1.0881905815848387
46122,703-004-5391,5276.8306,6,2,4,1.030291661903616
46207,703-004-5386,2198.2349,5,4,1,1.288372682617698
46264,703-004-5388,6713.3267,1,0,1,0.27920371738274696
46277,703-004-5389,9776.327,3,0,3,0.27920371738274696
46608,703-004-5393,8798.807,5,4,1,2.6544937325616953
46856,703-004-5399,8232.944,3,0,3,0.27920371738274696
46873,703-004-5396,4968.597,2,0,2,0.27920371738274696
46905,703-004-5384,3329.1387,5,4,1,0.9557906502835936
47085,207-008-2399,9479.647,2,1,1,0.4360946170900692
47104,703-004-5391,4051.1833,3,2,1,0.7214944910546138
4732,703-004-5398,872.89154,4,1,3,0.45787790428993014
47376,703-004-5381,4927.481,2,1,1,0.9384271138751888
47548,703-004-5399,3320.707,3,2,1,1.3405813731902285
47603,703-004-5399,2471.1067,5,1,4,0.43336734778454244
47644,207-008-2399,5850.188,9,4,5,1.1666972179676138
47649,703-004-5394,5874.026,5,3,2,0.839619218064231
48133,703-004-5396,6121.702,4,1,3,0.4924533046502581
48357,207-008-2399,2630.4072,7,5,2,3.3328306866633177
48461,703-004-5399,6131.688,3,0,3,0.27920371738274696
48511,703-004-5394,2222.6768,3,1,2,0.5861884348911983
48861,703-004-5393,9420.358,2,1,1,0.4465921163382542
48890,703-004-5394,9387.37,2,2,0,1.1311650511006492
49238,703-004-5393,9781.022,8,2,6,1.194883202441708
49405,207-008-2398,1729.2643,6,1,5,0.5686600011179055
49579,703-004-5381,9779.439,5,0,5,0.27920371738274696
49902,703-004-5380,1161.0717,2,2,0,0.5381208125813898
4996,207-008-2398,3922.0952,5,3,2,0.8732929800757033
6335,207-008-2399,267.05444,7,5,2,2.7260784309210555
6457,703-004-5390,629.5943,3,2,1,0.7246768454566511
6510,703-004-5397,7500.6567,7,5,2,2.8057732726598212
6542,703-004-5394,2153.6785,2,1,1,1.1631853153321947
6629,703-004-5381,8296.982,4,2,2,0.70092594458413
6892,703-004-5385,7723.6094,1,0,1,0.27920371738274696
7148,703-004-5386,8426.485,4,2,2,0.46599426222945606
7360,703-004-5385,352.425,2,2,0,0.49019265882988655
741,703-004-5388,8024.773,5,1,4,0.8451641768926834
7673,703-004-5392,9203.409,4,3,1,1.215146017517444
8147,703-004-5384,8221.124,1,0,1,0.27920371738274696
8565,703-004-5395,1732.977,4,0,4,0.27920371738274696
877,207-008-2399,1534.8041,"","","",0.27920371738274696
8995,703-004-5388,2432.6533,3,3,0,1.2718502308375517
8999,703-004-5384,2449.665,1,0,1,0.27920371738274696
9102,703-004-5388,9421.282,5,3,2,1.3359094560617142
9301,703-004-5399,5437.6353,"","","",0.27920371738274696
9320,703-004-5391,33.079983,5,3,2,1.196968896361625
9365,703-004-5381,92.06593,5,3,2,0.9644261514310785
9387,703-004-5394,4555.912,2,1,1,0.47845095497922163
9611,703-004-5391,3062.7202,6,2,4,0.7133066679958263
9776,703-004-5398,1605.1084,2,0,2,0.27920371738274696
9872,703-004-5389,7794.2256,7,4,3,1.0597437089445534
10100,703-004-5382,1617.2784,4,1,3,0.5208123581747227
10356,703-004-5386,7802.9326,4,2,2,0.44465421745112116
10517,703-004-5397,9319.714,2,2,0,0.9486398947559842
10665,703-004-5392,1535.6565,4,3,1,1.3306738518102583
10682,703-004-5396,9918.809,1,1,0,0.7477211656310175
10721,703-004-5383,5266.7534,3,1,2,0.3927331839402728
1096,703-004-5393,7130.103,5,1,4,0.3978652972704144
11056,703-004-5395,920.1044,3,0,3,0.27920371738274696
1146,703-004-5394,6178.399,6,2,4,0.7551941266693853
11706,703-004-5384,625.46967,"","","",0.27920371738274696
11971,703-004-5389,8896.148,3,3,0,2.369990881561521
12889,703-004-5393,9471.14,2,0,2,0.27920371738274696
13081,703-004-5393,2416.0688,4,2,2,1.9336022382703877
13271,207-008-2399,9828.763,2,0,2,0.27920371738274696
13479,207-008-2398,2538.7346,4,4,0,1.84434959908913
13745,703-004-5385,6133.621,4,2,2,0.6173892200625992
13993,703-004-5380,3706.2854,6,4,2,3.0549216059024613
14094,703-004-5397,634.585,6,3,3,1.0161852425245101
14314,703-004-5387,7711.5815,4,1,3,0.3978652972704144
14389,703-004-5381,5304.5093,3,1,2,0.5358421524380707
14454,207-008-2398,8679.112,3,1,2,2.4118634182667957
14519,703-004-5387,5314.574,3,3,0,1.0752953896581905
14563,703-004-5392,1848.1069,5,5,0,1.4979534382193083
14727,703-004-5384,9419.145,7,5,2,1.3312947043522174
14914,703-004-5391,2356.7266,3,0,3,0.27920371738274696
14979,703-004-5396,5572.9634,5,2,3,1.3602529171347817
15049,703-004-5397,4959.723,8,3,5,0.9436138112548911
15108,703-004-5383,8783.0205,9,4,5,0.8767029090905086
15145,703-004-5386,1429.4779,1,1,0,0.5468170358386668
15349,703-004-5387,8387.29,1,1,0,0.46057664464419823
15444,703-004-5387,7760.521,"","","",0.27920371738274696
15542,703-004-5397,2099.152,4,2,2,0.6310253842200123
15930,703-004-5397,6367.2285,2,2,0,0.7391745438652135
15931,703-004-5397,9078.158,3,1,2,1.4522177343276235
1595,703-004-5393,7011.589,8,7,1,3.0488857012391968
15986,703-004-5390,1938.2423,1,0,1,0.27920371738274696
16219,703-004-5388,1074.8541,6,3,3,0.914899586716657
16332,703-004-5397,7689.341,4,2,2,1.7909814498098706
16336,703-004-5390,6450.3877,1,0,1,0.27920371738274696
16348,703-004-5387,7869.856,3,1,2,1.2969591682019777
16469,703-004-5390,5593.204,2,1,1,0.38882518841248487
16562,703-004-5393,3063.7026,4,2,2,1.5408092822501216
16800,207-008-2398,3753.8296,1,0,1,0.27920371738274696
16984,703-004-5391,4825.202,2,2,0,0.5419287567686548
17006,703-004-5394,5351.3525,2,1,1,0.3805604835367963
17029,703-004-5396,309.02982,3,3,0,2.427561290925241
17112,703-004-5394,6758.4966,"","","",0.27920371738274696
17126,703-004-5398,44.199226,2,1,1,1.6728758835918742
17496,703-004-5389,2445.708,5,2,3,2.1152935106111417
17586,703-004-5393,8661.822,2,1,1,0.33472744830518475
17734,703-004-5395,5114.829,5,3,2,1.1298594985040753
18121,703-004-5399,7622.0005,3,3,0,1.8130071993883283
18234,703-004-5389,7431.9785,3,3,0,1.1439209176175014
18465,703-004-5381,5326.936,3,1,2,0.6007299848050522
18531,703-004-5395,6896.0225,2,1,1,0.5523144210117175
18628,703-004-5389,5549.9263,2,2,0,2.2410535041122204
18906,703-004-5383,761.1364,4,3,1,0.5358696789462533
18960,703-004-5387,7157.067,2,1,1,0.4737573522920102
19033,703-004-5397,4225.6143,3,1,2,0.3978652972704144
19446,703-004-5392,8655.842,4,3,1,0.7637993026576815
19734,703-004-5391,4109.8247,3,0,3,0.27920371738274696
19755,207-008-2399,7080.35,3,2,1,0.7752302307420692
19759,703-004-5395,3030.1912,4,2,2,1.3101190696513285
19771,703-004-5383,4628.158,3,2,1,0.40881148466557293
19845,703-004-5392,8605.023,3,1,2,0.5092618546273202
1996,703-004-5386,6945.455,6,2,4,1.028195424827337
20007,703-004-5388,8915.309,4,2,2,0.9640153289958309
20013,703-004-5398,4110.9463,4,1,3,0.6462858499122371
20027,703-004-5387,1424.5486,2,2,0,0.49494530231601236
20292,207-008-2399,1179.0663,2,1,1,0.6345939412194026
204,703-004-5382,3140.9634,1,0,1,0.27920371738274696
2050,703-004-5383,9391.211,1,1,0,0.432972294977076
20742,703-004-5395,3883.627,3,2,1,0.9221676460100843
21087,703-004-5391,706.5469,4,2,2,0.6902424858811317
21890,703-004-5389,8254.335,2,1,1,0.4572167663170572
22091,703-004-5387,9366.635,6,3,3,0.8840994173114755
2212,703-004-5389,9674.375,5,4,1,2.1987820468374157
22613,703-004-5394,2628.453,9,3,6,1.200134634279397
22643,703-004-5380,6869.452,5,3,2,1.7239673891312082
22682,703-004-5390,1345.2607,7,1,6,0.45670166396471623
23369,703-004-5380,1162.6965,3,1,2,0.6080161613413866
23421,703-004-5388,9122.027,8,3,5,1.1306075662738462
23425,703-004-5385,7351.4883,6,4,2,1.6453068937396575
23428,703-004-5380,1110.9412,4,3,1,0.7030066775891987
23667,703-004-5382,5235.638,2,2,0,2.118042046100498
23799,703-004-5391,7957.2485,3,1,2,1.2740601470291844
23873,703-004-5386,5734.563,6,2,4,0.49378340767961226
23909,703-004-5388,361.57788,4,3,1,0.7764378675198048
24266,703-004-5388,2761.4414,2,1,1,0.5368311919388605
24299,207-008-2399,25.245548,4,2,2,1.7834268555328607
24907,703-004-5391,1611.6827,7,3,4,1.5666187524536224
2501,703-004-5394,2777.588,4,1,3,0.7734152314244791
25066,703-004-5397,8926.805,5,3,2,1.6927838849409045
25192,703-004-5386,6648.0063,4,2,2,1.8755355140393084
25227,703-004-5388,4311.6406,2,1,1,0.6728981436508071
25367,703-004-5392,6895.0913,3,2,1,0.7863404225309631
25539,703-004-5399,2619.645,3,3,0,0.9564304494821921
26120,703-004-5394,8295.544,2,2,0,0.6032862607751217
26189,703-004-5395,8238.612,6,5,1,1.6529604846695092
26239,703-004-5394,8877.369,"","","",0.27920371738274696
26409,703-004-5381,6260.4775,4,3,1,1.2702799922012837
26631,703-004-5392,9739.93,3,3,0,1.3384381900421265
26864,703-004-5381,4833.7505,1,1,0,0.6415975023340801
26869,703-004-5389,5558.5854,2,2,0,0.5310578910754242
26942,703-004-5389,581.578,4,3,1,1.5668500241390877
27198,703-004-5383,7733.124,2,2,0,0.9431071919513947
28036,703-004-5398,7704.6733,"","","",0.27920371738274696
28199,703-004-5393,8381.895,6,3,3,1.3713086258664062
28352,703-004-5384,7654.671,1,1,0,0.541930213166932
28584,207-008-2399,5341.4834,2,0,2,0.27920371738274696
28801,703-004-5386,2735.8818,6,3,3,1.8544115846684015
28860,703-004-5390,441.51367,5,2,3,1.8933851967155253
28865,703-004-5393,5761.3804,2,1,1,0.9007066584327637
29094,703-004-5386,9841.759,2,1,1,0.8077318885837522
2919,703-004-5385,8679.37,7,5,2,1.00974304880393
29262,703-004-5386,3778.5977,5,1,4,0.44673783032997677
29589,703-004-5385,5250.509,5,4,1,3.1131147575212066
29659,703-004-5399,4174.8257,5,2,3,0.9068643519383671
29873,703-004-5397,9574.355,7,3,4,0.6853953863207625
30256,703-004-5384,8479.924,3,1,2,0.6565111517045885
30438,703-004-5390,2935.629,2,2,0,0.6194817779629173
30547,703-004-5394,379.87112,5,3,2,1.7463095889993832
30827,703-004-5394,5469.601,8,4,4,2.2012050029947656
31087,703-004-5386,3580.9421,3,2,1,0.67624276215117
31245,703-004-5394,4410.303,2,2,0,1.087888476728602
31339,703-004-5393,290.08984,2,1,1,0.4856891219327298
31374,703-004-5395,7338.446,4,3,1,0.9838262913607533
31546,703-004-5386,4798.8477,4,1,3,0.7868044755151048
32043,703-004-5389,3176.8142,5,3,2,1.0421353868669705
32555,703-004-5386,1911.3636,2,1,1,0.5383791487292702
32799,703-004-5387,535.3862,"","","",0.27920371738274696
32836,703-004-5387,3628.3457,8,5,3,1.3801949636250088
32982,703-004-5394,5809.0693,2,2,0,0.6129773180980493
32999,703-004-5385,2985.6687,8,4,4,1.2555032370115724
33037,703-004-5386,4464.2983,7,3,4,0.6575863139091227
3349,703-004-5383,6435.9023,3,2,1,0.5592374723617818
33517,703-004-5381,5214.8296,4,3,1,1.2661564048011529
33787,703-004-5388,7383.2456,5,2,3,1.0849076413523508
33844,703-004-5384,6602.1187,7,3,4,1.4469629232470138
33878,207-008-2399,1552.8536,7,4,3,0.9114817708942685
33984,703-004-5384,6845.492,4,0,4,0.27920371738274696
33998,703-004-5397,6915.542,3,1,2,0.38167194700174406
34549,703-004-5398,5446.058,3,2,1,0.7818215616255564
3472,207-008-2398,9315.643,6,3,3,1.3570930128462197
34746,703-004-5383,5973.4053,8,3,5,2.953160605893152
3475,703-004-5390,3154.9502,3,2,1,0.6889413413002908
35108,703-004-5397,8338.5,2,1,1,1.113193577115282
35286,703-004-5384,8141.0005,5,3,2,0.6760780882227088
35342,703-004-5381,1710.5789,3,2,1,0.7842173924132523
3542,703-004-5389,3270.877,2,1,1,0.9422165108244189
35900,703-004-5399,4008.23,7,3,4,0.8181435232360444
36039,703-004-5382,7486.7217,5,2,3,0.5809436349582525
3616,703-004-5389,4013.8418,8,3,5,1.1754045965826068
363,703-004-5391,2609.0896,4,1,3,0.7044527404495532
36428,703-004-5381,3178.3872,2,1,1,0.40519802507901903
36522,703-004-5392,1636.4824,"","","",0.27920371738274696
36895,703-004-5383,895.9681,3,1,2,0.4317955626152265
36999,703-004-5397,9.632111,5,2,3,0.8138934605425485
37312,703-004-5393,6847.1436,6,2,4,0.5177073075264468
37584,703-004-5385,3833.5586,3,2,1,0.7615715490254077
37815,703-004-5393,1367.9171,11,4,7,1.302443571966457
37910,703-004-5382,1939.8344,4,1,3,0.7298320399838111
37960,703-004-5399,9360.121,4,3,1,0.83102175440844
3815,703-004-5388,1731.3445,5,1,4,2.7410252636304264
38328,703-004-5381,5736.326,4,2,2,1.1340030329339308
38365,703-004-5380,934.73376,6,1,5,0.6562444468614885
38517,703-004-5396,1696.0037,5,3,2,1.4396949155272192
3859,703-004-5383,1020.5746,7,4,3,1.4846054719120407
38869,703-004-5391,5368.6567,"","","",0.27920371738274696
38951,703-004-5392,5954.2095,3,0,3,0.27920371738274696
38987,703-004-5382,8665.021,2,0,2,0.27920371738274696
38990,703-004-5386,3868.0952,3,0,3,0.27920371738274696
39397,703-004-5382,461.3173,6,4,2,2.299531062575042
399,703-004-5380,9627.5205,5,3,2,1.8105792971913979
40682,703-004-5388,2742.0742,4,2,2,0.8991595323243836
41154,703-004-5383,6380.7207,6,2,4,0.6550959369625724
41232,207-008-2398,4007.266,4,3,1,1.4289319648149954
41398,703-004-5383,6958.7285,5,2,3,0.778012501138043
41426,703-004-5389,4481.2744,2,0,2,0.27920371738274696
41443,207-008-2399,3349.747,2,1,1,0.6978331479043033
41830,703-004-5393,9792.149,4,2,2,0.4946535287181663
41870,703-004-5384,2656.9336,3,2,1,1.3734352065149886
42164,207-008-2398,4406.301,4,0,4,0.27920371738274696
42427,703-004-5386,4898.3164,7,3,4,0.9329706744055665
42502,703-004-5385,1759.0154,3,1,2,1.0089268311872246
42697,703-004-5388,4985.4033,4,3,1,0.9441236663974822
42873,703-004-5387,7807.237,6,3,3,2.2450230927659334
43238,703-004-5399,6509.8877,2,2,0,0.9075061045605265
43353,703-004-5394,6139.796,2,2,0,0.5088964239283003
43368,703-004-5399,8295.373,8,5,3,3.414154311141633
43751,207-008-2399,1948.9681,2,1,1,0.8272460223267973
43890,207-008-2398,4928.782,3,1,2,0.3978652972704144
43893,703-004-5393,6528.7534,9,6,3,1.483871783931377
44742,207-008-2398,532.0555,5,4,1,1.6041867252728879
44868,703-004-5396,1724.7003,3,2,1,0.7571596724275352
45101,703-004-5380,107.34022,1,0,1,0.27920371738274696
45401,703-004-5392,5764.3706,3,1,2,0.47751204994604507
45772,703-004-5389,7828.2036,3,0,3,0.27920371738274696
46478,703-004-5389,2251.299,3,1,2,0.49356825650878594
47036,703-004-5389,8947.806,2,1,1,0.4877167025616555
47196,703-004-5389,5897.343,4,3,1,1.7019287545552613
47218,703-004-5388,8557.841,6,4,2,1.927762768805594
47295,703-004-5387,7826.247,"","","",0.27920371738274696
47307,703-004-5397,2382.9175,4,1,3,0.5468853286556694
47959,703-004-5381,970.1991,5,2,3,0.5600107548256095
47985,703-004-5384,4434.345,2,0,2,0.27920371738274696
48073,703-004-5392,7289.0513,7,1,6,0.33853450732658075
48254,207-008-2398,4985.7314,2,1,1,0.48294692232841036
48304,703-004-5396,5383.8325,4,1,3,1.1411225529064237
48569,703-004-5389,2332.9211,3,1,2,0.504412361478723
48832,207-008-2398,7561.2935,2,1,1,0.3482952234211253
48926,703-004-5396,5014.9688,6,4,2,1.5131234179327322
49154,703-004-5380,9275.515,4,1,3,0.5010284176527136
49589,703-004-5388,8586.791,4,0,4,0.27920371738274696
5075,703-004-5399,3393.503,4,2,2,2.2235595543298348
5222,207-008-2398,7080.011,3,1,2,0.3726178760947696
5785,703-004-5392,5394.598,2,2,0,1.8396183435350446
5935,207-008-2398,6382.5083,3,1,2,0.5169754691381796
6157,703-004-5384,4447.7095,6,2,4,0.9680575239655789
6272,703-004-5383,7234.245,1,0,1,0.27920371738274696
6543,703-004-5384,8671.474,3,3,0,0.8618409353754022
665,703-004-5388,8602.732,3,2,1,0.51510617941851
673,207-008-2398,2686.5344,5,2,3,0.6649914776796241
7411,207-008-2399,9405.071,4,2,2,0.6741119515102837
7594,703-004-5387,2006.3478,6,5,1,2.731264794799994
7718,207-008-2399,2552.9592,1,0,1,0.27920371738274696
7957,703-004-5383,9650.2705,4,2,2,0.968771839431471
8120,703-004-5390,5694.8613,"","","",0.27920371738274696
865,703-004-5393,1082.0485,6,3,3,1.1790772350219079
8750,703-004-5394,79.73433,5,3,2,2.416461466588673
8783,703-004-5397,6394.384,3,2,1,2.0354474421581292
8932,703-004-5393,583.74286,1,1,0,0.4143460722548127
8984,703-004-5389,5238.7896,8,6,2,3.525206804181548
9174,207-008-2398,4889.3784,7,4,3,1.2363379092216633
9323,703-004-5386,6507.0635,2,2,0,0.7364569722086406
9337,703-004-5394,1667.2706,4,2,2,0.7495145791473498
9697,703-004-5382,702.2214,5,2,3,3.4932225610393717
9719,703-004-5381,3928.8884,3,2,1,0.7564100557291691
9920,703-004-5388,3657.8203,3,3,0,0.6800514338617791
9931,703-004-5398,5269.643,13,6,7,1.3152374546095338
9952,703-004-5395,5128.673,3,2,1,0.5052023873071356
10079,703-004-5399,1652.6759,7,5,2,2.2688153685303827
10135,703-004-5395,4321.5425,5,2,3,0.8976193864144789
10271,703-004-5382,5929.727,4,3,1,1.421886357836698
10432,703-004-5382,928.4359,4,0,4,0.27920371738274696
10543,703-004-5386,2942.9246,4,2,2,2.25185820736469
10577,703-004-5394,759.22845,6,3,3,1.1793839760207958
10917,703-004-5380,9037.934,"","","",0.27920371738274696
10990,703-004-5388,8549.584,3,1,2,0.62448135590994
11201,703-004-5384,4576.048,8,3,5,1.1870582424165608
11451,703-004-5384,3100.2932,7,4,3,1.8026454826583926
11479,703-004-5393,6721.337,4,1,3,0.4632847360615333
11610,703-004-5383,4146.643,2,0,2,0.27920371738274696
11899,703-004-5391,8036.661,1,1,0,0.42927626536177715
11977,703-004-5380,2066.2898,2,0,2,0.27920371738274696
12514,703-004-5393,7530.9233,3,2,1,0.8194609664147234
12668,703-004-5398,5413.2017,5,2,3,0.8868141195135775
12703,703-004-5398,7809.4985,1,0,1,0.27920371738274696
12829,703-004-5399,6679.0215,6,2,4,0.723848089022112
13010,703-004-5383,6283.798,3,1,2,0.745379797566102
13053,703-004-5389,7905.36,6,2,4,1.2410768355296402
13468,703-004-5388,2126.5208,6,3,3,0.745238676880818
1356,207-008-2399,5624.1016,2,1,1,0.36998301227997626
13765,703-004-5380,7640.0415,2,0,2,0.27920371738274696
1381,703-004-5395,2075.7627,3,3,0,1.4643643892864742
1382,703-004-5391,7317.1836,2,1,1,0.9156439750323201
13836,703-004-5385,1034.5507,6,4,2,1.0339306639790857
13924,703-004-5386,6687.8325,2,2,0,0.9856204146721997
13981,703-004-5393,7069.093,3,1,2,0.4274391892628705
14180,703-004-5390,1002.8225,5,3,2,0.9287275994405061
14307,703-004-5398,2433.3071,3,1,2,0.33853450732658075
14311,703-004-5399,5618.9937,4,4,0,1.7273413471843506
14751,207-008-2398,5412.481,4,3,1,2.3915204398181023
14856,703-004-5398,5983.575,5,2,3,0.48618974132918746
15396,703-004-5396,1206.2377,5,1,4,0.4768400827494778
15408,703-004-5386,4423.7183,7,3,4,0.7303430348175788
15410,703-004-5389,9613.224,6,3,3,0.7865302697513423
15443,703-004-5384,8967.562,5,2,3,1.4484114715602285
15612,703-004-5392,8459.936,2,1,1,0.8042924235895609
15955,703-004-5399,2777.6194,1,1,0,0.33853450732658075
15963,703-004-5392,6883.52,5,4,1,0.7044130562190327
16390,703-004-5392,6619.238,5,2,3,0.4454485908053691
16529,207-008-2398,932.62134,6,4,2,5.51792806307299
16953,207-008-2398,1448.2814,5,4,1,1.505052062925868
17289,703-004-5389,9034.042,7,3,4,1.5054075701954706
17369,207-008-2399,6616.2104,4,2,2,1.1016167984566678
17644,703-004-5385,2256.1807,5,4,1,1.987317397384455
1785,703-004-5397,307.5856,8,2,6,0.8104539207259116
18040,703-004-5382,6950.735,7,1,6,0.4911728317045353
18350,207-008-2398,3732.6282,2,2,0,1.7755894768728213
18671,703-004-5396,6985.304,7,6,1,2.764454094753769
1875,207-008-2398,9329.705,4,3,1,1.0729114873690193
19246,703-004-5397,3349.7178,7,2,5,1.2002352138877908
194,703-004-5390,5965.4526,9,3,6,1.0957871324701522
19558,703-004-5393,8288.137,3,1,2,0.5413414565736282
19686,703-004-5388,6540.665,2,1,1,0.3919322182760311
19917,703-004-5386,8945.185,2,2,0,0.4939487647886224
20324,703-004-5383,710.8527,3,2,1,0.7692591223904113
20795,703-004-5397,646.3408,5,1,4,0.688444890523015
21025,703-004-5383,5939.799,2,2,0,0.7719357012022461
21043,703-004-5384,5549.7075,4,1,3,0.6755422217798102
21139,703-004-5386,7836.3467,5,5,0,1.3010530166693377
21145,703-004-5397,8662.245,5,3,2,0.9007792864983833
21195,703-004-5389,1196.2533,2,0,2,0.27920371738274696
21302,703-004-5387,7312.13,6,3,3,1.2955478615201323
21438,703-004-5389,6252.2583,4,2,2,1.1940744974330046
21516,703-004-5389,1691.2699,3,2,1,0.8282221677504215
2168,207-008-2398,9340.276,3,1,2,0.3978652972704144
22161,703-004-5396,4785.343,5,3,2,1.1912674306679771
22648,703-004-5394,2562.5825,"","","",0.27920371738274696
2278,703-004-5382,2852.3428,4,4,0,0.7105537809523599
23198,703-004-5380,3693.942,2,2,0,0.681220909654672
23246,207-008-2398,4905.02,4,1,3,0.41470518183364624
23267,207-008-2398,1453.9879,5,4,1,1.6206015706100616
23375,703-004-5393,3898.6277,3,1,2,0.4433079565944446
23528,703-004-5384,6770.9585,4,2,2,1.6299262759378603
23747,703-004-5380,440.9057,2,1,1,0.5203691984728398
23948,703-004-5394,8987.028,3,2,1,1.601581025952686
24218,703-004-5387,1616.273,5,2,3,2.2410100006558786
24388,703-004-5397,2048.086,2,1,1,0.7290518815015885
24429,703-004-5398,3179.5508,6,5,1,1.9691989031976704
2449,703-004-5388,1907.9524,1,0,1,0.27920371738274696
24513,703-004-5381,4876.265,4,1,3,1.645062035291316
24835,703-004-5394,2232.0056,4,3,1,2.5199940373553997
24942,703-004-5397,1147.207,5,3,2,2.3727966279594646
2498,207-008-2398,4470.887,3,1,2,0.9958664130969054
24998,703-004-5395,4706.0547,3,2,1,2.7745727721598565
25135,703-004-5385,9068.337,7,5,2,0.994050440759679
25239,703-004-5397,4983.837,4,3,1,1.416624469627648
25479,703-004-5395,306.49542,6,3,3,0.7320240916418262
25489,703-004-5395,5329.809,5,1,4,0.8543234644270142
26181,703-004-5383,3086.2869,3,2,1,0.5165268771580819
2621,703-004-5384,5003.5083,7,5,2,2.167982715556043
26324,703-004-5398,2287.405,3,1,2,0.7646410262970139
26547,207-008-2399,5331.8467,6,5,1,2.549348961549106
27061,703-004-5388,1153.8291,5,2,3,1.9774007063675993
27128,703-004-5391,8109.8755,5,3,2,0.9524204476148094
27271,703-004-5385,4145.597,8,6,2,1.900036121236672
27373,703-004-5384,5024.6924,4,1,3,0.5977140904938029
2768,703-004-5399,8466.603,3,2,1,0.8715122844992336
27783,703-004-5384,1998.1707,3,2,1,1.4999454711503286
28226,207-008-2398,7170.326,3,1,2,0.3422921240230235
2832,703-004-5387,5193.241,4,3,1,1.338350464005174
28619,703-004-5388,1589.7799,2,0,2,0.27920371738274696
28654,703-004-5380,6951.585,2,1,1,2.567563328310306
29218,703-004-5399,284.29926,9,4,5,1.9051802237367819
2956,703-004-5391,4541.4,8,3,5,3.148157627173331
29693,703-004-5393,4287.466,2,1,1,0.5422559355920162
29748,703-004-5385,7397.823,3,1,2,1.0715365994455606
30253,703-004-5391,6826.584,7,2,5,1.0821449331330721
30680,703-004-5396,7405.6963,3,2,1,0.6468752812892856
30976,703-004-5390,727.4664,1,1,0,0.38945992828873904
31146,703-004-5393,3438.3958,5,2,3,0.7398072918338167
31256,703-004-5387,7665.6006,5,3,2,2.424825803560719
31338,703-004-5382,4601.6265,4,0,4,0.27920371738274696
31795,703-004-5397,2407.1885,7,5,2,1.6595264569762251
31905,703-004-5394,5646.5674,5,2,3,0.6132710981632922
32181,703-004-5388,81.57075,3,1,2,0.4678205951408863
32254,703-004-5388,6655.9536,3,1,2,0.5093196482653668
32267,703-004-5389,7777.1963,5,2,3,0.6964969399877108
32717,207-008-2398,8739.548,1,0,1,0.27920371738274696
3278,207-008-2399,2086.993,2,0,2,0.27920371738274696
33043,703-004-5399,7654.9985,4,1,3,0.4239533579369963
33061,207-008-2398,8221.391,4,3,1,2.3290443546526465
33204,703-004-5381,4299.111,3,1,2,0.6873775130023102
33440,703-004-5396,1329.6788,6,4,2,1.9994087179794018
33968,703-004-5389,142.65955,1,1,0,2.2759694478673462
34085,703-004-5393,1460.8604,3,0,3,0.27920371738274696
34129,703-004-5389,1258.0896,3,3,0,2.7848766157969504
34262,703-004-5399,6179.4683,"","","",0.27920371738274696
34926,703-004-5381,7842.4453,4,2,2,0.6569941165062425
35118,703-004-5397,7682.948,6,3,3,1.7355617834213524
35220,703-004-5393,3351.2258,3,2,1,1.24948998450936
35221,703-004-5390,9000.799,6,3,3,2.052009370097872
35327,703-004-5391,1235.6597,2,1,1,0.4230808829965438
35713,703-004-5392,3610.707,6,3,3,0.8801844956991025
35873,703-004-5386,9733.259,4,2,2,1.801875360366061
35928,703-004-5397,2752.9592,4,2,2,0.7515502787431753
36392,703-004-5384,7417.6133,2,0,2,0.27920371738274696
36445,703-004-5387,1234.2537,2,1,1,0.6123461029173735
36516,703-004-5399,3832.1519,6,3,3,0.6096308343361104
36756,703-004-5396,3788.3896,4,3,1,1.2088877554997146
36766,703-004-5388,7145.4126,3,0,3,0.27920371738274696
36976,207-008-2399,1881.0552,6,4,2,2.2941574895716155
37433,703-004-5381,919.5453,5,4,1,2.434709714901157
37611,703-004-5382,6501.346,5,2,3,0.5908170506509149
37801,703-004-5399,405.42303,4,3,1,1.9466423482559254
37838,703-004-5397,9427.238,4,1,3,0.9732494306773318
37853,703-004-5389,2811.991,4,3,1,0.9765364871015242
38111,703-004-5397,6260.2,3,1,2,0.35831143730785864
39023,703-004-5399,9268.312,4,1,3,0.5847408048185062
39621,703-004-5385,8600.341,2,2,0,0.8089935147904667
40103,703-004-5385,2702.4692,5,3,2,1.257891535277065
40114,703-004-5395,3814.8933,5,2,3,0.8579049779076139
41207,703-004-5390,9747.215,5,3,2,0.6162387589638445
41344,703-004-5391,8349.624,3,1,2,1.448657305000795
41392,703-004-5387,6675.432,4,2,2,0.5303212858200232
41423,703-004-5381,8955.756,4,3,1,1.583957937079455
41542,703-004-5392,2258.601,2,1,1,0.42426744326918797
41790,703-004-5398,5102.6577,5,4,1,1.2683807473585125
418,703-004-5385,1348.6857,6,2,4,0.8696129583625961
41947,703-004-5382,8541.247,3,3,0,1.058630575447658
42061,703-004-5385,8441.95,11,8,3,3.716927956418327
42406,703-004-5381,8242.272,4,3,1,1.338813203576093
42580,703-004-5381,6359.105,"","","",0.27920371738274696
42804,703-004-5395,9234.99,4,2,2,0.7868181792122071
43347,703-004-5380,2263.2395,6,2,4,0.638236931803384
43534,703-004-5382,2546.19,5,3,2,0.863975738317215
43542,703-004-5388,7912.0337,4,4,0,0.9468486279681294
43656,703-004-5396,7906.754,5,1,4,0.9135975429506318
43781,703-004-5382,3320.7297,9,4,5,2.7806859679503932
4382,703-004-5385,2288.37,4,1,3,0.4819914493318839
44069,703-004-5396,9607.265,2,0,2,0.27920371738274696
44123,703-004-5396,9416.024,5,2,3,0.629196371480724
44157,703-004-5383,1682.5348,3,3,0,3.1389107617914456
44166,703-004-5381,6644.5654,7,6,1,1.7895405606534056
44329,703-004-5394,4634.9614,3,3,0,2.1028211631208693
44334,703-004-5385,5035.1094,3,1,2,0.3518020132516895
44768,703-004-5394,228.62791,3,2,1,0.547604344930662
44938,703-004-5381,8224.411,6,4,2,0.8883882891006167
45354,703-004-5384,1836.999,1,1,0,0.5573402524583709
45369,703-004-5394,6114.0996,3,2,1,0.8188076244999343
45538,703-004-5382,7885.292,2,1,1,0.7584402956346431
4556,703-004-5386,7861.414,1,0,1,0.27920371738274696
46023,703-004-5388,1911.0203,6,0,6,0.27920371738274696
46344,703-004-5385,248.33917,5,3,2,1.6365849930608136
46575,703-004-5380,8042.2515,6,4,2,1.7476865858252324
46844,703-004-5392,2035.026,2,0,2,0.27920371738274696
46924,703-004-5383,8913.146,5,2,3,0.6294505281637007
47123,703-004-5391,3270.9634,4,3,1,0.6055754167332544
47126,703-004-5398,1596.1206,5,2,3,0.4057760692629256
47199,703-004-5399,6562.429,7,3,4,0.637886858500516
47477,703-004-5389,132.02011,2,2,0,0.5560807371206377
47586,703-004-5385,5460.6074,3,1,2,0.8959162452731686
47648,703-004-5394,29.51026,4,3,1,0.713725071089699
47665,703-004-5381,2255.1924,6,3,3,1.2266340698603462
47693,703-004-5386,6534.7085,8,5,3,2.658515884811501
4784,703-004-5381,4841.689,4,3,1,0.7106456853118167
47943,703-004-5383,300.86816,4,1,3,0.33853450732658075
48384,703-004-5396,3926.016,4,2,2,1.0485646079141289
48447,703-004-5383,3426.141,2,1,1,0.6522263899477171
48831,703-004-5390,294.35037,5,4,1,1.8265586187196639
48881,703-004-5398,2893.7615,5,2,3,0.931826964783977
48897,703-004-5387,2041.6462,3,1,2,0.33853450732658075
49001,703-004-5383,9041.993,4,3,1,1.9643995507395446
49116,703-004-5382,1559.6461,2,1,1,0.9410955337348699
49128,703-004-5384,6340.522,6,5,1,3.292579414904348
49139,703-004-5386,3893.223,2,1,1,0.5951091592011356
49162,703-004-5393,9674.338,5,3,2,1.2129869015353467
49236,703-004-5380,2745.521,5,4,1,0.6500968444356531
49278,703-004-5388,7144.0483,6,3,3,0.8925309215431682
49502,703-004-5389,3196.307,4,2,2,0.8427461941807831
49527,703-004-5396,783.8893,4,3,1,2.247048545729294
49531,703-004-5388,141.74342,6,3,3,1.6185583029994606
49584,703-004-5394,2881.5276,4,2,2,1.4222444212489094
5065,703-004-5380,7210.7305,6,2,4,2.4404723746839294
5265,703-004-5395,2323.4756,4,2,2,1.7694669113004935
5342,703-004-5381,5711.9155,4,3,1,0.9740559132562691
5380,703-004-5399,5413.956,2,1,1,0.4180377658513179
5439,703-004-5399,6676.3125,3,2,1,0.6363280174239372
5861,703-004-5381,7342.927,6,3,3,0.9169681830254768
6036,207-008-2399,754.25385,6,2,4,1.6024324428806698
6076,703-004-5384,5779.736,9,5,4,1.0176976317834643
6133,207-008-2399,2678.6428,7,6,1,2.883838479631251
6478,703-004-5385,8415.0,3,0,3,0.27920371738274696
6727,207-008-2399,2285.6616,2,1,1,0.3978652972704144
6746,703-004-5396,2537.7148,6,4,2,2.4380329171526567
6961,703-004-5398,3282.3628,4,2,2,0.7503213846454542
7695,703-004-5380,5654.3257,3,2,1,0.4314860782385869
7847,703-004-5389,4855.111,4,2,2,0.9995203306617202
8006,703-004-5394,6573.363,3,2,1,0.8676090026130957
8871,703-004-5394,2988.6729,2,2,0,0.7673253501176653
8873,703-004-5395,8183.475,3,2,1,1.1880503297012917
9082,703-004-5399,2752.2625,6,2,4,1.181695184429748
9166,703-004-5398,5555.4136,4,0,4,0.27920371738274696
9230,703-004-5392,6771.924,3,1,2,0.38008938077997684
9235,703-004-5387,6650.8276,2,0,2,0.27920371738274696
9434,207-008-2398,5652.161,5,3,2,1.9590277772364322
9699,703-004-5385,7038.6895,3,3,0,1.1108566650917369
9865,703-004-5389,3452.4924,2,1,1,0.5610999834655963
9933,703-004-5388,419.16312,3,2,1,0.7019122011866346
10232,703-004-5389,4392.609,3,0,3,0.27920371738274696
10551,703-004-5382,2406.2805,4,3,1,1.0302108989435395
10585,703-004-5385,7797.541,2,1,1,0.49630986394341187
10614,703-004-5381,6080.833,4,3,1,1.155415257497476
1068,703-004-5380,7231.5063,6,5,1,1.296742661651216
10734,703-004-5393,4371.104,5,2,3,1.109186515305186
11040,703-004-5390,7517.1763,2,1,1,0.5612316491776713
11094,703-004-5386,1568.6523,2,2,0,1.2799640768572962
11361,703-004-5385,149.0283,5,3,2,1.3121435231967817
1140,703-004-5389,1547.9785,4,3,1,0.9034485368119115
11654,703-004-5388,5273.0767,5,2,3,1.2948422500364787
12202,703-004-5393,9004.963,6,3,3,1.4909102671148808
12203,703-004-5386,3863.4778,3,1,2,0.36951836429724944
12415,703-004-5383,3872.1233,4,4,0,2.7952772033210467
12490,703-004-5385,3424.391,4,3,1,1.906418184055445
12499,703-004-5382,4473.4663,5,3,2,0.6841575711737685
12670,703-004-5384,4231.9233,5,3,2,0.6795686506612278
13321,703-004-5398,5318.158,2,2,0,1.515802617464974
13424,703-004-5382,8171.8394,1,0,1,0.27920371738274696
13691,703-004-5397,2113.8042,3,2,1,0.8073112022906958
13843,703-004-5380,2345.6997,1,1,0,0.5798836531981377
14018,703-004-5384,2233.3098,1,1,0,0.7608395951419646
14117,703-004-5399,1759.7585,4,2,2,0.6621313647044462
14308,703-004-5380,8986.819,2,1,1,0.5165268771580819
144,703-004-5398,2050.6108,6,2,4,0.9540174767717529
14750,703-004-5395,199.77986,5,2,3,0.515249049373878
15335,703-004-5395,9534.286,5,2,3,0.9172376521117441
15398,703-004-5380,3728.0894,4,3,1,1.503921624120772
15847,703-004-5396,41.37218,3,1,2,0.4324759395074263
1606,207-008-2399,8911.378,3,1,2,0.3668247134722495
16189,703-004-5397,7002.2266,8,2,6,1.9917011081666212
1714,703-004-5393,3516.6604,7,3,4,1.8095875222697437
17565,703-004-5389,5327.9067,1,0,1,0.27920371738274696
176,703-004-5393,771.66797,6,3,3,0.7992189156677911
18044,703-004-5382,3929.4243,6,5,1,1.5057848054086422
18296,703-004-5392,7081.8657,4,1,3,0.3978652972704144
18402,703-004-5383,1517.8854,2,1,1,0.39753897792572335
18823,703-004-5395,6983.805,4,2,2,0.8496117660625251
1917,207-008-2398,1392.0265,2,1,1,0.41669416909657997
19613,703-004-5385,5099.6763,7,2,5,0.6565775653284363
19874,207-008-2398,4480.763,4,4,0,1.2152991667105995
20073,703-004-5388,9877.358,3,1,2,1.2807464452570667
20115,703-004-5382,5095.2427,7,1,6,0.6983783440579923
20327,703-004-5396,8054.211,2,0,2,0.27920371738274696
2084,703-004-5384,7107.5522,7,3,4,1.7660371877858645
20893,703-004-5386,2745.4226,4,3,1,0.8204424872505575
20919,703-004-5395,1593.6023,7,5,2,2.6167239676985266
20922,703-004-5386,6596.24,6,3,3,1.2021742307515257
21126,703-004-5387,8289.043,7,2,5,1.585466981826254
21469,703-004-5380,3172.4668,3,1,2,0.7666697113664587
21809,207-008-2398,8014.342,7,2,5,0.5769412848916583
21859,703-004-5399,1285.7705,3,1,2,0.32666834933781397
21898,703-004-5385,3981.6255,6,2,4,0.9192801683862365
22003,703-004-5396,8669.348,1,1,0,0.3637500930527101
2202,703-004-5387,1185.5447,4,0,4,0.27920371738274696
22307,703-004-5390,7795.2,4,1,3,0.7725796346621566
22328,703-004-5397,9752.947,5,4,1,0.7451712089012753
22357,703-004-5392,6643.3994,4,2,2,0.7327390102204303
23432,703-004-5398,3996.826,1,0,1,0.27920371738274696
23719,703-004-5393,7317.3936,3,0,3,0.27920371738274696
23818,703-004-5394,9316.302,3,2,1,0.5356851910864266
23926,703-004-5390,7401.729,4,0,4,0.27920371738274696
24228,703-004-5388,1052.438,7,5,2,1.6139305693142785
24312,703-004-5390,3879.7349,4,0,4,0.27920371738274696
24441,703-004-5398,1829.8989,6,2,4,1.8141952128577183
24880,703-004-5393,491.22394,7,5,2,1.3057993088953896
25129,703-004-5388,7579.165,3,2,1,0.7458415424307477
25309,703-004-5387,6533.238,2,1,1,0.3923882915832162
25572,703-004-5383,8667.258,7,2,5,0.9395966424130773
25615,703-004-5396,2690.9453,7,3,4,1.6084991875048718
26155,703-004-5384,6971.322,9,4,5,1.0429436805676309
26274,703-004-5382,3617.639,2,1,1,0.6562073256973812
26546,703-004-5395,867.2398,5,3,2,1.864134787927216
2679,703-004-5382,5748.707,4,2,2,0.42182010371023726
26989,703-004-5398,2954.099,6,2,4,1.285604134817468
27073,703-004-5383,589.43866,3,0,3,0.27920371738274696
27156,703-004-5393,9546.563,5,1,4,0.7643846135933913
27176,703-004-5392,6529.9414,4,2,2,1.7575219014432981
2748,703-004-5392,9529.301,2,1,1,0.5094252635741041
27626,207-008-2399,7073.313,4,1,3,0.36173131313204354
27674,703-004-5392,7690.252,6,5,1,2.76751653151904
27741,703-004-5382,5399.0527,5,2,3,1.9587459018390943
29053,703-004-5390,1123.2954,1,0,1,0.27920371738274696
29056,703-004-5385,4861.7393,2,1,1,0.7700602984655766
2910,703-004-5399,2195.89,5,2,3,0.7731074886615342
29269,703-004-5389,3282.2258,2,2,0,0.8290658677824927
29427,703-004-5387,957.8371,5,3,2,2.5356566835898797
29844,703-004-5382,631.68823,5,4,1,1.17485742677024
30025,703-004-5381,3451.6418,1,0,1,0.27920371738274696
30687,703-004-5399,3665.5718,4,1,3,0.5568718143198889
30741,703-004-5385,428.46918,4,3,1,0.8269634426997116
30765,207-008-2399,8922.365,7,4,3,1.5381164418563975
30777,703-004-5386,9156.176,2,1,1,0.5316474923998098
30941,703-004-5397,286.14044,1,0,1,0.27920371738274696
3122,703-004-5388,1616.9191,2,2,0,0.9069357267865854
31394,703-004-5395,2862.4136,5,4,1,1.356843286401611
31727,703-004-5399,2038.188,3,1,2,0.6260163224034692
31972,703-004-5386,8408.574,4,2,2,0.9653814003772933
32326,207-008-2399,6777.2485,9,8,1,2.343855198425154
32493,703-004-5390,2449.472,1,0,1,0.27920371738274696
32710,703-004-5388,7450.963,8,3,5,0.6783280709134203
32766,703-004-5383,3840.0996,5,3,2,1.9960552862157959
33153,703-004-5392,6601.627,1,1,0,0.5748041640850724
33222,703-004-5390,7031.7607,4,0,4,0.27920371738274696
33281,703-004-5386,2077.5093,4,2,2,1.2027696737295168
33608,703-004-5396,5185.7983,2,2,0,0.7265855897131023
33660,703-004-5385,5564.3555,7,4,3,2.617409017577054
3375,703-004-5394,4634.133,6,1,5,0.3762528209752492
33763,207-008-2398,1716.2341,4,2,2,0.510738091693798
33967,703-004-5391,9816.198,3,0,3,0.27920371738274696
34026,703-004-5388,8127.6753,1,1,0,0.5027303656849573
34048,703-004-5380,7521.2437,6,3,3,0.7395003643728995
3431,703-004-5380,4.2122602,8,4,4,1.2037315356855853
34581,703-004-5393,8558.267,4,1,3,0.6102824515454536
34656,703-004-5396,587.18384,3,1,2,0.3637500930527101
34681,703-004-5384,2560.957,4,1,3,0.5296801917739247
34694,207-008-2398,7642.4287,4,1,3,1.2381628788881125
34865,703-004-5392,2930.2383,4,0,4,0.27920371738274696
35075,703-004-5394,4047.317,5,0,5,0.27920371738274696
35242,703-004-5386,9684.29,3,2,1,0.8071293722531879
35317,703-004-5392,1292.3157,5,4,1,1.8234616873335894
35422,703-004-5384,186.54883,4,2,2,0.7090274507777381
35512,703-004-5390,8631.346,7,3,4,0.6375475622649447
35803,703-004-5391,6915.679,4,3,1,0.9198996960706896
36082,703-004-5384,70.36984,9,5,4,4.0700367090675815
36147,703-004-5397,7063.887,3,2,1,1.298856058122449
3743,703-004-5387,761.7658,3,3,0,1.2291229010113722
3756,703-004-5386,1158.3782,7,6,1,1.348333390707135
37638,703-004-5384,4619.414,4,2,2,0.6648538520176662
37973,703-004-5393,3787.1157,8,5,3,1.402856784573283
3806,703-004-5392,7398.5,6,1,5,0.6442198678856159
3818,207-008-2398,2550.0845,3,2,1,0.7490366317140591
38244,703-004-5386,5673.4087,4,2,2,1.9969816286538633
38352,703-004-5381,232.86938,2,2,0,0.5652354709988483
38771,703-004-5398,8681.032,6,3,3,1.4619916913553088
38954,703-004-5392,7309.3296,5,3,2,0.7175610626269298
39380,703-004-5384,9854.43,3,1,2,0.46607740361610916
39429,703-004-5397,5840.749,2,0,2,0.27920371738274696
39774,703-004-5385,136.12509,4,3,1,1.1383598059144295
39790,703-004-5385,440.29712,1,1,0,0.3468408179187174
39923,703-004-5385,5705.739,6,6,0,1.9264698046030144
40044,703-004-5394,9657.479,3,3,0,0.8919518219570536
4051,703-004-5398,1417.3705,7,3,4,1.6153715701238873
4055,703-004-5398,7391.9917,5,1,4,0.5808266225388115
40722,703-004-5388,1690.8282,3,2,1,0.5249900729927902
41408,703-004-5381,2100.498,5,1,4,0.6231063419220257
41486,703-004-5388,7417.837,6,2,4,0.7382169095392034
41867,703-004-5387,3095.0398,2,0,2,0.27920371738274696
42108,703-004-5398,1462.2688,4,2,2,0.7807525540346097
42145,703-004-5396,1586.0254,3,2,1,0.8512412041132752
42186,703-004-5386,5054.034,3,1,2,0.6141203669187807
42364,703-004-5397,7055.0425,4,1,3,0.508243849991316
42386,703-004-5385,8608.535,8,5,3,1.4622260382294416
42482,703-004-5398,9509.217,2,1,1,0.3468408179187174
42731,703-004-5390,4466.1963,1,1,0,4.694656698142409
42880,703-004-5387,9591.986,4,1,3,0.3734090632516913
43080,703-004-5398,2660.7854,3,2,1,1.2368820160068867
43257,703-004-5393,4778.544,4,1,3,1.1314518717033069
43779,703-004-5391,5363.613,2,1,1,0.4615539664815064
43944,703-004-5386,3420.8162,4,1,3,0.5016463193860652
44059,703-004-5383,4347.9604,4,3,1,0.8840390267123829
44318,703-004-5381,1168.5747,3,1,2,1.600982278211142
44389,703-004-5384,7567.409,4,1,3,0.9691309799855077
44827,703-004-5380,7254.485,2,1,1,0.44829646872267315
44850,703-004-5394,9016.608,3,2,1,0.5577329348128236
44887,703-004-5395,2217.2034,1,0,1,0.27920371738274696
45030,703-004-5399,5756.1646,3,2,1,2.0399273280737487
45335,703-004-5391,5924.849,3,1,2,0.41602981964391045
46071,703-004-5392,4275.9053,4,1,3,0.33853450732658075
46072,703-004-5380,9390.758,3,2,1,0.7814694792197234
46081,703-004-5394,5715.0557,5,4,1,2.3754359736961392
46270,703-004-5385,8347.251,10,6,4,3.1778379052665686
46328,703-004-5389,8795.676,2,0,2,0.27920371738274696
46388,703-004-5386,3700.6443,5,2,3,1.5027885229988602
46451,207-008-2398,9543.071,2,1,1,0.9632808884718802
46463,703-004-5383,7215.7437,4,2,2,1.0118631607932882
46750,703-004-5395,7729.3945,5,3,2,1.0431878281549012
46778,703-004-5399,7197.443,3,0,3,0.27920371738274696
46944,703-004-5396,367.81192,6,2,4,0.7404241222627012
46953,703-004-5382,347.16428,4,1,3,0.3468408179187174
47186,703-004-5380,6519.6196,4,2,2,0.6029375532962934
47208,703-004-5382,4227.6514,6,4,2,1.0465266073846777
48012,703-004-5381,4284.6523,4,4,0,1.6075922726135539
48205,703-004-5384,9768.384,5,2,3,0.7641340405236813
4822,207-008-2398,8283.564,1,1,0,0.5748688981371003
4824,703-004-5386,7555.7275,3,1,2,0.5699304373502824
48388,703-004-5381,974.00726,9,3,6,2.1418339570757996
48555,703-004-5397,4279.3984,3,3,0,1.1119936094302485
48714,703-004-5395,9729.625,5,2,3,0.3922147458471921
48948,703-004-5394,8773.639,"","","",0.27920371738274696
48987,703-004-5380,6743.4224,2,1,1,1.3170480709989063
49006,703-004-5388,7178.7715,4,3,1,0.9139828208948733
4920,207-008-2398,4174.2915,"","","",0.27920371738274696
49783,703-004-5383,734.1069,4,2,2,0.4310905396389613
4990,703-004-5395,8981.318,5,3,2,0.9412442884892392
49911,703-004-5393,2838.4011,5,1,4,0.4870852573968724
49928,703-004-5385,1848.9432,1,1,0,0.43492257326680367
5114,703-004-5398,7814.442,4,2,2,0.7174534291628095
531,703-004-5399,9051.702,2,1,1,0.33853450732658075
5365,703-004-5380,299.84058,5,1,4,0.7215422672028337
5446,703-004-5380,2004.7969,5,3,2,1.4516870361808125
5604,703-004-5389,1667.716,5,3,2,1.1403957583434154
5807,703-004-5387,8063.53,8,3,5,1.0668116527363833
5846,703-004-5383,1059.0237,7,4,3,1.3457445637165246
5901,703-004-5385,3792.5046,3,0,3,0.27920371738274696
5909,703-004-5390,4633.184,4,4,0,3.3386173108569865
5920,703-004-5390,2945.913,4,1,3,0.3691084050195126
6318,703-004-5386,5171.696,7,0,7,0.27920371738274696
6596,703-004-5380,5858.775,3,0,3,0.27920371738274696
6854,703-004-5396,8381.156,7,2,5,0.45594612343652524
7073,703-004-5395,1694.3026,1,0,1,0.27920371738274696
7483,703-004-5384,7741.105,6,2,4,0.7952809434750994
754,703-004-5384,3598.8926,1,1,0,1.8448979825141014
7661,703-004-5386,9876.289,5,4,1,1.1913710303043612
7748,703-004-5385,926.3277,5,3,2,3.5022244862425502
8205,703-004-5384,4036.013,6,4,2,2.0761332517298206
8228,703-004-5389,224.30658,3,0,3,0.27920371738274696
830,703-004-5382,4357.6973,6,4,2,1.2948581898332536
8414,703-004-5397,7580.105,5,3,2,2.5407544758407608
858,703-004-5381,9327.637,5,2,3,0.6185585310477424
8597,703-004-5385,1526.5786,2,0,2,0.27920371738274696
8663,703-004-5399,564.9662,3,3,0,1.3024564965746468
8778,703-004-5382,6899.285,5,3,2,1.1474550655370235
8889,703-004-5393,9030.502,4,2,2,0.9157610981669735
8909,703-004-5382,3739.813,6,4,2,1.9539583338943098
9025,703-004-5388,602.75195,2,0,2,0.27920371738274696
9193,703-004-5382,1658.9194,5,1,4,0.33337555387717877
9436,703-004-5398,7714.1924,"","","",0.27920371738274696
963,703-004-5389,2576.748,4,3,1,1.7392386620144002
985,703-004-5386,8104.1934,2,1,1,0.7369956419378167
9985,703-004-5380,3247.9333,7,4,3,1.6155838176971526
10031,703-004-5380,6647.119,3,2,1,2.170154725813861
1018,207-008-2398,7194.4727,8,3,5,1.1582267597142863
10478,703-004-5397,6479.325,4,3,1,1.515713029855517
10757,703-004-5395,6443.4365,9,4,5,1.578259780466411
11267,703-004-5397,3766.1428,7,4,3,1.4508208761036554
11284,703-004-5384,409.9983,5,2,3,0.9092345792866227
11612,703-004-5389,1071.0531,5,2,3,1.1897630699508643
11617,703-004-5381,7746.3955,6,4,2,1.1991094569299199
11685,207-008-2399,4930.4233,6,3,3,0.893398078092062
11811,703-004-5380,5238.755,3,1,2,0.5356852996636016
11956,703-004-5388,5765.317,4,2,2,1.2870278047823265
12146,703-004-5387,1900.0966,2,0,2,0.27920371738274696
12717,703-004-5394,9863.496,4,4,0,1.4795689787232873
13199,703-004-5385,9768.698,4,3,1,1.5346388894026064
13455,703-004-5381,6551.4775,2,1,1,0.4456392457959418
13659,703-004-5391,6549.7334,3,1,2,0.3902511792276225
1370,703-004-5397,1601.4128,7,3,4,1.3687750314786418
13748,703-004-5389,3427.54,4,3,1,1.425039483744828
13816,207-008-2398,234.7803,5,3,2,1.7124163890250523
13823,703-004-5396,8203.309,4,2,2,0.8179096516858463
13856,703-004-5388,1765.3757,5,2,3,0.9362091422025812
13875,703-004-5387,1913.876,5,2,3,1.1353055461907435
14120,703-004-5393,1591.726,2,1,1,0.8643328085104636
14292,703-004-5391,6361.8184,1,0,1,0.27920371738274696
14599,703-004-5396,8937.168,1,0,1,0.27920371738274696
14965,703-004-5381,9384.752,9,2,7,0.48018445218582395
15050,703-004-5384,4670.661,7,2,5,0.957168484400567
15095,703-004-5391,457.23856,1,1,0,0.3978652972704144
15147,703-004-5384,5359.43,4,3,1,2.2053153793392406
15462,703-004-5398,555.29297,7,5,2,1.354985235616913
15566,703-004-5396,1034.4661,9,3,6,1.2318990502972131
16233,703-004-5395,1321.8569,2,1,1,0.428964519665974
16296,703-004-5396,4489.235,3,1,2,0.3535649741123519
16426,703-004-5387,8367.9375,4,3,1,1.495221895672115
16439,703-004-5395,458.6017,6,4,2,1.6615846472261864
16479,703-004-5388,2058.6711,4,3,1,1.1545641633897568
16509,703-004-5397,5934.861,1,0,1,0.27920371738274696
16747,207-008-2398,2866.6204,8,6,2,2.64934323585875
17049,703-004-5386,3951.0505,4,1,3,0.47156451779722236
17629,703-004-5392,6685.556,5,3,2,1.5707603961123238
17729,703-004-5393,2963.6812,5,2,3,1.1744663427288604
17893,703-004-5391,784.0532,2,1,1,0.9627849810200325
17984,703-004-5388,1848.5856,3,1,2,0.48289852815678486
18006,703-004-5386,8908.304,4,3,1,2.123669350057586
18056,207-008-2399,6549.167,1,0,1,0.27920371738274696
18327,703-004-5381,6559.1167,6,3,3,1.251668092777597
18330,207-008-2399,2817.6885,4,1,3,0.4902996156759335
18435,703-004-5387,5694.4434,3,1,2,0.3889656787788394
18550,703-004-5383,4102.9106,4,2,2,0.4576441422885675
18605,703-004-5388,6837.56,3,0,3,0.27920371738274696
1864,207-008-2399,4995.298,1,1,0,1.002553912535005
1879,703-004-5389,9983.152,4,2,2,1.1668071554706987
19159,703-004-5391,1773.0057,3,1,2,1.8361425867804388
19258,703-004-5387,8880.557,4,3,1,1.8770991387806262
19341,703-004-5382,6389.5137,4,2,2,1.0527621874623085
19440,703-004-5389,5820.8516,5,1,4,0.41917099552729
19565,703-004-5399,4264.8413,4,0,4,0.27920371738274696
19625,703-004-5395,535.56976,2,1,1,0.8085793314714226
19910,703-004-5398,7740.02,8,3,5,3.277227140657175
20094,703-004-5389,4314.9556,3,1,2,0.43435788075157455
20114,703-004-5380,3611.2004,5,3,2,1.1834607152060272
20262,703-004-5399,3961.692,7,4,3,0.9372710092370291
20276,703-004-5391,741.96936,5,3,2,1.3902492257299082
20468,703-004-5387,487.18692,1,1,0,0.7763137277551447
20787,703-004-5395,6317.4414,1,1,0,0.6175848908520762
21415,703-004-5381,3108.03,2,2,0,0.6206607103213572
21651,703-004-5388,6424.7544,7,4,3,2.396777111269451
21659,703-004-5386,5350.9087,5,3,2,1.3582480954123497
21993,703-004-5397,2189.6719,6,5,1,1.7730631217267852
22313,703-004-5399,9675.983,3,1,2,0.8116401906254114
22885,703-004-5394,9197.729,3,2,1,1.3552637955386972
22911,703-004-5392,4042.0837,6,2,4,0.617880525581243
23008,703-004-5382,5660.116,2,0,2,0.27920371738274696
23033,703-004-5380,3814.792,7,4,3,0.955997989356141
23151,703-004-5396,6422.5396,5,0,5,0.27920371738274696
23186,703-004-5389,7008.4854,4,0,4,0.27920371738274696
23365,703-004-5393,3460.2505,4,3,1,2.219546324028478
23367,703-004-5386,3406.4473,7,4,3,0.8701017560012271
23430,703-004-5389,191.14613,6,1,5,0.5036392510362666
23575,703-004-5382,8084.5205,3,1,2,0.8509561045159524
23631,703-004-5382,6866.4614,3,2,1,1.214949799081962
23771,703-004-5395,7143.9956,3,2,1,0.5956345970831934
23914,703-004-5397,2720.588,5,5,0,1.5879242799747595
23976,703-004-5395,6264.66,6,4,2,1.7428325650363121
24234,703-004-5394,2023.117,4,2,2,0.5328774540201034
24243,703-004-5385,875.1738,10,3,7,1.0925412926047484
245,207-008-2398,2558.2385,2,1,1,0.5022213830100445
24581,703-004-5394,3477.3594,4,1,3,0.6697162342208742
24670,207-008-2399,3120.5981,5,4,1,1.9048011162590592
24672,703-004-5383,992.651,6,4,2,1.1513288291722734
25062,703-004-5393,581.44867,3,1,2,0.4101115660222241
25482,703-004-5394,1838.3682,4,1,3,0.5110051967758303
25558,703-004-5394,3929.9678,4,2,2,0.598791959920241
25604,703-004-5399,805.15564,8,4,4,3.826612680881599
25809,703-004-5384,9674.188,6,3,3,2.707418206311221
25942,703-004-5399,3171.7092,5,2,3,1.3837688190436748
26014,703-004-5397,1337.4144,4,1,3,0.7943207488091699
26047,703-004-5395,7732.8765,2,1,1,1.0133872381522733
26264,703-004-5399,7458.0054,6,3,3,3.187044069385863
26428,703-004-5388,785.374,1,1,0,0.7118408584801412
26771,703-004-5391,7471.397,5,1,4,1.3571186144766971
27056,703-004-5390,883.5757,2,2,0,0.5155164681615313
27127,703-004-5396,7825.419,5,4,1,1.031992318225422
27210,703-004-5381,7661.508,2,1,1,1.7466466616470908
28037,703-004-5394,9516.449,4,1,3,0.6164729360974316
28243,703-004-5387,8318.129,2,1,1,0.35534489781066697
285,703-004-5390,4945.4365,1,1,0,0.36951836429724944
28633,703-004-5382,1544.9327,2,2,0,1.23552602007749
28643,703-004-5397,6737.314,6,3,3,0.9250448643606735
28652,703-004-5395,1092.8792,3,1,2,0.6414482352590513
28674,703-004-5384,156.30603,1,1,0,0.8527048081218032
28739,207-008-2399,3724.8909,1,1,0,0.9409226973193232
29011,703-004-5384,119.91799,3,2,1,0.4961368623473843
29300,703-004-5394,6474.4683,3,3,0,1.4082337917807395
29311,703-004-5394,1704.4127,4,2,2,0.8057375867261064
29375,703-004-5381,9409.26,6,3,3,0.8952910000019213
29394,207-008-2398,3398.0942,5,3,2,0.9930222644684654
29622,703-004-5389,2959.8396,"","","",0.27920371738274696
29695,703-004-5383,5215.4272,2,0,2,0.27920371738274696
30132,703-004-5396,7267.797,2,1,1,0.46197438553337966
30492,703-004-5391,9256.516,1,0,1,0.27920371738274696
30591,703-004-5383,5155.6353,4,2,2,0.6528200071794019
31345,703-004-5395,7267.0503,3,3,0,2.1094992788383586
31427,703-004-5380,6847.526,5,3,2,1.8249238012187454
31615,703-004-5382,9501.001,3,1,2,0.5230519343373575
31632,207-008-2398,4701.7427,4,3,1,1.0945796724385877
3165,703-004-5386,1725.08,2,1,1,0.7257440352445834
31775,703-004-5394,8286.058,6,3,3,0.8169269368312131
31810,703-004-5380,6608.1206,2,2,0,0.5828034897190901
31832,703-004-5381,2882.3013,3,1,2,0.7040017707448143
32017,703-004-5386,4507.7173,6,1,5,0.7998732306230757
32219,703-004-5396,2876.7651,4,3,1,1.4283091760953919
3222,703-004-5398,8822.19,2,1,1,0.5622098293840244
32233,703-004-5391,83.33444,2,2,0,0.6174502865620513
32543,703-004-5392,9358.812,4,2,2,0.6639757276877005
32552,703-004-5397,6748.293,6,4,2,1.0791480263702005
32859,703-004-5385,2863.872,2,0,2,0.27920371738274696
32876,703-004-5383,745.52,1,0,1,0.27920371738274696
33143,703-004-5387,5597.371,2,0,2,0.27920371738274696
33156,703-004-5389,6615.4927,6,3,3,0.8340214356209971
33377,703-004-5382,7725.48,4,4,0,2.0052225907395136
33420,703-004-5398,7225.961,4,3,1,0.5955939263243054
34150,703-004-5392,2616.8406,4,4,0,2.4608116017219412
34530,703-004-5392,4244.274,2,0,2,0.27920371738274696
34771,703-004-5388,5841.478,4,2,2,1.824109835326229
34847,703-004-5387,766.4257,6,3,3,2.447349930380669
34992,703-004-5395,7993.3145,5,2,3,1.4861491239747724
35163,703-004-5398,764.52374,3,2,1,1.3522103922253639
35243,703-004-5385,7710.3306,5,2,3,2.3721454978132983
35291,207-008-2398,1232.9131,2,0,2,0.27920371738274696
35469,703-004-5394,9859.06,4,2,2,0.5836465039542351
36135,703-004-5397,7668.486,1,0,1,0.27920371738274696
3643,703-004-5393,2314.6797,4,2,2,1.568666420917487
36436,207-008-2398,1535.9152,3,1,2,0.4810111390301225
36575,703-004-5391,2643.491,4,2,2,1.43168174084444
36652,703-004-5388,7522.667,6,5,1,1.2984338149953334
3690,703-004-5389,3409.8953,6,3,3,2.5851841079382605
36929,703-004-5380,444.36456,9,4,5,0.8996808028560852
37057,703-004-5381,6192.212,4,2,2,0.8933929424459699
37112,703-004-5382,6504.559,2,2,0,0.7570760184646504
37260,703-004-5387,3079.4788,3,0,3,0.27920371738274696
37287,703-004-5392,9789.459,3,3,0,1.0819430560903354
3755,207-008-2399,3123.619,4,2,2,0.6526377891523393
38267,207-008-2399,4219.789,4,1,3,1.2520694387952576
38382,703-004-5383,3420.8374,3,1,2,0.5994043911336708
38561,703-004-5399,4373.198,5,3,2,0.9037926731736522
38621,703-004-5383,7.556081,2,1,1,0.6552555972343582
38758,703-004-5386,5012.585,4,4,0,2.5902614348738493
38769,703-004-5394,1163.0958,5,2,3,2.4074746559983455
38962,703-004-5387,7043.582,6,2,4,2.3247885507986754
39648,703-004-5396,1298.8097,1,0,1,0.27920371738274696
39691,703-004-5395,5571.0864,4,3,1,0.9235974633969637
39739,703-004-5385,3674.5542,2,1,1,0.3254817335389373
40041,703-004-5391,1804.0377,2,0,2,0.27920371738274696
40255,703-004-5381,7673.898,6,3,3,1.7339867338485206
40461,703-004-5391,9017.327,3,1,2,0.4406066586006219
40645,703-004-5393,1070.1221,"","","",0.27920371738274696
4076,703-004-5380,419.50046,1,1,0,0.4443172852552015
40803,703-004-5388,3810.2764,2,2,0,0.5882753533086081
40851,703-004-5381,7326.404,10,4,6,1.0670531114392467
41168,703-004-5396,169.1848,5,2,3,2.100829411687417
4120,207-008-2398,6477.5776,7,4,3,1.956996153931747
41255,703-004-5397,9114.327,5,2,3,0.7416445739108742
41346,207-008-2399,5632.2583,2,0,2,0.27920371738274696
41362,703-004-5399,3746.4136,6,3,3,0.8331809850549085
41405,703-004-5398,4764.9233,4,2,2,0.5204637908715134
41526,703-004-5397,9333.471,4,4,0,1.890558185005606
42128,703-004-5390,7564.9995,4,1,3,0.5866247626530346
42249,703-004-5389,1677.8422,6,1,5,0.6086297021385441
42344,703-004-5381,6851.2183,6,2,4,0.7577873733677386
42677,703-004-5393,2810.142,2,0,2,0.27920371738274696
42964,703-004-5389,9459.29,2,1,1,0.3250491131955969
42996,703-004-5389,3204.122,4,1,3,0.5834654646819581
43034,207-008-2398,7984.166,4,1,3,1.0174855802949858
44158,703-004-5388,8299.405,3,2,1,0.6056642930582575
44495,703-004-5391,1189.655,"","","",0.27920371738274696
44935,703-004-5390,6343.7944,7,1,6,0.33853450732658075
4494,703-004-5399,6931.5645,5,3,2,1.021399306280708
45009,703-004-5389,7549.243,3,3,0,0.7906166523660324
45011,703-004-5396,5148.0435,3,2,1,0.8195491209069857
45202,703-004-5385,5809.783,4,1,3,0.7182515629671166
45216,703-004-5385,2776.2986,5,1,4,0.33853450732658075
45237,703-004-5393,2803.8394,6,3,3,1.7049508181244935
45367,207-008-2398,766.44183,9,6,3,2.303126640800277
45720,703-004-5387,4649.7505,6,2,4,0.5563685500521988
45722,703-004-5381,9724.195,3,2,1,2.57799512021499
46063,703-004-5382,3210.2424,7,4,3,0.8091680604791903
46159,703-004-5383,9299.413,6,4,2,1.9651321677322182
46490,703-004-5391,9960.445,4,0,4,0.27920371738274696
46578,703-004-5391,3392.5117,4,1,3,0.3978652972704144
4660,703-004-5384,7458.369,2,2,0,0.48667769042645403
4683,207-008-2398,2709.81,"","","",0.27920371738274696
47328,703-004-5383,4396.6616,4,3,1,0.697395729413887
47670,703-004-5395,4575.5796,4,3,1,0.5015297883635355
47724,703-004-5394,8956.038,3,1,2,0.3897066790402956
47914,703-004-5397,9180.693,3,2,1,1.0251454507828475
48000,703-004-5386,2705.2402,3,1,2,0.4600637420615335
48307,703-004-5387,7168.1826,8,5,3,4.435052650240925
48379,703-004-5385,8689.407,6,2,4,1.1229281046095347
48849,703-004-5393,995.2968,1,0,1,0.27920371738274696
49568,703-004-5392,2191.1157,8,2,6,1.6538362764492403
4962,703-004-5393,7875.5894,4,2,2,0.5739623779787097
5115,703-004-5398,9027.127,5,5,0,1.5111688419367193
5121,703-004-5381,9233.292,3,3,0,0.6511509644097173
5394,703-004-5398,8626.658,4,3,1,1.4141227044936167
5508,703-004-5386,2903.8816,4,2,2,1.9957910049451433
5749,703-004-5385,2225.9158,6,3,3,2.048531801067578
5982,703-004-5392,7485.4004,5,4,1,1.5207242931905802
6246,703-004-5390,2923.4421,4,3,1,1.0720910112484479
6291,703-004-5381,3477.0674,5,3,2,1.1354274706909928
6372,703-004-5398,3877.123,1,0,1,0.27920371738274696
6411,207-008-2398,915.47546,3,2,1,0.9908094106471753
6607,703-004-5391,8558.6455,4,2,2,2.287134550365439
7168,703-004-5398,4947.396,3,3,0,1.0369172852406912
7365,703-004-5394,5536.9023,5,2,3,0.6908075276082938
7449,207-008-2398,9080.914,4,2,2,0.5518510821340399
7624,207-008-2398,3465.8499,5,2,3,1.184307871950185
7727,703-004-5388,6523.1484,2,1,1,0.4196322407916998
7760,703-004-5394,8907.224,5,3,2,0.7102477501565808
7999,703-004-5392,7994.1465,5,2,3,1.31675688434949
8005,703-004-5381,2582.109,6,3,3,1.2122319059236126
8085,703-004-5386,3484.39,3,2,1,0.6930968222021326
8091,207-008-2399,2027.3137,4,2,2,0.7765139256852708
8107,703-004-5381,3960.3657,4,3,1,1.326148303494846
8403,703-004-5397,6857.1533,3,1,2,0.4112983811785064
9017,703-004-5393,2219.3508,9,6,3,1.6030537497461774
9217,703-004-5386,8780.168,2,0,2,0.27920371738274696
9233,703-004-5381,7207.45,3,3,0,1.0050003942966592
9306,703-004-5396,6845.374,2,0,2,0.27920371738274696
9936,703-004-5390,9259.337,3,3,0,0.6405249319856975
9990,703-004-5391,5680.5996,5,3,2,2.3054786780962497
10046,703-004-5397,5591.412,4,3,1,0.9700428569610824
10066,703-004-5399,6243.16,7,4,3,1.318641503835778
10193,703-004-5380,6038.548,4,0,4,0.27920371738274696
10373,703-004-5385,2445.9993,7,2,5,0.9790325200776167
10501,703-004-5394,7256.6094,4,2,2,0.6201301514842337
10541,703-004-5399,7570.9336,1,0,1,0.27920371738274696
10928,703-004-5384,4183.2896,2,2,0,0.7382581157559213
11196,207-008-2398,6932.725,2,2,0,0.3859991392816477
11217,703-004-5389,9007.211,2,0,2,0.27920371738274696
11413,703-004-5391,7123.6367,4,3,1,0.7932482410766831
11688,703-004-5389,3971.0693,3,2,1,0.8689106597878836
1177,703-004-5394,7552.0884,7,6,1,1.7326142070173154
11924,703-004-5398,4122.641,1,0,1,0.27920371738274696
12082,703-004-5388,5145.9155,3,1,2,0.5056117996865533
122,703-004-5397,1455.3994,1,1,0,0.45113322211686263
12511,703-004-5397,4643.925,3,0,3,0.27920371738274696
12951,703-004-5381,408.66495,6,3,3,1.4293439785822772
13039,703-004-5381,8789.328,4,2,2,0.5846358438237291
13183,703-004-5399,2612.471,2,1,1,0.6754075278374937
14617,703-004-5399,4143.3267,5,3,2,2.606458919670266
14682,703-004-5384,3407.6553,5,1,4,0.46454844017209035
1471,207-008-2399,3989.0342,6,2,4,0.7475812363381962
14714,703-004-5396,22.00544,2,2,0,0.490421329582795
14742,703-004-5394,4478.412,11,5,6,2.782549866030827
15018,703-004-5385,7240.8525,4,2,2,1.1889632495048648
15163,703-004-5390,5233.388,2,1,1,0.8258964063881524
15251,703-004-5386,8343.471,4,1,3,1.4645913900383996
15570,703-004-5380,1287.244,5,3,2,0.9921247278913187
1564,703-004-5383,4225.3853,5,3,2,1.1255164199232728
15653,703-004-5389,7801.4546,6,3,3,1.4013132926129275
15813,703-004-5382,9264.145,3,1,2,0.37175974969512765
16190,703-004-5386,7094.161,5,4,1,0.9382028894504199
16218,703-004-5392,43.77484,6,5,1,2.3954934572881283
16403,703-004-5399,4465.951,6,1,5,0.9059091034416991
16455,703-004-5382,8256.066,7,2,5,0.5710008288016366
16499,703-004-5385,2040.0566,11,5,6,1.1217212239832655
16727,703-004-5384,939.92413,3,3,0,0.7901901957588808
16840,703-004-5380,3812.502,2,1,1,0.7914958744914193
17299,703-004-5395,2851.3657,1,0,1,0.27920371738274696
17650,703-004-5387,5171.2974,8,1,7,0.653539691711756
1766,207-008-2399,7860.6284,10,7,3,3.3775837725846567
18159,703-004-5397,3206.5981,6,4,2,1.71507146176652
18371,703-004-5393,8398.651,4,4,0,1.2338517642035034
18396,703-004-5392,5573.6187,6,5,1,1.3339186530533498
18640,703-004-5398,493.35123,8,3,5,1.8334700394398644
19075,703-004-5395,4489.5034,1,0,1,0.27920371738274696
19145,703-004-5388,606.3455,4,2,2,0.9992822379886875
19157,703-004-5387,8087.6147,4,2,2,0.7165575333770132
19190,703-004-5391,717.98566,3,0,3,0.27920371738274696
19339,207-008-2399,3041.9446,4,3,1,0.8420979948396977
1950,207-008-2399,5647.8584,3,0,3,0.27920371738274696
19635,703-004-5382,7171.61,1,0,1,0.27920371738274696
19903,703-004-5385,510.10608,5,3,2,0.5753119402871306
19962,207-008-2398,5149.043,2,0,2,0.27920371738274696
19970,207-008-2398,690.5222,2,0,2,0.27920371738274696
20036,703-004-5384,7464.699,9,2,7,1.3853117011195466
20083,703-004-5389,7560.225,4,3,1,1.5214652635120909
20127,703-004-5382,6924.771,3,2,1,0.795988184299623
20291,703-004-5395,7907.285,4,2,2,2.2686363818328465
20445,703-004-5380,1664.4413,3,2,1,0.5990138287392383
20456,703-004-5398,6983.988,4,2,2,0.5466062612392564
20743,703-004-5381,9195.341,5,3,2,1.2142247419888614
20750,703-004-5396,9804.719,1,1,0,0.6419802182848543
21547,703-004-5399,104.04408,4,2,2,0.5838856489906303
2176,703-004-5393,147.09235,5,2,3,1.2397925846765725
21790,207-008-2398,1003.01984,1,1,0,0.5062256034026554
22021,207-008-2399,8053.5293,3,2,1,0.6939117827994279
22413,703-004-5380,6766.9917,3,1,2,0.6035400845189497
22446,703-004-5383,8965.918,1,1,0,0.4682711335587564
2254,703-004-5388,2740.3467,3,2,1,1.0107913394072905
22679,703-004-5390,3737.1123,5,3,2,2.2449310403025606
22759,703-004-5397,354.2918,4,2,2,0.8910902635006954
22825,703-004-5399,5486.1484,4,0,4,0.27920371738274696
23176,703-004-5392,4975.8228,5,0,5,0.27920371738274696
23423,703-004-5395,4039.4634,2,0,2,0.27920371738274696
23511,703-004-5381,4575.9507,4,2,2,0.4824116729403775
23556,703-004-5388,4086.9678,4,2,2,0.6163135272368564
23601,703-004-5380,9829.506,10,3,7,3.7798022381956553
23622,207-008-2399,5812.6045,2,1,1,0.42450701939186036
23810,703-004-5382,9899.567,2,2,0,0.7807788808237904
24041,703-004-5386,1378.0289,3,1,2,0.6073029857721475
24118,703-004-5389,8829.856,2,0,2,0.27920371738274696
24137,703-004-5382,748.13666,4,2,2,1.0130715087799533
24334,703-004-5383,7499.28,3,3,0,1.1069975119128481
24396,703-004-5396,8896.021,7,1,6,0.48551005863744434
24410,703-004-5394,3345.205,7,4,3,1.2985672800588335
24476,703-004-5390,2149.1326,5,1,4,0.4314860782385869
25165,703-004-5392,2571.348,2,0,2,0.27920371738274696
25245,703-004-5394,971.6898,4,3,1,0.7811393209471766
25368,703-004-5398,8381.103,5,3,2,3.9031295171116094
25409,703-004-5399,9592.05,10,3,7,2.1403460276189605
25520,703-004-5381,1099.0471,3,2,1,0.6716768928612071
25554,703-004-5387,2571.1162,4,2,2,0.5469446002772789
25669,703-004-5383,9117.768,9,6,3,2.0543846132800585
25804,703-004-5396,2564.7866,8,3,5,1.8059110858117307
25893,703-004-5382,7147.7954,4,3,1,1.1356223360851008
26258,703-004-5393,8777.446,10,3,7,0.7007020498556364
26302,703-004-5383,2549.5696,1,1,0,0.35831143730785864
2643,703-004-5382,1167.4559,7,1,6,0.48209941715217597
26462,703-004-5396,7960.5503,3,2,1,0.831870025709558
26512,703-004-5388,3137.0557,3,3,0,0.900414416454662
26783,703-004-5398,2845.7725,5,3,2,1.5811878133880224
26808,703-004-5394,6952.567,3,3,0,2.014721535599585
27437,703-004-5381,4072.1858,5,3,2,0.5919948803982608
27628,703-004-5398,1268.27,4,2,2,0.8711910279837011
27807,703-004-5390,510.43213,7,3,4,0.6016347958117606
28198,703-004-5390,4328.259,5,3,2,1.133897769536036
28545,703-004-5389,1093.7225,1,0,1,0.27920371738274696
28573,703-004-5390,8641.772,2,1,1,0.40066465990635813
28720,703-004-5391,820.387,8,2,6,0.5054141458172862
293,703-004-5391,5911.62,6,3,3,0.6951125548890214
294,703-004-5397,6126.119,2,1,1,1.056109067323326
29497,703-004-5399,8549.907,3,2,1,2.4063833618810513
29810,207-008-2399,386.3573,2,1,1,0.4809677152470155
30131,703-004-5389,1930.4686,4,1,3,0.8384656516504919
30192,703-004-5383,4830.5347,6,1,5,0.35831143730785864
30195,207-008-2399,1676.898,3,2,1,2.992879641660815
30211,703-004-5396,2770.912,3,2,1,0.5833804631104222
30342,703-004-5382,3265.5872,4,2,2,0.5956345970831934
30362,703-004-5394,6634.616,1,1,0,0.32666834933781397
3050,703-004-5397,5490.996,"","","",0.27920371738274696
30805,703-004-5396,732.03204,3,1,2,0.6300487198794394
30845,703-004-5396,4630.103,6,3,3,1.158197623556433
30939,703-004-5397,4482.872,4,1,3,0.5934512240132604
3142,703-004-5399,3250.7961,2,0,2,0.27920371738274696
31501,703-004-5384,2454.5586,4,3,1,1.3773167470170469
31504,703-004-5395,9039.983,3,3,0,1.4865008588080937
31930,703-004-5394,608.30054,4,2,2,0.8568066661122843
31978,703-004-5397,7890.672,2,0,2,0.27920371738274696
31995,703-004-5384,785.3979,6,4,2,1.276958931654532
32074,703-004-5380,7116.627,3,0,3,0.27920371738274696
32193,703-004-5385,325.64224,3,3,0,1.3039048705664409
32401,703-004-5386,3536.443,4,1,3,0.5685396104408268
32486,703-004-5384,284.37912,2,2,0,0.6119793616844443
32593,703-004-5389,9088.585,6,4,2,2.1617846156052183
32706,703-004-5388,2854.4373,2,0,2,0.27920371738274696
32733,703-004-5395,3519.1619,3,1,2,0.4174279771768951
33148,207-008-2398,1090.1421,5,3,2,0.8406649382151196
33200,703-004-5389,7976.6406,9,2,7,0.47511927559103173
33380,703-004-5384,214.33414,7,2,5,0.7646284637732133
33444,703-004-5394,7877.681,5,2,3,0.5125138648871903
33545,703-004-5388,8169.107,"","","",0.27920371738274696
33570,703-004-5386,3860.116,6,3,3,1.2016147457365767
33758,703-004-5380,3229.794,6,3,3,1.7641125602503425
3382,703-004-5386,1289.1179,7,5,2,1.2029895680926876
33835,703-004-5386,8622.211,7,1,6,0.3969293802925761
33995,703-004-5392,3190.891,3,2,1,0.49658940873738483
34042,703-004-5388,582.5871,6,2,4,1.2057152091667152
34093,703-004-5382,2035.6763,4,4,0,1.8233568380742287
34283,703-004-5397,4998.7637,4,1,3,0.6221774846342005
34369,703-004-5386,7134.365,1,0,1,0.27920371738274696
34373,703-004-5398,661.8929,3,1,2,0.7447901358046511
34387,207-008-2398,2375.098,6,4,2,1.0662995351081963
34457,703-004-5380,4955.041,2,1,1,0.37512182779194486
34910,703-004-5389,3446.027,6,2,4,1.4014162698725765
35146,703-004-5383,9497.9375,4,1,3,0.5606093079858964
35199,703-004-5394,9453.518,4,2,2,0.8170771918262866
35211,703-004-5392,3438.6587,4,2,2,0.7467844521355166
35306,703-004-5392,8970.78,5,3,2,1.167460612974466
35797,703-004-5385,7701.5933,3,3,0,2.9343755011143005
35829,703-004-5386,3828.06,2,1,1,0.4289236006398631
35937,703-004-5384,2705.8733,1,1,0,0.4211300261936823
36230,703-004-5381,4345.116,6,3,3,1.0204686553794096
36390,703-004-5396,1052.6991,2,1,1,0.43269741519994015
36517,703-004-5390,7639.695,5,4,1,2.015441625213801
3701,703-004-5391,1651.2507,4,1,3,0.45270177987600274
37612,703-004-5387,7796.988,1,1,0,0.35831143730785864
37763,703-004-5383,9270.969,7,4,3,1.4471798340988713
380,703-004-5391,3221.7854,5,2,3,0.6027709021886126
38066,703-004-5390,4745.507,7,5,2,1.4149609641122747
38354,207-008-2399,7245.985,9,5,4,3.5237525001174324
38356,703-004-5392,4754.8813,3,1,2,0.44570932939134233
39109,703-004-5390,5344.8496,4,2,2,0.7674090677401793
39164,703-004-5381,4273.8086,3,1,2,0.4640138810076899
39172,703-004-5387,5590.101,2,0,2,0.27920371738274696
39189,703-004-5384,3946.2239,6,1,5,0.5175755235122633
39222,703-004-5384,2235.6182,4,1,3,0.33853450732658075
3928,703-004-5397,7242.877,1,0,1,0.27920371738274696
39395,703-004-5396,5234.9863,4,2,2,0.7483579608564591
39423,703-004-5384,3268.3826,6,2,4,0.5543188673984096
39473,703-004-5393,9046.619,6,0,6,0.27920371738274696
39556,703-004-5393,2461.0251,6,2,4,1.0703947406915357
39922,703-004-5391,5367.2896,4,4,0,1.1164669785344867
40013,703-004-5387,3889.7568,4,2,2,1.2602430441695847
4023,703-004-5383,3578.5776,3,0,3,0.27920371738274696
4046,703-004-5396,8417.506,4,1,3,0.3348481699819454
40525,703-004-5382,1393.4523,1,0,1,0.27920371738274696
40589,703-004-5392,2835.7864,3,1,2,0.8285861292489317
40742,703-004-5383,6658.6714,6,4,2,1.9314837147659696
40821,703-004-5397,7932.5386,3,2,1,2.224077435137187
40824,703-004-5390,9496.735,3,2,1,0.9228088837727121
40906,703-004-5395,2520.9893,1,0,1,0.27920371738274696
41069,703-004-5399,6263.0366,3,1,2,0.4336439748764743
41090,703-004-5399,473.6489,3,3,0,0.8195910243074324
41242,207-008-2399,8902.281,4,2,2,0.8921447496096164
41337,703-004-5399,568.4841,5,4,1,1.3375750247989084
41588,703-004-5399,9832.86,2,1,1,0.5279644423960663
41592,703-004-5391,8870.355,7,5,2,1.3429890683665842
41689,703-004-5386,960.353,3,3,0,3.441887610547451
4172,703-004-5396,4558.23,2,2,0,1.2399355132235772
41851,703-004-5385,138.45087,3,1,2,1.1476126963201414
42098,703-004-5388,5549.451,"","","",0.27920371738274696
42274,703-004-5388,431.86487,3,2,1,1.130494330874578
42438,703-004-5380,1753.7421,6,1,5,0.3919322182760311
42851,703-004-5391,6487.091,5,4,1,4.328282958960577
42881,703-004-5386,9610.634,5,3,2,1.807224689788609
42963,703-004-5388,7562.081,4,2,2,0.9253574871511101
43013,703-004-5398,1354.1597,3,2,1,1.0843194439009758
43267,703-004-5399,6223.052,4,2,2,0.6959954383994396
43611,703-004-5390,8108.8223,6,2,4,0.7752997987540743
43668,703-004-5396,643.1103,6,0,6,0.27920371738274696
4381,703-004-5386,8347.8125,5,1,4,0.6321687255068369
44304,703-004-5384,4834.4536,2,0,2,0.27920371738274696
44378,207-008-2399,9458.069,6,3,3,0.9351637916715161
44724,703-004-5395,3221.0415,3,0,3,0.27920371738274696
44785,703-004-5389,783.9078,3,1,2,0.6835506866713238
44806,207-008-2399,2371.9502,6,3,3,1.1640601739275422
45376,703-004-5381,8706.611,9,4,5,1.120277653790747
45724,703-004-5387,4196.347,6,4,2,3.325762836963312
45762,703-004-5387,3893.2466,5,2,3,1.124047650637353
45788,703-004-5392,5317.254,5,2,3,2.745602589661836
46308,703-004-5382,4635.7383,2,0,2,0.27920371738274696
4636,703-004-5398,4488.677,1,0,1,0.27920371738274696
46387,207-008-2398,9075.6,5,4,1,2.95520039240769
46408,703-004-5380,1688.1675,1,0,1,0.27920371738274696
46560,703-004-5384,2662.2534,5,3,2,0.6619640658439733
46598,703-004-5393,1607.0771,5,2,3,0.9564445629025975
46780,703-004-5393,9484.43,2,1,1,2.2314338732625463
47595,207-008-2398,175.38905,4,3,1,1.2423595967736478
47625,703-004-5395,1329.9805,2,1,1,0.35114230018964543
47684,703-004-5385,1713.3195,2,1,1,0.5474507343073526
47778,703-004-5397,8642.53,4,3,1,1.272023371226931
47842,703-004-5390,4505.569,9,1,8,0.4087426087601173
47948,703-004-5381,3995.1504,2,2,0,0.5419409738188983
48179,703-004-5398,3462.6936,6,4,2,2.048156158784132
48182,703-004-5387,2588.2185,4,2,2,1.6840654572591305
48321,703-004-5388,2988.823,5,3,2,1.74292664055072
48538,703-004-5390,3457.57,2,1,1,0.37982502895311754
48810,703-004-5390,8518.014,8,6,2,3.856310371744425
48990,703-004-5382,2301.6494,2,1,1,1.6023286357293833
48996,703-004-5387,8695.843,1,1,0,1.3871620589528482
49436,207-008-2398,946.0592,5,4,1,1.5801760315252737
49479,703-004-5388,7084.5083,3,2,1,0.9300634585377511
49524,703-004-5382,381.43396,2,2,0,0.584837766711331
49594,207-008-2398,3446.93,2,1,1,1.1297636054214828
49599,703-004-5396,6770.891,6,2,4,0.4833698683222327
49875,703-004-5387,3847.0537,7,3,4,1.519079025674228
49940,207-008-2398,6270.2275,4,3,1,0.9218925763859318
49941,703-004-5385,8852.541,4,2,2,0.9771462562082207
49971,703-004-5399,7266.308,8,3,5,1.2086374181796178
5218,703-004-5386,3870.0403,8,4,4,1.8656627405570767
5397,703-004-5383,6911.9873,3,0,3,0.27920371738274696
615,207-008-2399,2885.031,3,3,0,0.7130875832097827
6162,703-004-5386,1598.5089,2,1,1,0.3558633747512886
6222,703-004-5390,2010.7747,3,1,2,0.47332252553648185
6253,703-004-5390,3657.0984,3,1,2,0.7125054589400752
660,703-004-5389,5789.1787,3,2,1,0.4983321015753062
6724,703-004-5395,8449.835,3,2,1,0.8979060612779622
6792,703-004-5392,216.38214,2,2,0,1.0569877719661689
6955,703-004-5386,249.2255,2,1,1,0.45846073948267596
7112,207-008-2399,2517.6436,4,2,2,0.7952814028083796
7230,703-004-5396,6453.2876,6,2,4,0.5628268333459702
7484,703-004-5389,4126.1597,5,1,4,0.42764253789171397
7596,207-008-2398,512.8568,7,3,4,1.4811107830646186
7732,703-004-5387,3518.0867,2,1,1,0.5165268771580819
7749,703-004-5391,6071.6973,7,2,5,0.4779217800954315
7892,703-004-5384,8118.873,2,1,1,1.2750154261245905
7964,703-004-5397,708.78265,"","","",0.27920371738274696
8051,703-004-5397,8573.712,2,0,2,0.27920371738274696
8155,703-004-5396,9702.152,6,3,3,0.7081964072691215
8317,703-004-5398,3698.0159,2,1,1,0.660185255667692
8497,703-004-5385,1843.3792,7,1,6,0.3565006121564479
8525,703-004-5394,6436.104,5,4,1,1.2819594491433364
8610,703-004-5386,1915.0233,3,1,2,0.697582754826493
8637,703-004-5384,1993.2037,4,1,3,1.0369504488732644
869,703-004-5391,5521.8955,3,0,3,0.27920371738274696
8746,703-004-5399,9651.528,3,3,0,0.6415843681619158
8802,703-004-5389,1211.6938,1,1,0,0.9017402194682398
9041,703-004-5397,5272.697,2,2,0,0.591198559318649
9195,703-004-5390,7056.967,3,1,2,0.8326081574171724
9262,703-004-5395,8793.507,3,2,1,2.008738109708344
9362,703-004-5399,3216.7214,4,1,3,0.5837684390944268
9532,703-004-5395,4676.0654,4,1,3,0.3551100467671392
9738,703-004-5393,3500.306,2,1,1,1.6442429869112742
9802,703-004-5383,7560.5864,3,1,2,1.520730560505111
9910,703-004-5385,8142.963,4,3,1,1.4976602908121572
10112,703-004-5399,5309.934,6,4,2,2.2520127717585345
10612,703-004-5380,8134.1714,"","","",0.27920371738274696
1077,207-008-2398,6787.761,2,1,1,0.4932184991270373
108,703-004-5394,8508.105,4,2,2,0.8163564007505157
10883,703-004-5386,8349.574,5,4,1,1.0950353621467868
10939,703-004-5381,3169.16,10,8,2,2.4036153782598553
10945,703-004-5389,1187.7925,3,2,1,0.5089694666803197
11022,703-004-5393,7062.8647,7,4,3,2.155422252958985
11070,703-004-5398,8138.2544,3,1,2,0.46202525819474555
11268,207-008-2399,4723.456,2,0,2,0.27920371738274696
11432,703-004-5387,2809.5876,5,2,3,0.7052976738293796
11614,207-008-2399,4938.959,4,2,2,0.8836059711340988
117,703-004-5391,6702.9736,3,1,2,0.9189140465638937
11731,703-004-5387,6018.7974,2,1,1,0.33853450732658075
12346,703-004-5391,1968.9935,2,1,1,0.8690881933295155
12562,703-004-5384,5263.718,4,2,2,0.9889191954623907
12796,207-008-2399,6065.882,4,3,1,0.6688717843861848
13146,703-004-5389,8743.209,4,2,2,0.6359400375364235
13202,703-004-5395,9870.422,5,2,3,0.5721757928312609
13478,703-004-5391,2686.1035,6,4,2,2.26330239750981
13827,703-004-5390,3835.4587,4,2,2,0.5712417852613557
13885,703-004-5399,2710.641,3,1,2,0.5002230644950786
13891,703-004-5380,3454.5083,2,1,1,0.40066465990635813
1399,703-004-5383,632.65204,7,5,2,2.753213479725383
14205,703-004-5383,9327.999,3,1,2,0.44513930860439904
14251,703-004-5396,7322.8354,4,2,2,0.7367138043707533
14359,703-004-5391,6185.6963,6,3,3,0.9415332777814904
14741,703-004-5395,2498.9497,4,2,2,0.5706114051120362
14806,703-004-5393,6103.0967,5,3,2,1.37950570924479
15019,703-004-5390,2852.8398,5,3,2,1.409011994310454
15620,703-004-5394,1546.2214,8,5,3,0.9792880729386726
15805,703-004-5381,2418.6409,8,3,5,1.1771675676625422
16239,703-004-5388,1503.1445,3,0,3,0.27920371738274696
16311,703-004-5385,5891.2505,8,3,5,1.374336654315342
16441,703-004-5398,7913.0728,1,0,1,0.27920371738274696
16614,703-004-5396,732.3742,4,2,2,0.4820868953407451
16716,703-004-5383,7309.8945,5,3,2,1.3842499338634557
1674,703-004-5399,4740.0845,1,1,0,0.5942926204235428
16920,703-004-5391,6152.839,1,1,0,0.8303500798036436
16972,703-004-5398,2332.8662,3,3,0,1.2896428492552656
1741,703-004-5397,2936.75,6,3,3,1.7132572276174343
17454,703-004-5389,3600.831,4,3,1,1.9404578772284438
18053,207-008-2399,5368.428,3,3,0,1.471749615849531
18156,703-004-5384,4383.1426,5,2,3,2.206815702987829
18160,703-004-5395,3863.9902,1,0,1,0.27920371738274696
18282,703-004-5399,6962.9575,3,1,2,0.49339771716171715
18479,703-004-5397,3279.4504,4,2,2,0.43599592854352004
18649,703-004-5381,4493.762,4,2,2,0.7676353897438037
18793,703-004-5398,9308.627,2,2,0,2.649553589857484
18856,703-004-5395,2176.5667,4,1,3,0.5694520637180952
18930,703-004-5388,5213.5493,6,5,1,1.9990272535515037
18948,703-004-5388,1042.1622,1,0,1,0.27920371738274696
19260,703-004-5399,6005.4263,3,1,2,0.5093812251442214
19486,207-008-2398,6612.104,8,3,5,1.7474030599073078
19491,703-004-5388,9426.583,2,1,1,0.33853450732658075
19494,703-004-5389,1204.7964,6,4,2,2.4066353485336136
19766,703-004-5397,9212.383,4,0,4,0.27920371738274696
19861,703-004-5389,7721.7354,8,3,5,0.6924757089185153
19904,703-004-5381,2005.7856,3,3,0,3.2462120819603864
19937,703-004-5388,3822.8481,5,1,4,1.5079193720142772
1997,703-004-5386,1620.2861,6,3,3,0.6632289403718478
20062,703-004-5396,7505.993,6,2,4,0.8262760873064204
20063,703-004-5385,296.83353,5,4,1,3.797018292423713
21039,703-004-5395,3634.1274,11,4,7,2.943973397999852
21085,703-004-5391,3668.732,2,0,2,0.27920371738274696
21518,703-004-5396,5632.8813,2,1,1,0.6072071912675507
21567,703-004-5385,3177.9468,1,0,1,0.27920371738274696
21867,703-004-5399,7790.9277,6,3,3,2.0552604761191198
21902,703-004-5381,4225.4062,5,2,3,0.9697351653522295
22163,703-004-5398,4173.202,4,3,1,1.5363332260068712
22283,703-004-5388,9512.5,4,0,4,0.27920371738274696
2236,703-004-5390,5265.092,4,4,0,2.4968721546318244
22382,703-004-5387,2172.7358,2,1,1,0.35831143730785864
22409,703-004-5391,7463.9136,2,1,1,0.49307849079654475
22746,703-004-5396,3657.67,2,2,0,1.60462403705859
2326,703-004-5388,225.85928,4,3,1,1.0072208660911075
23422,703-004-5387,4203.6772,2,1,1,0.3978652972704144
23927,703-004-5395,3757.7527,6,2,4,0.9894257592818626
24057,703-004-5397,5255.9644,4,3,1,1.8128651835725784
24096,703-004-5390,5401.0767,1,0,1,0.27920371738274696
24109,703-004-5385,8588.121,5,3,2,1.4343449392049579
24301,703-004-5399,567.8731,3,1,2,0.3367545836282657
24365,703-004-5383,488.72055,2,0,2,0.27920371738274696
24695,207-008-2399,593.9674,10,6,4,3.275736731520077
247,703-004-5395,6589.1426,2,1,1,0.32666834933781397
25115,703-004-5388,5647.7407,4,1,3,0.35831143730785864
25405,207-008-2398,206.4234,1,1,0,0.32666834933781397
25438,703-004-5383,1255.542,5,4,1,2.612732907525489
25717,703-004-5385,5769.585,3,0,3,0.27920371738274696
25719,703-004-5392,2894.7498,2,0,2,0.27920371738274696
26059,703-004-5384,5302.3125,5,2,3,0.6837848980853362
26169,703-004-5385,6832.4375,7,4,3,1.1527270030903207
26183,703-004-5382,5425.304,5,3,2,1.1177710404278876
26344,703-004-5384,7017.5713,5,4,1,3.141199214578343
26376,703-004-5383,6934.5244,5,5,0,1.0958538962634565
2650,703-004-5390,551.00977,1,1,0,0.8228304459471281
26734,703-004-5394,1599.5753,7,3,4,1.2585584751495984
26928,703-004-5386,5144.697,2,1,1,0.5920587763821088
27299,703-004-5388,2069.1584,2,1,1,0.3413949051196612
27550,703-004-5396,3867.6929,1,1,0,0.4568697678695571
27719,703-004-5390,7090.2173,2,0,2,0.27920371738274696
28170,703-004-5397,9238.035,8,5,3,1.445221969016592
28679,703-004-5392,298.13348,2,1,1,0.4987276401749318
28719,703-004-5389,634.1594,6,3,3,1.5389692217092972
28762,703-004-5394,827.77026,5,2,3,0.7468986697163288
2884,703-004-5398,4171.934,3,1,2,0.3547681711404605
29116,703-004-5394,8869.773,5,2,3,1.6334635184846653
29206,703-004-5392,6915.011,5,0,5,0.27920371738274696
29588,703-004-5389,7333.6206,8,3,5,0.8438698223026518
29620,703-004-5388,4473.4805,7,3,4,1.3079440393428843
29812,207-008-2398,404.2369,5,2,3,0.7670183116995606
3034,703-004-5390,427.25385,6,3,3,0.8641880889195269
30440,703-004-5388,3212.6426,7,6,1,2.8370623362838603
30734,703-004-5394,88.124275,5,3,2,1.5783579066973772
31313,703-004-5381,4074.2505,7,4,3,1.383597009936476
31383,703-004-5393,5631.485,4,4,0,2.344122776569802
3156,703-004-5387,2696.5857,3,3,0,2.5469841897906997
3158,703-004-5384,2087.0703,2,2,0,1.051120540329709
31663,703-004-5387,6853.2764,5,1,4,0.3672681650251874
3184,703-004-5384,732.69366,2,1,1,2.2024327360457923
3190,703-004-5397,6715.709,4,1,3,1.221180237675534
32100,703-004-5393,5584.002,4,1,3,0.47944612228968486
3258,703-004-5391,5984.0405,2,1,1,0.9771962056054233
32609,703-004-5391,4797.475,2,2,0,0.9776894815773067
32669,703-004-5382,138.52536,4,2,2,1.2001476823148645
33314,703-004-5392,4651.595,5,0,5,0.27920371738274696
33321,703-004-5399,8229.725,2,0,2,0.27920371738274696
3344,703-004-5393,2392.9053,4,1,3,0.752520050722512
33797,703-004-5388,420.19666,4,3,1,2.258470884630368
33868,703-004-5382,8837.368,2,1,1,0.40569644009299677
34076,703-004-5386,9375.776,6,3,3,1.77967392257917
34168,703-004-5390,1024.397,4,1,3,0.7712131121595578
3500,703-004-5385,1440.4119,2,2,0,2.0334936269528994
35696,703-004-5397,8578.891,2,0,2,0.27920371738274696
35970,703-004-5382,7245.9673,6,3,3,1.0432172831287718
3617,703-004-5385,6676.9785,1,1,0,0.33853450732658075
36321,703-004-5394,6218.0938,6,4,2,1.5229621554314428
36416,703-004-5380,5145.19,4,0,4,0.27920371738274696
36507,207-008-2399,3158.88,4,1,3,0.3978652972704144
36615,703-004-5395,8869.211,2,0,2,0.27920371738274696
36797,703-004-5395,9042.238,4,2,2,0.8625627560241624
3704,207-008-2398,6441.7227,4,2,2,0.6241159890897977
37094,703-004-5397,1312.0181,2,2,0,0.7135392527164686
37132,703-004-5383,2489.1646,3,2,1,0.8768555423833599
37289,703-004-5395,71.540474,7,2,5,0.8957701965200465
38559,703-004-5381,4859.15,4,1,3,0.33853450732658075
38739,703-004-5397,6704.424,4,1,3,0.4500510532294496
39325,207-008-2398,1547.4498,4,2,2,0.661105070070734
39399,703-004-5380,9250.031,2,0,2,0.27920371738274696
39417,703-004-5381,6098.4526,4,3,1,1.4071286683065463
39952,703-004-5389,5413.6533,2,2,0,0.7876333190464463
40004,703-004-5396,455.1476,4,3,1,1.1414193699827322
40008,703-004-5380,8792.92,7,2,5,1.0832330283064076
4008,703-004-5394,801.5591,6,4,2,2.1314346491144542
40554,703-004-5394,9432.819,8,4,4,1.716118167455291
41103,703-004-5387,256.54196,3,2,1,0.8181568602690311
41212,703-004-5398,2050.3806,2,2,0,1.3302820537434656
414,703-004-5397,2106.8137,4,3,1,1.9916424830737118
41580,703-004-5393,2198.5037,5,3,2,0.9801320727879987
41621,703-004-5397,9224.477,3,3,0,1.1379580772934348
41637,703-004-5382,3821.45,9,5,4,1.023470392310998
41681,703-004-5385,9342.381,4,2,2,2.304835246646657
41746,703-004-5384,109.24757,5,1,4,0.6334882853619587
42444,703-004-5385,8317.22,6,6,0,2.1259390290230287
42605,703-004-5390,5555.835,6,3,3,1.6802378162951785
42616,703-004-5387,806.20886,2,1,1,0.8199245498067929
42633,703-004-5391,537.1439,3,2,1,1.1646256410172617
42637,703-004-5392,5579.9897,2,0,2,0.27920371738274696
42735,703-004-5392,9744.413,3,2,1,0.7347915887280363
42767,703-004-5389,2278.4036,6,4,2,1.3882850188173057
43065,703-004-5392,9753.501,5,3,2,1.6143251729756474
43179,703-004-5385,2820.2163,2,2,0,0.5020524382143948
4322,703-004-5395,8701.4375,3,1,2,0.45752076256963753
43396,703-004-5392,3663.732,5,2,3,0.5130690565112084
43481,207-008-2399,9194.26,6,3,3,1.5261631815681727
43563,703-004-5384,1920.6523,5,2,3,0.8675261502087497
43586,703-004-5396,1196.6646,9,4,5,2.4092137997627168
43637,703-004-5391,578.9596,6,3,3,0.7888273002128982
43755,703-004-5391,383.84854,1,1,0,2.4556205055164826
44002,703-004-5387,2398.1697,3,1,2,2.9415732150982192
44003,703-004-5387,78.18639,2,0,2,0.27920371738274696
44074,703-004-5382,2205.6787,5,3,2,4.526066734894209
44093,703-004-5399,2281.7935,4,2,2,0.7494813347904296
44521,703-004-5384,1072.8973,4,2,2,0.49604931215427384
45053,703-004-5396,6732.7925,3,1,2,0.6546139505819626
45296,703-004-5385,1718.8025,6,2,4,0.9728345048220886
45553,703-004-5392,8334.333,3,2,1,0.7247575929132218
45853,207-008-2398,1314.2914,1,1,0,0.487784462443965
4630,703-004-5390,2447.2554,6,1,5,0.3978652972704144
46314,703-004-5395,9511.555,5,1,4,0.7918675205217491
46350,703-004-5384,3202.8604,4,3,1,0.7589377127126049
46654,703-004-5390,6862.648,4,2,2,0.8894420060184097
4678,703-004-5396,1658.6018,6,4,2,1.1244948708403926
47239,703-004-5386,8032.402,2,1,1,0.33853450732658075
47282,207-008-2398,5586.1934,8,4,4,1.3880648419313442
47333,703-004-5399,9656.774,1,1,0,0.4230808829965438
47861,703-004-5389,1364.1709,3,0,3,0.27920371738274696
48047,703-004-5385,3845.4915,5,2,3,0.5149301728585892
48117,703-004-5393,5716.2446,4,2,2,0.6420558049506817
482,703-004-5389,8624.841,8,6,2,2.3565711244101637
48830,703-004-5380,7609.719,2,1,1,0.35831143730785864
49089,703-004-5385,5194.1475,5,4,1,0.7981474721031788
49090,703-004-5392,1822.3292,"","","",0.27920371738274696
49239,703-004-5391,4763.002,8,1,7,0.5260062952851314
49459,703-004-5399,5221.5547,6,3,3,1.7678774632388585
49511,207-008-2399,5668.985,4,0,4,0.27920371738274696
49615,703-004-5397,3545.7844,4,0,4,0.27920371738274696
49726,703-004-5380,5422.865,1,1,0,0.43116399826424606
49917,703-004-5380,8811.239,2,1,1,0.573335540963862
49961,703-004-5393,3078.608,5,3,2,1.8635162264793086
5249,207-008-2399,5926.943,5,2,3,0.7768524599585951
5370,703-004-5387,62.726738,9,5,4,1.4841907903704703
576,207-008-2399,9127.17,6,6,0,3.6504208380044756
5815,703-004-5398,5731.287,3,1,2,0.37944329300254137
612,703-004-5392,7170.827,5,4,1,2.8740563250803826
6390,703-004-5396,642.9672,3,2,1,1.0920835749766806
6560,703-004-5389,7814.3213,7,3,4,0.5717243782706586
6628,703-004-5393,4555.5894,2,0,2,0.27920371738274696
6641,207-008-2398,9776.523,7,4,3,1.7191696856004277
671,703-004-5396,2685.0544,1,1,0,0.5679791056370113
6802,703-004-5380,83.35173,6,2,4,0.9567363483793314
7432,207-008-2398,4218.605,4,3,1,0.9026353413791296
7979,703-004-5384,9931.611,4,3,1,1.3543619589397737
8366,703-004-5393,5421.278,3,1,2,0.8835947849071929
8456,703-004-5396,2948.5369,5,4,1,0.9542716836836682
8648,703-004-5384,2523.123,4,2,2,0.9872825334949554
8838,703-004-5395,5258.57,4,3,1,2.7577249850478687
8976,703-004-5391,8582.387,1,0,1,0.27920371738274696
9315,703-004-5396,2151.0732,3,1,2,0.5165268771580819
9445,207-008-2398,7345.0264,7,2,5,0.5391539803155767
9507,703-004-5397,8635.718,3,1,2,0.4278984633771401
968,703-004-5382,8294.963,3,1,2,0.6845758278387553
9769,703-004-5398,7143.11,4,1,3,0.7885031347243433
10008,703-004-5383,3690.5068,4,1,3,0.37696726257082286
10087,207-008-2399,5776.199,4,4,0,1.3719324275987226
10248,703-004-5380,9128.579,4,0,4,0.27920371738274696
10393,703-004-5383,6284.515,4,2,2,0.6139834883096636
10684,703-004-5382,9871.429,4,3,1,0.8721434092499839
10911,703-004-5395,3089.3784,4,1,3,0.7546113104031571
11940,703-004-5389,3901.1794,5,2,3,0.8342879717711751
12147,703-004-5398,1100.4972,2,1,1,1.3151161366197297
12169,703-004-5395,4542.631,1,1,0,0.43042908269607644
12254,703-004-5397,9708.512,"","","",0.27920371738274696
12557,703-004-5382,9022.523,3,2,1,1.9223050977587852
12667,703-004-5385,7559.476,6,1,5,0.46771020850371336
12932,703-004-5384,5108.508,5,2,3,0.5105937981636984
13086,703-004-5383,2559.9038,2,2,0,0.7703230706356721
13087,703-004-5382,2565.0144,5,4,1,1.6355147191978983
13203,703-004-5382,2479.2476,6,2,4,0.7292179893010148
13302,703-004-5393,3121.4504,4,1,3,0.7265975675527815
13333,703-004-5380,3140.505,"","","",0.27920371738274696
13730,703-004-5387,5173.1553,5,2,3,2.385970041145047
13928,703-004-5388,8405.048,4,1,3,0.3978652972704144
14027,703-004-5383,8474.972,3,3,0,0.9883112397746796
14172,703-004-5382,8129.7607,6,4,2,1.4821128481260026
14441,207-008-2399,5009.768,2,2,0,0.9021244687830948
14482,207-008-2399,3038.3342,7,2,5,2.6361347029079383
1460,703-004-5398,6523.3843,2,1,1,0.3978652972704144
14735,703-004-5398,2796.9224,4,2,2,0.5388340594743087
15055,207-008-2398,4349.801,8,5,3,1.8355733970623929
15058,703-004-5394,8824.333,5,3,2,0.8065300020514325
15671,703-004-5395,3063.9272,6,4,2,2.2135476888596983
16049,703-004-5396,3538.3499,5,3,2,1.0482423437360318
16216,703-004-5396,2059.2922,4,2,2,0.991525768044476
16276,703-004-5386,4311.2104,"","","",0.27920371738274696
16410,703-004-5383,5676.529,4,2,2,1.0248227778312093
16544,703-004-5399,7818.8584,1,0,1,0.27920371738274696
16656,703-004-5391,2399.4248,2,0,2,0.27920371738274696
16733,703-004-5384,6076.399,2,1,1,0.42043925020618733
17068,703-004-5399,3041.106,4,1,3,0.7541538352899746
17203,703-004-5398,8334.59,4,3,1,2.138490482764889
17292,703-004-5398,6449.762,6,4,2,1.069188445198882
17373,207-008-2399,48.07651,4,3,1,1.6617124704202846
17616,703-004-5396,6852.4736,1,0,1,0.27920371738274696
17813,703-004-5381,8153.3687,1,0,1,0.27920371738274696
17909,703-004-5392,6986.954,8,4,4,1.3413011256232592
18210,703-004-5389,2639.5464,1,1,0,0.3969986831858182
18431,703-004-5381,2856.0842,6,3,3,1.3543586322339538
18553,703-004-5391,2531.1643,6,1,5,0.5778274943128344
18586,703-004-5385,8414.443,5,2,3,0.8777917197471411
18922,703-004-5383,6819.3335,2,1,1,0.7765616100974866
19024,703-004-5380,3049.6245,5,2,3,1.2410923298709489
19445,703-004-5385,6274.1094,5,3,2,1.6616204318179004
19621,703-004-5386,9499.302,9,1,8,0.6028202149763912
19715,703-004-5386,8025.755,8,5,3,1.8410981758350236
19924,703-004-5398,9313.778,7,2,5,0.9670527938744826
20146,703-004-5395,8989.511,4,1,3,0.457429047283995
20309,703-004-5383,8212.659,3,0,3,0.27920371738274696
20575,703-004-5395,3928.2786,8,6,2,2.653962309947425
20613,703-004-5390,4949.3184,6,3,3,1.2587657880938294
20726,703-004-5388,7553.479,6,4,2,2.6348631263158286
2073,703-004-5383,5742.4434,3,3,0,1.008086506659787
20835,703-004-5398,8233.08,4,0,4,0.27920371738274696
20889,703-004-5381,3021.906,3,1,2,1.1291175110335838
21091,207-008-2398,2032.2794,5,4,1,1.117854860616739
2119,703-004-5399,1564.8097,5,3,2,0.7170170314404695
21318,703-004-5398,4878.0103,3,3,0,0.6109960096363554
21367,703-004-5390,4598.322,3,1,2,0.3947757746411426
21825,207-008-2399,3942.57,3,2,1,1.0267592598823856
22060,703-004-5390,8149.5967,1,0,1,0.27920371738274696
22111,703-004-5387,5423.9546,5,2,3,0.6732858890347145
22275,207-008-2399,2630.6694,3,1,2,0.8192993348812632
2279,703-004-5394,8581.803,3,1,2,0.6815541274433142
22975,703-004-5395,3216.3823,4,3,1,1.0593313715135568
22985,703-004-5381,805.074,5,2,3,0.6964737952768365
23588,703-004-5396,5802.729,9,4,5,1.694080423791245
23933,703-004-5392,7776.6895,1,0,1,0.27920371738274696
24381,703-004-5384,3771.112,"","","",0.27920371738274696
24392,703-004-5388,8291.581,2,1,1,0.43355516949458445
24404,703-004-5389,9404.439,5,3,2,0.7892526854716864
24507,703-004-5392,2453.3623,3,2,1,1.8715418149212513
24795,703-004-5395,2811.2073,2,2,0,0.8233752986953911
25014,703-004-5395,940.32764,2,2,0,0.8298994511696864
25213,703-004-5392,7762.05,4,3,1,1.040796632022772
25314,703-004-5381,6594.8223,5,4,1,1.3851398893963849
25462,703-004-5384,4709.587,6,2,4,1.672015207208622
25779,703-004-5386,6692.869,2,1,1,0.5366219044708949
2586,703-004-5397,1406.7048,5,0,5,0.27920371738274696
25948,703-004-5381,4605.7646,6,1,5,0.9938567213722765
25967,703-004-5398,1746.5741,5,3,2,2.0178498927521185
2623,703-004-5382,1814.4727,3,1,2,0.6604512632480529
26291,703-004-5393,8617.417,1,0,1,0.27920371738274696
2675,703-004-5391,1897.3523,8,4,4,1.5995748409650405
26766,703-004-5382,194.55194,2,2,0,0.728314977076021
26844,703-004-5390,4064.2124,2,0,2,0.27920371738274696
2715,703-004-5398,5364.7446,3,2,1,2.171099869861185
27177,703-004-5395,370.36835,3,1,2,0.5126951489769405
27306,703-004-5384,4250.004,3,0,3,0.27920371738274696
27514,703-004-5391,5125.1943,4,2,2,1.0761478268538767
27635,703-004-5381,4953.5996,2,2,0,0.8767012879736197
27972,207-008-2399,8342.304,2,1,1,0.3439270169014758
28305,703-004-5380,5198.508,4,2,2,0.7051650259687102
28421,703-004-5382,7006.5464,2,2,0,0.6228410765847079
2872,703-004-5392,3384.5222,2,1,1,0.347768751473439
28851,703-004-5385,5239.3687,1,1,0,1.0008127341419277
28999,703-004-5384,9541.877,3,2,1,1.5870085562591978
29176,207-008-2399,4090.718,4,2,2,1.5136117952507804
29422,703-004-5395,5340.8228,6,0,6,0.27920371738274696
29711,703-004-5397,8885.529,2,2,0,1.1473383710150433
29713,703-004-5388,1243.183,2,2,0,1.005672848463154
30300,703-004-5392,9303.757,4,3,1,0.7815187437765884
30529,703-004-5386,1754.505,2,0,2,0.27920371738274696
30974,703-004-5391,6202.306,2,0,2,0.27920371738274696
31116,703-004-5383,9626.087,1,1,0,0.8492354053347866
31986,703-004-5387,423.81763,4,3,1,1.3608984673843822
32109,703-004-5383,9417.261,9,4,5,1.9841461020839244
32412,703-004-5395,3849.243,8,6,2,2.224539424224075
32819,703-004-5389,8361.337,5,4,1,1.189409322061211
32916,703-004-5390,7898.9624,4,3,1,0.9332371082136124
33036,703-004-5387,2002.1272,4,1,3,0.5057674816387098
33507,703-004-5387,7015.3022,3,2,1,0.7218828137888011
33757,703-004-5397,606.25793,3,1,2,0.4611441168515522
33777,703-004-5383,9170.404,3,1,2,0.7880389392340498
33838,703-004-5390,3258.0603,2,1,1,0.5251330038570781
33929,703-004-5398,6135.2183,6,2,4,1.039920419568962
33955,703-004-5384,4306.5073,2,2,0,0.6127367161498669
34050,703-004-5381,4276.1006,4,1,3,0.686890409678397
34086,703-004-5380,7262.9814,"","","",0.27920371738274696
34109,703-004-5387,3283.409,2,1,1,0.4961099690952827
34182,703-004-5386,3749.6238,3,1,2,0.33853450732658075
34209,703-004-5388,9394.828,5,1,4,0.6937022137270925
34313,703-004-5392,8949.805,6,2,4,0.7630416982158976
34464,703-004-5393,7644.9336,9,4,5,3.7835151124829554
34529,703-004-5390,2349.791,5,2,3,0.6075622897898215
34553,703-004-5393,9773.061,4,2,2,1.2260741937298132
34745,207-008-2398,134.8108,2,2,0,1.5476239899005833
34796,703-004-5388,8620.809,5,3,2,1.2283280905731042
34950,703-004-5398,1631.8047,7,3,4,2.059520574198239
34956,703-004-5398,4125.555,1,1,0,0.35831143730785864
35002,703-004-5381,5726.933,7,2,5,0.6950862919823388
35121,703-004-5398,8316.788,10,6,4,1.6448505081227838
35244,703-004-5380,47.97518,3,1,2,0.5669580486103406
35371,207-008-2399,5084.1426,5,2,3,1.3459644412176672
35395,703-004-5381,6065.591,3,0,3,0.27920371738274696
35901,703-004-5389,4770.401,3,1,2,0.437726317676742
36006,703-004-5383,5361.109,4,1,3,0.7674110408448571
36024,703-004-5399,4691.577,3,1,2,0.6874752782701445
36143,703-004-5398,7899.4175,2,1,1,0.33853450732658075
36163,703-004-5397,295.3136,2,1,1,2.3280560400907184
36168,703-004-5381,8789.454,3,1,2,0.3187575773453028
36404,703-004-5399,6408.477,3,0,3,0.27920371738274696
3654,703-004-5380,5061.1055,4,1,3,0.6179370278287454
36711,703-004-5381,430.05347,"","","",0.27920371738274696
36758,703-004-5382,7511.9204,3,1,2,0.33243191178950066
36795,703-004-5399,3972.1238,2,1,1,0.5936956336665569
36978,703-004-5382,2845.633,4,3,1,1.8541903675647313
37021,703-004-5385,6047.382,7,4,3,1.1359323224988922
37546,703-004-5383,7829.182,5,2,3,0.6703244171596953
37673,703-004-5392,5182.6426,6,4,2,2.028825186445481
37702,703-004-5386,8977.053,4,4,0,1.4127034481820566
38069,703-004-5385,5907.0464,5,2,3,0.6026772522300822
38108,703-004-5393,3016.1692,2,1,1,0.43367769362563624
38117,703-004-5380,5081.461,3,0,3,0.27920371738274696
38536,703-004-5387,3459.5078,2,1,1,0.8308721162277203
38553,703-004-5384,1400.8516,2,1,1,0.48418465116923476
38695,703-004-5381,8960.322,1,1,0,2.7677030135822154
3872,703-004-5383,7610.878,2,1,1,0.4916839645700298
38736,703-004-5396,2584.917,5,1,4,0.5679162702837389
38831,703-004-5393,631.78894,"","","",0.27920371738274696
39027,703-004-5398,3750.0208,1,0,1,0.27920371738274696
39136,703-004-5389,5368.1426,1,0,1,0.27920371738274696
39242,703-004-5398,4931.342,4,3,1,1.9448277593529468
39331,703-004-5389,1222.3792,2,1,1,0.38735685763882965
39576,207-008-2398,237.52272,4,2,2,0.9600256078444138
39663,703-004-5396,8932.985,5,1,4,0.6560231515211458
39701,703-004-5399,8567.318,2,0,2,0.27920371738274696
39831,703-004-5386,231.02045,1,0,1,0.27920371738274696
39999,703-004-5397,7704.5894,7,1,6,0.4314860782385869
40327,703-004-5392,2342.3398,3,3,0,1.5074365064917286
40630,703-004-5382,702.6202,2,2,0,0.6855222540742401
40775,703-004-5395,382.0622,4,1,3,0.7675236222150482
40794,207-008-2398,7066.1646,7,1,6,0.5883912964775505
40962,207-008-2399,6096.459,1,0,1,0.27920371738274696
41123,703-004-5387,6494.0005,5,2,3,1.1754517229323396
41143,703-004-5386,4243.7466,3,3,0,1.509990051156376
41202,703-004-5387,6542.294,4,2,2,3.796686845152066
41328,703-004-5398,7969.2236,2,0,2,0.27920371738274696
41459,703-004-5383,9205.089,8,3,5,1.0038909187488059
4188,703-004-5389,9543.369,3,2,1,1.0495954008156045
41985,703-004-5381,3007.5103,3,1,2,0.4239373339365663
42646,703-004-5390,7731.27,8,4,4,0.8813187833980669
43465,207-008-2398,7980.22,3,2,1,0.8379603074555404
4361,703-004-5396,2343.5105,1,1,0,0.7052721998010671
44436,703-004-5395,9098.329,3,1,2,0.3625591510504
44554,703-004-5384,6550.9253,7,3,4,1.3277236880362606
44555,703-004-5399,1034.3075,3,2,1,1.0145747178752393
4471,703-004-5398,3301.9507,3,1,2,0.7849888131889388
44744,703-004-5387,3755.312,2,1,1,0.5241220845763204
44819,703-004-5380,8630.606,3,2,1,1.0448237863359426
44873,703-004-5384,9249.977,4,2,2,0.6641521072320427
44939,703-004-5392,6601.5386,4,1,3,0.33556796782938897
45128,703-004-5387,515.4705,4,3,1,0.9202360010185912
45246,703-004-5389,4584.577,4,2,2,0.4781843541568794
45302,703-004-5391,776.9793,3,1,2,0.4477941089499378
45539,703-004-5396,9325.277,2,2,0,1.7864127418965068
45543,703-004-5383,2683.5054,4,2,2,0.3978652972704144
4568,703-004-5383,1037.3503,7,2,5,1.0135360240924824
45685,703-004-5391,6457.3975,2,1,1,0.4024743451466392
45717,703-004-5384,6478.005,6,3,3,2.2483145988729287
45875,703-004-5385,1961.1168,2,2,0,0.6818571715595734
45928,703-004-5380,7135.5093,2,2,0,1.3468986333792192
46376,703-004-5388,2015.8058,2,2,0,0.6250897471863188
46464,703-004-5393,764.5953,4,1,3,1.1794372277885825
46552,703-004-5382,6974.093,4,1,3,0.3978652972704144
46613,703-004-5396,3764.9734,4,4,0,1.1491720685268072
4777,703-004-5391,9562.021,3,2,1,0.8754120604034856
47858,703-004-5389,9123.757,"","","",0.27920371738274696
48045,703-004-5382,5998.0386,4,4,0,1.9387683586022162
48288,703-004-5390,8739.626,3,0,3,0.27920371738274696
48344,703-004-5381,4927.8374,5,5,0,1.9947786968361767
48360,703-004-5384,8156.9785,5,1,4,2.3830040939960355
4855,703-004-5393,2891.6597,2,0,2,0.27920371738274696
48718,703-004-5393,6866.225,4,0,4,0.27920371738274696
48812,207-008-2398,452.35455,6,5,1,1.5909060747851491
4917,703-004-5381,8208.654,3,2,1,0.40685803214065136
49263,703-004-5394,345.58655,7,6,1,1.9336997939116356
49347,703-004-5386,4034.0698,5,2,3,0.7612545322974154
49564,703-004-5389,3998.8655,8,2,6,0.5722178879466112
49576,703-004-5395,7748.289,2,1,1,0.44249002800326986
49712,703-004-5398,2527.5308,5,3,2,1.077752836540637
49801,207-008-2398,5179.5547,1,0,1,0.27920371738274696
49873,703-004-5390,6854.4614,7,6,1,4.290484335684093
49884,703-004-5386,1370.3025,5,2,3,0.8241287201535916
49886,703-004-5395,8531.8955,6,5,1,1.393637326476753
5387,703-004-5389,9158.988,5,3,2,1.6886957879553501
5442,703-004-5389,1348.8234,2,1,1,0.5811067939344463
5493,703-004-5382,3675.335,2,1,1,0.34693970256862383
5549,703-004-5392,3972.003,5,2,3,0.9749535506569916
5585,703-004-5394,5681.187,3,2,1,0.5442041632820808
605,703-004-5389,3501.7437,2,1,1,0.6257944153046424
6113,703-004-5392,7249.2266,4,0,4,0.27920371738274696
627,703-004-5392,7581.703,9,3,6,1.4520123865138215
6281,703-004-5387,5074.739,5,2,3,0.7080088769638588
6363,703-004-5382,6184.09,5,3,2,1.4926129711779592
6580,703-004-5380,6772.413,7,5,2,1.624057221279446
683,703-004-5389,7972.4453,"","","",0.27920371738274696
7260,703-004-5381,2142.8096,6,3,3,1.8895928254098775
7346,703-004-5387,8524.352,1,0,1,0.27920371738274696
7557,703-004-5387,2460.3425,2,2,0,1.3203548947732184
7608,703-004-5389,8416.663,3,1,2,0.4457749101500602
7622,703-004-5388,211.57742,4,1,3,0.7700577520839121
7684,207-008-2398,1981.1785,5,1,4,0.46321608070373455
7708,703-004-5394,2614.6882,6,3,3,0.6913136804711197
7767,703-004-5393,7494.798,1,1,0,0.4032564883833108
7817,703-004-5388,2088.7505,"","","",0.27920371738274696
7958,703-004-5382,5277.465,3,2,1,0.6221168081927556
8001,207-008-2399,7758.273,4,2,2,0.7445390174980941
8165,703-004-5390,5489.91,7,4,3,1.6716081818471302
8519,703-004-5389,5706.0347,6,4,2,1.8261572886284465
86,703-004-5398,1772.0336,3,2,1,0.5916726763738192
8762,703-004-5396,3584.8599,4,3,1,0.7247054912181207
9055,207-008-2398,8041.111,1,1,0,0.44829646872267315
9372,703-004-5384,9304.72,4,1,3,0.42984091465098156
9684,703-004-5393,6790.29,4,3,1,0.9358609857187047
10096,703-004-5390,6552.3394,6,4,2,1.953914176374394
10351,703-004-5395,7181.452,1,0,1,0.27920371738274696
10436,703-004-5399,1644.0135,4,0,4,0.27920371738274696
1090,703-004-5390,2843.3894,5,4,1,2.1000966329307436
11078,703-004-5390,8630.1875,4,4,0,1.275357338868905
11332,703-004-5393,635.10297,4,3,1,0.873944845189751
11563,703-004-5393,9295.325,5,3,2,5.470673355888797
1159,703-004-5389,83.90605,7,3,4,0.6761093972932611
11722,207-008-2399,6461.56,9,2,7,1.124358897367902
11888,207-008-2399,7570.749,2,1,1,0.4917556878040435
12394,703-004-5381,4215.964,4,3,1,2.192462768385717
12529,703-004-5385,4789.121,5,2,3,0.7581532732922888
12847,703-004-5388,5974.5293,4,1,3,0.3807252912866403
13192,207-008-2399,9796.371,4,0,4,0.27920371738274696
13282,703-004-5382,2720.4836,3,1,2,0.3978652972704144
13442,703-004-5385,8202.474,7,3,4,0.5518619407386408
13610,703-004-5397,1452.651,5,2,3,0.9207853274606134
13772,703-004-5389,9774.088,3,0,3,0.27920371738274696
13865,703-004-5393,6192.733,3,3,0,0.9728705356323623
14157,703-004-5387,3485.521,6,4,2,1.2307771975942987
14204,703-004-5380,2191.7659,5,3,2,1.0320955775646337
1436,703-004-5384,9822.163,2,1,1,1.2857093518389167
14369,703-004-5391,6258.3228,3,1,2,0.9888988497609047
14838,703-004-5396,6701.659,2,2,0,0.8591512210893426
14887,207-008-2398,2674.2214,2,2,0,0.8274359577925502
14899,703-004-5390,9780.769,1,0,1,0.27920371738274696
1512,703-004-5392,1359.9205,4,1,3,0.8006096391640355
15269,703-004-5397,7804.506,3,0,3,0.27920371738274696
15271,703-004-5388,4676.2695,2,1,1,0.40477426928373905
15555,703-004-5381,2077.005,5,4,1,2.9961767879620926
15574,703-004-5382,562.03125,3,1,2,0.5020561283857213
15634,703-004-5396,4529.6504,5,2,3,0.514195105467698
1572,703-004-5397,1338.036,3,1,2,0.5165268771580819
16250,703-004-5396,1273.4133,2,0,2,0.27920371738274696
16320,703-004-5380,9950.079,"","","",0.27920371738274696
16504,703-004-5381,7152.3623,4,2,2,0.5165268771580819
16576,703-004-5385,9405.199,4,2,2,0.6790811257476569
16974,703-004-5396,7102.3906,5,2,3,0.71707132716465
17401,703-004-5380,7529.821,6,2,4,1.2625786579276803
17427,703-004-5394,1094.5522,5,2,3,0.5991374312988619
17506,703-004-5386,924.7154,2,0,2,0.27920371738274696
17686,703-004-5383,7036.606,2,0,2,0.27920371738274696
17714,703-004-5395,9564.736,6,4,2,2.9107892730890668
18130,703-004-5385,652.84607,2,1,1,0.6336351824809233
18306,703-004-5392,3028.0364,5,3,2,0.8627349991822477
18314,703-004-5399,3230.421,8,3,5,1.2194568902812077
18333,703-004-5380,9337.363,4,2,2,1.2546127394308788
18509,703-004-5398,1198.1774,5,1,4,0.6502910898729986
18556,703-004-5391,7114.012,5,4,1,1.1957987445108753
18574,703-004-5399,2172.954,7,5,2,1.6228850051560195
18634,703-004-5393,5548.703,4,3,1,1.4176370768922297
18726,703-004-5386,7779.2363,5,1,4,1.0796721599033132
18947,703-004-5397,6759.3687,3,1,2,0.7351657238014431
18992,703-004-5393,560.87555,3,1,2,1.5489403908856962
19095,703-004-5389,6425.3447,3,2,1,1.3008368494960025
19132,703-004-5398,1118.3542,4,1,3,0.43287448133877254
19338,703-004-5383,7401.754,"","","",0.27920371738274696
20158,703-004-5387,9267.171,2,1,1,0.7327740434815728
20219,703-004-5394,621.3439,3,2,1,0.6246953977036585
20428,703-004-5391,4339.275,3,1,2,0.35831143730785864
20512,703-004-5389,6015.2065,6,2,4,0.9117542648232274
20569,703-004-5387,4396.2646,4,1,3,0.7663562207859025
2069,703-004-5398,2692.6177,4,2,2,0.533502130667238
20868,703-004-5382,89.89453,1,0,1,0.27920371738274696
2088,207-008-2398,1917.5488,4,1,3,0.5161088316179623
21248,703-004-5389,7953.3647,2,1,1,0.365617184599966
21249,703-004-5396,3215.3643,1,1,0,0.83016601130692
21259,703-004-5390,1910.907,4,4,0,1.2824899532739866
21331,703-004-5395,4243.251,6,2,4,1.4838245495802094
2136,703-004-5389,3193.0881,8,4,4,0.9541822237554597
21452,703-004-5388,8680.018,5,5,0,1.5898474937124232
2162,703-004-5385,92.75377,3,1,2,0.45001294354315996
21783,207-008-2399,6916.3794,3,2,1,0.9713771579901824
21889,703-004-5397,6301.466,7,3,4,0.9832323146297763
21894,703-004-5396,334.83743,4,2,2,1.3515792943904203
22121,703-004-5383,9453.136,1,0,1,0.27920371738274696
22254,703-004-5396,3106.2615,3,1,2,0.5661642519040408
22596,703-004-5386,9212.366,6,2,4,3.604929223811968
22728,703-004-5394,9370.261,4,3,1,0.8745073653735865
2294,207-008-2399,1040.7454,6,4,2,1.8534004642105188
23097,703-004-5384,4636.6055,2,1,1,0.4600637420615335
23318,703-004-5388,122.17641,5,3,2,1.4134647095741657
23459,703-004-5391,4605.6733,4,3,1,0.7118714471169861
23843,703-004-5382,453.67538,3,1,2,0.33853450732658075
23918,703-004-5398,227.12886,5,0,5,0.27920371738274696
24114,703-004-5391,768.5292,6,4,2,1.1896459297145092
24269,703-004-5385,3608.319,12,5,7,1.158343057341147
24504,703-004-5390,9129.486,8,2,6,0.8625999929939347
25032,703-004-5396,2240.5583,6,2,4,1.2490533652959388
25555,703-004-5396,6124.913,6,3,3,1.259634861105279
25894,703-004-5390,8826.007,4,3,1,1.3948797436670732
25912,703-004-5397,5849.813,4,2,2,0.6530360072609371
25969,703-004-5382,4078.3079,8,3,5,0.6969507515206064
26005,703-004-5385,1791.7502,4,4,0,1.3331463101689256
26082,703-004-5398,2750.594,5,3,2,0.7005571241843958
26112,703-004-5387,8988.294,5,1,4,0.6402237578708351
26439,703-004-5389,2044.878,4,1,3,0.7630953913653127
27108,703-004-5380,2812.8196,7,5,2,1.683079709808277
27248,207-008-2399,4170.281,6,3,3,0.7757754626409971
27264,703-004-5381,6027.5073,4,2,2,0.6980756310301669
27317,207-008-2399,6221.087,6,1,5,0.5397086305676955
27884,207-008-2398,4924.872,6,2,4,0.8206372763383436
27990,703-004-5393,6778.1963,2,1,1,0.3510917454123807
28117,703-004-5390,5742.519,6,0,6,0.27920371738274696
28135,703-004-5394,3613.829,1,0,1,0.27920371738274696
28158,703-004-5395,9237.869,1,1,0,0.4987276401749318
28197,703-004-5390,9118.203,2,1,1,0.35831143730785864
28316,703-004-5391,9747.579,9,2,7,0.47488510901469005
28334,703-004-5381,8881.176,1,0,1,0.27920371738274696
28426,703-004-5383,2814.1863,4,1,3,0.33853450732658075
28473,703-004-5386,8188.349,7,4,3,1.133818383249953
28503,703-004-5394,7660.75,"","","",0.27920371738274696
28675,703-004-5392,5703.8804,1,0,1,0.27920371738274696
28839,703-004-5397,592.04224,2,2,0,1.210698580439303
2904,703-004-5381,9883.503,4,3,1,2.0661154171438727
29089,703-004-5388,6130.018,3,2,1,0.7842024536728478
29210,703-004-5381,8560.663,4,2,2,0.5684792605837421
29454,703-004-5396,1803.1764,4,2,2,0.6307065013616558
29539,703-004-5392,7921.9575,6,3,3,0.9040947358056972
29549,207-008-2398,6768.4263,3,1,2,0.7494144425677857
29573,703-004-5393,8168.421,2,0,2,0.27920371738274696
296,703-004-5382,1545.1687,6,5,1,5.606709522012732
29865,703-004-5381,5138.6724,4,0,4,0.27920371738274696
29912,703-004-5396,5273.0674,2,1,1,0.3919322182760311
30002,703-004-5386,6213.86,5,2,3,0.7043345586435082
30923,703-004-5389,9206.825,3,2,1,0.4253084510303948
30966,703-004-5399,5994.7754,6,6,0,2.0740824607149975
31039,703-004-5395,9853.61,3,2,1,2.8286863729163105
31118,703-004-5399,7465.02,5,2,3,1.2600316431891099
31432,703-004-5391,8784.951,5,2,3,1.261841670593458
31518,703-004-5382,8890.92,6,4,2,1.7722890797293918
31713,703-004-5382,6564.8154,4,2,2,0.9278819809224635
3210,703-004-5392,1224.1035,4,1,3,0.5430650450767092
32275,703-004-5388,2394.5374,2,1,1,0.37512182779194486
32558,703-004-5393,3700.2302,1,0,1,0.27920371738274696
32773,703-004-5380,4915.1235,3,3,0,1.3954629011414532
32812,703-004-5385,1608.6757,3,3,0,0.7997251163125026
33174,703-004-5385,4234.205,"","","",0.27920371738274696
33665,703-004-5390,7399.248,3,2,1,1.037627480035132
33783,207-008-2398,4013.5718,4,2,2,0.8961866936533553
3414,207-008-2398,4397.9644,1,0,1,0.27920371738274696
34635,703-004-5394,5598.6504,8,3,5,1.4237465413756667
34657,703-004-5397,6580.5396,2,2,0,1.0223300104464548
35004,703-004-5394,2968.9646,4,2,2,1.051927713094128
35350,703-004-5382,1549.7982,3,0,3,0.27920371738274696
35374,703-004-5381,6301.6943,7,5,2,1.831576838598202
35444,703-004-5396,7790.423,3,2,1,1.8036332485920217
35640,703-004-5396,7244.4917,2,2,0,0.4770527787323197
35670,703-004-5389,9681.709,7,3,4,1.4058960475126654
35844,703-004-5386,7018.5767,4,1,3,0.4563833529317681
3606,703-004-5396,4577.9907,5,3,2,1.7981716428604313
36067,703-004-5390,103.89924,2,1,1,0.7309754899840184
36470,703-004-5397,4148.8193,8,5,3,1.9296254357555902
36526,703-004-5381,4032.4038,4,1,3,0.5161565154371154
37246,703-004-5387,6678.281,5,3,2,1.5056898962404024
37311,703-004-5381,7200.4116,2,1,1,0.49850309708381124
37774,703-004-5388,1089.7083,9,4,5,2.4898629378524655
37982,703-004-5383,9558.086,5,5,0,2.1888440121015083
38223,703-004-5388,7978.5903,1,0,1,0.27920371738274696
38252,207-008-2398,87.84175,5,4,1,1.7011804323540052
38271,703-004-5394,5351.5405,4,1,3,0.6423137759034728
38433,703-004-5396,2220.2886,5,3,2,2.0122254513331352
38672,703-004-5392,1766.6549,2,1,1,0.3978652972704144
38685,703-004-5388,3517.2505,4,1,3,0.5146248278546521
38986,703-004-5394,4648.1226,4,2,2,0.7242733291318847
39103,703-004-5392,9750.861,9,8,1,2.3945829946229997
39350,703-004-5382,7416.1655,4,1,3,0.9278405724765942
39457,703-004-5397,5268.2637,6,3,3,0.984409231469029
39458,703-004-5393,7581.425,2,1,1,0.35534489781066697
39581,703-004-5381,1066.6024,2,1,1,0.5814454361440198
3959,703-004-5380,3660.5764,"","","",0.27920371738274696
39590,703-004-5391,8529.256,5,4,1,1.6849984284966084
39641,703-004-5381,7319.0635,4,2,2,0.96843167297463
39645,703-004-5393,1769.9761,3,1,2,0.3393166109727525
39659,207-008-2398,1301.0382,2,1,1,0.6326509755335846
39917,703-004-5393,1380.2356,5,3,2,1.087240670841218
4032,703-004-5395,1871.8302,3,1,2,0.8275826287068251
40340,703-004-5381,1620.9126,7,3,4,2.4319349767312284
40726,703-004-5381,684.3102,5,2,3,2.3963766227432255
40740,703-004-5389,6733.7856,7,3,4,4.514238581053249
40874,703-004-5399,3897.5388,6,2,4,1.0759553639156325
41105,703-004-5387,904.0153,"","","",0.27920371738274696
41157,703-004-5387,9125.409,4,2,2,1.2712268392616837
41374,703-004-5382,2313.4165,3,3,0,1.4370467319125342
41785,703-004-5384,2911.619,4,2,2,1.2017487249557237
41998,703-004-5389,883.5638,6,4,2,1.549640061404718
42370,703-004-5380,6050.639,7,3,4,0.9844289150035124
42686,703-004-5386,3062.849,1,0,1,0.27920371738274696
42688,703-004-5399,1319.5825,1,1,0,0.395899964853525
42743,703-004-5390,7482.129,4,1,3,0.33853450732658075
42776,703-004-5397,3132.1274,5,2,3,0.4902285045154776
42923,703-004-5385,4465.8696,4,1,3,0.6363853853992059
43085,703-004-5395,6542.8193,6,2,4,0.5035576815005781
43462,207-008-2399,6661.7534,1,0,1,0.27920371738274696
44032,703-004-5398,4321.889,3,1,2,1.4984749393287524
44423,703-004-5399,5203.6494,2,2,0,0.8091850753114307
44446,703-004-5394,29.429794,3,1,2,0.32666834933781397
44717,703-004-5395,2393.831,7,3,4,0.6349349210149999
44801,703-004-5380,8436.475,7,4,3,1.4247084839467674
45141,703-004-5384,8510.876,2,1,1,0.9001022201710603
45157,703-004-5391,6818.978,4,2,2,0.6196939199479499
45273,703-004-5396,974.77795,7,4,3,0.7246298074691848
45300,703-004-5385,9770.949,2,0,2,0.27920371738274696
45540,703-004-5399,6331.227,5,3,2,1.089213465826584
45670,703-004-5399,1437.0394,1,0,1,0.27920371738274696
46525,703-004-5381,406.19373,7,4,3,3.6086325533080363
46534,703-004-5395,1255.8215,6,4,2,1.9167595534068225
46538,703-004-5399,9612.163,5,1,4,0.4938235103438638
46683,703-004-5383,779.02496,5,1,4,1.3701279988474244
467,703-004-5390,6429.079,4,2,2,0.5241904568873041
46870,703-004-5392,8176.5933,2,1,1,0.32666834933781397
47092,703-004-5398,5220.1772,5,3,2,0.8688935424295555
47140,703-004-5384,7511.936,2,1,1,1.358197831454239
47437,703-004-5388,1391.1825,4,3,1,0.8896720345389761
47880,703-004-5398,2046.2048,2,1,1,0.5371624384069424
47919,703-004-5383,7810.629,8,2,6,0.7134018694543531
47940,703-004-5388,5846.213,2,1,1,1.6653797166252837
47960,703-004-5391,6174.9346,5,1,4,0.5989948205264193
47984,703-004-5395,5704.16,5,2,3,0.7364119026211057
48063,703-004-5382,8218.922,2,2,0,0.7081554927964168
48078,703-004-5398,6716.9707,5,5,0,1.4683350590537392
48147,703-004-5381,3931.743,3,2,1,1.0279750693169623
4821,703-004-5386,7195.402,4,1,3,0.5073448637386361
48358,703-004-5381,1280.7388,5,2,3,1.7654074161090272
48370,703-004-5390,2674.6553,2,0,2,0.27920371738274696
48402,207-008-2398,6619.608,1,0,1,0.27920371738274696
48493,703-004-5395,3185.4285,3,3,0,1.1208760881472328
48738,207-008-2399,4637.606,7,3,4,1.440170571953276
49003,703-004-5382,3578.4858,4,0,4,0.27920371738274696
49079,703-004-5389,3089.4417,3,3,0,1.0761129860169336
49290,703-004-5394,6001.587,5,3,2,1.1963362028519389
49307,207-008-2399,7608.0884,3,1,2,1.067448133726371
4937,703-004-5395,5499.13,6,5,1,2.160804515862603
49630,703-004-5387,9929.338,8,6,2,1.8575700901090657
49755,703-004-5383,7007.679,1,1,0,0.5707019355336607
5325,703-004-5395,374.19498,4,3,1,0.9479770757714445
5645,703-004-5383,5968.3364,5,1,4,0.7113617900309265
5925,703-004-5399,4635.208,7,4,3,2.034780759735968
6194,703-004-5383,2288.0132,2,1,1,0.5535050219322947
6240,703-004-5382,2744.0542,6,3,3,1.1876643729922174
6613,703-004-5383,1062.0754,5,2,3,1.1557110272954874
6731,703-004-5392,2004.3176,7,3,4,2.8175293820127987
675,703-004-5382,4921.8237,2,0,2,0.27920371738274696
691,703-004-5397,42.764545,5,1,4,1.0136131069184742
7252,703-004-5396,1135.8422,"","","",0.27920371738274696
7273,703-004-5398,5570.351,5,3,2,0.8448910483311121
7711,703-004-5399,1665.9362,2,2,0,0.693796075724968
7762,703-004-5395,82.41117,4,0,4,0.27920371738274696
829,703-004-5380,1642.4185,4,3,1,2.064165930839762
8304,703-004-5393,7726.293,6,3,3,1.6545422550201814
8433,703-004-5398,9141.734,5,1,4,0.485469496249469
9009,703-004-5399,8180.3335,6,3,3,1.0464856043268362
9030,703-004-5396,1350.7008,11,6,5,1.8975750463445646
9583,703-004-5399,8084.152,3,1,2,0.3583920945639817
9586,703-004-5382,7186.5537,3,2,1,1.6396815402653473
9993,703-004-5389,8652.825,6,2,4,0.7232913864949367
10174,703-004-5396,414.04785,4,3,1,1.0649565233466096
10176,703-004-5382,4247.9473,3,1,2,0.5096420511938525
10235,703-004-5395,3404.4468,6,3,3,1.2005469383520249
10421,703-004-5397,5653.925,2,0,2,0.27920371738274696
1044,703-004-5388,7529.905,2,1,1,3.13787394400245
10532,703-004-5395,4967.357,4,3,1,0.9371418900155694
10580,703-004-5394,7411.8726,3,1,2,0.3568940317992897
10947,703-004-5384,9657.1045,2,0,2,0.27920371738274696
11059,703-004-5391,5374.1133,4,1,3,1.4623978095876762
11127,703-004-5393,3948.0137,2,1,1,1.6076034552361915
11160,703-004-5391,9229.521,4,2,2,0.9449406559057124
11283,703-004-5389,7306.804,5,5,0,0.8439022660465033
11294,703-004-5393,2636.2551,1,1,0,0.532947149401717
11374,703-004-5386,6199.8223,5,2,3,0.992669955523263
1217,703-004-5380,2845.8828,6,4,2,1.0213814915117827
12339,207-008-2398,2267.5342,4,2,2,1.306302077293987
12440,703-004-5393,3805.3865,3,2,1,0.6810569008833521
12501,703-004-5383,244.81714,6,3,3,0.9891082498014657
12550,703-004-5398,7084.0913,3,1,2,0.4459694467119847
12654,703-004-5386,8282.523,5,1,4,0.438700553398386
12813,703-004-5391,9609.357,3,2,1,1.1121511467361735
13035,703-004-5393,4481.6333,3,1,2,0.3439270169014758
13214,207-008-2399,9473.476,1,0,1,0.27920371738274696
13334,207-008-2398,7017.554,1,0,1,0.27920371738274696
13663,703-004-5388,3501.7473,3,1,2,0.6633071185932714
13844,703-004-5386,2533.0483,4,0,4,0.27920371738274696
13858,703-004-5390,1002.04346,4,0,4,0.27920371738274696
141,703-004-5391,2740.5496,6,4,2,0.8985333609717013
1413,703-004-5399,3505.6208,5,4,1,1.8229912612033063
14239,703-004-5394,8524.384,2,1,1,0.3978652972704144
148,703-004-5396,2072.2913,4,3,1,0.631147378209833
15003,703-004-5384,687.27435,5,1,4,0.39069848542932173
15332,703-004-5389,5529.768,6,2,4,0.8305145139743524
15422,703-004-5391,7162.5415,"","","",0.27920371738274696
15631,703-004-5381,3586.6846,4,2,2,0.7134806190732284
15641,703-004-5389,5304.947,4,2,2,0.9712009004276692
15683,703-004-5386,1095.5054,3,2,1,0.5191760279372984
15784,703-004-5393,5587.6143,3,2,1,0.8441453267294176
15876,703-004-5397,4529.371,4,2,2,1.241743343855757
16235,703-004-5397,3811.4946,3,2,1,1.0446967449840678
16310,703-004-5381,7736.489,3,1,2,0.40984733570829024
16843,703-004-5380,4237.6675,2,0,2,0.27920371738274696
17001,703-004-5380,3891.2456,4,2,2,0.9930132790139133
17053,703-004-5386,7080.8022,6,1,5,0.47914751897329966
173,703-004-5384,2096.3252,5,3,2,0.612430394496388
17447,703-004-5387,6750.4727,4,0,4,0.27920371738274696
17853,207-008-2399,7478.8438,3,1,2,0.35831143730785864
17874,207-008-2398,992.8137,4,2,2,0.5921736343364699
180,703-004-5384,7697.61,"","","",0.27920371738274696
18062,207-008-2399,6452.9316,2,1,1,0.5068698553022774
18163,703-004-5385,8059.481,4,3,1,1.1356257587728664
18381,703-004-5397,373.6806,3,2,1,0.519322856285771
18487,703-004-5381,3559.0273,1,0,1,0.27920371738274696
18904,703-004-5382,9143.108,4,2,2,0.9124488903055498
1891,703-004-5398,2274.189,3,2,1,1.5072554451500502
18935,703-004-5388,905.1627,3,2,1,0.711478355392532
19366,703-004-5392,86.56442,1,0,1,0.27920371738274696
19439,703-004-5385,5410.9897,4,0,4,0.27920371738274696
19455,703-004-5381,3132.9202,3,1,2,0.46024179368367507
19474,703-004-5393,9182.302,7,4,3,3.0544592903408776
19490,703-004-5390,1608.2495,3,1,2,1.6273031642007012
19497,703-004-5389,6589.9404,4,2,2,0.6883126544449182
19644,703-004-5383,7171.145,3,0,3,0.27920371738274696
19797,703-004-5383,1387.7743,2,0,2,0.27920371738274696
19847,703-004-5383,461.44547,"","","",0.27920371738274696
19987,703-004-5384,9997.555,5,2,3,0.6178901202879877
20190,703-004-5383,5239.9336,3,1,2,0.5165268771580819
20357,703-004-5386,7284.754,8,7,1,1.894389736482012
20384,703-004-5387,2495.2085,6,4,2,1.939120249485403
20509,703-004-5396,618.29565,2,2,0,0.8212108198826907
20582,207-008-2399,5463.0596,3,0,3,0.27920371738274696
20778,703-004-5386,8059.01,3,1,2,0.42619187579977474
2133,703-004-5398,5940.114,1,0,1,0.27920371738274696
21341,703-004-5385,3744.018,2,0,2,0.27920371738274696
21375,703-004-5386,2121.4622,5,0,5,0.27920371738274696
21384,703-004-5392,6349.0195,8,2,6,1.3839615085243402
2141,703-004-5388,9142.714,4,3,1,1.3916106063084852
21629,703-004-5391,9017.462,9,5,4,2.600668207798418
21637,703-004-5397,7020.903,2,1,1,0.4781632081736695
21913,207-008-2398,4229.9277,1,0,1,0.27920371738274696
21928,703-004-5391,7238.169,3,3,0,0.9929512751069792
22819,703-004-5386,8744.939,3,3,0,1.5150911139263963
22935,703-004-5383,762.614,3,0,3,0.27920371738274696
23613,703-004-5386,1303.907,6,4,2,1.512161006895545
23623,703-004-5395,7336.2427,4,1,3,0.37867740460775706
23916,703-004-5383,7838.4463,4,1,3,1.3841954363572375
23990,703-004-5399,1617.034,4,1,3,0.592296151266369
23994,703-004-5397,3535.21,8,4,4,1.5790607056114696
240,703-004-5397,1641.2014,2,2,0,2.330695522923433
24025,703-004-5389,3542.2158,3,1,2,0.35831143730785864
243,703-004-5388,5001.8438,3,1,2,0.42466444607829695
24319,703-004-5397,7580.847,2,0,2,0.27920371738274696
24417,703-004-5389,9406.951,4,4,0,0.9627043896921378
2450,703-004-5391,2059.0525,5,4,1,2.5086512491485435
24681,703-004-5393,8205.905,4,3,1,1.3951714146188692
24728,207-008-2399,9457.952,6,2,4,0.5348647221682387
24980,703-004-5396,5464.2686,1,0,1,0.27920371738274696
2541,207-008-2399,8197.737,5,1,4,0.513575572361352
25478,703-004-5388,7992.095,5,3,2,2.8963722616099288
25528,703-004-5388,469.0677,6,3,3,1.0956764370658374
25535,703-004-5386,1310.0529,5,3,2,1.859363658286063
25906,703-004-5391,2256.316,6,3,3,1.534577360944001
2592,703-004-5382,5994.088,4,3,1,0.9617274050332676
25979,703-004-5386,930.8213,3,0,3,0.27920371738274696
25999,703-004-5386,7426.4233,6,4,2,1.4507138994211741
26151,703-004-5393,2683.6235,4,1,3,0.6095948819292808
26276,207-008-2398,7006.5503,4,4,0,1.598847227334501
26617,703-004-5398,1762.9653,2,2,0,3.5034567634999303
26628,207-008-2398,2665.6777,3,2,1,0.5272217190007492
27190,703-004-5386,3890.1245,9,4,5,1.2005269600882706
27364,703-004-5381,4242.77,3,1,2,0.589036845197784
27799,703-004-5390,80.408455,4,2,2,0.568911307906233
27980,207-008-2399,4302.627,3,0,3,0.27920371738274696
28091,703-004-5390,8540.762,9,5,4,1.8339127188765612
2837,703-004-5393,7837.543,1,1,0,0.4394286613485519
28672,703-004-5383,4003.5837,6,4,2,1.387480653927158
28751,207-008-2399,301.50534,3,1,2,0.33853450732658075
28972,207-008-2398,2178.4043,5,2,3,1.361940652582389
29252,703-004-5384,8967.097,9,5,4,1.2034969275690108
29266,703-004-5391,9425.306,5,1,4,1.3692581709851768
2932,703-004-5389,9386.237,5,3,2,1.1214724415381419
29371,703-004-5393,3504.9326,2,0,2,0.27920371738274696
29450,207-008-2399,2636.7258,2,1,1,0.5987098562883255
29466,703-004-5387,3623.5637,5,1,4,0.8816660816029456
29515,703-004-5397,7613.681,4,2,2,1.1384254773652362
29647,703-004-5396,2819.923,4,3,1,1.5681375100056838
29669,703-004-5387,6876.895,3,2,1,0.5030674114753401
29834,703-004-5385,1919.5873,6,2,4,1.0506658278625312
29885,207-008-2398,8556.369,5,2,3,0.5854349591370632
29886,703-004-5392,2436.3906,6,2,4,0.5687257035729165
29890,703-004-5388,7750.8105,4,2,2,2.1303844626206065
30029,207-008-2398,1567.6653,4,2,2,1.354027497096168
30098,207-008-2399,3079.5664,4,2,2,1.1019977121105935
30179,207-008-2398,6914.31,1,0,1,0.27920371738274696
30233,703-004-5394,2038.1696,2,1,1,0.33386003519765156
30592,703-004-5380,1238.0969,5,3,2,1.0315287455815365
30624,207-008-2399,8453.967,3,0,3,0.27920371738274696
30913,703-004-5385,5117.025,1,0,1,0.27920371738274696
31020,703-004-5381,5909.257,4,2,2,1.1480311138511021
31445,703-004-5396,6472.138,6,4,2,2.436826653226905
31772,703-004-5398,996.1015,4,3,1,0.9288705897531122
32019,703-004-5380,1396.3884,2,1,1,0.4442987182924171
32178,703-004-5394,1725.468,4,0,4,0.27920371738274696
3229,703-004-5391,4766.945,6,4,2,0.746813191991559
32701,703-004-5382,5865.1064,4,0,4,0.27920371738274696
32911,703-004-5391,3052.3467,6,4,2,1.4477766802769167
32996,703-004-5395,2311.755,6,4,2,0.6035453690757047
33040,703-004-5389,2164.6296,4,1,3,0.3858384517255498
33237,703-004-5391,8611.055,2,0,2,0.27920371738274696
33376,703-004-5394,3225.684,3,1,2,0.5426875290883584
33866,703-004-5396,6112.9253,2,2,0,1.0965944394263758
33895,703-004-5385,8320.714,4,2,2,0.8088938779668278
34398,703-004-5390,1356.0819,5,2,3,1.6264876189976136
34447,207-008-2399,7097.0835,4,1,3,0.4036620390537393
34495,703-004-5384,1042.6581,3,1,2,0.5308166743134707
34674,703-004-5386,5455.439,3,2,1,0.701036828320291
35070,703-004-5387,9232.756,3,1,2,0.6131261380892309
35378,703-004-5380,2583.4822,3,2,1,1.1076936330940086
35450,703-004-5389,8285.043,2,2,0,1.7422973854435506
35481,703-004-5395,6373.046,4,3,1,1.343166103235133
35741,703-004-5391,4651.593,4,2,2,0.4875918033529874
36554,703-004-5386,8120.4326,5,4,1,1.1969645843691623
36839,703-004-5384,5361.8716,4,1,3,0.35831143730785864
36906,703-004-5384,7108.146,3,0,3,0.27920371738274696
37066,703-004-5381,2912.5435,5,3,2,0.5033720141253961
37100,703-004-5386,1500.5255,1,1,0,0.95014367649021
37124,703-004-5382,6265.939,2,0,2,0.27920371738274696
37218,703-004-5386,2895.6443,4,3,1,2.394238448280456
37265,703-004-5396,3747.4685,4,2,2,0.678313869188669
37313,703-004-5389,3658.5056,5,3,2,1.0978810483488204
37537,703-004-5387,861.7824,4,3,1,0.9549906439593783
37708,207-008-2398,4479.6406,3,2,1,1.2590106274640531
37777,703-004-5397,827.657,"","","",0.27920371738274696
37956,703-004-5386,4288.414,5,5,0,1.9323263237168964
38150,703-004-5388,711.43744,6,3,3,1.8526595900181635
38193,703-004-5396,3829.8564,4,2,2,1.598506933277222
38246,703-004-5386,1772.07,4,4,0,1.1805093618744007
38456,703-004-5395,9470.811,4,4,0,2.454296476798353
38507,703-004-5384,6453.331,1,1,0,1.038563982631381
38530,703-004-5397,7023.0615,4,2,2,0.7665179184293979
38570,703-004-5380,400.32626,5,2,3,2.0237378709484695
39014,703-004-5381,4732.4453,2,1,1,0.3983714694813131
39168,703-004-5385,523.1237,6,5,1,2.964034123425053
3968,703-004-5384,217.91756,2,1,1,0.5604496030800938
39685,703-004-5386,7604.359,3,1,2,0.33853450732658075
39698,703-004-5386,6152.1816,3,2,1,0.9786880456087879
39826,703-004-5394,8069.6045,2,0,2,0.27920371738274696
40147,703-004-5381,8882.691,7,3,4,1.8658100688389938
40152,703-004-5381,4723.176,5,4,1,1.5688504443444895
40156,207-008-2399,5837.1143,6,3,3,1.0796578565880066
4016,703-004-5390,1025.3704,7,4,3,1.1844806279986604
40261,703-004-5381,6912.4873,6,2,4,0.797409286525053
40424,703-004-5398,2238.277,6,1,5,0.7267459358488387
40505,703-004-5399,5206.366,2,1,1,0.5493523010637111
40526,703-004-5395,8294.365,6,2,4,2.0922629223640463
40627,703-004-5380,5015.44,1,0,1,0.27920371738274696
40973,703-004-5393,9171.11,9,6,3,3.34312030129371
40989,703-004-5397,6458.7534,2,2,0,0.8091721434420206
4102,703-004-5397,4603.219,10,5,5,2.371796307082608
41108,703-004-5392,2446.3792,2,0,2,0.27920371738274696
41221,703-004-5399,1170.0791,2,1,1,0.5093066753444128
41540,703-004-5394,4944.0283,6,4,2,1.4685634203767528
41614,703-004-5389,2048.1199,2,1,1,0.8426484525493545
41658,703-004-5384,6937.442,7,4,3,4.719893884804908
41675,703-004-5393,7916.3755,8,5,3,1.7519687014940408
41728,703-004-5387,3896.433,3,1,2,0.4685063895489454
41908,703-004-5394,2404.3704,3,2,1,0.6491916796497015
42091,207-008-2398,1410.9445,3,2,1,1.038172224798081
42270,703-004-5380,9163.293,3,3,0,1.9213928374805205
42448,703-004-5388,5849.5825,3,1,2,0.5261871829912459
43367,703-004-5393,1079.9384,3,2,1,0.6042771154850118
43556,703-004-5381,6552.1323,7,3,4,2.9962880242911214
44038,703-004-5398,2940.4253,7,4,3,4.2359527335007625
44129,703-004-5389,6475.887,2,1,1,0.46899386509420676
44453,703-004-5394,6113.404,2,0,2,0.27920371738274696
4448,703-004-5390,6681.3945,5,1,4,1.1441134518612521
44575,703-004-5383,9409.75,4,0,4,0.27920371738274696
44752,703-004-5384,8586.296,7,4,3,0.8243433464441979
45024,703-004-5392,29.757618,5,4,1,1.624577071219802
45035,703-004-5397,6806.6025,3,1,2,1.2546431059968344
45545,207-008-2399,4528.6133,4,3,1,0.7507591976019886
45803,703-004-5391,1850.9674,9,4,5,1.187274402574606
4637,703-004-5388,4375.3438,3,1,2,0.36443588923670356
46456,703-004-5395,8542.761,4,3,1,0.7232575983686276
46591,703-004-5391,2545.2732,5,2,3,0.6646028303450686
46601,703-004-5387,5082.7563,3,1,2,0.5898715416691452
46824,703-004-5391,2200.6453,5,2,3,0.7507179904208324
46848,703-004-5387,9108.863,2,1,1,1.4177929266634928
47097,703-004-5398,9299.301,"","","",0.27920371738274696
47287,703-004-5384,9344.231,1,1,0,0.5658641371707511
47857,703-004-5393,1730.1166,3,2,1,0.7288652332634592
47906,703-004-5382,4473.8657,2,1,1,0.3978652972704144
48138,703-004-5396,625.65985,8,5,3,1.5022401467875357
48140,703-004-5385,2443.5627,8,5,3,3.503049397655619
48680,703-004-5387,7701.179,6,0,6,0.27920371738274696
48734,703-004-5396,9286.735,10,6,4,1.741704678462061
4909,703-004-5394,7456.142,4,2,2,1.0672825245287665
49330,703-004-5382,511.42395,4,2,2,0.684005055570597
49339,703-004-5382,6770.19,7,0,7,0.27920371738274696
49352,703-004-5386,9652.137,4,3,1,0.7269632297221948
49387,703-004-5383,6265.632,7,4,3,1.5865042885100582
49508,703-004-5395,5992.939,5,3,2,3.0138703540633354
49538,703-004-5389,301.36288,5,3,2,3.617009407750407
49560,703-004-5383,3329.8374,4,3,1,0.7829438939616373
49905,703-004-5389,1270.4557,3,2,1,0.472390388518545
4994,703-004-5382,2818.0093,2,1,1,0.408205610175209
49986,703-004-5384,5534.26,3,2,1,1.1322809894147383
515,703-004-5383,632.6395,3,2,1,0.9900472712185688
5445,703-004-5381,4478.874,6,4,2,1.363006936870581
5518,703-004-5392,9797.006,3,2,1,1.4314117324989128
5591,207-008-2398,4089.9302,8,3,5,2.292751705603937
5782,703-004-5389,8563.092,1,1,0,0.35831143730785864
5955,207-008-2398,7489.869,"","","",0.27920371738274696
6177,703-004-5385,9868.908,1,0,1,0.27920371738274696
643,703-004-5382,4200.479,2,0,2,0.27920371738274696
6485,207-008-2399,8976.647,3,1,2,1.1287727109715728
6547,703-004-5385,7525.7075,4,3,1,1.8356570321847645
6593,703-004-5392,9009.853,2,1,1,0.3415216477925028
6937,703-004-5388,4015.3562,2,1,1,0.6189679111050553
7081,703-004-5387,678.8933,10,6,4,2.5328440469024964
7106,703-004-5395,668.9149,5,3,2,4.3793984657559974
7144,703-004-5383,4774.9497,2,1,1,1.0843766253725764
7358,207-008-2398,6579.3745,5,3,2,1.0620331540726111
7430,703-004-5398,8526.77,2,2,0,1.0361439543108024
7511,703-004-5392,9250.91,2,0,2,0.27920371738274696
7857,703-004-5397,9908.962,3,3,0,0.788803870182487
7891,703-004-5382,1181.0923,4,1,3,0.9584832499116981
8102,703-004-5388,2786.7043,5,2,3,0.6166565948932196
8118,703-004-5395,7517.205,4,3,1,0.8885321888156062
8726,703-004-5391,7368.9976,5,3,2,2.360735947260973
8784,703-004-5386,1392.4313,6,1,5,1.0262025848263465
8902,703-004-5384,6873.741,4,3,1,2.484869864619036
9283,703-004-5385,3378.4866,9,6,3,2.7613254339468676
9419,703-004-5386,6225.649,2,0,2,0.27920371738274696
9748,703-004-5398,2853.5896,6,3,3,0.5560807371206377
9884,703-004-5384,6758.241,5,3,2,1.370308257474512
10010,703-004-5397,181.98967,4,1,3,0.49033837978220174
10138,703-004-5390,505.14697,4,3,1,3.6487926945105102
10392,703-004-5382,1329.0734,4,2,2,1.241797326444029
10561,703-004-5392,8927.898,2,2,0,1.314585134022038
1097,703-004-5395,1230.7042,4,3,1,0.8073576197160964
11029,207-008-2398,3181.8909,2,1,1,0.4640756385908506
11120,703-004-5391,1712.9701,3,2,1,0.6618239437389082
11255,207-008-2399,5885.0415,5,2,3,0.940011207099274
11273,703-004-5388,4447.885,4,2,2,1.5926499804585348
11279,703-004-5399,1198.889,3,1,2,0.5789821668349091
11326,703-004-5392,1736.4109,5,0,5,0.27920371738274696
11338,703-004-5383,243.3169,3,0,3,0.27920371738274696
11367,703-004-5383,1758.7429,6,2,4,0.576134349428765
11499,703-004-5397,5320.783,3,0,3,0.27920371738274696
11589,703-004-5389,7838.194,4,1,3,0.37764528618040044
11593,703-004-5386,1009.48694,5,1,4,0.43071177782019776
11968,703-004-5393,4153.5093,6,1,5,0.5284454479930263
12006,703-004-5390,9840.468,10,7,3,5.006278755718861
12022,703-004-5382,1032.8453,3,1,2,1.5045658616153184
12163,703-004-5393,971.14026,5,2,3,1.811310288232681
12614,703-004-5392,9296.094,5,5,0,1.6292340743334783
12925,703-004-5394,1076.5522,3,2,1,0.9045276825274737
12949,703-004-5381,2032.7347,8,6,2,2.332952755926626
12993,703-004-5381,984.1496,2,2,0,0.6960427033259738
13006,703-004-5399,3280.6086,3,1,2,0.6026515677124162
13026,703-004-5382,6582.6255,3,3,0,1.759777592917723
133,703-004-5398,5585.6245,8,4,4,0.6425435504150161
13491,703-004-5380,5823.0107,5,1,4,0.32666834933781397
13624,703-004-5380,7739.457,4,1,3,0.4554359692188502
14081,703-004-5384,7607.4336,1,0,1,0.27920371738274696
14241,703-004-5389,4613.7305,4,3,1,1.8398509788487327
14530,703-004-5392,2409.101,2,1,1,0.3978652972704144
14554,703-004-5387,8097.3677,7,5,2,2.3005733045198857
14674,703-004-5398,8931.946,2,2,0,1.1866605028765536
14895,703-004-5383,9236.324,8,5,3,1.6211547578362553
14951,703-004-5382,3034.7817,7,2,5,1.4581269742364735
15467,703-004-5386,1274.2484,2,0,2,0.27920371738274696
15554,703-004-5391,353.13785,4,4,0,1.7103525081422917
15572,703-004-5385,5963.2,3,0,3,0.27920371738274696
15746,703-004-5391,2231.9539,3,0,3,0.27920371738274696
15791,703-004-5391,6490.2056,3,0,3,0.27920371738274696
15852,703-004-5390,6864.024,6,3,3,1.9548420581266295
15864,703-004-5399,8961.181,5,3,2,0.5790052387334349
16522,703-004-5394,9142.47,5,3,2,1.85040626574558
17404,703-004-5389,7985.5176,3,2,1,0.5561203190889621
17451,703-004-5384,7964.9956,2,1,1,0.37175974969512765
18977,703-004-5393,3015.2803,2,0,2,0.27920371738274696
19058,207-008-2399,3436.042,2,2,0,0.6716677578740725
19563,703-004-5389,4976.498,8,3,5,0.6202802699476889
20052,703-004-5396,3085.1912,7,3,4,1.172296800992047
20248,703-004-5387,3236.2664,5,5,0,3.383270024167089
20305,703-004-5384,1613.6903,"","","",0.27920371738274696
20471,703-004-5389,9264.176,2,1,1,0.41227420339963117
20720,703-004-5399,7615.6675,6,3,3,0.8485781558337623
20917,703-004-5380,559.482,9,4,5,0.8725909704107422
21232,703-004-5382,4018.861,3,3,0,1.049622221844975
21497,703-004-5395,7038.6157,7,3,4,4.253446679227356
21830,703-004-5390,7999.0903,5,2,3,1.2103357086753044
21950,703-004-5380,7189.1875,2,2,0,0.6185803733654772
22084,703-004-5381,2023.2034,"","","",0.27920371738274696
22469,703-004-5384,7553.9424,6,4,2,1.172518081896219
2252,703-004-5398,5236.666,3,1,2,1.2373597624517652
22789,703-004-5381,5237.2373,3,2,1,0.9925756257279135
22910,703-004-5380,7101.13,1,1,0,0.7019171867069047
23041,703-004-5396,6306.3745,5,5,0,1.0860252166056066
2339,703-004-5395,9296.617,1,0,1,0.27920371738274696
23580,207-008-2398,6007.3506,5,2,3,0.7485093834947459
24001,703-004-5394,1442.5117,6,2,4,0.9347437095947949
24155,207-008-2399,2705.9216,2,0,2,0.27920371738274696
24512,703-004-5393,5600.8076,7,4,3,0.9782207528262096
24703,703-004-5385,8648.056,1,0,1,0.27920371738274696
25108,703-004-5384,2171.1868,8,4,4,1.5581496414498175
25386,703-004-5387,6009.245,5,0,5,0.27920371738274696
25427,207-008-2398,739.23706,"","","",0.27920371738274696
25606,703-004-5398,9443.125,3,1,2,0.32666834933781397
2562,703-004-5385,2840.2246,5,3,2,0.8423624696437402
25853,703-004-5380,4675.2383,3,3,0,1.027336895926461
25923,207-008-2398,1702.1812,"","","",0.27920371738274696
26354,703-004-5385,1973.8698,4,2,2,1.505108425498392
26499,207-008-2399,2362.8516,2,1,1,0.45364409908718883
26619,703-004-5392,7398.7217,7,1,6,0.3842955421724792
26762,703-004-5393,9417.497,4,1,3,0.6190946099107453
27365,703-004-5387,7186.1333,3,1,2,0.5606093079858964
2739,703-004-5387,1799.314,5,1,4,1.0304988273776
27699,703-004-5397,7816.2573,7,5,2,2.357392209737396
27713,703-004-5398,2282.797,3,2,1,0.5185882100892556
27765,207-008-2398,1553.7894,9,6,3,1.8689629363866433
2791,703-004-5399,6162.2744,2,1,1,0.35831143730785864
28350,703-004-5388,2055.2224,2,1,1,0.35831143730785864
29129,703-004-5389,4456.1934,3,2,1,0.3859991392816477
29150,703-004-5396,9411.873,5,4,1,1.4138423076523938
29304,703-004-5397,181.83708,4,3,1,1.93338184058222
29360,207-008-2399,5106.2354,4,2,2,0.769313784734302
29764,207-008-2398,6193.1,2,0,2,0.27920371738274696
29841,207-008-2399,3525.5784,2,1,1,0.6300725476135725
29998,703-004-5385,1226.4824,2,0,2,0.27920371738274696
30225,703-004-5390,1043.1946,1,1,0,0.7592906598374006
3058,703-004-5395,9529.089,2,1,1,1.1282007000831753
30797,703-004-5384,3465.218,4,3,1,0.6387317989944651
30965,703-004-5387,9314.765,4,2,2,0.5071201605087308
31056,703-004-5384,79.35166,5,3,2,1.167067248984913
31158,703-004-5386,5110.0146,3,1,2,0.6575755581766947
31289,207-008-2399,3375.807,3,3,0,1.7813148645128827
31484,703-004-5399,7711.765,1,0,1,0.27920371738274696
31644,703-004-5390,5812.9614,4,3,1,1.330195870158776
31655,703-004-5396,5037.5015,8,5,3,2.258684479490454
32506,703-004-5382,6058.383,6,2,4,1.7485915420325904
32888,703-004-5384,5728.968,2,0,2,0.27920371738274696
33006,703-004-5389,4943.388,5,4,1,1.9993436693307565
3316,703-004-5394,3599.9668,4,2,2,1.2143820834064856
33199,703-004-5395,7360.4614,3,1,2,0.8890906234017406
33514,207-008-2399,7366.1353,6,3,3,0.8980043969700661
33569,703-004-5397,6881.7896,4,2,2,2.8062684870598473
33714,703-004-5381,9840.608,5,2,3,1.0186844360330745
33811,703-004-5393,7062.442,4,1,3,0.8775505588366473
33875,703-004-5395,9106.978,7,6,1,1.5824425523076517
34101,703-004-5387,8840.422,3,3,0,0.9598091861952537
34111,207-008-2398,9394.418,3,2,1,0.6809326378388112
34113,703-004-5387,9094.062,7,3,4,0.9102734795500123
34472,703-004-5384,1675.7339,2,0,2,0.27920371738274696
34502,703-004-5384,8910.202,5,0,5,0.27920371738274696
34662,703-004-5384,6079.5605,6,3,3,1.3167737131109414
34783,703-004-5384,5267.6895,6,3,3,1.4250908816756636
34900,703-004-5399,4108.4766,3,1,2,0.4781632081736695
34944,703-004-5388,3449.0764,1,0,1,0.27920371738274696
34976,703-004-5399,8841.691,5,4,1,1.373821862777701
35013,703-004-5398,3388.911,4,2,2,1.4457331044226973
35019,703-004-5387,1252.6566,6,0,6,0.27920371738274696
35126,703-004-5386,3118.2212,3,2,1,1.2119972718870655
35520,207-008-2399,5098.559,4,3,1,1.2076466437532936
35555,703-004-5388,9241.393,3,3,0,0.8646268392834344
3580,703-004-5399,7096.869,8,5,3,2.165662034313063
35889,703-004-5396,5015.9204,8,4,4,0.8933596558868112
36054,703-004-5399,5397.7666,2,1,1,0.5303197589901282
36092,703-004-5395,9256.826,5,4,1,0.9928814392946121
36292,703-004-5385,8116.1885,1,0,1,0.27920371738274696
36311,703-004-5386,8034.417,5,2,3,1.5611948817179535
3733,703-004-5398,5980.116,7,2,5,0.36622220930036975
37561,703-004-5392,8368.84,4,2,2,0.6026926045395444
37589,703-004-5387,4523.977,2,1,1,1.1197587279525063
37934,703-004-5387,3074.9524,3,1,2,0.9890982498351294
3794,703-004-5386,8428.185,1,0,1,0.27920371738274696
37946,207-008-2399,8701.267,7,4,3,1.4644651674678522
38087,703-004-5389,6555.32,8,2,6,0.5602194717385947
38463,703-004-5391,7357.183,4,4,0,1.8941888333359185
39525,703-004-5392,2705.6326,3,1,2,0.7336676910457871
39627,703-004-5399,3024.2568,3,2,1,2.0547285998645908
39719,703-004-5390,4586.6436,3,3,0,1.5221654257162158
39896,207-008-2398,3168.9255,5,3,2,1.0191174411471275
40030,703-004-5380,3763.9595,6,3,3,1.6166471922370425
40060,703-004-5387,9443.79,6,4,2,0.6420736558341599
40213,703-004-5383,6711.197,2,2,0,1.323466273707424
40403,703-004-5393,2459.7502,5,3,2,0.7603644856570827
40516,703-004-5396,3495.6514,6,5,1,1.611274245914602
40725,207-008-2398,8335.97,8,2,6,1.2988441507249195
40754,703-004-5380,5226.2397,8,4,4,1.6296760785118838
40784,703-004-5391,415.39847,7,4,3,1.664334412481833
40939,703-004-5383,9375.497,6,3,3,1.105993327475024
41036,703-004-5394,4841.0117,2,1,1,0.36951836429724944
41037,703-004-5395,4035.2224,3,1,2,0.3985613348434229
41196,703-004-5397,1855.8138,6,1,5,0.4306682980772542
41217,703-004-5395,9300.71,7,3,4,1.168403220066024
41285,703-004-5384,8383.667,3,1,2,0.7191893838724074
41320,703-004-5390,8360.595,8,4,4,2.6858839256271816
41835,703-004-5395,7218.6636,7,3,4,1.2134307011940841
43310,703-004-5395,7888.9526,1,1,0,1.0876044284826998
4341,703-004-5388,3283.629,4,2,2,0.5107144709236393
43515,703-004-5384,6302.539,6,3,3,1.112582170197216
4358,703-004-5384,8207.517,7,3,4,1.6626557440304264
4372,703-004-5396,8507.127,5,3,2,1.1794040327619184
43957,703-004-5399,616.4771,3,3,0,3.2063988156410708
44020,703-004-5387,1428.2996,3,2,1,0.6975069760546118
44098,703-004-5398,3736.2034,4,3,1,1.0189603216373113
44335,703-004-5391,6143.6416,2,1,1,0.7482487226457317
44538,703-004-5384,2922.7585,6,3,3,0.9732796532765479
45034,703-004-5388,9588.422,7,4,3,1.1024082230898253
45883,703-004-5397,8046.4077,2,2,0,1.1695154621477228
46493,703-004-5397,4641.1543,2,0,2,0.27920371738274696
46616,703-004-5384,7875.4067,7,7,0,3.554693014276696
46747,703-004-5381,8262.842,4,2,2,0.7538500369334169
47373,207-008-2398,8120.21,2,2,0,0.7232968924225627
47727,207-008-2398,8622.506,6,3,3,0.9566101126935374
47780,703-004-5380,9320.077,8,4,4,1.417310013181074
47899,703-004-5390,3259.3394,6,4,2,1.8065595858756913
48020,703-004-5388,6564.374,2,0,2,0.27920371738274696
48329,703-004-5392,5533.7334,1,0,1,0.27920371738274696
48375,703-004-5393,495.77832,2,1,1,0.3187575773453028
48449,207-008-2399,8050.7153,4,2,2,0.5100993749141666
48494,703-004-5380,1204.7815,8,3,5,1.3502834780624546
48509,703-004-5396,550.8983,2,2,0,0.4536172204053431
48663,703-004-5396,5902.238,5,1,4,0.979661856364373
48679,703-004-5394,1493.9504,1,0,1,0.27920371738274696
48697,703-004-5383,7809.905,9,4,5,0.9569365291794123
48732,703-004-5397,4013.1658,3,0,3,0.27920371738274696
48746,207-008-2398,6062.935,2,0,2,0.27920371738274696
4882,703-004-5386,546.12695,2,2,0,0.9379553670401947
48866,703-004-5382,4003.3132,6,2,4,1.0061721209437129
48921,703-004-5393,191.16699,7,3,4,2.088970350931378
49084,703-004-5399,3886.3982,9,4,5,2.4455321165005226
49104,703-004-5395,7372.6772,4,1,3,0.44043758984568143
49105,703-004-5383,4632.2764,4,4,0,1.448668722772981
49191,703-004-5380,8355.378,3,2,1,1.2137733581840733
49265,703-004-5388,3784.619,7,3,4,2.1926806381314994
49268,703-004-5386,7291.221,4,3,1,1.3795386385327917
49358,703-004-5393,8678.498,3,2,1,1.490067844554661
49386,703-004-5394,2167.6404,2,1,1,0.3978652972704144
4942,703-004-5386,8941.559,4,0,4,0.27920371738274696
49715,207-008-2398,7216.7427,4,2,2,0.522769794722172
5017,703-004-5396,5083.441,3,1,2,0.5204610735865005
5062,703-004-5381,3250.0266,7,2,5,0.44130457444406745
5226,703-004-5399,3696.8828,5,3,2,1.813762874974476
5329,703-004-5395,7698.4946,3,1,2,0.5593192567873001
6179,703-004-5397,1968.4779,5,4,1,2.221736176300836
6367,703-004-5384,3354.0737,5,3,2,0.8494016084856388
6622,703-004-5381,1916.9825,3,0,3,0.27920371738274696
6627,703-004-5390,3026.6875,8,2,6,0.9091148385626968
6908,703-004-5381,3123.4683,5,2,3,1.042762169925754
7343,703-004-5399,836.00104,3,1,2,0.4590130926562781
7428,703-004-5394,7116.0913,6,5,1,1.399508162100561
7547,703-004-5386,7366.562,4,2,2,0.7716669976314836
7717,703-004-5389,2263.5728,4,4,0,2.724639882446777
7879,703-004-5388,9403.3,3,2,1,0.7562279037491344
8194,703-004-5381,598.0796,4,1,3,0.4601185859604878
8224,703-004-5391,9168.864,4,1,3,0.5165268771580819
8349,703-004-5394,1339.4731,4,3,1,1.4234563435151062
874,703-004-5385,7523.18,2,2,0,0.5859845677046414
878,207-008-2399,6399.3857,5,1,4,0.6390126606649351
8798,703-004-5388,4272.888,6,4,2,1.419024145012277
8988,703-004-5382,1083.8246,7,4,3,1.493457342298201
9281,703-004-5395,2483.9646,2,0,2,0.27920371738274696
9455,703-004-5398,306.73743,3,1,2,0.5172540913542684
9780,703-004-5383,4794.2603,3,1,2,0.5401451887541899
9972,703-004-5393,5246.468,3,1,2,0.4434539529854838
10022,703-004-5397,9837.682,6,3,3,1.2056272638709844
10059,703-004-5383,8430.947,4,3,1,0.9697058687533046
10168,703-004-5380,8157.208,4,1,3,0.634132850513032
10190,703-004-5394,348.2163,6,3,3,1.1192360183508652
10819,703-004-5391,6870.829,2,1,1,0.4266110649982019
11408,207-008-2398,1434.6903,4,1,3,0.5030423070658473
11572,703-004-5387,1003.0246,4,3,1,0.9811355170820487
1203,703-004-5393,1785.3582,3,2,1,0.8736703412241511
12262,703-004-5393,2730.1877,2,1,1,1.2597878841874564
12351,207-008-2398,7839.6387,2,2,0,1.1118703152432694
12401,207-008-2398,8803.183,5,5,0,1.0380185717323693
12623,703-004-5395,1165.2649,5,4,1,1.9654513238234237
12685,703-004-5382,5957.573,2,1,1,0.38345697974030424
12800,703-004-5390,1572.9529,"","","",0.27920371738274696
12870,703-004-5390,6926.41,2,2,0,1.0786477019545957
12938,703-004-5382,4459.457,"","","",0.27920371738274696
13013,703-004-5383,504.08304,6,2,4,1.1000321282787808
13124,703-004-5392,7248.6616,2,0,2,0.27920371738274696
1331,703-004-5382,6542.309,2,0,2,0.27920371738274696
13394,703-004-5386,8899.552,3,2,1,0.808314238580425
13450,703-004-5383,9834.167,2,0,2,0.27920371738274696
13631,703-004-5393,4302.665,2,0,2,0.27920371738274696
14002,703-004-5397,6149.198,5,1,4,1.0250849138831595
14109,703-004-5399,7236.128,4,0,4,0.27920371738274696
14171,703-004-5392,3026.7102,2,2,0,0.8275890011983691
14242,207-008-2399,9085.37,3,3,0,0.9175384925698379
14390,703-004-5393,7939.9834,3,1,2,0.4140446800822855
14396,703-004-5388,7020.6196,1,0,1,0.27920371738274696
14867,703-004-5380,8483.669,1,0,1,0.27920371738274696
14870,703-004-5388,2740.3606,7,5,2,1.7579086154062604
15402,703-004-5381,9923.824,7,3,4,1.9858840853430473
15898,703-004-5392,3078.55,2,0,2,0.27920371738274696
1625,703-004-5395,3882.6836,3,1,2,0.33853450732658075
16328,703-004-5396,1137.715,4,2,2,0.4820530787446753
16435,703-004-5397,970.0513,3,2,1,0.7721823582427961
16543,703-004-5382,9610.735,7,4,3,3.008065408341669
16547,703-004-5380,1766.1774,2,1,1,0.38532342750728743
1656,703-004-5388,1600.5159,3,0,3,0.27920371738274696
16819,703-004-5380,6772.9443,4,2,2,1.0389361436487725
16857,703-004-5394,4012.1614,1,0,1,0.27920371738274696
16985,703-004-5383,2606.3066,5,3,2,2.0118277274660152
17008,703-004-5391,1396.7354,3,2,1,0.6147705196946814
17039,703-004-5384,7822.5444,3,1,2,0.6841782963561165
17811,703-004-5389,3533.6619,7,5,2,1.7762329109305688
18528,703-004-5384,2343.3835,1,0,1,0.27920371738274696
18810,703-004-5383,6312.1665,2,1,1,0.5830008496918005
1883,703-004-5389,9666.934,"","","",0.27920371738274696
1890,703-004-5397,336.38358,3,1,2,0.5778769968166576
19108,703-004-5380,1879.9973,2,2,0,0.5386760799108559
1922,703-004-5387,5758.853,2,0,2,0.27920371738274696
19272,703-004-5392,4199.3374,3,2,1,0.836674746332218
19780,703-004-5380,4557.1304,7,2,5,0.4684774606024189
20297,703-004-5394,3940.7039,4,3,1,2.3266112534975614
20369,703-004-5384,1895.3455,6,2,4,0.5099029152866059
20437,703-004-5387,4411.4087,4,4,0,2.032630084950205
2049,703-004-5396,8875.455,5,5,0,2.1283529360665443
2051,703-004-5398,474.53403,5,3,2,0.8689115841563962
20802,703-004-5380,2827.074,2,2,0,0.77951897101623
20918,703-004-5383,3020.246,3,1,2,0.5385985777551872
21023,703-004-5380,77.368614,1,0,1,0.27920371738274696
21150,703-004-5394,7101.8403,5,2,3,0.8269158236480881
21262,703-004-5394,4508.121,3,2,1,2.013049518361303
21386,703-004-5381,2110.1064,2,0,2,0.27920371738274696
21624,703-004-5387,4329.6875,3,0,3,0.27920371738274696
21905,703-004-5387,1942.8104,3,1,2,0.4064319102300921
22299,207-008-2398,7458.731,3,2,1,0.5507943322091894
23160,703-004-5388,7152.213,5,4,1,1.1042182699408272
23458,703-004-5399,5604.161,5,2,3,0.669386940202491
24022,207-008-2398,1869.4132,6,1,5,0.38532342750728743
24150,703-004-5399,763.61835,5,2,3,1.1091381359545762
24210,703-004-5397,1373.7213,6,1,5,0.7270937708374616
24414,703-004-5397,8856.25,8,4,4,1.1036064359644093
24426,703-004-5396,1724.1853,2,1,1,0.7799953708979814
2485,703-004-5392,3536.3315,6,3,3,0.719013623165196
24850,703-004-5387,5629.2017,4,0,4,0.27920371738274696
24854,703-004-5381,5764.3677,3,1,2,0.33853450732658075
24874,703-004-5398,148.2159,7,4,3,1.3380220040164197
2500,703-004-5394,8192.476,2,0,2,0.27920371738274696
25127,703-004-5397,4035.4663,3,2,1,0.3985920994472264
25157,703-004-5399,8359.893,8,3,5,1.1037284356790102
2566,703-004-5398,7926.0864,7,3,4,1.8129967233056556
26168,703-004-5394,6596.5825,3,1,2,0.41960398883400196
26348,703-004-5397,6057.4546,4,2,2,0.9826230805105118
26356,703-004-5380,877.92755,3,1,2,0.3486207416170325
26531,703-004-5380,11.21521,3,3,0,0.8956569359980492
26603,703-004-5392,336.56,5,2,3,1.112267803214503
26671,703-004-5391,2531.379,3,2,1,1.20168350529187
26688,207-008-2398,3279.093,5,2,3,0.44129419945117687
26825,703-004-5399,9923.45,3,0,3,0.27920371738274696
26932,703-004-5390,2336.2876,4,3,1,1.8979608400873027
27439,703-004-5395,5253.153,7,5,2,2.642507315884631
27608,703-004-5397,6546.471,3,1,2,0.9277517308992351
27631,207-008-2398,5891.858,2,1,1,0.663906284709696
27868,703-004-5393,7440.4653,4,1,3,0.3902511792276225
27873,703-004-5380,6294.163,8,5,3,2.698611629068839
2817,703-004-5384,6078.3584,3,3,0,0.948313453286168
28191,207-008-2398,8369.785,4,2,2,0.9509203944091073
2859,703-004-5385,4113.34,5,2,3,1.083435257374448
28602,703-004-5390,1781.45,3,1,2,0.8522512112467983
2864,703-004-5395,7022.8223,3,2,1,0.9284544036985153
28645,703-004-5392,4953.475,"","","",0.27920371738274696
28740,703-004-5390,4589.7725,3,2,1,0.5316693370523338
28927,703-004-5387,4166.676,3,2,1,0.694024823740051
28963,703-004-5395,8443.966,2,1,1,0.7565944789327446
29415,703-004-5396,451.5344,4,2,2,0.713932232150002
29590,703-004-5383,9394.942,4,2,2,1.1388039058096644
29989,703-004-5382,7761.5977,5,3,2,0.7508047034475944
30114,703-004-5399,3572.0188,2,1,1,0.34045286953476467
30486,703-004-5398,4848.4136,4,1,3,1.473081682590424
30495,703-004-5381,3503.5085,4,2,2,1.2349278722893628
31287,703-004-5394,64.82423,5,2,3,1.1122421121231956
31377,703-004-5396,8765.78,1,0,1,0.27920371738274696
31707,703-004-5399,5975.8306,"","","",0.27920371738274696
31731,703-004-5387,866.78864,1,0,1,0.27920371738274696
31791,703-004-5389,2408.6755,4,2,2,0.5097108406439094
3246,703-004-5398,6371.6377,5,2,3,2.3428097968491137
32618,703-004-5391,2948.8135,4,1,3,0.6112956421783647
32621,703-004-5380,1951.84,6,3,3,1.3910348430724837
32785,207-008-2399,8639.719,1,1,0,0.575121058863988
32929,703-004-5381,5239.176,1,1,0,0.6173892200625992
33257,703-004-5398,5998.4927,3,2,1,0.9458924214553637
33543,703-004-5391,6694.3926,3,3,0,1.6533134067043564
33544,703-004-5384,2693.1274,3,2,1,0.9283757529405128
33692,703-004-5385,3862.791,3,2,1,0.7033721509008152
33972,703-004-5382,4251.7583,3,1,2,1.1932921850592881
34189,207-008-2399,4549.228,"","","",0.27920371738274696
34407,703-004-5398,8979.172,2,2,0,0.4275754692087432
347,207-008-2399,8109.1553,4,3,1,1.116273065203648
34836,703-004-5395,7057.6865,4,2,2,0.6128371877010855
34982,703-004-5396,8165.969,3,0,3,0.27920371738274696
35058,703-004-5392,9298.351,5,2,3,1.3464257013359182
35119,703-004-5391,1768.9961,4,4,0,2.804494792303468
35145,703-004-5398,319.62335,4,1,3,0.35831143730785864
35433,703-004-5387,4161.646,2,0,2,0.27920371738274696
35539,703-004-5389,201.31827,6,5,1,1.9571604342358182
35690,703-004-5392,156.12543,1,1,0,0.8539975007170245
36133,703-004-5393,4971.5913,7,3,4,1.049753527351722
36177,703-004-5397,7874.053,8,8,0,2.172314966261352
36204,703-004-5399,2412.3691,3,1,2,1.9608346779415506
36393,703-004-5381,7138.2725,10,5,5,1.3376507843068066
36462,703-004-5385,7578.8413,3,3,0,0.7538500369334169
36883,703-004-5384,3823.7297,3,1,2,0.5337135348331103
3689,703-004-5385,7270.303,6,3,3,1.7226784410192963
37352,703-004-5392,4678.7935,3,1,2,1.0067908185156604
37593,703-004-5399,9046.716,4,2,2,0.9431233761963601
37680,207-008-2398,114.49754,4,2,2,0.9301829790133204
37938,703-004-5382,2.8151274,2,2,0,0.5941687233305079
38115,703-004-5380,7808.855,8,2,6,0.41764222725169237
38144,703-004-5383,1649.8888,3,0,3,0.27920371738274696
38338,703-004-5390,359.34567,4,3,1,0.7920375671807354
38592,703-004-5383,8354.499,5,4,1,1.5186705679973909
38897,703-004-5383,2299.841,5,5,0,2.895015530248685
3917,703-004-5393,1343.2097,2,1,1,0.4451344601344843
39341,703-004-5399,221.06946,5,4,1,1.4492198795224847
39636,703-004-5382,2456.0605,1,0,1,0.27920371738274696
39978,703-004-5380,1504.6656,4,2,2,2.018771661016712
40277,207-008-2398,7708.495,6,4,2,1.4046865086943812
40389,703-004-5397,5618.116,3,3,0,1.6429507783259516
40429,703-004-5390,1848.9677,3,1,2,0.4258748481786801
40488,703-004-5387,988.75226,5,3,2,0.7934268718619291
40731,703-004-5397,1435.3854,5,3,2,1.3558262415540476
4128,703-004-5392,2671.0974,5,3,2,1.2881455713012955
41440,703-004-5381,670.864,6,3,3,1.6398955691574055
41535,207-008-2399,6481.8896,7,2,5,0.5112231061038706
41550,703-004-5399,6137.3496,2,2,0,1.3968906443871922
41601,703-004-5382,9211.207,2,0,2,0.27920371738274696
4184,703-004-5398,4798.4863,3,1,2,1.500723575192839
41910,703-004-5388,9361.664,2,2,0,0.5366993457389854
42092,207-008-2399,4879.0376,3,2,1,1.0060487086570442
42237,703-004-5389,1293.9155,5,2,3,0.576248299387204
42474,703-004-5393,289.7382,5,1,4,0.428470096416442
42500,703-004-5384,8735.723,4,2,2,0.4926791587680897
43055,207-008-2399,2469.5796,4,4,0,2.8215148995268997
43187,703-004-5384,5627.076,5,0,5,0.27920371738274696
43684,703-004-5382,792.79663,4,3,1,2.0193234347670495
43738,703-004-5393,4247.355,6,2,4,2.0311391898442177
43834,703-004-5390,7775.793,7,6,1,3.840248664942487
44145,703-004-5395,3494.0493,7,5,2,0.9352673348764947
44197,207-008-2399,5924.871,4,0,4,0.27920371738274696
44264,703-004-5390,9472.306,4,1,3,0.460782554011072
44393,703-004-5396,8910.289,5,3,2,2.1874269267964808
44455,703-004-5382,3088.1672,5,2,3,0.9446654276977187
44556,703-004-5398,5863.047,5,1,4,0.5837684390944268
44576,703-004-5382,4573.8994,5,2,3,0.9718072632296014
45073,703-004-5394,7271.191,6,6,0,1.7944922406912518
45167,703-004-5397,6959.31,6,4,2,1.2869528454767731
45338,207-008-2399,3252.6184,5,4,1,1.7939854202613787
45346,703-004-5382,5856.4697,4,3,1,1.3974963482909015
4551,703-004-5392,9660.379,7,5,2,1.5252277061083557
45680,207-008-2398,1842.8314,6,2,4,0.7472626761185329
45686,703-004-5385,2091.9292,8,3,5,0.6288086117094972
45753,703-004-5381,2525.727,5,4,1,1.0524213415488077
46058,703-004-5396,5445.8354,1,0,1,0.27920371738274696
46208,703-004-5385,4447.116,3,1,2,0.32666834933781397
46237,703-004-5396,5174.7793,4,1,3,1.8017088301749797
464,703-004-5390,4144.921,2,1,1,0.5071445364970073
4641,703-004-5390,8108.9263,9,6,3,4.52999434252034
46609,703-004-5395,4202.016,4,2,2,1.218630026390701
46792,703-004-5394,3150.0708,3,1,2,0.5983715222080354
46934,703-004-5395,4541.1987,3,1,2,0.5309552628300697
47132,207-008-2399,6552.8257,4,2,2,1.1472391394738246
47188,703-004-5383,1393.3801,3,2,1,0.8090470300171767
4720,703-004-5397,7261.2275,7,1,6,0.6826699726757228
47297,703-004-5382,2101.7676,"","","",0.27920371738274696
47787,703-004-5381,5458.434,7,3,4,0.7797625846836111
4779,703-004-5392,4841.918,4,3,1,1.125599013514175
47810,703-004-5387,1614.0896,5,2,3,0.6726367025552694
47819,703-004-5387,7779.576,3,1,2,0.3316724905947
48313,703-004-5381,2926.579,4,2,2,2.3833032335156115
48437,703-004-5398,8161.4844,5,0,5,0.27920371738274696
48502,703-004-5386,864.7895,3,2,1,1.0108689961040203
48783,703-004-5392,4667.813,4,3,1,1.6091485117353101
48906,703-004-5388,7209.096,7,4,3,2.567889906824348
49069,703-004-5386,9591.115,6,3,3,1.3492019621845555
49173,703-004-5393,252.07698,7,1,6,0.39657116849562796
49588,703-004-5389,2858.5046,7,3,4,1.741976967648455
49753,703-004-5389,1758.0236,6,2,4,1.373430416537547
49893,207-008-2398,1311.9478,"","","",0.27920371738274696
49897,703-004-5398,8687.992,5,1,4,0.4242009494644841
5168,703-004-5384,8706.578,1,1,0,1.4980044632953748
5217,703-004-5398,3984.2498,4,3,1,0.8767753632433971
5975,703-004-5391,6466.392,"","","",0.27920371738274696
6032,703-004-5388,6869.126,2,0,2,0.27920371738274696
6166,703-004-5383,3297.507,6,1,5,0.6618662562703351
6572,703-004-5390,1423.9216,1,1,0,0.4314860782385869
6583,703-004-5391,7160.799,7,3,4,0.8261505580198005
6838,703-004-5397,2078.15,3,3,0,1.0451291870245063
7133,703-004-5395,2618.2659,9,4,5,1.0035810117933015
7356,703-004-5390,6509.6475,"","","",0.27920371738274696
7525,703-004-5384,2617.6726,5,1,4,0.9786795356852499
8321,703-004-5390,431.64374,3,1,2,0.42404408597410803
8331,703-004-5384,4384.1396,"","","",0.27920371738274696
8460,703-004-5388,3187.213,5,3,2,0.9822226449006749
8636,703-004-5396,572.6397,7,0,7,0.27920371738274696
8690,703-004-5382,9794.791,2,2,0,1.000917136241708
8713,703-004-5386,6020.476,3,2,1,0.9851283945317254
8850,703-004-5389,7230.6865,5,4,1,1.7326514871917187
8953,703-004-5393,2517.4314,4,2,2,2.041047027368167
9167,703-004-5399,5375.6606,9,5,4,4.221394994107741
9238,207-008-2398,6825.6274,4,3,1,0.7535921305925168
9253,703-004-5381,1342.5977,11,6,5,1.8161074677482587
9398,703-004-5394,7330.8716,3,3,0,0.9690938224255655
9490,703-004-5388,3482.7036,2,1,1,0.39977706716860467
9696,703-004-5395,2867.35,1,0,1,0.27920371738274696
10249,703-004-5381,533.0664,6,3,3,3.0188947031424216
10643,703-004-5395,5069.329,4,0,4,0.27920371738274696
10753,703-004-5397,2319.0886,4,2,2,1.0839769444985596
10774,703-004-5391,4961.8022,5,3,2,1.1049381953792572
10925,703-004-5391,3521.2397,2,2,0,0.7203344961632095
1126,207-008-2398,9754.713,7,3,4,1.4796874754766165
11354,703-004-5382,4352.889,2,0,2,0.27920371738274696
11375,207-008-2398,8970.891,2,2,0,0.7402626461169002
11417,703-004-5382,6801.126,3,2,1,2.071729730147759
11551,703-004-5383,6974.2163,5,4,1,1.080511509012828
11669,703-004-5388,290.47488,6,2,4,1.0944954674596903
12103,703-004-5381,7148.633,5,3,2,0.9352377531105404
12213,703-004-5381,4138.1777,6,2,4,0.9110194449423025
12288,703-004-5389,8800.265,2,0,2,0.27920371738274696
12458,207-008-2398,4414.1226,3,0,3,0.27920371738274696
12746,703-004-5385,5853.3174,1,0,1,0.27920371738274696
12845,703-004-5387,267.4681,5,4,1,1.4305096457590696
12973,703-004-5395,5886.189,4,3,1,1.1758172563971256
13273,703-004-5396,4132.4707,6,5,1,2.516183431733084
13607,703-004-5396,8012.909,1,0,1,0.27920371738274696
13899,207-008-2399,1873.1237,5,4,1,1.625451699430794
14138,703-004-5382,3947.2402,4,3,1,1.0092397063400103
14296,703-004-5392,9227.595,7,3,4,0.7415961099641827
14544,703-004-5384,1449.8258,5,2,3,0.8725646526797216
1478,703-004-5387,6910.762,3,3,0,1.1011205850878942
14825,703-004-5384,5372.066,7,2,5,1.017869580067229
150,703-004-5382,9434.383,6,0,6,0.27920371738274696
15009,703-004-5390,4715.825,4,2,2,1.3913980102029726
15102,703-004-5393,2710.241,2,2,0,2.7352875156091123
15517,703-004-5387,2702.958,3,2,1,0.644941944092316
15662,703-004-5389,331.15207,8,3,5,1.166019420964153
15723,703-004-5396,5609.93,4,2,2,0.9794468736547507
15782,703-004-5391,4913.2993,"","","",0.27920371738274696
15948,703-004-5387,3900.7114,5,3,2,0.8187522970709827
16024,703-004-5385,5557.584,1,1,0,0.44815356570860276
16456,703-004-5390,2706.8657,2,0,2,0.27920371738274696
1672,207-008-2398,6786.114,3,1,2,0.35831143730785864
16777,207-008-2398,6005.6494,6,4,2,1.3001186066064936
17210,703-004-5391,2409.402,5,4,1,1.864506304300293
17261,703-004-5392,7657.486,2,2,0,1.552749945672106
17271,703-004-5381,153.0701,3,2,1,0.538273584297385
17405,703-004-5387,4491.7227,3,1,2,0.6872964305299053
17648,703-004-5399,5674.207,4,1,3,1.104103817751373
17670,703-004-5391,9272.174,3,3,0,0.9040544795373266
17895,703-004-5382,4982.205,2,1,1,0.8527336392519705
18036,703-004-5397,2280.3562,"","","",0.27920371738274696
18194,207-008-2399,5833.6313,2,1,1,0.44286634947995257
18275,703-004-5391,8696.7705,5,0,5,0.27920371738274696
18406,703-004-5380,2781.9597,4,3,1,1.1306769181457774
18482,703-004-5381,4117.763,4,3,1,4.609215069952355
18689,207-008-2398,5286.712,4,2,2,0.45285432796086833
18821,703-004-5392,4821.494,3,2,1,0.6622569250754806
18932,703-004-5399,3223.0698,1,1,0,0.5792174216777471
19026,703-004-5398,6928.1772,3,0,3,0.27920371738274696
19037,703-004-5398,8686.487,2,0,2,0.27920371738274696
19234,703-004-5396,9138.326,6,2,4,1.807019493840393
19548,703-004-5394,7901.9575,7,3,4,1.2350581037652935
19789,207-008-2399,6947.774,6,4,2,1.0925392355075807
20155,207-008-2398,6759.67,8,4,4,1.4595011837852037
20163,703-004-5399,7608.7134,"","","",0.27920371738274696
20350,703-004-5380,9807.347,1,1,0,1.5868574901270343
2082,703-004-5381,4556.2085,1,1,0,0.5613226700091778
20836,703-004-5396,2565.2725,6,1,5,0.4532122471599821
21033,703-004-5388,7417.0703,5,2,3,1.0373964137223282
21428,703-004-5387,454.59033,3,2,1,1.6555990544166457
21479,703-004-5385,5012.1953,6,5,1,0.5719022811056601
2225,703-004-5384,9874.15,2,1,1,0.9659290797278965
22672,703-004-5392,4863.6157,8,5,3,3.1223028766119754
22820,703-004-5385,283.23828,4,4,0,1.1322979218392246
23014,207-008-2398,1045.9792,6,1,5,0.44829646872267315
23216,703-004-5384,742.87177,6,1,5,0.3565006121564479
23426,703-004-5381,1400.9398,4,3,1,0.8607440213095393
23503,703-004-5380,9194.094,4,2,2,1.11092116965217
23682,703-004-5390,7692.3145,3,2,1,0.7342628582884164
23683,703-004-5381,3609.0266,4,3,1,1.024342146316051
23775,703-004-5399,143.47374,6,2,4,0.5832286358180987
23974,703-004-5397,5559.9194,2,1,1,0.34866894788386177
24010,703-004-5386,8955.192,3,2,1,2.0195631015775923
24154,703-004-5387,6712.6875,4,3,1,2.027189582243212
24323,703-004-5389,7568.6787,4,2,2,1.1348995902208083
24337,703-004-5397,6432.7104,4,2,2,0.7196461731721907
24440,703-004-5383,338.10556,2,1,1,0.4315363234099965
24616,703-004-5380,2610.3586,6,3,3,1.6986851158681051
24685,703-004-5389,2417.2097,2,0,2,0.27920371738274696
25036,703-004-5394,1885.3319,3,1,2,1.012620305686181
25175,703-004-5392,4781.956,3,1,2,1.8192672076045937
25274,703-004-5384,9107.15,6,3,3,1.85681905388314
25380,703-004-5389,6373.0703,3,1,2,1.3747313772203702
25525,703-004-5391,4458.9395,6,4,2,0.9714263912450317
26055,703-004-5385,3775.0513,1,1,0,0.5479448411367135
26122,703-004-5383,3679.1665,1,1,0,0.39175924443767807
26144,703-004-5383,2530.3232,2,2,0,0.8191952295101912
26197,703-004-5390,884.1693,5,3,2,2.0584298599294772
26250,703-004-5391,2014.9672,2,2,0,0.9642658149667511
26351,703-004-5380,1819.9015,3,2,1,0.5851165677786389
26414,703-004-5389,565.7595,2,2,0,0.6879145358033782
26763,703-004-5384,2472.8625,5,2,3,1.1012314272865367
26892,703-004-5384,1936.1257,4,1,3,0.4781632081736695
269,703-004-5388,9210.2295,2,1,1,0.3187575773453028
27170,703-004-5395,3843.3499,7,2,5,0.5600366695854423
27518,703-004-5390,9496.864,5,3,2,0.7246587162367656
27569,703-004-5393,9767.819,4,2,2,0.5219562451592401
277,703-004-5383,4996.7866,4,0,4,0.27920371738274696
27718,703-004-5399,7511.5747,2,1,1,1.3615254774666745
28047,703-004-5393,4059.071,2,0,2,0.27920371738274696
28203,703-004-5393,5950.669,3,1,2,0.3978652972704144
28219,703-004-5389,9215.287,8,5,3,2.2075921911305127
28369,207-008-2398,489.41733,4,2,2,0.5343580513214318
28534,703-004-5380,4937.4004,1,1,0,0.6258774376104267
28879,703-004-5388,148.63968,5,3,2,0.989725814123503
29100,703-004-5384,7627.9805,9,3,6,2.93166009628904
29147,207-008-2398,9989.05,2,1,1,0.7085484750832234
29194,703-004-5381,6415.3,6,1,5,0.6601403799467279
29547,703-004-5396,755.856,3,0,3,0.27920371738274696
29907,703-004-5384,572.39655,7,4,3,1.8392101014768858
29979,703-004-5398,6671.004,7,5,2,1.1353784047003859
30085,703-004-5391,9610.347,3,2,1,1.4557286426278793
30467,703-004-5397,2773.5222,6,4,2,1.4616102435607983
30875,703-004-5382,6832.491,1,1,0,0.41996396629891697
31109,703-004-5382,9988.634,5,4,1,0.9874333253566572
31380,703-004-5397,9363.675,3,0,3,0.27920371738274696
31410,207-008-2398,7214.6797,5,3,2,1.8965390892498657
31749,703-004-5394,5283.1763,7,4,3,1.232793410678251
32125,703-004-5392,6657.144,"","","",0.27920371738274696
32143,703-004-5384,6451.696,4,3,1,1.3093641342316367
32582,207-008-2398,5919.222,3,2,1,0.6151575453224775
32628,703-004-5384,8830.794,1,0,1,0.27920371738274696
33071,703-004-5399,1669.4188,6,3,3,1.9302839740974858
33252,703-004-5381,1024.6045,3,2,1,1.1099915247632701
33317,703-004-5396,1096.4817,2,0,2,0.27920371738274696
33342,703-004-5398,4627.05,4,2,2,1.3500871581208538
33355,207-008-2399,6138.7188,3,2,1,1.4158699246925142
33366,703-004-5399,4385.2656,2,1,1,0.7378941780564102
33772,703-004-5382,8157.921,3,2,1,0.6627099778717791
34358,703-004-5383,9272.52,4,4,0,1.0472984012498994
34668,703-004-5391,965.5035,5,1,4,0.9715145838057541
34978,703-004-5384,3314.7961,5,0,5,0.27920371738274696
35036,703-004-5399,172.27113,"","","",0.27920371738274696
35191,703-004-5397,844.73846,6,1,5,0.5165268771580819
35423,703-004-5392,1568.8247,2,1,1,0.3468408179187174
35504,703-004-5388,6608.522,4,3,1,1.144297111185728
35547,703-004-5385,4711.2383,5,2,3,0.793614941937659
35758,703-004-5382,4715.5645,7,3,4,1.5193300022949319
35773,703-004-5384,49.33834,5,2,3,1.0000688249678038
36222,703-004-5383,8612.877,1,1,0,0.9741298815855919
36913,703-004-5380,2765.6907,"","","",0.27920371738274696
37042,703-004-5385,7901.5312,1,0,1,0.27920371738274696
37516,703-004-5392,5662.281,7,5,2,2.677391660994086
37926,207-008-2399,9286.093,5,4,1,2.2108562358132957
38109,703-004-5382,5131.9097,4,3,1,0.8175078424998987
38656,703-004-5391,4943.916,1,0,1,0.27920371738274696
38862,703-004-5393,7529.322,3,1,2,0.3676354821074616
38953,703-004-5384,9073.571,4,1,3,1.1585419639923522
39269,703-004-5392,495.38254,3,0,3,0.27920371738274696
40298,703-004-5398,6892.338,4,2,2,1.0971661411967253
40400,703-004-5394,8042.4814,2,1,1,0.6703689755881796
40416,703-004-5399,5595.269,3,0,3,0.27920371738274696
40501,703-004-5390,8046.9946,2,1,1,0.5040942513964947
40913,207-008-2399,5941.9595,2,2,0,0.5189495510807883
41147,703-004-5382,9707.892,3,1,2,0.4589049717661095
41175,207-008-2398,5445.573,2,1,1,0.4087426087601173
41355,703-004-5385,1920.2144,4,2,2,0.43933893843588034
4143,703-004-5385,9579.503,4,3,1,1.0753204836191104
41609,703-004-5383,7235.4106,3,2,1,0.45693569096949466
41669,703-004-5380,1467.8353,4,3,1,1.7162712999565692
41736,703-004-5398,8524.524,6,4,2,0.9200710523091897
41794,703-004-5384,4360.2554,4,2,2,0.7657001011601747
41805,703-004-5393,1640.9403,4,2,2,1.0522475225354928
41949,207-008-2398,1792.2944,4,3,1,0.7275317483673021
42002,703-004-5381,4163.8335,6,3,3,1.3964682850669554
4209,703-004-5392,9403.541,4,1,3,1.6757967510709997
42322,703-004-5390,9693.897,2,1,1,0.4314860782385869
42408,703-004-5381,8109.784,4,2,2,0.6280553486870694
42504,703-004-5387,2816.8887,2,1,1,0.5669580486103406
42893,703-004-5386,7191.0327,"","","",0.27920371738274696
42910,703-004-5393,154.01065,3,2,1,0.5436424055335151
43028,703-004-5385,9047.41,3,1,2,0.3978652972704144
43073,703-004-5387,1600.055,4,2,2,0.48104811946496834
43214,207-008-2399,6252.8984,3,1,2,0.41182451368219974
43399,703-004-5385,4762.9,3,2,1,0.4694014618322486
43528,703-004-5396,47.926903,2,1,1,0.4281465203940294
43722,703-004-5396,483.15167,3,1,2,1.644044197589569
44618,703-004-5384,8095.241,4,2,2,0.4536087647176418
45094,703-004-5399,5221.377,2,1,1,0.7136958150442895
4581,703-004-5387,3733.1145,5,2,3,0.5565966543144993
45918,703-004-5390,5161.363,2,1,1,0.7966525409967065
46035,703-004-5399,1485.9486,5,2,3,0.7234913094125812
46280,703-004-5395,8586.7,4,1,3,0.5211714852662627
46338,703-004-5382,766.54376,3,0,3,0.27920371738274696
46474,207-008-2399,3582.341,2,1,1,0.4270472561761223
46657,703-004-5383,6723.0273,7,3,4,2.328317721212019
46686,703-004-5398,618.1478,5,2,3,0.8961924402695483
4707,703-004-5380,6626.179,1,1,0,0.3978652972704144
47127,703-004-5381,6634.388,4,3,1,2.1715507167115806
47152,207-008-2399,8042.894,2,1,1,0.7241210243520557
47389,703-004-5388,1305.3632,4,1,3,0.9149906757999068
47728,703-004-5388,9039.284,2,2,0,0.9622056937086538
47852,703-004-5391,2871.0645,4,2,2,0.5920632282514514
47893,703-004-5389,5896.674,7,5,2,1.4399805229320464
48018,703-004-5392,1565.3491,2,0,2,0.27920371738274696
48053,703-004-5384,3831.2595,2,1,1,0.3978652972704144
48529,703-004-5395,3148.6636,2,0,2,0.27920371738274696
48965,703-004-5396,3460.893,7,3,4,0.929202660603798
49114,207-008-2398,6429.7334,5,2,3,0.43445261773577853
49302,703-004-5385,4526.811,3,2,1,1.0546685721286053
4958,703-004-5382,4249.6084,3,1,2,0.35831143730785864
49761,703-004-5389,4326.304,5,4,1,1.922209691962077
5175,703-004-5388,3993.3782,4,3,1,2.405582093589878
526,703-004-5392,7183.6187,5,3,2,1.2840698879001957
5375,703-004-5386,8847.455,5,2,3,1.6076815792756152
5465,703-004-5386,9694.864,5,3,2,0.8133973225963684
5674,703-004-5390,8911.064,5,1,4,0.7381283087620876
5680,703-004-5399,3979.4265,"","","",0.27920371738274696
5698,703-004-5381,1468.7585,3,2,1,1.2152873175319883
6018,207-008-2399,7051.422,4,4,0,1.0737839940357208
623,703-004-5390,5816.902,3,2,1,1.122447167449045
6383,703-004-5395,7865.6772,4,2,2,1.5369489866194403
6462,703-004-5394,9298.228,3,0,3,0.27920371738274696
6511,703-004-5381,5124.278,1,0,1,0.27920371738274696
6646,703-004-5383,5553.0117,5,1,4,0.43652184366760577
7617,703-004-5391,3727.0535,4,3,1,0.8010693425656794
7751,703-004-5386,8066.9326,3,3,0,0.9176543793296423
7763,703-004-5382,1501.7235,4,2,2,1.4839945612999557
7812,703-004-5395,2554.3738,4,1,3,0.5999915162238353
794,703-004-5389,3803.5042,1,1,0,0.5165268771580819
8252,703-004-5392,3738.8843,1,0,1,0.27920371738274696
8434,207-008-2398,7198.2344,4,2,2,0.9408409133638947
8655,703-004-5398,6227.885,2,0,2,0.27920371738274696
8866,703-004-5399,4986.0645,2,0,2,0.27920371738274696
8905,703-004-5389,9281.885,4,3,1,1.411559376750923
8986,703-004-5391,5686.7217,6,2,4,1.1014799457227638
9029,703-004-5392,2461.4333,5,2,3,0.8988325073245955
9185,703-004-5382,8171.4775,3,2,1,0.9962518778770135
9331,703-004-5394,7313.308,3,3,0,1.2708380760319722
9458,703-004-5399,6235.0957,2,1,1,0.44305852085286834
952,703-004-5396,1501.4744,4,2,2,1.0040597589706757
9641,703-004-5392,202.16763,7,6,1,1.8888461409776076
9711,703-004-5397,1632.1086,5,3,2,1.5490232621812614
9773,703-004-5392,8143.157,2,2,0,2.430658392412018
9955,703-004-5382,4284.662,"","","",0.27920371738274696
10037,703-004-5396,1151.1158,6,3,3,0.9897304019720324
10266,703-004-5398,6610.4404,5,3,2,0.904239179520063
10608,703-004-5397,8125.8906,4,3,1,1.2656208019415185
11365,207-008-2399,9520.609,4,2,2,0.9645607463162705
11584,703-004-5387,8698.935,3,2,1,1.4325374981442476
11716,703-004-5396,5531.8296,2,1,1,0.3187575773453028
1173,703-004-5394,3263.6172,2,1,1,0.7272868355303799
1202,703-004-5391,7122.7344,3,0,3,0.27920371738274696
12087,703-004-5385,2763.117,2,0,2,0.27920371738274696
12220,703-004-5382,245.05496,2,1,1,0.4901257466209106
12325,703-004-5397,7694.7876,1,1,0,0.4390013116314725
12411,703-004-5394,933.8689,6,3,3,3.271369548671749
12436,703-004-5386,9080.572,6,0,6,0.27920371738274696
12567,703-004-5386,3932.783,3,1,2,1.3782457440230191
12639,703-004-5398,7802.6426,4,2,2,0.5057187849233135
12803,703-004-5389,6736.1807,5,3,2,1.0408915835108798
13019,703-004-5395,8551.019,3,3,0,1.3166181677355477
13280,703-004-5381,1474.036,3,0,3,0.27920371738274696
13440,703-004-5394,7302.7476,2,1,1,0.6665177649634946
13682,703-004-5388,1916.5045,2,0,2,0.27920371738274696
13739,703-004-5380,1065.2703,3,0,3,0.27920371738274696
13743,703-004-5386,7571.524,5,5,0,1.4176198673303186
13912,207-008-2399,8239.469,4,2,2,1.13736233606553
14393,703-004-5395,4908.5415,3,1,2,0.4154066479978971
14675,703-004-5380,7675.2925,3,2,1,0.9536800141720935
14877,703-004-5380,6479.241,1,0,1,0.27920371738274696
15669,703-004-5387,2356.5872,7,5,2,2.9934357907577165
15740,703-004-5390,2508.8394,2,0,2,0.27920371738274696
15777,207-008-2398,129.8356,2,0,2,0.27920371738274696
1597,703-004-5385,8386.036,6,3,3,0.8310548407447398
1599,703-004-5384,1891.244,4,2,2,0.6712609093366053
16099,207-008-2398,3938.8628,3,2,1,0.8273012240526653
1612,703-004-5391,2944.0303,5,5,0,1.917404143561445
16333,703-004-5391,4741.356,2,1,1,0.3978652972704144
16379,703-004-5395,3225.6782,4,1,3,0.5453446894165154
16502,207-008-2398,2313.1865,8,5,3,1.22975385928585
16506,703-004-5398,7353.964,6,3,3,0.7987607413977654
16812,703-004-5389,9469.467,4,2,2,1.1598181028878414
17756,703-004-5389,8578.626,3,3,0,1.3928579799599048
178,703-004-5398,3784.735,3,3,0,1.1801893178891603
17888,207-008-2399,1591.5155,5,3,2,0.7846327307348754
18379,703-004-5381,4975.2905,1,1,0,0.49913959039448924
18738,703-004-5382,4667.684,3,2,1,2.2806928324273774
18791,703-004-5387,661.7272,2,0,2,0.27920371738274696
19615,703-004-5390,4899.9663,4,1,3,0.4684689373035765
19618,703-004-5384,5163.164,4,2,2,0.7837908630794382
19738,703-004-5383,9828.944,5,2,3,0.5830658989514652
20207,703-004-5380,4091.621,5,1,4,0.4630250162942165
20267,703-004-5387,4570.4087,6,3,3,1.2438828647505489
20397,703-004-5394,4331.2983,2,1,1,0.33853450732658075
20485,703-004-5395,8423.858,4,2,2,1.3933740746551697
20753,207-008-2399,8128.6074,4,2,2,1.5777563894962097
20930,703-004-5386,377.95007,2,1,1,0.485834025501431
21295,703-004-5393,4674.0273,2,0,2,0.27920371738274696
2170,703-004-5390,4858.976,3,3,0,1.3754717406487604
21793,703-004-5391,5206.6147,2,0,2,0.27920371738274696
21998,207-008-2398,3380.2039,6,5,1,2.213657139501041
22104,703-004-5397,6688.021,5,2,3,0.8029627463869236
22199,703-004-5392,4902.87,5,2,3,0.7440162599950533
22463,207-008-2398,8680.16,6,6,0,2.8213448595846824
22488,703-004-5381,1230.1057,2,1,1,0.7032950622049676
22926,703-004-5385,4814.539,3,2,1,1.5431250250535173
23028,703-004-5392,8917.405,4,2,2,0.993973630094147
23055,703-004-5398,2370.351,5,4,1,2.1236842773534366
23793,703-004-5380,3160.295,4,1,3,0.578745187985299
2386,703-004-5394,6890.3906,6,3,3,1.1726368488962016
23912,207-008-2399,8542.102,3,2,1,0.5070326679275782
24043,703-004-5385,2454.949,5,2,3,0.6448466856098563
24156,703-004-5381,2155.2349,3,1,2,0.33853450732658075
24310,703-004-5387,1696.1796,5,2,3,1.3371953832929089
2433,703-004-5386,7782.622,5,1,4,0.3919322182760311
24402,703-004-5386,5546.84,3,2,1,0.6957417622359374
2446,703-004-5390,7291.6157,4,3,1,0.883009179912244
24537,703-004-5390,1621.412,5,3,2,1.1697229674730354
24607,703-004-5385,5530.949,2,1,1,0.5250027932752261
2489,703-004-5389,4709.2637,7,2,5,0.9140077678748851
24898,703-004-5394,5114.636,"","","",0.27920371738274696
25632,703-004-5397,2424.127,8,3,5,0.7671310735542755
25834,703-004-5392,4020.6243,2,0,2,0.27920371738274696
2606,703-004-5392,3566.2598,4,2,2,2.0595674031847877
26128,207-008-2399,4018.9128,5,4,1,2.2781197179723844
26305,703-004-5391,216.0871,4,2,2,1.0396322916402836
26450,703-004-5382,4141.157,3,3,0,1.6958867039853407
26548,703-004-5388,8526.44,3,0,3,0.27920371738274696
26694,207-008-2399,46.853424,5,2,3,0.8031598460707968
26740,703-004-5394,9701.424,3,0,3,0.27920371738274696
2681,703-004-5396,4533.927,9,3,6,1.4332724868800886
27143,703-004-5391,5823.1016,4,2,2,1.2124535773026774
27239,703-004-5380,9848.167,2,1,1,0.43753968342140503
27388,703-004-5392,5544.872,4,3,1,1.221681217881347
27407,703-004-5380,2139.2764,1,0,1,0.27920371738274696
27409,703-004-5382,1903.2056,3,1,2,0.4250411564263891
27572,703-004-5386,7747.7437,7,4,3,1.5068787201474
2804,703-004-5384,3486.235,4,1,3,0.35831143730785864
28054,703-004-5390,2353.8745,"","","",0.27920371738274696
28125,703-004-5395,8497.189,3,1,2,0.6921465937280342
28200,703-004-5394,773.0478,6,2,4,1.7497171262486404
28250,703-004-5391,2744.962,3,0,3,0.27920371738274696
28377,703-004-5396,4994.872,5,2,3,0.9407546781629922
28383,703-004-5387,1782.1073,3,2,1,2.178091135306955
28526,703-004-5385,7680.915,5,2,3,1.165013818412098
28580,703-004-5399,1446.3192,2,2,0,0.6764549706641949
28737,703-004-5394,1699.7063,3,2,1,0.9706601718998921
2885,207-008-2398,8227.373,4,1,3,0.5716678759007351
28895,703-004-5382,1940.5901,6,4,2,1.5857332144096827
29370,703-004-5394,4622.964,6,3,3,1.0797096753876778
29452,703-004-5391,7745.4136,2,1,1,0.6613695598274296
29518,703-004-5389,847.3587,3,2,1,0.6688092380139217
29578,703-004-5397,9140.188,5,1,4,0.4068967619618647
29788,703-004-5390,2431.069,3,2,1,0.708750509493939
29933,703-004-5385,3131.6567,5,2,3,0.5323461349474315
30059,703-004-5388,4273.3706,3,1,2,0.48491991016524705
30219,703-004-5389,299.6403,2,2,0,1.3732780873343005
30243,703-004-5394,7873.3154,7,4,3,3.522731306515088
3059,703-004-5385,7538.337,7,2,5,1.5278447727007927
30992,703-004-5384,9351.2705,5,1,4,0.7940008827412944
31030,207-008-2398,8885.88,"","","",0.27920371738274696
31175,703-004-5383,4254.8887,6,5,1,1.6344867454379808
31234,703-004-5395,7230.8213,2,1,1,0.424978177280706
31254,703-004-5385,5638.94,9,5,4,3.71152652559864
31511,703-004-5381,5668.0654,9,3,6,1.7132548493902124
3188,703-004-5380,5625.89,2,2,0,0.807277205173967
31921,703-004-5385,2419.2798,3,2,1,0.5449629586440421
32060,703-004-5397,6774.857,6,3,3,0.5387021258742145
32135,703-004-5394,6811.0215,5,2,3,0.5488841320441171
32192,207-008-2399,806.76495,2,1,1,0.6339870035279007
32232,703-004-5387,1073.6191,2,1,1,0.6556749107721649
3230,703-004-5396,7058.9824,3,2,1,0.5635930979699707
32328,703-004-5384,8935.386,2,1,1,0.444495919607396
32544,703-004-5397,8204.158,1,0,1,0.27920371738274696
33211,703-004-5386,7764.6367,5,4,1,1.7429923244541055
3367,703-004-5395,4198.5015,7,2,5,2.694946423977557
3381,703-004-5394,9504.044,2,0,2,0.27920371738274696
33932,703-004-5390,890.29193,1,1,0,0.9095687559254927
3394,703-004-5388,8928.214,5,2,3,0.7564467836646722
33953,703-004-5390,2694.897,5,2,3,0.4993868711743077
34091,703-004-5392,1191.8354,7,4,3,1.8985622301432301
34966,703-004-5387,5008.355,8,5,3,1.761032250695002
35116,703-004-5391,7658.465,5,3,2,1.3095964650870993
35194,703-004-5386,9731.366,3,1,2,0.628007450860458
35300,703-004-5397,3871.9194,1,0,1,0.27920371738274696
35600,703-004-5387,6118.533,2,0,2,0.27920371738274696
3574,703-004-5385,7241.174,5,4,1,1.1603196515574088
35847,207-008-2399,2286.2942,1,1,0,0.5990448830435174
36040,703-004-5386,3152.4104,6,2,4,0.6883806400574926
36056,703-004-5394,46.786667,8,3,5,0.8999484899833478
36592,703-004-5387,5060.343,5,1,4,0.5002003372636453
36877,703-004-5390,8735.966,4,2,2,0.43497773642871895
36955,703-004-5381,6766.542,5,1,4,0.6396234261506129
37078,703-004-5396,172.61981,3,3,0,0.9177489142280542
3717,703-004-5399,571.63654,9,2,7,1.3281135477421853
37473,703-004-5387,8874.61,3,0,3,0.27920371738274696
37536,703-004-5391,1666.9828,4,2,2,2.16085892563619
37543,703-004-5396,3432.3728,5,1,4,0.9464530258211163
37717,703-004-5383,3134.8723,2,2,0,1.3902744367863036
37751,703-004-5381,3345.6946,4,3,1,0.6221695237827406
37939,703-004-5396,3238.9587,4,1,3,0.4411442958067029
38138,703-004-5382,1757.338,5,2,3,1.0371088899047416
38418,207-008-2399,6162.465,5,2,3,1.0591722918348787
38567,703-004-5385,2014.854,2,2,0,2.311529985090014
38752,703-004-5388,1670.5227,5,2,3,0.8098247977009322
39213,703-004-5399,9116.2295,2,1,1,0.5837684390944268
4011,703-004-5395,6567.1123,3,1,2,0.6257979503227568
40161,703-004-5387,3202.7437,2,2,0,0.631616398210675
40406,703-004-5393,1921.8958,3,1,2,0.6501657135165309
40786,703-004-5398,4449.585,4,2,2,0.7925545141109349
40831,703-004-5380,7802.0938,3,3,0,1.266480713669966
41419,703-004-5385,5482.9287,3,2,1,0.4824116729403775
41567,703-004-5398,1410.2435,10,5,5,3.0237025209085298
41702,703-004-5392,6842.171,4,2,2,1.1649667291210473
42033,703-004-5391,5424.6978,5,4,1,4.002323096677715
42037,703-004-5382,4160.235,5,2,3,0.7761206693661508
42099,703-004-5393,4637.788,6,1,5,1.2283282725226135
42423,703-004-5392,7046.0156,2,0,2,0.27920371738274696
4252,703-004-5383,1712.252,2,2,0,2.6851438827738434
42680,703-004-5391,4803.1675,5,2,3,1.164726062685619
42942,703-004-5395,1728.844,3,2,1,0.8188539557703216
42982,703-004-5385,4898.4062,4,3,1,2.17757272367166
43508,703-004-5395,2140.498,6,3,3,0.838025994801211
43520,703-004-5383,8974.13,1,1,0,2.862343999517393
43874,703-004-5392,9441.441,4,2,2,0.9146673065330547
43981,703-004-5382,735.5654,1,0,1,0.27920371738274696
44096,703-004-5387,8674.415,1,1,0,0.40582995185415505
44154,703-004-5399,7424.349,4,0,4,0.27920371738274696
44268,703-004-5386,1695.5626,2,1,1,0.483480071545454
44924,703-004-5392,6990.7075,3,1,2,1.2873659086431997
45051,703-004-5391,287.77182,9,3,6,1.666127267915124
45160,703-004-5387,8750.224,3,1,2,0.5199040794009333
45554,207-008-2398,6671.056,6,5,1,2.640945330711402
4558,703-004-5393,5775.6997,4,1,3,0.42555299924420353
45970,703-004-5382,9622.416,5,2,3,0.4128531887208093
46043,703-004-5398,8330.65,3,1,2,0.6429099691377402
46050,703-004-5397,9398.149,6,3,3,0.8600214561830666
46125,703-004-5388,1557.5076,3,2,1,0.4568664717145602
46505,703-004-5381,7620.0747,"","","",0.27920371738274696
47225,703-004-5389,8094.33,6,5,1,1.2826056616513484
47312,703-004-5393,8753.839,4,0,4,0.27920371738274696
47329,703-004-5384,9808.958,2,1,1,0.5066357503705501
47549,703-004-5380,8771.311,2,2,0,0.5105937981636984
4757,703-004-5393,358.5559,8,5,3,2.8785746186602363
47587,207-008-2398,1512.4333,3,2,1,0.8421867269375346
47669,703-004-5382,7327.942,3,2,1,1.4818671687578138
47867,703-004-5384,5904.2227,2,2,0,1.0920995367623385
4787,703-004-5389,4349.8696,5,0,5,0.27920371738274696
47974,703-004-5396,1726.5123,4,3,1,1.2370897280152813
48225,703-004-5396,9328.178,3,0,3,0.27920371738274696
4873,703-004-5390,1248.6821,6,2,4,1.2313688477255609
49072,703-004-5399,1462.8959,2,1,1,0.4224466697085791
49148,703-004-5380,1333.1813,6,2,4,0.7866768347558625
49257,703-004-5396,6611.328,4,2,2,0.7532408080961696
5125,703-004-5386,7539.6025,3,1,2,0.8034434918421093
5132,703-004-5399,9412.084,3,2,1,0.6594236275471154
5148,703-004-5391,1205.8175,2,2,0,1.1733935021668922
519,703-004-5383,3308.174,5,3,2,0.7409941282788699
5688,703-004-5395,8439.252,4,1,3,0.37175974969512765
6165,703-004-5391,639.0512,2,1,1,0.7991748411297824
6302,703-004-5383,4274.132,1,0,1,0.27920371738274696
6377,703-004-5393,674.7961,1,0,1,0.27920371738274696
6902,703-004-5399,5723.8853,6,3,3,1.0705095995840423
6928,703-004-5394,1776.492,4,1,3,0.5090176304067093
7043,703-004-5385,1617.6539,6,3,3,1.6591907046285705
7274,703-004-5388,7836.9604,6,3,3,2.627359373608686
7493,703-004-5385,2452.0325,6,3,3,0.621672619845529
7586,703-004-5398,2683.2146,3,3,0,0.7760386124241824
7635,703-004-5384,5447.939,5,2,3,0.9883337157103321
8032,703-004-5398,1461.4081,1,1,0,0.6028819953618467
8315,703-004-5385,9781.824,3,2,1,0.6073449730693888
8375,703-004-5397,1676.516,6,4,2,1.8734354492314782
8512,703-004-5396,9875.066,1,1,0,0.4081457164879594
8515,703-004-5392,1354.6879,5,1,4,0.5311461428132773
8646,207-008-2398,8973.57,8,5,3,1.6724965564381071
8859,703-004-5384,4179.5146,2,0,2,0.27920371738274696
9120,703-004-5387,709.1373,1,0,1,0.27920371738274696
9178,703-004-5382,5160.857,3,0,3,0.27920371738274696
9317,703-004-5381,6896.5537,2,1,1,0.5770691313551896
9566,703-004-5382,1879.8745,4,1,3,0.3978652972704144
9600,703-004-5396,8146.8643,5,1,4,0.35831143730785864
9831,703-004-5391,6950.64,4,0,4,0.27920371738274696
9973,703-004-5387,1908.3684,2,1,1,0.6393233912999997
9986,703-004-5383,8953.684,8,7,1,1.6161834334981797
10272,703-004-5384,721.07074,3,0,3,0.27920371738274696
10309,703-004-5390,3452.5347,4,2,2,0.624354390248428
10338,207-008-2399,4014.2876,6,3,3,3.7890876947365646
10603,703-004-5399,5981.551,2,1,1,0.35027013757747105
11205,703-004-5382,2386.0508,7,3,4,1.4254301393626785
11236,703-004-5390,5911.559,3,2,1,1.702937029643384
11247,703-004-5389,9763.213,6,2,4,0.6550345019013397
11313,703-004-5387,4645.7964,4,3,1,1.2805344217197896
125,703-004-5394,8443.037,4,2,2,0.9657759135930407
12542,703-004-5398,8886.909,4,3,1,1.2748571086453813
12637,703-004-5383,9601.501,1,0,1,0.27920371738274696
12888,703-004-5397,7620.911,2,1,1,0.9613826437912941
13187,703-004-5386,576.1224,3,2,1,0.7774145961912826
1372,207-008-2399,4225.0073,1,1,0,0.5575531147430723
1394,703-004-5380,6578.567,1,1,0,0.3943041670342941
13985,703-004-5395,7373.5454,3,1,2,0.5193613302068438
14218,703-004-5385,6930.199,5,5,0,1.4994949968297133
14879,703-004-5380,6333.829,1,1,0,1.136324103743474
14974,703-004-5390,2026.9376,6,4,2,1.821458290354508
15052,703-004-5395,7666.126,4,2,2,1.0750439420644002
15448,703-004-5382,2738.9526,5,2,3,1.0515266852660463
15539,703-004-5392,2693.6758,2,1,1,0.4682573121736508
15947,703-004-5384,4994.105,5,2,3,1.199040407136093
16549,703-004-5388,2168.6543,5,3,2,1.031636957467539
16639,703-004-5398,8983.634,3,3,0,0.9189983607411812
1669,703-004-5389,6897.642,7,4,3,0.6730442530017039
17551,703-004-5385,5951.9478,2,2,0,0.7447314857898191
17757,703-004-5380,8980.764,4,3,1,0.7932385101724493
17835,703-004-5382,8481.781,2,1,1,0.3187575773453028
17866,703-004-5397,1582.2285,4,1,3,0.5279985688143205
17910,703-004-5394,174.21722,7,5,2,1.963185670934233
18386,703-004-5385,895.23615,4,4,0,1.3433527874029774
18429,703-004-5383,763.9432,2,1,1,0.33853450732658075
19289,703-004-5399,5996.2446,"","","",0.27920371738274696
19369,703-004-5397,1851.108,2,0,2,0.27920371738274696
19582,703-004-5399,8892.65,3,0,3,0.27920371738274696
19665,207-008-2399,8392.07,3,2,1,0.9128719591412076
19919,207-008-2399,2082.535,4,2,2,0.9006560287299248
19989,703-004-5392,5251.764,5,2,3,0.6243333797492095
19990,703-004-5386,8919.116,6,4,2,1.0989609326957337
20141,703-004-5398,5715.629,1,0,1,0.27920371738274696
20252,207-008-2399,5045.8066,2,1,1,0.6283197248556733
20256,703-004-5394,7246.3945,9,7,2,2.7285795783814963
20959,703-004-5386,2997.539,5,1,4,0.5437758111464308
2110,703-004-5391,5453.2866,4,2,2,1.1320269681171484
21453,207-008-2399,9177.651,4,4,0,3.2017289209496416
21515,207-008-2399,2190.7507,6,2,4,0.9785110265278921
21534,703-004-5390,6330.634,6,3,3,1.4662844552567886
21535,703-004-5382,5781.9736,2,0,2,0.27920371738274696
21645,703-004-5398,9056.781,4,1,3,0.47845095497922163
21671,703-004-5383,5542.321,6,4,2,2.570178145093333
21711,703-004-5380,7603.8877,1,0,1,0.27920371738274696
22130,703-004-5392,4196.503,2,2,0,0.9057907837540198
22314,703-004-5389,3478.8406,4,2,2,1.023315904701251
22436,703-004-5394,6090.5435,"","","",0.27920371738274696
22542,703-004-5383,9311.531,2,1,1,0.4550692432025116
2275,207-008-2399,7017.97,3,2,1,0.543142094171259
23113,703-004-5387,8452.804,7,5,2,2.4260930031663412
23479,703-004-5387,8110.8784,5,3,2,1.0026326236545684
23514,703-004-5398,1606.6515,5,3,2,1.0267592414295412
23592,703-004-5386,8350.482,3,2,1,1.0703654612849574
2393,703-004-5381,617.3915,2,1,1,0.773448435581201
24078,703-004-5398,4011.2937,6,2,4,1.2429945826616624
24528,703-004-5398,8000.9824,2,0,2,0.27920371738274696
2464,703-004-5383,3611.0598,4,2,2,0.6026630193837536
25349,703-004-5386,7585.144,"","","",0.27920371738274696
25350,703-004-5380,5888.1377,4,4,0,3.1171278133691276
25532,703-004-5391,5700.4956,5,3,2,0.9812236371328009
25821,703-004-5384,4645.57,5,3,2,0.6471963908461392
26222,207-008-2399,1791.5458,"","","",0.27920371738274696
26686,703-004-5383,3138.8735,5,4,1,1.1808247751621022
26687,703-004-5380,1593.2673,2,1,1,0.3903332740880135
27081,703-004-5386,8791.773,1,1,0,0.5598691754414225
27125,703-004-5399,7491.7817,5,4,1,1.306194023159574
27130,207-008-2399,1837.9575,3,1,2,0.3710179603135642
27247,703-004-5387,2824.557,3,2,1,0.45336809137657835
27339,207-008-2399,1590.417,5,4,1,1.71885661824275
27429,703-004-5389,8299.082,6,5,1,1.4073305908230858
27492,703-004-5380,124.462845,2,1,1,0.8469638235154101
27541,207-008-2398,7690.4966,2,1,1,0.8317705760599059
2756,703-004-5385,7698.4097,3,3,0,0.8672107251864575
27563,207-008-2398,1702.3683,7,4,3,1.3580382145536376
27729,703-004-5393,8942.34,1,1,0,1.1873612532896307
27752,703-004-5380,6500.752,2,0,2,0.27920371738274696
27753,703-004-5396,3996.2644,1,0,1,0.27920371738274696
27890,703-004-5391,1573.677,4,2,2,0.5520629682829117
27966,703-004-5389,9631.942,3,2,1,1.0563010718975565
28039,703-004-5392,7938.395,1,0,1,0.27920371738274696
28102,703-004-5388,7680.962,1,1,0,0.5393487126381684
28183,703-004-5394,4712.3105,3,2,1,0.43741915723297026
28288,703-004-5389,5507.025,9,5,4,3.7112731438846684
28449,703-004-5394,6895.331,3,2,1,0.5166075678564442
28463,703-004-5384,2666.6099,7,5,2,1.569252764491664
28500,703-004-5389,1999.2888,6,4,2,1.8396897240861065
28524,703-004-5381,7228.387,2,1,1,0.5439604003356163
29055,703-004-5394,327.19553,2,0,2,0.27920371738274696
29097,703-004-5388,4008.0732,3,2,1,0.5619026373770291
29978,703-004-5389,1583.7443,3,1,2,0.5941167061860563
30054,703-004-5390,1956.8187,6,5,1,4.534758173165974
3015,207-008-2399,4573.8887,4,1,3,0.603953089529431
30740,703-004-5388,8986.132,4,1,3,0.9649011105890597
30750,703-004-5380,9893.743,2,1,1,0.33853450732658075
30811,703-004-5399,4094.9482,2,0,2,0.27920371738274696
30857,703-004-5391,6437.5205,2,2,0,1.2178741054588702
30953,703-004-5399,7679.6562,8,0,8,0.27920371738274696
31067,703-004-5381,1140.7208,3,1,2,0.5629313495785501
31330,703-004-5393,6451.403,4,1,3,0.4538460989430802
32361,703-004-5387,7136.7085,2,1,1,1.246026349913696
32392,703-004-5398,5571.648,5,2,3,1.1373784939003275
32529,703-004-5397,3676.6226,4,2,2,1.0056700682603814
32654,703-004-5391,8694.358,5,2,3,1.595385453183986
32660,703-004-5398,7961.858,4,2,2,0.6364762759044543
32788,207-008-2399,9967.195,3,1,2,0.3978652972704144
3281,703-004-5396,8591.726,8,7,1,4.174739181453979
32939,703-004-5390,9278.947,5,2,3,0.7903695492121046
32943,703-004-5397,4421.0176,4,1,3,2.3694794342422765
33004,703-004-5381,8464.862,2,0,2,0.27920371738274696
33615,703-004-5381,9171.009,4,2,2,1.342953746749568
3368,703-004-5389,5059.757,4,1,3,0.6105812435460113
33774,703-004-5393,1132.5884,1,1,0,0.5210768431721786
33840,703-004-5387,4698.9805,5,4,1,1.7752289612366532
34347,703-004-5392,6972.237,2,1,1,0.35831143730785864
34404,703-004-5381,3856.4407,5,3,2,2.030887583048186
3441,703-004-5386,5101.7476,6,1,5,0.699367890989993
34414,703-004-5384,6436.614,3,1,2,0.808890753565397
34565,703-004-5392,8247.341,3,2,1,0.5573897226737735
34591,207-008-2398,6835.193,4,1,3,0.4322383518600983
34829,703-004-5392,9469.598,3,0,3,0.27920371738274696
35089,703-004-5397,5113.6675,6,3,3,1.1169817536908473
35095,703-004-5390,5087.9985,2,1,1,0.954119392354166
3517,703-004-5396,4220.33,5,3,2,1.4216339074204383
35438,703-004-5388,7933.184,2,0,2,0.27920371738274696
35771,703-004-5385,1559.8882,4,3,1,1.4817703324129803
3650,703-004-5386,5400.9395,5,2,3,0.7317099639921224
36538,703-004-5384,9322.684,6,2,4,0.5274398744915906
36689,703-004-5387,5515.919,2,1,1,0.4546005856217786
36782,703-004-5395,474.96558,4,0,4,0.27920371738274696
37160,207-008-2399,2310.1968,6,4,2,1.703554740409037
37399,703-004-5386,8287.807,7,3,4,0.7216947431865317
37796,703-004-5380,7266.1567,6,2,4,0.6225592617990948
38203,703-004-5389,2017.2828,3,0,3,0.27920371738274696
3826,703-004-5383,3302.8645,3,2,1,1.4396176582807847
38296,703-004-5397,2202.3594,6,1,5,0.3797614955655527
38318,207-008-2398,9980.349,5,3,2,1.867443042825924
38339,703-004-5390,8939.893,2,1,1,0.44587996256008733
38526,703-004-5396,9245.574,5,2,3,1.2428661711125675
38576,703-004-5390,3414.8289,4,2,2,1.177798253830052
3858,703-004-5388,356.07635,3,2,1,2.5058424399821404
38900,207-008-2398,8147.8955,3,3,0,0.724570204103509
38926,703-004-5385,8683.888,3,2,1,0.626978235706349
39083,703-004-5389,8277.368,5,2,3,0.6221684814063383
39692,703-004-5386,7900.586,5,4,1,0.9810856907433357
39755,703-004-5395,2134.2646,5,2,3,0.5958207920965163
39840,703-004-5396,714.854,4,0,4,0.27920371738274696
40079,703-004-5382,7912.5386,3,2,1,2.2146610228354513
40353,207-008-2399,1690.1373,3,3,0,2.3281954720039972
40512,703-004-5383,475.54315,10,5,5,4.897458923110246
40524,703-004-5392,4885.1113,4,3,1,0.8152604252178055
40866,703-004-5381,3479.6423,5,3,2,0.9887409601544233
40972,703-004-5398,1298.4866,2,2,0,0.5375508627570658
41009,703-004-5389,6681.529,5,1,4,0.44014580264413117
41256,207-008-2398,6116.071,3,1,2,0.9601352669383911
41262,703-004-5397,8957.0205,1,0,1,0.27920371738274696
41280,703-004-5394,9953.1045,4,1,3,0.44365934631320175
41313,703-004-5389,9942.476,3,2,1,2.010529112145474
41983,703-004-5383,2584.9753,2,0,2,0.27920371738274696
42507,207-008-2398,4431.136,5,2,3,0.8180631693018152
42548,703-004-5388,8309.201,6,4,2,2.1282092018399625
42679,703-004-5383,3256.6924,7,0,7,0.27920371738274696
42975,703-004-5382,8793.933,5,2,3,0.9246779796127874
43341,703-004-5399,5926.184,6,3,3,1.4143307321084118
44350,703-004-5387,5570.6514,2,1,1,0.5783265178096785
44603,703-004-5382,509.80927,9,2,7,2.7720755125860923
44966,207-008-2398,5061.8823,8,4,4,1.5093184759832075
451,703-004-5389,5866.524,2,2,0,0.7368175971354327
45756,703-004-5399,8142.0864,5,3,2,1.121180877481558
45856,703-004-5387,6969.426,5,1,4,0.4369685760263021
46391,703-004-5390,1950.6067,5,5,0,2.58233623725566
46444,703-004-5382,7221.218,8,2,6,1.7352097628158205
46879,703-004-5390,2393.2612,5,3,2,0.7438912653982819
47268,703-004-5393,5407.3384,3,1,2,1.1834839923422804
47445,703-004-5394,5185.917,4,2,2,0.934051105593577
47570,703-004-5389,1580.4667,5,2,3,1.4645947906892327
47877,703-004-5396,788.5706,2,0,2,0.27920371738274696
48088,703-004-5380,4093.3687,3,2,1,0.902428340044123
48114,703-004-5399,2432.1277,4,2,2,0.619000068601823
4838,703-004-5395,2929.2686,6,2,4,0.7062689990261191
48393,703-004-5395,7597.262,5,3,2,0.8190802767648533
48590,703-004-5383,4774.278,2,0,2,0.27920371738274696
4894,703-004-5381,1074.4244,3,2,1,3.06521993190269
49137,703-004-5398,3670.5107,3,1,2,0.8996424324431791
49627,703-004-5396,314.4598,3,1,2,0.6168838163999214
4975,703-004-5396,638.77106,4,2,2,0.8175443495416572
49916,703-004-5389,7577.7197,2,1,1,0.4110187983571774
49960,703-004-5390,2789.8735,6,3,3,0.7815379984909971
49995,703-004-5386,2321.9836,4,1,3,0.5724173170781235
5023,703-004-5380,7828.691,8,6,2,1.5617535812549064
5067,703-004-5383,8529.306,3,1,2,0.3985613348434229
5149,703-004-5389,4060.8467,4,3,1,1.0124421685861162
5523,703-004-5395,9419.589,5,4,1,1.9795486824097486
5613,703-004-5397,3399.669,2,1,1,0.403045754207177
5657,703-004-5399,2039.994,5,3,2,1.9026794955025563
6248,703-004-5396,2377.122,5,2,3,0.7022119277095275
6366,207-008-2398,2690.1477,5,3,2,1.1133931127179728
6558,703-004-5388,5593.6797,3,0,3,0.27920371738274696
6797,703-004-5386,8681.913,2,2,0,0.7100282383106707
7328,703-004-5392,9017.386,3,1,2,0.36951836429724944
7362,703-004-5380,2864.3674,4,1,3,0.32666834933781397
7650,703-004-5386,1029.048,6,5,1,3.6674924167803287
7655,703-004-5386,6720.5605,6,1,5,0.35114230018964543
7743,703-004-5390,3354.7002,5,4,1,1.749064311138215
7994,703-004-5393,3279.8708,5,4,1,1.7091608761271346
800,703-004-5399,3601.049,2,1,1,0.5056619262496174
8092,703-004-5395,883.441,5,4,1,2.437061491508764
8306,703-004-5386,6467.6777,8,4,4,1.5628663391118047
8386,703-004-5380,8160.486,6,0,6,0.27920371738274696
853,703-004-5392,1430.6837,6,3,3,1.176644074358792
8965,207-008-2398,4802.109,7,3,4,0.9949054774625747
9003,703-004-5383,7688.619,7,3,4,1.129360576788906
9032,703-004-5397,3637.2156,4,1,3,1.4923590763257928
9308,703-004-5395,160.98082,6,3,3,1.2361675780992725
9407,207-008-2398,5289.102,5,3,2,0.7859012387976042
944,703-004-5394,5796.9844,4,3,1,1.4415838846771571
9569,703-004-5385,6252.079,2,2,0,1.1380572755686955
9630,703-004-5382,2314.8406,4,3,1,0.7693406729923414
9830,703-004-5382,9965.208,9,5,4,1.8725876789914904
9975,703-004-5381,2562.7488,4,3,1,0.924573262741383
1043,703-004-5388,6477.5415,2,1,1,0.41972746760707774
10452,703-004-5396,3097.8584,5,1,4,0.696418834848264
10829,703-004-5387,4977.79,5,3,2,1.1883561473950135
11463,703-004-5390,4917.464,6,2,4,1.0559763846022885
11510,207-008-2398,7318.0396,5,3,2,1.0820013877663102
12024,703-004-5388,4260.1543,3,1,2,0.3367545836282657
12043,703-004-5398,9186.176,2,1,1,0.35216515830407125
12386,703-004-5388,5753.9136,6,4,2,1.071365677124945
12466,703-004-5385,6710.6934,4,2,2,0.5417424628842112
12508,703-004-5393,6652.824,5,3,2,1.2369175925143903
12789,703-004-5383,7524.5713,2,1,1,1.3084385167191854
13071,703-004-5386,6168.194,4,2,2,1.6084800537246016
13571,703-004-5398,646.1358,3,1,2,0.47244304731329956
13672,207-008-2399,6228.3833,4,2,2,1.8739674718070385
14116,207-008-2399,7774.4365,4,3,1,0.698939283848635
14164,703-004-5393,9436.538,2,1,1,0.5025945558799534
14227,703-004-5385,5772.8823,2,2,0,1.525499319284317
14244,703-004-5390,8118.548,7,6,1,5.392929384880243
1425,703-004-5383,9989.701,2,2,0,0.7755734971098323
14267,703-004-5382,3982.6316,"","","",0.27920371738274696
14353,703-004-5384,4097.1567,5,3,2,1.4311055677218965
14361,207-008-2398,1109.1488,4,2,2,0.7798917967658927
14432,703-004-5382,1354.3564,3,2,1,0.6378040933755648
14443,703-004-5390,4538.1797,4,3,1,0.75344083567284
14986,703-004-5390,5718.6196,1,0,1,0.27920371738274696
15107,703-004-5384,9285.87,6,4,2,0.9629251483854931
15343,703-004-5385,2077.238,4,3,1,1.554393183615786
15741,703-004-5398,7568.965,4,2,2,0.7730648653971198
16031,703-004-5382,1739.5121,2,0,2,0.27920371738274696
16131,703-004-5380,3489.4937,4,0,4,0.27920371738274696
16622,703-004-5395,4666.551,5,2,3,0.945688854120135
169,207-008-2398,7203.8423,4,3,1,2.4544322810692623
1706,703-004-5389,5076.7314,3,1,2,0.8066148312415584
17100,703-004-5380,6458.7314,6,3,3,0.8931255021691359
17403,703-004-5385,118.02972,2,0,2,0.27920371738274696
17507,207-008-2399,634.2566,4,2,2,0.47697301719552604
17570,703-004-5383,9464.934,6,5,1,2.7684291815404203
17855,703-004-5385,9015.7,4,2,2,3.1744909932300582
17930,703-004-5390,6944.138,3,1,2,0.7108601382174652
18161,703-004-5397,2424.1216,6,1,5,0.6386665095759556
18492,703-004-5398,5103.251,11,5,6,1.4654362225903175
18533,703-004-5381,7814.6177,6,4,2,1.5259046114237442
18613,703-004-5393,4572.942,6,4,2,1.575073446010155
1880,703-004-5399,5658.5957,2,0,2,0.27920371738274696
18991,703-004-5399,1288.063,4,2,2,1.4214548385921564
19333,703-004-5393,6104.748,3,0,3,0.27920371738274696
19353,703-004-5396,499.21512,2,1,1,0.3978652972704144
19568,703-004-5389,6290.199,3,0,3,0.27920371738274696
1987,703-004-5394,1924.5845,3,1,2,1.0558430053326275
19877,703-004-5382,2005.1742,1,0,1,0.27920371738274696
19933,703-004-5391,7660.752,3,0,3,0.27920371738274696
19985,703-004-5381,7028.052,5,1,4,0.6010031790162963
205,207-008-2398,5195.5376,2,1,1,0.3637500930527101
20714,703-004-5381,8741.618,5,4,1,1.3539158782818999
21238,703-004-5387,3351.959,3,0,3,0.27920371738274696
2129,703-004-5396,5131.6426,4,1,3,0.8416637279850638
21498,703-004-5387,1405.173,8,3,5,1.2600960010232036
21584,703-004-5382,2938.1199,7,6,1,2.2194583505012577
21748,703-004-5389,7343.5186,4,3,1,0.7113296374736692
22049,703-004-5382,8215.276,5,1,4,0.9620023094305543
22184,703-004-5390,8881.462,3,1,2,0.3978652972704144
22508,703-004-5381,973.7146,1,0,1,0.27920371738274696
22875,703-004-5398,5477.587,"","","",0.27920371738274696
22895,703-004-5388,9825.667,9,4,5,2.325284431967025
23171,703-004-5388,3631.78,4,3,1,0.9375886979226501
23250,703-004-5394,553.7427,4,1,3,0.42179400914984533
23328,703-004-5388,5514.378,5,2,3,0.5908046138909058
23468,703-004-5386,3578.0024,3,2,1,0.4512630082198648
23672,703-004-5396,3814.1067,7,5,2,3.0638653322919853
23728,207-008-2398,5796.2515,6,3,3,1.2466049984814525
23877,703-004-5390,4356.624,3,0,3,0.27920371738274696
2402,703-004-5391,407.2213,4,2,2,1.1267864519558983
24174,703-004-5399,391.43442,6,4,2,2.268323884098397
24214,703-004-5386,8784.04,2,1,1,0.6602557157970191
24423,207-008-2398,3750.4412,"","","",0.27920371738274696
24598,703-004-5380,7516.886,7,2,5,0.9413344383564102
24613,703-004-5380,6851.335,2,1,1,1.2674173494504313
24631,703-004-5383,8662.338,5,3,2,1.038196311577778
24710,703-004-5397,4961.5747,6,2,4,0.5192956473554609
2477,207-008-2398,1866.4307,7,3,4,2.4992774396526887
2495,703-004-5390,9773.06,4,2,2,0.6243990430226298
25015,703-004-5387,4091.3887,2,1,1,0.6478331300828317
25040,703-004-5398,883.3909,"","","",0.27920371738274696
25410,703-004-5398,1681.6127,5,3,2,1.4641625194091692
26196,703-004-5393,907.4223,2,1,1,0.8326969142930659
2644,703-004-5381,3600.121,5,3,2,0.8312037374424952
26643,207-008-2398,5443.5293,6,1,5,0.5101349109330147
26848,703-004-5386,5408.122,5,2,3,0.7038080204526852
26906,703-004-5390,6848.72,3,0,3,0.27920371738274696
27062,703-004-5391,2214.9844,2,1,1,0.5165268771580819
27363,207-008-2398,4623.8022,5,3,2,1.4341068165827031
27698,703-004-5390,6946.285,3,2,1,0.7607750419773897
2789,703-004-5385,1766.7794,3,0,3,0.27920371738274696
2808,703-004-5394,8689.88,3,1,2,0.4157242622031468
28153,703-004-5388,7757.0234,2,0,2,0.27920371738274696
28656,703-004-5381,8600.344,6,2,4,1.4425173469399137
28945,207-008-2398,9496.318,5,2,3,1.748072712464956
2915,703-004-5388,4325.7417,3,0,3,0.27920371738274696
29239,703-004-5384,695.98315,7,5,2,1.0226031015848207
29302,703-004-5390,6809.6675,4,2,2,1.6718805274285176
29553,703-004-5382,6258.0215,5,2,3,1.199120447887861
29554,703-004-5388,2317.5098,5,3,2,0.7149534341204374
30125,703-004-5381,7334.1245,5,3,2,3.432921528425099
30406,703-004-5386,3948.024,4,3,1,5.51948613344306
30540,703-004-5392,8813.886,5,1,4,0.5261871829912459
30749,703-004-5385,8035.228,5,1,4,0.7109827697613001
30890,703-004-5390,4099.367,1,0,1,0.27920371738274696
31260,703-004-5390,4356.6904,3,1,2,0.6575416591668043
31340,703-004-5396,2655.253,8,3,5,1.1320520559842202
31594,703-004-5384,8948.341,4,1,3,0.580337823316748
31661,703-004-5397,8288.057,3,1,2,0.6296114837871768
31724,703-004-5397,5589.8047,5,4,1,1.3886743839702589
3179,703-004-5396,4167.8325,4,1,3,0.6135874201742207
31839,207-008-2398,3071.5776,3,1,2,0.4108747540878072
31991,703-004-5386,979.836,5,3,2,0.8909730559355289
32383,703-004-5388,4139.633,1,1,0,0.32666834933781397
3241,703-004-5396,3424.5498,4,3,1,0.8629070740401618
3299,207-008-2398,4266.3486,5,3,2,1.4079007580316962
33293,703-004-5399,471.94778,9,3,6,1.3508636812928583
334,703-004-5397,6819.9272,1,1,0,0.35831143730785864
33659,703-004-5384,1532.675,6,2,4,0.5410821054584913
33706,703-004-5383,467.71646,1,1,0,0.43425359727536994
33720,703-004-5386,8173.901,3,3,0,1.1190516713861267
33805,703-004-5380,7268.0103,7,4,3,1.3917712375803586
33927,703-004-5382,8557.419,7,5,2,3.172916566204656
34052,703-004-5389,5744.9395,6,5,1,2.832720689174404
34629,703-004-5394,7765.4653,5,5,0,4.144474973040478
34868,703-004-5382,7538.673,1,0,1,0.27920371738274696
35174,703-004-5388,2016.2887,5,2,3,1.4869276020203033
35388,207-008-2398,9190.616,5,2,3,2.1241843312272795
35502,703-004-5399,8660.923,5,1,4,0.5443856011777014
3553,703-004-5393,3261.1895,4,1,3,0.33853450732658075
35575,703-004-5399,7488.7036,6,1,5,0.33853450732658075
35721,703-004-5399,3741.7288,3,0,3,0.27920371738274696
35871,703-004-5388,2525.0703,8,3,5,1.6939435846570596
35893,703-004-5394,7444.2295,4,4,0,1.8047404707344519
36009,703-004-5384,8261.534,7,4,3,2.2323297544418326
36091,703-004-5396,6878.5864,3,1,2,0.5554092608285416
36425,703-004-5396,7206.3945,2,1,1,0.3978652972704144
36763,703-004-5391,1218.7546,1,0,1,0.27920371738274696
36853,703-004-5385,8877.374,4,2,2,0.440056081230474
36956,703-004-5380,1882.6825,1,1,0,0.45792041727481253
36985,703-004-5384,6053.512,1,1,0,0.38440583158767266
37071,703-004-5391,1000.7662,5,5,0,0.8825935149764231
37463,703-004-5398,4607.2866,3,1,2,0.7971860468390507
37555,207-008-2399,498.11365,4,1,3,0.3975356817707265
3786,703-004-5386,6001.83,2,1,1,0.33853450732658075
37945,703-004-5392,3032.4578,6,3,3,0.6499026371402075
38017,703-004-5395,7682.141,3,2,1,1.0064455082369166
38434,703-004-5398,1610.216,8,5,3,2.286755361821504
3848,703-004-5399,1486.0446,5,1,4,0.38416016121531477
38509,703-004-5397,3349.5408,4,1,3,0.34104123320170765
38609,703-004-5395,1298.8049,4,1,3,0.733694760494916
3875,703-004-5382,1542.365,4,1,3,0.6530303998370778
38756,703-004-5387,8785.336,4,2,2,0.8969452775597143
38795,703-004-5389,5547.8467,4,2,2,1.1006736795653052
38842,703-004-5385,4205.962,3,1,2,1.2522792380630126
39470,703-004-5381,4644.2383,2,1,1,0.3978652972704144
39793,207-008-2398,727.7012,3,3,0,1.389929339149543
39821,703-004-5382,3931.6362,5,2,3,0.5419363799865232
39892,703-004-5386,7578.0386,6,5,1,2.405927004204733
40038,703-004-5387,2604.438,7,3,4,1.04922924387698
40086,703-004-5388,4375.7417,6,2,4,0.5953980377130136
40331,703-004-5390,6768.392,5,2,3,0.6239610759458315
40464,703-004-5387,8150.3696,6,5,1,2.1197200187073624
40484,703-004-5392,1182.0496,1,1,0,0.35831143730785864
40735,703-004-5384,4251.701,3,1,2,1.6734262608742858
40791,703-004-5380,1955.3489,5,3,2,2.222997295334417
40859,703-004-5385,769.42206,5,2,3,0.7056479638932055
41210,703-004-5387,1254.4244,3,2,1,0.5768806648867985
41218,703-004-5393,2865.051,5,4,1,3.005285182431362
41314,703-004-5380,203.87888,3,2,1,0.9066564902066487
41473,703-004-5381,8136.2783,3,2,1,1.1225439140713516
41781,703-004-5382,5914.284,6,2,4,0.652529184481735
41846,703-004-5393,8018.7173,3,1,2,0.42289135408422324
41944,703-004-5395,453.1896,2,0,2,0.27920371738274696
41994,703-004-5385,280.81656,4,2,2,0.8673532428074207
42071,703-004-5392,8199.358,5,1,4,0.39093389533135114
42336,703-004-5383,1752.4684,3,1,2,1.0788847474794634
42337,703-004-5389,7506.971,3,1,2,0.3978652972704144
42667,703-004-5396,8907.237,5,2,3,0.5910523394168488
42783,703-004-5398,2175.1196,4,3,1,0.9392367742742618
42819,703-004-5386,9966.331,7,4,3,1.5261898783876497
42972,703-004-5380,8555.345,"","","",0.27920371738274696
43573,703-004-5384,9829.413,5,1,4,0.6055713753058702
43582,703-004-5396,2581.0076,5,3,2,1.0153160850363123
43619,703-004-5388,5362.578,4,2,2,1.0347865376361143
43655,703-004-5399,4835.118,2,1,1,0.5984166355450541
44042,703-004-5392,2356.789,1,1,0,0.3978652972704144
44067,703-004-5393,5344.298,2,0,2,0.27920371738274696
4417,703-004-5385,5949.9683,6,1,5,1.4098514733015854
44205,703-004-5387,7384.4214,6,4,2,1.290368575787643
44294,703-004-5393,9592.39,2,1,1,0.6290217326098799
44399,703-004-5399,3567.7969,6,3,3,1.2666379702928912
4465,703-004-5381,2988.7969,7,3,4,1.3023127239499537
44957,703-004-5385,1122.4198,5,3,2,0.830894307742109
45329,703-004-5397,4920.9546,4,3,1,2.8044457060813586
45342,703-004-5390,3268.9102,4,1,3,0.5380972891966762
4569,703-004-5399,7353.214,6,2,4,0.8789594184674774
45715,703-004-5391,6330.0786,5,2,3,0.6197502101057661
45872,703-004-5387,3669.346,5,3,2,0.6723258468666902
46003,703-004-5398,8507.11,5,2,3,0.528244708171989
46414,703-004-5383,2983.2004,4,2,2,1.272188950475612
46580,703-004-5381,2672.4148,5,4,1,3.7396129397733193
46644,703-004-5398,6510.571,4,1,3,0.4822810987930965
4672,703-004-5398,3006.9722,5,2,3,0.4150609575098446
4690,703-004-5390,493.46744,3,1,2,0.5196841190577539
46954,703-004-5389,2212.677,2,1,1,0.7731240745207375
47030,703-004-5384,2351.3877,2,1,1,0.5479277832298762
47073,703-004-5382,1555.6365,2,1,1,0.4698597454996858
47108,703-004-5395,9123.571,4,1,3,0.5002720948006572
4719,207-008-2399,1170.8433,2,0,2,0.27920371738274696
47259,703-004-5387,2023.48,8,3,5,1.2269452723487524
47270,703-004-5380,1830.1981,2,0,2,0.27920371738274696
47359,703-004-5394,3091.2864,3,2,1,1.2542730550057828
4736,703-004-5397,7496.2007,2,1,1,0.49947914169430313
47436,703-004-5394,7965.863,1,0,1,0.27920371738274696
47620,207-008-2398,2212.8535,6,5,1,4.009902745159015
4776,703-004-5398,333.31274,2,1,1,0.3783626723474551
4782,703-004-5384,6162.183,5,4,1,1.2679653970163325
47846,703-004-5381,8830.477,3,1,2,0.9652100013042841
48059,703-004-5394,9057.278,5,2,3,1.3356974023086174
4818,703-004-5383,5751.208,5,3,2,0.835767325389395
48245,703-004-5389,1370.8413,1,1,0,0.6667769706322298
48877,703-004-5395,9642.741,7,2,5,1.1831187096079845
48994,703-004-5391,4584.975,6,1,5,0.5791728918202321
49671,207-008-2399,5805.6665,2,2,0,0.8445874832986121
49770,703-004-5384,7483.64,3,2,1,0.5702538976736745
4980,703-004-5381,2456.4314,3,1,2,0.48735368568131626
5071,703-004-5387,7901.3525,10,5,5,1.7321770998793595
5085,703-004-5381,2364.3208,8,1,7,0.35831143730785864
5291,703-004-5389,7049.0186,6,3,3,1.598621814667792
5434,703-004-5381,7453.4766,4,1,3,0.4148085553554106
544,703-004-5390,1060.1699,2,0,2,0.27920371738274696
5543,703-004-5381,2641.2273,6,5,1,3.3631414430820032
577,703-004-5380,3473.3337,2,1,1,0.3766240504317727
581,703-004-5395,2942.3457,3,1,2,0.5799378361087673
6217,703-004-5397,5055.937,4,1,3,1.9892561610857613
6264,703-004-5394,129.84633,4,3,1,0.8242207728993204
6278,207-008-2398,678.4838,4,3,1,1.1541205984616427
6605,703-004-5387,2937.9749,8,5,3,1.2391119595873261
6687,207-008-2398,7209.626,6,4,2,2.9468031679648075
6949,703-004-5392,4337.1714,1,1,0,0.8833258008668543
7364,703-004-5397,8277.637,5,3,2,1.1122880637935484
740,703-004-5386,7414.2705,5,1,4,0.37512182779194486
7402,703-004-5396,4511.581,2,0,2,0.27920371738274696
747,703-004-5393,618.1896,3,1,2,0.35831143730785864
7746,703-004-5396,8041.176,2,1,1,0.49401106924256516
7829,703-004-5390,4770.4385,5,3,2,1.486368359075035
7976,703-004-5394,4973.3774,6,3,3,1.055124613559776
8053,207-008-2399,4962.249,4,3,1,0.5993131829799765
8183,207-008-2398,428.0895,"","","",0.27920371738274696
8680,703-004-5395,1515.9202,5,4,1,2.995505096031224
8691,703-004-5394,9455.941,3,1,2,0.6083873053801222
9028,703-004-5383,1952.0253,6,4,2,1.9733601599369683
9296,703-004-5382,7314.6035,2,1,1,0.39455586733890036
9314,703-004-5387,6660.975,5,5,0,1.8208439443764666
9417,703-004-5393,8750.878,2,1,1,1.3110152470838943
9980,703-004-5385,5540.7715,4,2,2,0.6188866536088378
10221,703-004-5399,4130.9736,3,2,1,0.7893635814393122
10318,703-004-5397,7058.2104,6,4,2,1.1583661798161862
10496,703-004-5393,321.1099,5,2,3,0.7691112345689696
106,703-004-5392,3134.4282,1,0,1,0.27920371738274696
10931,703-004-5399,9821.683,4,4,0,2.2003903345643216
10966,703-004-5398,4934.6514,3,3,0,1.232537154007768
11080,703-004-5385,2814.4758,2,0,2,0.27920371738274696
11504,703-004-5396,2626.201,3,2,1,0.8643329295428366
11560,703-004-5387,1429.1167,3,3,0,0.9605164876716034
11561,703-004-5383,1224.2675,2,2,0,0.7081875840739756
11724,703-004-5389,8727.499,3,0,3,0.27920371738274696
1180,703-004-5383,8775.938,5,3,2,2.2437269954892387
12481,703-004-5393,9530.641,3,2,1,0.8751249968543247
12491,703-004-5395,5370.8535,1,0,1,0.27920371738274696
12576,703-004-5390,8779.695,1,0,1,0.27920371738274696
12822,703-004-5392,7086.0625,5,2,3,0.9520389376893182
12959,703-004-5389,2071.305,2,2,0,0.5438807715112974
13361,703-004-5381,5719.691,7,4,3,1.9904247495868952
13412,703-004-5393,7251.003,5,3,2,1.0696966967285557
13557,703-004-5390,7837.557,3,3,0,0.7954771728744684
13569,703-004-5386,7917.046,3,2,1,0.7071197570061849
13699,703-004-5381,4382.999,1,0,1,0.27920371738274696
1450,703-004-5391,8185.6226,6,2,4,0.6965869735270496
14660,703-004-5394,1965.7511,6,2,4,4.627802207396081
14754,703-004-5388,90.68727,7,5,2,1.7397561600264886
15334,703-004-5388,2907.9407,"","","",0.27920371738274696
15650,207-008-2398,2762.8005,5,3,2,1.265372570061806
15744,703-004-5380,2154.3462,1,1,0,0.809976352455055
15793,703-004-5396,5134.459,8,4,4,0.980609258255192
158,703-004-5399,9853.662,2,0,2,0.27920371738274696
16373,703-004-5390,7726.174,6,1,5,0.39004673089314773
16542,703-004-5387,9216.586,2,1,1,0.5241539683679388
16713,703-004-5381,2415.319,2,1,1,1.1427502035843704
16745,703-004-5385,628.8725,3,2,1,0.5547986210268048
17357,703-004-5382,8492.473,8,2,6,0.952249292614241
17720,207-008-2398,6200.0747,3,1,2,0.5738309949910761
17837,703-004-5395,3644.221,4,2,2,0.7041034212669853
1789,703-004-5386,9430.349,1,1,0,0.33853450732658075
17931,703-004-5393,9653.88,3,1,2,1.794654244866728
18011,703-004-5396,8309.455,8,7,1,1.8318527057798661
18493,703-004-5396,7764.5317,3,3,0,1.5959578624083146
18664,703-004-5391,9824.256,10,7,3,3.0043610887504264
1869,703-004-5390,2698.791,"","","",0.27920371738274696
18709,703-004-5398,8995.868,6,1,5,0.5165268771580819
19730,703-004-5382,1812.5254,3,0,3,0.27920371738274696
20017,703-004-5398,820.272,3,2,1,2.1358857583571145
20128,703-004-5391,8091.469,5,1,4,0.35831143730785864
20225,703-004-5398,1024.3655,6,3,3,3.263613680154033
2032,703-004-5383,5580.0283,4,1,3,0.9910398667166583
20448,703-004-5397,7684.7295,4,2,2,1.1262112926254468
20494,703-004-5393,9077.532,5,2,3,1.9910850911009754
2053,703-004-5384,8303.419,2,2,0,0.42732390143496196
20657,703-004-5395,4792.106,8,2,6,1.1074355877780655
21454,703-004-5388,8853.153,6,0,6,0.27920371738274696
21521,703-004-5384,2907.09,1,0,1,0.27920371738274696
21564,703-004-5385,8130.2686,2,1,1,0.48149113547677974
21720,703-004-5396,7336.665,5,1,4,0.403713290857151
22020,703-004-5393,5126.964,2,1,1,0.5986880218876613
22112,703-004-5382,1042.8113,4,2,2,0.6740289758376665
22119,703-004-5383,6211.14,5,3,2,1.484523097377384
22400,703-004-5396,6492.7,2,0,2,0.27920371738274696
22405,703-004-5386,9208.783,3,2,1,1.6346845334783857
2244,207-008-2398,1066.5203,3,2,1,0.4512630082198648
22729,703-004-5394,803.5475,2,1,1,0.5711191267252976
23077,207-008-2398,9220.825,2,2,0,0.9242816212276325
23283,703-004-5399,8949.003,7,5,2,2.284116916313737
23487,703-004-5389,1129.9437,3,1,2,0.36891928812656655
23525,703-004-5384,53.839684,4,4,0,1.4586474144349313
23733,703-004-5386,2749.7751,1,1,0,0.3637500930527101
23861,207-008-2399,1642.0818,8,3,5,0.860245099279723
24386,703-004-5384,9832.6875,6,2,4,1.0222737418310752
24439,703-004-5397,6527.704,2,1,1,1.1218892069603301
2445,703-004-5396,5252.63,8,3,5,1.073739261680037
24458,703-004-5383,1534.6134,4,0,4,0.27920371738274696
24499,207-008-2398,8561.324,7,4,3,0.8243938621225398
24604,703-004-5397,8088.3745,3,1,2,0.560975137585638
25026,703-004-5387,8155.285,3,2,1,1.5509152679921652
25185,703-004-5384,3830.0193,4,1,3,0.34856320377059913
25209,703-004-5398,4090.197,8,5,3,3.3681512581424617
2544,703-004-5391,6967.314,3,1,2,0.8578010983832745
25454,703-004-5381,6926.053,6,3,3,1.7084932154271042
25954,703-004-5388,4859.419,2,1,1,0.5165268771580819
26036,703-004-5395,6476.3413,7,1,6,0.8976538083871389
26116,703-004-5395,5019.8735,3,3,0,1.133269535618929
26372,703-004-5390,4545.595,9,7,2,2.3633001282802435
26472,703-004-5394,7161.2324,5,1,4,0.7598542479571022
26504,703-004-5396,2399.5984,6,3,3,1.6188244911019793
26742,703-004-5387,6548.246,4,2,2,1.6018754516823115
26820,703-004-5396,548.36096,5,3,2,2.0381175408042096
26827,703-004-5397,2777.1794,5,1,4,0.5160465477228625
26840,703-004-5392,9078.59,4,2,2,1.179814803749611
27088,703-004-5392,3077.3645,6,5,1,2.811230083062603
27234,703-004-5380,7575.313,2,2,0,0.904788391542404
27300,207-008-2399,3365.1287,1,1,0,0.33853450732658075
27354,703-004-5380,643.7468,3,2,1,0.7366136227635395
27468,703-004-5380,4794.004,6,3,3,1.7914137854406593
27522,703-004-5394,7446.341,3,1,2,0.5165268771580819
27734,703-004-5383,7573.0664,4,2,2,0.4041164552219967
28161,703-004-5396,1006.9007,2,1,1,0.44829646872267315
28208,703-004-5387,8380.706,3,1,2,0.8299475391360867
28225,703-004-5380,4222.5303,4,3,1,1.8412743417490989
28481,703-004-5387,6562.3027,5,1,4,0.3919322182760311
28509,703-004-5397,8991.574,4,4,0,1.0717000389042555
2876,703-004-5394,2049.592,4,3,1,1.6954930077457477
2879,207-008-2399,1000.0682,1,0,1,0.27920371738274696
28932,703-004-5398,546.425,4,2,2,0.524248561843543
28958,703-004-5397,1261.2039,4,1,3,0.5384446578219826
29153,703-004-5396,3556.695,2,0,2,0.27920371738274696
2968,703-004-5393,2499.9243,3,1,2,2.626752462366403
30102,703-004-5399,7463.968,4,1,3,0.49385487244846354
30110,207-008-2399,3370.2468,6,4,2,0.900755549804702
30163,703-004-5388,185.23573,2,1,1,0.5569882667618763
3025,703-004-5383,6773.321,7,5,2,1.1171803994870904
30726,703-004-5384,8190.9917,3,1,2,0.6086526861542045
30865,703-004-5385,5092.004,6,2,4,1.0592530509642364
31061,703-004-5398,6260.079,3,1,2,0.33853450732658075
31110,207-008-2399,8298.328,6,4,2,1.3507437830707927
31126,703-004-5397,4151.9062,5,1,4,0.8107046638602103
31153,703-004-5397,7126.3115,5,1,4,1.6403986382026123
31505,703-004-5394,4058.5613,2,0,2,0.27920371738274696
31882,703-004-5385,6692.237,5,2,3,0.5781403860336679
3225,207-008-2399,1376.763,3,3,0,1.1377154536240517
32467,703-004-5398,7689.7583,4,2,2,0.7243731720449432
32607,703-004-5392,7246.948,3,2,1,0.9399166742255649
32987,703-004-5397,7482.2847,3,2,1,1.1234097143838362
33011,703-004-5381,7910.7744,4,3,1,0.990283377362363
33859,703-004-5397,1467.7382,5,1,4,0.5837684390944268
33935,703-004-5385,4822.134,1,0,1,0.27920371738274696
34029,703-004-5385,6091.6226,9,4,5,1.2401955924378147
3435,703-004-5390,3999.6653,3,1,2,0.32666834933781397
35468,703-004-5396,5340.784,6,3,3,1.1710465546273727
35479,207-008-2398,7994.369,7,4,3,1.579037118247181
36104,703-004-5386,8700.905,2,2,0,0.6854542189796389
36339,703-004-5385,1826.7256,6,4,2,5.4165386997874
36660,703-004-5389,9609.6875,3,2,1,0.42844844138900484
36892,703-004-5388,3431.0747,5,2,3,1.0627149336334778
3697,703-004-5390,5940.092,3,2,1,0.5169930405489691
37280,703-004-5383,6810.454,4,3,1,1.4586953354767311
37332,703-004-5395,4692.3403,4,2,2,1.0217523150057009
37658,207-008-2399,6543.466,2,1,1,2.0304980052066135
37985,703-004-5390,8723.912,4,3,1,1.9190999162407345
3812,703-004-5393,5015.086,6,2,4,0.9233115724574679
38396,703-004-5389,5052.974,2,1,1,0.39455586733890036
38461,703-004-5382,8386.305,4,2,2,0.9360820235703754
38476,703-004-5384,28.159023,5,2,3,1.0441069538138612
38515,703-004-5386,5795.216,7,2,5,0.6441009187680496
38810,703-004-5385,9068.947,2,1,1,0.494783517879386
38979,703-004-5389,3677.3264,1,0,1,0.27920371738274696
39064,703-004-5394,9817.225,7,3,4,0.9864459880968564
39171,703-004-5381,3792.457,1,1,0,2.0163537556517155
39469,703-004-5391,358.40927,4,1,3,0.5837684390944268
39526,703-004-5389,9042.9375,7,3,4,0.7959311893765763
39591,207-008-2398,1692.692,4,0,4,0.27920371738274696
39842,703-004-5382,5155.6904,6,3,3,0.7462406905233273
39847,703-004-5398,6225.7163,2,1,1,0.5967209753688617
39877,703-004-5386,6931.8623,7,4,3,2.4710030792960054
39951,703-004-5397,6157.28,8,4,4,1.2028087199524577
40108,703-004-5382,2889.7954,3,1,2,0.7866184875244175
40166,207-008-2398,8644.794,2,2,0,0.7980207483871223
402,703-004-5398,4026.3325,6,1,5,0.4371377338052172
40215,703-004-5385,1459.0568,4,4,0,1.3305287647882067
40346,703-004-5392,1856.901,6,3,3,0.8743616318270894
40617,703-004-5381,5727.8784,8,5,3,1.41727789777555
41113,703-004-5392,8287.057,1,1,0,1.5938126400104353
41316,703-004-5395,8082.1997,3,0,3,0.27920371738274696
4149,703-004-5397,6682.975,1,0,1,0.27920371738274696
41585,703-004-5388,4141.933,1,1,0,0.5772989026891813
41767,703-004-5389,198.34756,2,2,0,0.554780041397319
4283,703-004-5393,8003.2773,6,5,1,1.5121536864808367
42836,703-004-5383,5204.41,4,2,2,1.0433341829968552
43038,703-004-5392,4884.5874,4,1,3,0.3705334289347922
43599,703-004-5392,8453.076,2,1,1,0.8663092527372328
43988,703-004-5393,163.37692,6,2,4,2.1156534637006796
43994,703-004-5397,2291.574,3,3,0,1.4559206720581286
44492,703-004-5394,1728.118,5,4,1,1.5421893162640226
44812,703-004-5382,2186.9873,2,1,1,0.4020974431682231
44849,703-004-5393,2938.693,5,1,4,0.6273061759501722
44993,703-004-5394,5394.6387,3,1,2,0.4514769785137747
45068,703-004-5381,7445.2065,5,2,3,1.162674260817658
45088,703-004-5385,9166.292,5,3,2,0.7122576845912311
45110,703-004-5390,829.3831,3,2,1,1.6858811075363285
4516,703-004-5397,1779.8383,8,3,5,1.0546648495346078
45425,703-004-5388,8512.023,3,1,2,0.5076676958698044
45486,703-004-5390,1791.0457,3,2,1,0.5047463974571597
457,207-008-2399,434.70322,3,2,1,0.9409904220831127
45739,703-004-5392,3321.6416,1,1,0,0.6515027782819108
45817,703-004-5380,8788.339,3,1,2,0.3971891279468004
46018,703-004-5380,8664.271,5,0,5,0.27920371738274696
46060,703-004-5386,1450.0862,5,3,2,1.4280405466098725
46331,703-004-5387,5902.5327,2,1,1,0.5658621824813097
4716,207-008-2398,8663.478,4,2,2,1.1658766476974065
47311,207-008-2398,8442.425,3,2,1,1.3271469843435086
47330,703-004-5397,7689.6436,6,1,5,0.707360389899748
47449,703-004-5381,6831.4614,5,0,5,0.27920371738274696
47581,703-004-5384,1017.3964,9,5,4,1.4821202639304718
47904,703-004-5383,8070.085,1,1,0,0.3902511792276225
47976,703-004-5386,7179.449,5,1,4,0.4092894941618434
48023,703-004-5397,8549.642,1,1,0,0.4525558826282161
48048,703-004-5391,6422.038,4,2,2,0.43741915723297026
48279,703-004-5388,7079.7437,6,2,4,0.9135385542182992
48489,703-004-5394,9982.61,10,7,3,1.9682775656498555
49102,703-004-5381,810.6124,4,0,4,0.27920371738274696
49270,703-004-5393,7067.641,6,3,3,2.89211775226356
49400,703-004-5380,3860.9521,3,2,1,0.6069300206006621
49470,703-004-5391,2329.6826,9,6,3,1.5755455052476952
49791,703-004-5398,9579.555,7,2,5,1.0796226337489567
5066,703-004-5387,8436.089,8,3,5,1.1759591559761955
5201,703-004-5389,1997.8452,4,1,3,0.4044095589160322
5385,703-004-5390,6586.984,3,1,2,0.6511233411785997
5456,703-004-5396,1645.8744,3,2,1,0.6314777521351567
5470,703-004-5383,337.98337,3,2,1,0.4978523050135729
5509,703-004-5397,3175.6604,2,0,2,0.27920371738274696
5719,703-004-5388,1828.6418,4,3,1,0.8261403006598174
5741,703-004-5395,6252.6626,3,0,3,0.27920371738274696
6014,703-004-5399,942.42035,4,1,3,0.3618589241232504
6279,703-004-5386,9731.081,3,2,1,1.1003781793314724
67,703-004-5380,8432.237,5,3,2,1.2987452152786392
6748,703-004-5393,6353.522,4,2,2,1.8834551588719208
811,207-008-2399,9292.62,5,4,1,1.3148485512704058
8578,703-004-5383,9752.721,4,0,4,0.27920371738274696
8651,703-004-5393,8805.411,4,1,3,0.9585523538594954
8766,703-004-5387,1137.5928,3,3,0,0.7457319400402816
9148,703-004-5392,2010.5255,4,3,1,1.973652132133279
9691,703-004-5382,9266.286,6,6,0,1.4343562877580749
9811,703-004-5381,7985.597,5,3,2,1.5597287241503652
9969,703-004-5389,1908.4626,3,3,0,1.7484868347820148
10088,703-004-5391,4373.9414,3,1,2,0.4884410594232229
10177,703-004-5380,4555.0317,6,3,3,1.032601591772276
10203,703-004-5389,7467.5347,3,1,2,0.5310365527611767
10710,703-004-5387,8636.462,1,0,1,0.27920371738274696
11237,703-004-5385,3902.619,5,2,3,0.6036364853445773
11280,703-004-5383,7752.132,1,1,0,0.5657994423160962
11718,703-004-5386,2556.8872,3,1,2,0.4994329186175822
12307,703-004-5398,8179.0776,5,3,2,0.9616239367206257
12454,703-004-5381,5690.512,4,2,2,0.6876759699159941
12778,703-004-5389,7703.6714,5,1,4,1.134677192529971
12838,207-008-2398,6703.218,6,6,0,3.7539848100426614
12986,703-004-5391,9495.604,3,2,1,1.899282390090269
132,703-004-5399,4340.9688,6,3,3,1.5955291735854857
13735,207-008-2398,500.97943,4,1,3,0.5507739715243947
13986,207-008-2399,3168.0059,5,4,1,1.5445236591186922
14387,703-004-5382,9119.827,8,6,2,1.8235425563052003
14836,703-004-5382,3921.8264,2,1,1,0.4740194896564528
14872,703-004-5383,6981.772,6,4,2,1.0244594966546925
15259,703-004-5395,4294.036,4,3,1,1.3533573433752397
15331,703-004-5380,9536.054,2,2,0,0.8846973577129466
154,703-004-5389,5821.0093,4,1,3,0.3978652972704144
15492,703-004-5385,5297.3877,2,0,2,0.27920371738274696
15899,703-004-5394,7563.9473,"","","",0.27920371738274696
16561,703-004-5395,9390.552,8,5,3,2.2820046579807736
16590,703-004-5386,7313.2056,6,5,1,0.9463594026090969
16705,703-004-5390,4128.558,9,5,4,2.0595126990645727
16735,703-004-5387,1958.9901,3,3,0,2.941071254319424
17106,207-008-2399,3429.4849,3,1,2,0.3851743228458582
17423,703-004-5390,8891.123,5,1,4,0.33853450732658075
17704,703-004-5387,9393.078,7,3,4,1.6641759082531495
18111,703-004-5390,304.98148,8,5,3,2.103355629198147
18539,703-004-5392,7163.6865,4,2,2,0.9862183724773637
19074,703-004-5380,7572.9688,3,1,2,1.6424228622237038
19214,703-004-5388,4501.642,4,2,2,1.1103330441483736
19697,703-004-5386,6066.4844,5,1,4,1.5453993474510033
19844,703-004-5390,5443.9844,2,0,2,0.27920371738274696
19869,703-004-5398,9607.06,1,0,1,0.27920371738274696
20621,703-004-5391,8939.024,3,2,1,1.208492418748378
20722,703-004-5392,7322.75,7,6,1,3.107607485704233
20764,703-004-5384,9641.544,2,2,0,1.8446506610709068
2079,703-004-5395,9180.513,4,0,4,0.27920371738274696
21045,703-004-5399,9610.584,5,1,4,0.45846073948267596
21401,703-004-5396,5561.5405,4,3,1,1.2118230242449644
21430,703-004-5398,8852.58,5,3,2,0.7630962870458545
21604,703-004-5381,5794.322,5,2,3,0.5723472620302388
21612,703-004-5390,9612.206,2,1,1,0.5007364536817241
21731,703-004-5399,3363.0396,1,1,0,0.4158571747625472
22249,703-004-5399,7912.8633,3,1,2,0.5906049689852284
22434,703-004-5396,2852.325,4,0,4,0.27920371738274696
22526,207-008-2398,9200.378,1,0,1,0.27920371738274696
22821,703-004-5389,6715.417,10,2,8,0.8401298603163083
23065,703-004-5384,5008.9966,3,2,1,0.6217128998721841
23368,703-004-5393,7989.7485,1,1,0,0.49711856717728836
23383,703-004-5396,6845.211,7,2,5,0.5169601155304843
23486,703-004-5391,3452.2944,7,1,6,0.6173892200625992
23798,703-004-5382,2571.1196,6,1,5,0.5948265959513093
23819,703-004-5384,8798.777,11,7,4,2.0580251114968906
24347,703-004-5383,7194.3003,6,2,4,0.5535440540034818
24362,703-004-5395,6727.4053,3,1,2,0.6183112772946422
24394,703-004-5398,664.022,"","","",0.27920371738274696
24565,703-004-5386,5080.899,4,1,3,0.9170112368397034
24641,703-004-5381,6497.659,2,1,1,0.421560531504233
24651,703-004-5398,7339.133,3,2,1,0.7632334167045868
25198,703-004-5382,8769.124,5,2,3,0.7560102371263554
26238,703-004-5386,4840.653,2,1,1,0.3712081725383869
26392,703-004-5399,7420.4565,3,1,2,0.33853450732658075
26425,703-004-5390,1606.4275,3,2,1,0.9520530216412441
26780,703-004-5398,8543.9,3,2,1,0.6328976667572263
26918,703-004-5387,9054.972,1,0,1,0.27920371738274696
26977,703-004-5393,2520.7268,7,6,1,3.109190612298615
27432,703-004-5393,2635.6597,2,2,0,1.3373943371919463
27538,703-004-5383,1799.5477,1,1,0,0.44652759476080367
2762,703-004-5394,7374.2886,6,4,2,1.7232182242776146
27666,703-004-5384,8638.573,2,1,1,0.35831143730785864
27814,703-004-5392,5205.4995,5,2,3,1.2558189381113682
27832,207-008-2399,9588.04,10,6,4,3.040632959808134
28144,703-004-5381,6499.304,5,4,1,0.9462181593227603
28206,703-004-5380,6213.631,4,2,2,0.7041844224037574
28436,703-004-5380,4634.197,10,4,6,1.3670104346447958
28852,703-004-5382,7513.9404,3,2,1,0.7147528158184712
29079,207-008-2399,1050.424,5,4,1,0.7660128488719028
2931,703-004-5395,4138.017,1,1,0,0.4295987897703373
29760,703-004-5388,6619.6562,"","","",0.27920371738274696
29855,703-004-5383,9013.581,3,3,0,1.869288356076817
30375,703-004-5397,3330.763,3,2,1,1.7587461947449154
30555,703-004-5385,7912.449,5,3,2,1.2070852004758421
30556,703-004-5391,6806.778,5,2,3,0.49882652482483814
30558,703-004-5387,5156.56,1,0,1,0.27920371738274696
30782,703-004-5396,1959.8907,3,0,3,0.27920371738274696
30961,703-004-5393,1624.7153,5,4,1,1.2485645476858178
31147,703-004-5390,8383.148,5,2,3,0.4864751542796589
31182,703-004-5390,4839.515,7,2,5,1.833540494075611
3140,703-004-5382,1873.3925,4,0,4,0.27920371738274696
317,703-004-5382,8768.897,7,2,5,1.114971452014104
31880,703-004-5390,2590.6968,2,2,0,1.9154778446380496
32428,703-004-5387,2089.68,3,3,0,1.863717044858186
32970,703-004-5394,9982.348,2,0,2,0.27920371738274696
32971,703-004-5392,7013.8003,2,1,1,0.7842498411479834
33080,703-004-5389,3292.7375,1,0,1,0.27920371738274696
33341,703-004-5395,3252.8538,"","","",0.27920371738274696
33703,703-004-5399,5520.666,4,1,3,0.5649912239867204
34318,703-004-5389,2676.6694,6,3,3,0.9280200648843494
34499,703-004-5391,4787.2188,4,2,2,1.1472458451793717
34559,207-008-2398,9578.686,8,3,5,0.7100591349593088
34649,703-004-5394,6143.6235,3,2,1,1.4758620101748399
34725,703-004-5383,6134.4165,1,1,0,1.0278375444426953
34785,703-004-5395,1552.7314,8,5,3,1.0750683303102377
3490,703-004-5391,2089.7466,7,4,3,1.4099389686602832
35176,703-004-5382,1092.7104,9,1,8,0.4410119661795691
35182,703-004-5399,3156.2156,3,2,1,1.2217471982312995
35590,703-004-5396,7247.658,7,5,2,1.3118936931165353
35671,703-004-5394,9070.597,5,5,0,5.12068867704573
35678,703-004-5392,4263.4814,4,1,3,0.7852886884658283
3581,207-008-2399,8014.855,2,1,1,0.32666834933781397
35845,703-004-5387,5160.3306,3,2,1,0.711028226927367
36065,703-004-5391,9443.988,3,2,1,1.0400861871562608
36306,703-004-5389,3872.5256,5,3,2,4.7736525255743905
36651,703-004-5381,1279.7052,4,2,2,0.8497103709993851
36667,703-004-5387,4821.053,3,0,3,0.27920371738274696
36890,703-004-5396,6750.6294,6,1,5,0.42438495327036546
36930,207-008-2399,6065.844,3,1,2,0.6516403906739249
36958,703-004-5399,2364.1128,4,2,2,1.7928473083793801
3711,703-004-5393,6215.2583,4,3,1,0.7204145225422475
37364,703-004-5381,3694.1558,1,1,0,0.5774585917766604
3740,703-004-5396,244.36475,1,1,0,0.4230808829965438
37422,703-004-5380,6397.576,8,2,6,0.5457785941683087
3781,703-004-5386,6357.586,8,6,2,1.6681494945257953
37937,703-004-5389,3640.6995,7,3,4,0.6236182633320485
37959,703-004-5397,5484.224,6,2,4,1.6110872783190209
3808,703-004-5397,2943.7847,6,2,4,0.540452017471661
38095,703-004-5390,800.8194,3,2,1,0.7241886208445871
38315,207-008-2399,9577.623,1,0,1,0.27920371738274696
38346,703-004-5385,3212.483,6,3,3,1.3612381605155548
38527,703-004-5391,9892.328,6,5,1,3.5309789962457403
38762,703-004-5386,6397.794,5,4,1,1.7330313163076307
38873,703-004-5384,1764.167,3,2,1,1.3820670223390226
39119,703-004-5383,8424.155,2,0,2,0.27920371738274696
39225,207-008-2399,3033.6135,7,3,4,0.79657545959128
39357,703-004-5381,8365.95,5,3,2,1.6130813497933316
3967,703-004-5395,8315.668,4,3,1,0.6483770994582498
40203,703-004-5390,1414.7211,3,1,2,0.49461145987028643
40260,703-004-5399,4417.601,6,3,3,1.3415243335214635
40434,703-004-5394,3690.8508,7,4,3,1.5778752228249528
4044,703-004-5390,7756.9805,7,4,3,1.558811960329582
40805,703-004-5394,1183.052,2,1,1,0.9969408229007035
41266,703-004-5383,8962.862,5,3,2,2.13957451773655
41393,703-004-5391,4306.7915,4,1,3,0.8253757125494595
41561,703-004-5382,7069.865,3,2,1,3.2264403610195664
4165,703-004-5388,8556.308,1,1,0,1.3926974709517494
41779,703-004-5393,5524.2227,5,2,3,0.710561758674326
41829,703-004-5383,4828.03,6,1,5,0.3978652972704144
41848,703-004-5388,7177.3047,10,6,4,2.1741236304262395
42156,703-004-5391,1813.2466,3,1,2,0.3543840069263139
42247,703-004-5392,4238.856,6,3,3,4.703997792269193
42457,703-004-5391,7046.9873,4,2,2,0.5809463777589352
42486,703-004-5399,195.11879,5,2,3,0.8527986194561569
42874,703-004-5397,9939.928,5,2,3,1.1863400251905836
42971,703-004-5385,8761.53,5,4,1,1.421043220133969
43209,703-004-5386,6073.7954,3,0,3,0.27920371738274696
43234,703-004-5389,5720.039,7,2,5,2.8189623652658438
43414,703-004-5394,9803.838,2,1,1,0.5922270337824761
43660,703-004-5382,5939.679,11,3,8,0.8390645461369498
4369,703-004-5383,4913.566,2,1,1,0.4409419228858854
43955,703-004-5388,7670.0703,5,3,2,3.5775342892493684
43968,703-004-5393,8696.098,1,1,0,0.7120207548883917
4403,703-004-5393,661.35645,1,0,1,0.27920371738274696
44057,703-004-5385,3989.4521,3,2,1,0.5438182216437384
44087,207-008-2398,2104.1064,8,4,4,1.7833121329428407
44233,703-004-5390,2044.5121,4,2,2,0.5376390030943456
4437,703-004-5381,576.22314,2,0,2,0.27920371738274696
44505,703-004-5391,9847.63,7,3,4,0.9537919533034651
45198,703-004-5383,5619.028,7,4,3,1.723678844838179
45439,703-004-5383,849.9807,2,1,1,0.5107895493950639
45474,703-004-5391,8066.606,2,2,0,1.4454520947062603
4564,207-008-2399,6168.175,7,5,2,2.802946552322655
45848,703-004-5391,8395.474,7,3,4,1.4520987825600398
45895,703-004-5395,9279.411,4,2,2,0.7521779229979495
46004,703-004-5386,6981.9087,2,1,1,0.3239227110853239
46066,703-004-5394,1834.4224,3,3,0,1.2637697097646379
46121,703-004-5383,8957.574,3,2,1,1.2139390520211886
46457,703-004-5392,6098.5024,4,2,2,2.263861039121412
46514,207-008-2398,924.52704,5,4,1,1.0613919283716078
46549,703-004-5395,3464.496,2,0,2,0.27920371738274696
46720,703-004-5393,4466.511,5,2,3,0.47576902791302006
46788,207-008-2399,9092.024,10,6,4,2.061397175887828
46886,703-004-5393,6964.3623,8,3,5,1.1853812104649133
47144,703-004-5396,9710.231,6,3,3,0.46090256415788294
4740,703-004-5383,2595.64,3,3,0,1.3814944044631927
47522,703-004-5397,4022.7754,4,1,3,0.6123461029173735
47529,703-004-5381,1742.3641,3,0,3,0.27920371738274696
47881,703-004-5389,1542.4615,5,2,3,0.37808836728913653
48120,703-004-5381,4560.9067,3,2,1,4.226749418857438
48130,703-004-5384,8043.4297,7,3,4,2.864176916621804
48158,703-004-5384,5070.0903,4,2,2,0.7905802278967398
48443,703-004-5389,7698.924,2,1,1,0.4475223903010426
48822,703-004-5385,2960.7625,8,4,4,0.8973778927042979
4884,703-004-5385,5453.5884,3,2,1,0.7962290670058728
48951,207-008-2398,5965.426,6,5,1,2.214001889657709
49256,703-004-5396,6618.7817,4,2,2,0.6655523207495945
49401,703-004-5392,1114.2528,2,1,1,0.5321179706973056
49931,703-004-5383,6023.645,4,1,3,0.988292709593615
5426,207-008-2398,285.94138,4,2,2,0.9711397835190588
5656,703-004-5387,3838.379,5,3,2,1.0030759648754195
5732,703-004-5397,9517.993,5,2,3,1.4830403766358513
5802,207-008-2398,618.99243,2,1,1,0.8953478015411441
5829,703-004-5381,6768.145,6,4,2,0.8108898157751592
5965,703-004-5390,9010.297,2,1,1,0.6688647370236817
6019,703-004-5395,8294.217,5,3,2,1.1868515414716434
6121,703-004-5389,2478.95,9,4,5,2.8410409408175172
6300,207-008-2399,2546.1353,5,1,4,0.9196204617803384
6388,703-004-5380,2874.5376,2,1,1,0.44233382732628634
6460,703-004-5380,6722.483,6,3,3,0.7915903626314543
7012,703-004-5387,3469.4678,8,2,6,0.502478532715181
714,703-004-5394,9176.859,4,2,2,0.8221606585210944
727,207-008-2399,3112.3853,7,5,2,3.1690533890012134
7521,703-004-5387,6015.028,5,3,2,1.2584088064668861
7621,703-004-5390,7807.4785,7,2,5,0.5796573454078068
7625,703-004-5399,102.91994,4,0,4,0.27920371738274696
8421,703-004-5389,8241.538,7,0,7,0.27920371738274696
8714,703-004-5383,1189.7898,3,1,2,0.3978652972704144
9201,703-004-5399,9049.999,3,2,1,1.0842640748104095
9687,703-004-5398,1910.7169,6,3,3,0.7502781505419067
987,703-004-5385,4644.672,5,2,3,1.6510899335444558
9951,703-004-5390,8121.8237,5,2,3,1.0215323174853315
10007,207-008-2398,8896.011,9,7,2,2.387807842950428
10121,703-004-5397,6932.035,3,3,0,0.6604040427718787
10780,703-004-5397,7053.333,1,0,1,0.27920371738274696
11024,703-004-5381,9142.1875,5,2,3,1.0410568604145543
11074,703-004-5393,6260.562,11,5,6,1.2926142543871868
11104,703-004-5382,2534.2273,3,2,1,0.47697301719552604
11312,703-004-5389,3986.072,3,2,1,0.8674021873786102
11389,703-004-5385,6070.7446,4,3,1,0.5893794095821275
1155,703-004-5387,6784.0957,1,0,1,0.27920371738274696
11590,703-004-5384,4941.3433,4,4,0,2.055253138205756
11932,703-004-5396,3644.697,2,2,0,0.6292553780513659
11988,703-004-5392,9334.754,4,2,2,0.7963506676242333
12116,703-004-5389,7535.1313,3,3,0,1.0686220670996605
12157,703-004-5393,1379.7725,4,4,0,1.9652942706783112
12544,703-004-5394,8463.636,6,2,4,0.7017456636635755
12558,207-008-2399,3969.6824,5,1,4,0.3919322182760311
12625,703-004-5382,685.7556,7,3,4,0.7007820101535501
12764,703-004-5396,1991.9169,6,2,4,1.0409051460545717
12765,703-004-5387,4583.8286,8,1,7,0.9269434117282414
13057,703-004-5388,3742.919,5,3,2,1.0920721133576958
13172,703-004-5387,3398.9895,5,2,3,2.974755789877242
13256,703-004-5393,2235.831,2,0,2,0.27920371738274696
13390,703-004-5383,3064.2832,5,2,3,0.6579410936771147
13420,703-004-5384,4313.297,1,1,0,0.3978652972704144
13573,207-008-2398,8528.928,3,1,2,0.35831143730785864
13638,703-004-5392,836.6698,10,5,5,1.713960373654129
1368,703-004-5399,679.91315,3,0,3,0.27920371738274696
13918,703-004-5382,9889.391,2,0,2,0.27920371738274696
14005,703-004-5388,6944.832,8,4,4,2.6586352569845793
14039,703-004-5396,1232.8005,3,2,1,1.7346801499266522
14325,703-004-5383,312.97983,3,1,2,0.5165268771580819
14640,703-004-5380,9632.397,6,2,4,1.7852549865231915
1466,703-004-5397,1623.227,3,2,1,1.7561850152589966
15053,703-004-5398,6593.8086,4,2,2,1.4916460508285343
15059,703-004-5386,4749.168,6,1,5,0.35831143730785864
15086,703-004-5399,973.289,3,2,1,1.345402545537196
15109,703-004-5396,6154.378,2,0,2,0.27920371738274696
15773,703-004-5390,3694.265,5,3,2,0.9561151655038618
15997,703-004-5395,2679.6733,4,1,3,0.4987276401749318
16248,703-004-5397,3352.8096,3,1,2,0.46883201423688403
16369,703-004-5393,8255.1,3,2,1,1.4706155182295952
16468,703-004-5395,5711.2383,4,1,3,0.45691371921119844
16625,703-004-5384,4488.66,5,4,1,1.133960435772761
16868,703-004-5387,6498.17,5,3,2,3.7190937484107005
17034,703-004-5390,5086.752,4,3,1,0.6214478030071827
17080,703-004-5387,2556.4038,3,1,2,0.3889656787788394
17085,703-004-5381,3057.8948,5,2,3,0.7407581034844508
17157,207-008-2398,6265.5127,2,2,0,0.46757658574204636
17222,703-004-5384,5732.3564,2,0,2,0.27920371738274696
17356,703-004-5386,1214.5173,5,3,2,1.1753624746360496
17381,703-004-5389,1303.249,5,2,3,0.5080722395910855
17548,703-004-5398,9263.68,3,2,1,1.214843710806352
18166,703-004-5393,3383.8135,3,1,2,0.33853450732658075
18641,703-004-5395,1834.532,6,3,3,1.3337343310369587
19019,207-008-2398,1695.4272,4,3,1,1.9404274518986078
19155,703-004-5399,6056.279,7,6,1,2.5341919816716865
19278,703-004-5388,4944.0835,7,3,4,2.841963578971369
20496,703-004-5398,2542.594,6,3,3,0.5853218672241698
20627,703-004-5397,8869.028,6,1,5,0.7150126793423154
20709,207-008-2399,6311.5913,4,3,1,0.9478730897393783
20848,703-004-5380,8378.832,3,1,2,0.35114230018964543
20909,703-004-5380,6501.9517,2,2,0,0.8014941781471355
21226,703-004-5380,748.4794,5,2,3,0.5509979314388428
21487,703-004-5380,978.3393,4,1,3,0.3978652972704144
21734,703-004-5393,4611.0513,3,0,3,0.27920371738274696
21802,703-004-5383,1641.5352,3,1,2,0.49944908609987376
21821,207-008-2399,6259.265,9,6,3,2.3599966505961985
21977,703-004-5383,2965.2483,"","","",0.27920371738274696
22798,703-004-5382,4788.437,5,2,3,0.7533642863626191
22889,703-004-5387,8390.548,6,5,1,1.8752311864233924
23738,703-004-5399,4102.6255,3,1,2,0.7972280751245618
2401,703-004-5396,2282.43,8,5,3,1.056730279634129
2418,703-004-5390,7946.322,5,2,3,0.810888111582526
24368,703-004-5380,7936.823,5,0,5,0.27920371738274696
25098,703-004-5399,6524.2173,2,0,2,0.27920371738274696
25208,207-008-2398,3245.5308,3,0,3,0.27920371738274696
25330,703-004-5386,1308.4019,4,1,3,0.4170357347322665
2546,703-004-5383,4331.489,4,2,2,3.60200013749805
25497,703-004-5391,7021.972,5,2,3,1.7424668757884454
25640,703-004-5390,1471.0564,3,1,2,0.48897069534999427
25642,703-004-5390,9982.025,3,2,1,0.9100496912917065
25661,207-008-2398,5356.786,2,1,1,0.528231845442138
25722,703-004-5398,932.32513,6,3,3,1.4240919622433976
25795,703-004-5389,9305.589,6,4,2,1.0501721626107308
25943,703-004-5387,2094.8267,5,3,2,1.1223693101341559
26200,703-004-5394,8836.393,4,4,0,1.1789796677657225
26207,703-004-5390,5295.769,3,1,2,0.32666834933781397
26226,703-004-5384,9814.651,2,1,1,0.5155976005499554
26363,703-004-5395,4420.183,3,1,2,0.4350442771451881
26475,703-004-5386,4749.8477,4,3,1,1.0710527777244496
26668,703-004-5393,3001.474,3,1,2,0.43011982459718384
26774,703-004-5395,1827.8801,3,2,1,0.9503418712520448
26913,703-004-5380,3721.242,4,1,3,0.6735009857531908
26966,703-004-5385,834.37384,3,2,1,1.2020953379550932
27116,703-004-5384,3727.6113,5,4,1,1.3329993194750156
2724,703-004-5389,4436.033,5,2,3,0.9913634858420582
27282,703-004-5386,3708.8484,4,3,1,2.4669844891820976
27397,207-008-2398,861.513,1,1,0,0.33853450732658075
27404,703-004-5382,9562.867,6,4,2,1.3792779978230088
28010,703-004-5384,7970.2134,2,2,0,0.9155510587989366
28454,703-004-5389,3719.4216,6,2,4,1.0852044107559553
2855,703-004-5385,4408.201,4,0,4,0.27920371738274696
28682,703-004-5382,2777.5383,3,1,2,0.8199245498067929
29425,703-004-5383,6833.5723,6,4,2,1.527316590461552
29445,703-004-5396,3291.9204,3,2,1,2.9302345987969267
29751,703-004-5387,2790.3699,3,0,3,0.27920371738274696
29876,703-004-5389,1276.1188,6,3,3,1.1641269289654619
30278,703-004-5391,8493.4375,6,4,2,2.2055544333792176
3041,703-004-5391,7798.279,2,0,2,0.27920371738274696
30518,703-004-5391,4942.627,5,3,2,1.2494331693413872
30606,703-004-5383,2639.0146,4,0,4,0.27920371738274696
3071,703-004-5382,676.1527,2,0,2,0.27920371738274696
30721,703-004-5381,391.73663,4,2,2,1.8609837043108075
30862,703-004-5384,4565.736,"","","",0.27920371738274696
30888,703-004-5395,8190.451,"","","",0.27920371738274696
31329,703-004-5385,1781.1382,1,0,1,0.27920371738274696
3150,703-004-5381,2513.6262,4,3,1,1.0322009544777715
31542,703-004-5383,9115.988,7,5,2,1.066901491294458
31667,703-004-5397,2865.297,6,4,2,0.8220549785739936
31935,703-004-5399,9013.292,1,0,1,0.27920371738274696
32015,703-004-5382,9245.088,2,1,1,0.5981508890377719
3231,207-008-2399,6332.7183,7,3,4,0.6695282499522545
32598,703-004-5387,9748.686,2,2,0,0.590780230968025
32688,703-004-5384,899.36255,3,1,2,0.4314860782385869
33062,703-004-5394,7570.707,3,3,0,1.3070882332723328
33074,703-004-5390,7651.506,2,1,1,0.7273128231357445
3308,703-004-5396,6243.5854,4,2,2,0.5057956473365036
33206,703-004-5386,5305.147,"","","",0.27920371738274696
33270,703-004-5398,9834.496,2,1,1,0.37751921211565326
33271,703-004-5380,3053.689,5,2,3,0.937140038499454
33316,703-004-5390,8039.1533,5,1,4,0.4722092491862857
33421,703-004-5382,2099.422,2,1,1,0.5465260106900864
33502,703-004-5384,2050.4731,6,5,1,1.3591954688628771
3364,703-004-5395,3497.8604,4,2,2,0.5912397639832491
33923,207-008-2399,4309.892,7,3,4,0.9075731889091748
33937,703-004-5391,8823.072,1,0,1,0.27920371738274696
34337,207-008-2399,6917.1714,5,3,2,1.0811727738123806
34625,703-004-5380,3874.6135,2,1,1,0.4866238781901213
34634,703-004-5392,7214.5464,4,1,3,0.8292604988065502
34791,703-004-5380,4927.9355,4,3,1,1.4776585277429524
35059,703-004-5385,5424.7715,5,3,2,1.3906957517210845
35147,703-004-5399,8046.8237,2,2,0,1.3809755975912386
3569,703-004-5380,9981.01,5,2,3,0.7213210986064347
35843,703-004-5395,2006.2727,2,0,2,0.27920371738274696
36030,703-004-5387,4287.5786,3,2,1,1.9379778954828102
36041,703-004-5385,490.23627,6,2,4,1.3383107639742118
36047,207-008-2399,4410.991,1,0,1,0.27920371738274696
36251,703-004-5381,6907.162,4,1,3,1.1314889164128865
36702,703-004-5399,7536.841,2,0,2,0.27920371738274696
36925,703-004-5395,4122.309,9,7,2,1.954256196575206
37052,703-004-5398,4776.0723,1,0,1,0.27920371738274696
37086,703-004-5390,2807.343,2,1,1,0.3615907414311952
37106,703-004-5395,8780.843,3,0,3,0.27920371738274696
37180,703-004-5383,1243.1317,4,4,0,0.9455855989869811
37318,207-008-2398,1286.4673,6,4,2,2.0069677324527113
37521,703-004-5390,7372.949,3,2,1,0.6983955252659134
38118,703-004-5391,551.34534,6,1,5,0.585258674954134
38458,703-004-5397,6847.0806,3,1,2,1.0338024293909687
38688,703-004-5394,6999.6274,5,2,3,1.3212238648751506
39126,703-004-5397,2713.9146,2,0,2,0.27920371738274696
39289,703-004-5398,5355.409,3,2,1,0.5842981632025968
39543,703-004-5395,542.6192,6,4,2,1.979820304489308
39806,207-008-2398,7460.3623,4,2,2,1.24298911459974
39908,703-004-5389,8533.458,6,4,2,1.4209050996367254
39931,703-004-5397,6964.8643,4,2,2,0.6195353881213548
40028,207-008-2399,403.952,3,2,1,0.8849608133217204
40053,703-004-5380,7357.325,"","","",0.27920371738274696
40163,703-004-5392,4336.4917,2,1,1,0.9966927771789701
40417,703-004-5396,3876.4023,2,1,1,0.4918510501552291
40420,703-004-5388,4178.755,5,3,2,1.0870964547445678
4049,703-004-5387,4207.0977,1,1,0,0.36738513398520634
41378,207-008-2399,2792.5164,1,1,0,0.3978652972704144
41463,703-004-5391,3299.3364,4,1,3,0.5174145991381915
42265,703-004-5398,7540.727,8,0,8,0.27920371738274696
42314,703-004-5392,7367.5083,4,4,0,0.9046346188499153
42335,703-004-5388,1964.6371,3,3,0,1.4004557967891356
42418,703-004-5396,687.8048,4,1,3,0.5165268771580819
42627,703-004-5388,3924.9348,5,4,1,2.446720387468319
42656,703-004-5399,2007.5035,8,4,4,0.6675504953895355
42978,703-004-5392,3029.257,2,1,1,0.35831143730785864
42986,703-004-5391,2291.1704,4,2,2,0.7759168334754684
43060,703-004-5393,5223.4453,4,4,0,1.419456312879567
43104,703-004-5399,9787.494,8,3,5,1.6702403182808019
43154,703-004-5387,9834.017,4,2,2,1.0673871592520066
4335,703-004-5398,4372.8823,3,3,0,0.6747423170083052
43753,703-004-5385,4842.9634,9,3,6,3.364877153480959
44394,703-004-5396,1346.842,4,3,1,0.7937781774955306
44478,703-004-5395,2085.544,3,3,0,2.1564677758786517
44716,703-004-5386,5297.494,3,2,1,0.6221138686619869
44755,703-004-5387,4781.1265,1,0,1,0.27920371738274696
44836,703-004-5396,8937.579,9,6,3,3.6773040906908943
45066,703-004-5382,8893.308,2,1,1,1.586811069166682
45180,703-004-5395,3313.7173,5,4,1,0.8908219219938823
45226,703-004-5388,4764.8604,3,2,1,0.4158623035533773
4523,703-004-5385,8213.781,1,1,0,0.5338756124209357
45275,703-004-5395,5583.914,7,3,4,2.9696943447134165
45382,207-008-2398,4453.569,5,2,3,0.7043515375592002
4553,703-004-5390,7645.6436,1,0,1,0.27920371738274696
45561,703-004-5390,5599.1646,5,2,3,1.310522282321937
45729,207-008-2398,2323.2156,8,2,6,0.5308027892119327
46595,703-004-5395,8816.378,5,4,1,1.5742048975292773
46702,703-004-5383,7010.8013,4,1,3,0.4676625494017165
47000,703-004-5393,6346.6294,4,1,3,0.34969275559044416
47032,703-004-5389,8170.049,2,1,1,0.6072354272619381
47281,703-004-5391,4305.0884,8,2,6,0.7487288162367676
47284,703-004-5386,6551.612,7,3,4,1.2239826307980521
47326,703-004-5388,8619.774,1,1,0,0.9249513640051794
47520,703-004-5394,5791.6265,8,3,5,0.8526488681629969
47559,207-008-2398,9730.701,4,3,1,0.5368198600984696
47735,703-004-5382,849.0479,5,4,1,0.9246893359335705
47807,703-004-5380,2946.4548,2,0,2,0.27920371738274696
48233,703-004-5395,1695.469,7,5,2,3.3148410088740623
4851,703-004-5382,7778.9688,6,2,4,1.7041199683597503
48725,703-004-5395,4686.382,7,3,4,1.8724222286573369
4880,703-004-5395,1215.8776,7,4,3,1.5543183252167432
490,703-004-5380,2228.7393,6,5,1,2.000133770073079
49029,703-004-5399,7258.4487,3,1,2,0.4160026093388337
4907,703-004-5394,9163.256,3,1,2,1.3751076130021795
49130,703-004-5397,2880.6377,4,0,4,0.27920371738274696
4932,703-004-5384,3550.5276,4,3,1,1.0055146635745456
494,703-004-5390,8059.956,4,1,3,0.5682205068588193
49595,207-008-2398,9850.314,3,3,0,1.5086185755525785
49765,703-004-5385,482.80002,4,4,0,2.2186206230472663
4993,703-004-5390,2443.6277,3,1,2,0.5801795047048903
5050,703-004-5392,1369.3446,3,3,0,2.528148205371846
5409,703-004-5394,4293.977,3,2,1,0.6727947848030038
5598,703-004-5381,5279.409,4,2,2,0.7744306220392525
5622,703-004-5386,2771.7703,3,2,1,0.9795089504349922
5697,207-008-2398,6499.533,4,2,2,0.5884654599649802
5774,703-004-5392,567.10364,6,5,1,2.940747680370378
5981,703-004-5392,1357.6125,6,3,3,1.0487683028689472
6138,207-008-2399,8872.858,8,4,4,2.2608397947701184
6184,703-004-5384,2223.4504,5,3,2,0.6998204426678766
6193,703-004-5387,6691.8345,4,1,3,1.9144631210704923
6296,703-004-5385,5246.6445,3,3,0,1.122870241605633
6590,703-004-5392,8009.4917,2,1,1,0.45144489253778886
6685,703-004-5397,8790.519,4,1,3,0.35828671614538204
6774,703-004-5391,6714.375,10,5,5,1.710131570339056
6936,207-008-2398,7809.896,5,3,2,2.004519807428476
7125,703-004-5392,3262.0615,8,2,6,0.5380710354220247
715,703-004-5396,480.994,2,1,1,0.6191163532798979
7314,703-004-5387,5927.9966,2,2,0,1.3893311478676733
7468,703-004-5381,5202.3105,3,3,0,1.7594394849884005
7509,703-004-5390,5192.1304,8,2,6,1.544086242730987
7517,703-004-5397,2938.5364,4,4,0,1.034907689145419
7794,703-004-5396,9611.43,5,4,1,0.7671251560960207
79,703-004-5396,3867.5034,3,0,3,0.27920371738274696
864,207-008-2398,3813.554,1,1,0,0.36951836429724944
8666,703-004-5397,750.8898,5,4,1,1.1279029025034306
8796,207-008-2398,9225.12,8,4,4,1.890779150534909
893,703-004-5388,329.62204,2,1,1,0.5389852457910116
9168,703-004-5386,2620.8806,5,2,3,0.7654632277503316
9198,703-004-5382,7740.2915,8,3,5,0.8362384822789428
930,703-004-5391,8468.489,6,5,1,2.20936961973019
9644,703-004-5388,672.04474,9,5,4,2.7069102635147217
9750,703-004-5387,9573.183,6,3,3,0.9296645127144291
9836,703-004-5393,3634.082,7,1,6,0.7002940859165993
9869,703-004-5395,8822.29,5,4,1,1.3014908391935003
9996,703-004-5399,8714.326,5,3,2,0.915447501078616
10106,703-004-5381,9442.815,2,1,1,0.3822662437476815
10151,703-004-5385,6513.2207,3,2,1,1.2122827505332754
10161,703-004-5380,462.51477,1,0,1,0.27920371738274696
10302,703-004-5398,1577.5925,3,2,1,1.0455953361057235
10777,703-004-5393,6529.4473,2,0,2,0.27920371738274696
10895,703-004-5392,5078.6274,8,4,4,1.1278982406808087
10986,207-008-2399,7540.783,4,0,4,0.27920371738274696
11016,703-004-5385,2105.4382,4,3,1,1.4145062771227532
11416,703-004-5384,1725.7618,5,3,2,1.0389625491602026
11762,703-004-5391,9714.837,3,1,2,0.46847415852332186
11770,703-004-5384,8268.619,5,1,4,0.6735679662792452
11894,703-004-5389,7403.397,5,3,2,0.8809591911988014
11960,703-004-5395,4449.594,4,3,1,2.0649833896510668
12089,703-004-5391,3612.06,3,1,2,0.41107729594537584
12100,703-004-5382,1190.3483,6,2,4,0.47438236919415555
12256,703-004-5380,1727.308,4,2,2,0.7596956316250896
12525,703-004-5385,8685.9,5,4,1,2.501725669783684
12587,703-004-5380,251.94287,1,1,0,0.3995249113113434
12709,207-008-2398,3389.8772,4,1,3,1.2503958631083723
13363,703-004-5396,3304.8665,2,2,0,1.064517795730079
13364,703-004-5386,2417.7825,6,4,2,2.137753855994907
13590,703-004-5398,1485.8383,4,0,4,0.27920371738274696
13848,703-004-5385,7881.591,4,0,4,0.27920371738274696
13861,703-004-5397,1174.928,4,3,1,0.9857603026939336
14303,703-004-5390,2492.5088,4,2,2,1.306112179506057
1467,703-004-5399,2627.3203,4,2,2,1.3160381791547275
1495,703-004-5391,1906.743,6,3,3,2.5873100156821773
15247,703-004-5397,690.1145,3,2,1,1.02701037475462
15943,703-004-5386,901.7539,6,3,3,4.585903739587124
1596,207-008-2399,6103.6396,5,3,2,0.5956345970831936
16056,703-004-5382,9841.213,4,2,2,0.41065431702020905
16082,703-004-5383,4524.6665,8,3,5,1.0910823281947999
16260,703-004-5392,9171.048,4,2,2,1.221791936993176
1638,703-004-5392,6221.102,3,3,0,0.813683045104816
16570,703-004-5380,8956.151,3,0,3,0.27920371738274696
16838,703-004-5397,4944.568,9,7,2,5.3618993353298015
1684,703-004-5388,6597.882,4,1,3,0.8344249883503494
17048,703-004-5397,4192.3896,9,3,6,1.946277503019854
17094,703-004-5383,5331.632,4,2,2,0.5370165530176949
1718,703-004-5388,6945.053,4,0,4,0.27920371738274696
17286,703-004-5381,4990.2324,5,2,3,0.5705355442918298
17677,703-004-5385,8336.98,5,4,1,0.980545345962009
17927,703-004-5395,7985.934,4,3,1,0.6296462864962087
18201,703-004-5395,4888.4917,5,4,1,1.5179369297360368
18294,703-004-5393,5596.2236,4,1,3,0.4241643909469243
18535,703-004-5392,8990.008,3,1,2,0.6123461029173735
18736,703-004-5390,2676.1865,3,1,2,0.9965916437230485
1902,207-008-2399,8323.455,8,4,4,0.8588016059997444
19178,703-004-5389,7766.507,7,3,4,1.013003442012248
19313,703-004-5393,1486.4999,3,1,2,0.492671916840759
19354,703-004-5389,1187.1768,1,0,1,0.27920371738274696
19386,703-004-5383,9413.289,4,1,3,0.380383176052608
19674,703-004-5380,282.1654,1,1,0,0.4067060989956455
19841,703-004-5395,2560.6638,4,1,3,0.5102579045187899
19942,703-004-5382,8013.765,2,1,1,0.4921380375236956
20071,207-008-2398,4988.5254,2,2,0,0.44511238299568734
20579,703-004-5393,3822.7935,5,4,1,0.6747769266357725
20602,703-004-5399,3577.0583,3,0,3,0.27920371738274696
2101,703-004-5383,2977.7515,5,2,3,0.9196496289785439
21046,703-004-5399,7673.4434,5,1,4,0.3852512128714995
212,703-004-5391,6404.1904,5,2,3,0.9764064210660945
21293,703-004-5397,2912.7812,1,0,1,0.27920371738274696
21315,703-004-5382,1657.6302,6,4,2,1.7791264316356723
21366,703-004-5399,8372.637,5,4,1,1.8522710939409506
21672,703-004-5396,8035.3975,1,0,1,0.27920371738274696
2172,703-004-5391,7522.5137,5,3,2,1.9572884270682884
22453,703-004-5391,7615.096,1,1,0,1.000606428702723
23169,703-004-5386,7339.5156,3,0,3,0.27920371738274696
23350,703-004-5383,2238.6265,4,1,3,0.39033151487077267
23482,703-004-5397,5873.1855,4,3,1,1.5094894298532986
23908,703-004-5397,9010.945,2,2,0,1.0036121527024617
23919,207-008-2398,520.5333,3,2,1,0.6244549192590174
23931,207-008-2399,730.5664,6,3,3,1.1106240250289163
23939,207-008-2398,2501.2554,3,2,1,0.46531501928443836
24003,703-004-5387,2279.176,2,1,1,0.35831143730785864
24219,207-008-2399,1678.6587,3,1,2,0.6075361720664149
24373,703-004-5388,4744.224,4,1,3,0.3187575773453028
24531,703-004-5392,8077.4043,3,1,2,0.7578194569748111
24568,703-004-5398,3149.9248,7,6,1,1.9345612643083343
24716,703-004-5397,7458.0337,7,4,3,1.1319947699302788
24903,703-004-5382,1822.9747,1,1,0,0.6439680788247856
25740,703-004-5397,1062.6698,5,3,2,0.9743610520656395
25755,703-004-5396,5236.5054,1,1,0,0.9945350002163486
25808,207-008-2399,1104.7548,4,2,2,0.6771332654391669
25996,703-004-5387,9323.037,7,2,5,0.6197842743025491
26109,703-004-5399,1117.3815,3,3,0,1.8677011109954498
26331,703-004-5381,8932.62,5,1,4,0.35831143730785864
26689,207-008-2398,256.4347,5,3,2,1.0975625794434178
27026,703-004-5394,354.5499,4,1,3,0.9148540129371218
27111,703-004-5395,9479.499,7,5,2,1.992655570555755
27559,703-004-5393,1660.8292,6,3,3,2.161301894776034
27656,207-008-2398,7281.848,5,2,3,0.638621247153117
27849,703-004-5390,9246.813,7,4,3,1.6343247540484405
27932,703-004-5389,1194.9641,5,4,1,1.086058667827894
28065,703-004-5382,7016.793,4,1,3,0.33853450732658075
2829,703-004-5386,6419.7754,6,5,1,2.8845172377097943
28332,703-004-5385,3498.5488,6,3,3,1.1122842400315176
28451,703-004-5399,7508.62,3,0,3,0.27920371738274696
28655,703-004-5388,5979.3594,1,0,1,0.27920371738274696
2881,703-004-5386,2514.0376,10,2,8,0.8072720809127522
28985,703-004-5387,1412.5836,5,1,4,0.33853450732658075
29008,703-004-5398,582.1377,5,2,3,1.1815266365285275
29078,703-004-5381,7815.9136,3,2,1,0.644397951793246
29132,703-004-5395,5319.3613,6,5,1,2.1414354716833612
2959,703-004-5391,7204.4604,7,4,3,1.2611145892096525
29690,703-004-5384,2780.4731,7,3,4,1.4554455362203345
29706,703-004-5398,2340.5593,4,2,2,1.1926290246732034
29773,703-004-5389,7789.2437,7,6,1,2.463584827772181
30273,703-004-5384,7665.9067,3,2,1,1.116946117453157
30321,703-004-5397,759.1939,2,0,2,0.27920371738274696
30681,703-004-5393,4154.8223,4,1,3,0.6505538049187674
30755,207-008-2399,6497.851,4,2,2,0.5179013298430474
30763,703-004-5389,2487.5354,3,1,2,0.3486207416170325
3088,703-004-5383,7321.266,4,1,3,0.4302838120419517
30915,703-004-5399,2542.2668,4,3,1,1.0305046628030665
30920,703-004-5397,8826.746,4,2,2,1.2870070577194934
31064,703-004-5398,9593.761,3,2,1,1.1428422846965167
31303,703-004-5393,4853.783,3,2,1,1.3130429913601893
32068,207-008-2399,4666.2886,5,2,3,0.4942351816843046
32411,703-004-5397,9151.591,3,3,0,1.0074640603846465
32435,703-004-5381,3818.444,4,3,1,0.9859937809896987
32557,703-004-5391,7540.385,5,1,4,0.5262580443524131
32578,703-004-5387,9221.548,6,4,2,1.7869851356955653
32731,703-004-5399,7709.9497,3,2,1,0.7938464525517639
32947,703-004-5394,1377.5796,3,0,3,0.27920371738274696
32954,703-004-5389,6871.155,6,5,1,1.8298616636495832
33486,703-004-5388,9464.636,7,3,4,2.607227966402654
33709,703-004-5381,8825.453,4,2,2,1.9772091111692607
33802,703-004-5396,9207.11,3,3,0,2.438308616666992
34392,703-004-5391,9950.875,1,0,1,0.27920371738274696
34417,703-004-5395,7342.429,5,3,2,1.3799933502675803
34504,703-004-5388,2762.7927,1,1,0,0.8720610533326851
346,703-004-5399,8066.801,3,1,2,0.4122491253049764
34762,703-004-5384,7187.184,5,1,4,0.45287420311728743
34890,703-004-5389,5769.65,4,2,2,0.6657280304701763
35093,703-004-5385,5542.2354,7,4,3,2.4490968728828513
35175,703-004-5392,5143.355,4,3,1,1.188496375231946
35200,703-004-5384,6734.062,3,3,0,1.5220328838383792
35638,703-004-5398,194.88931,2,2,0,0.433727463636465
36051,703-004-5389,3793.5537,2,0,2,0.27920371738274696
36069,703-004-5383,3065.893,4,2,2,0.9328417971930604
36113,703-004-5392,1204.5824,2,0,2,0.27920371738274696
36333,703-004-5397,9955.526,4,2,2,0.6737084907322863
36379,703-004-5380,5230.3887,4,1,3,0.3978652972704144
36743,703-004-5388,4676.1807,5,4,1,2.177259819288897
36878,703-004-5398,6701.2,4,1,3,0.3781048826279685
36897,703-004-5393,8410.071,6,4,2,2.2964012747278812
37326,703-004-5382,1311.8798,3,2,1,0.8505612470393765
37328,703-004-5383,8673.353,2,0,2,0.27920371738274696
37333,703-004-5385,2364.3584,7,3,4,2.6792920900186012
37342,703-004-5389,9819.044,4,1,3,0.4717535557579671
37483,703-004-5398,2602.0586,5,3,2,0.7904302300272866
37515,703-004-5395,3765.2732,2,0,2,0.27920371738274696
37711,703-004-5393,3230.1838,3,2,1,0.5847391218076509
37799,703-004-5381,4904.6904,4,3,1,1.611825959015116
37850,703-004-5396,928.94556,4,2,2,0.8398959715937181
38275,703-004-5392,9912.487,4,0,4,0.27920371738274696
38367,703-004-5384,3736.633,5,2,3,0.4057760692629256
38540,703-004-5398,1515.2186,5,3,2,1.4604078618031389
38702,703-004-5384,9978.444,6,3,3,1.0375243896716306
38859,703-004-5381,4926.004,4,0,4,0.27920371738274696
39008,703-004-5392,4768.704,3,0,3,0.27920371738274696
39194,703-004-5399,191.3935,7,2,5,1.0679076280220168
39444,703-004-5396,2841.5256,3,1,2,0.5837684390944268
39900,703-004-5392,2362.9277,2,1,1,0.6034149927116526
40342,703-004-5393,3956.2673,6,3,3,3.276792771784667
40349,207-008-2399,1131.4326,4,2,2,3.995759204635702
40506,703-004-5390,5097.881,5,1,4,0.6545710245767664
40761,703-004-5395,977.58887,5,1,4,1.4981092885255514
40812,703-004-5392,8870.217,6,1,5,0.3487699393065504
40855,703-004-5399,2086.9524,5,4,1,2.239209487011654
40948,703-004-5391,788.4431,4,2,2,1.0951453647164018
4129,703-004-5397,551.7417,6,4,2,2.117945713127529
41738,703-004-5387,7330.123,3,2,1,0.9932519445846499
42058,703-004-5395,219.49231,5,3,2,1.191274931279562
42133,703-004-5394,182.72757,2,0,2,0.27920371738274696
42258,703-004-5381,3912.6265,1,0,1,0.27920371738274696
4260,703-004-5385,5017.2476,1,0,1,0.27920371738274696
42979,703-004-5380,5867.417,6,4,2,2.3867416416369904
43237,703-004-5381,3318.4392,4,1,3,0.5181746492555426
4324,703-004-5390,6527.175,2,2,0,1.6416503452140285
43325,703-004-5387,1662.2257,7,3,4,0.6994554525498943
43361,703-004-5389,6990.1826,5,1,4,1.0305215001678936
4340,703-004-5397,1693.5474,4,2,2,0.5854433297757519
43705,703-004-5388,3329.3628,2,0,2,0.27920371738274696
43864,703-004-5382,4091.3713,6,2,4,0.7022899037398421
44092,703-004-5382,5934.2324,3,2,1,1.570292782583585
44639,703-004-5385,4846.6353,6,2,4,0.659469682864788
44989,703-004-5390,1380.4501,4,3,1,0.9808452034437654
45231,703-004-5386,8439.315,8,3,5,1.0050496121830477
45421,703-004-5393,5324.9937,2,2,0,0.9696746836101403
45515,703-004-5383,2358.7024,2,1,1,0.8263581177720108
45850,703-004-5393,6878.0986,5,4,1,2.1076742506651924
46261,703-004-5395,289.74594,5,1,4,0.35534489781066697
46633,703-004-5389,27.284622,5,2,3,2.2451496703748415
46911,703-004-5383,9209.637,4,2,2,1.4805976125954396
46921,703-004-5382,672.5359,3,1,2,0.4049039066507512
47419,703-004-5399,6166.2188,8,3,5,1.7323785090307633
47623,207-008-2398,3172.9055,3,1,2,0.5312333328404197
4766,703-004-5392,5132.608,3,1,2,0.5142222055842638
47710,703-004-5381,2718.8713,5,3,2,2.6193937170633133
47837,703-004-5384,8485.968,9,5,4,1.709489343034294
47987,703-004-5389,1003.0365,5,5,0,2.571950129669558
480,703-004-5381,7928.8374,2,1,1,0.38274253814473064
48418,703-004-5384,9142.646,8,3,5,1.0220415011450337
48712,703-004-5390,8318.826,4,2,2,0.7184081787160929
48749,703-004-5387,4325.5933,4,1,3,0.3978652972704144
48909,703-004-5390,3665.0466,6,2,4,1.3223026244120268
48982,207-008-2398,2361.7368,2,1,1,0.9283521190487125
49099,703-004-5388,5508.259,2,0,2,0.27920371738274696
49267,207-008-2398,9496.537,4,2,2,0.7949621253147063
49416,703-004-5386,9074.656,10,2,8,0.7935129709668374
49784,207-008-2399,1711.4204,9,3,6,0.9350247388850851
49790,703-004-5381,8930.144,6,3,3,1.7150036853824642
49977,703-004-5381,4581.6123,2,0,2,0.27920371738274696
5166,703-004-5396,389.62543,3,1,2,0.5144122910824741
5347,703-004-5394,9536.032,2,1,1,0.4887041509171165
5386,703-004-5393,7578.892,4,3,1,1.3483347186681343
5948,703-004-5380,6122.764,3,2,1,0.810402915303805
6343,703-004-5398,9157.146,5,3,2,1.0953169185367426
6434,703-004-5396,6568.1206,3,2,1,0.8284968146046321
7294,703-004-5394,1020.89166,7,3,4,0.7704572005859142
7457,703-004-5391,7240.7085,5,4,1,1.7384907949365678
757,703-004-5388,5147.5483,3,1,2,0.6295511200311865
7665,703-004-5397,6790.4126,4,0,4,0.27920371738274696
8076,703-004-5382,34.897327,2,1,1,0.39907663423176776
8316,703-004-5391,4231.2812,4,3,1,0.7691488229754295
9601,703-004-5384,2015.7189,2,1,1,0.5136044243445785
10345,703-004-5396,8871.755,1,1,0,0.3978652972704144
11000,703-004-5388,2976.1548,5,2,3,0.8043910341436658
1111,703-004-5395,4637.613,4,2,2,1.417229903258642
11331,703-004-5388,2833.575,"","","",0.27920371738274696
11364,703-004-5399,2924.6855,7,4,3,1.778817048696795
11869,703-004-5381,9065.648,3,2,1,0.650335816088625
12289,703-004-5399,2717.8877,5,2,3,0.41764222725169237
12380,703-004-5396,6646.3623,5,1,4,0.5165268771580819
12429,703-004-5382,8120.6357,3,1,2,0.3648707857516491
12479,703-004-5386,1470.1862,2,1,1,0.6316634588835703
12808,703-004-5383,6610.833,3,1,2,0.32666834933781397
12913,703-004-5390,6574.11,3,2,1,0.7230144537357519
13120,703-004-5392,3041.4517,5,4,1,1.2230325974438654
13232,703-004-5381,5678.584,1,1,0,0.3978652972704144
138,703-004-5382,1527.015,4,2,2,1.3051124068223106
13852,703-004-5382,5586.0747,7,3,4,0.7698817791689552
14790,703-004-5395,7838.492,4,2,2,1.210199916002179
14795,703-004-5396,9924.107,4,1,3,0.4653894152244837
1497,703-004-5380,3732.5776,6,2,4,0.5651675301281072
15211,703-004-5394,3202.9675,4,1,3,0.4443850267606817
15242,703-004-5382,3298.8203,5,2,3,0.690214034910868
15309,703-004-5391,4294.2856,2,1,1,0.6497491535421839
15362,703-004-5383,5625.676,3,1,2,0.44544668978660146
15368,703-004-5386,525.42566,3,2,1,0.9461186795793027
15623,703-004-5387,1436.7091,4,3,1,3.064447793173103
1620,703-004-5392,4786.717,5,3,2,1.4535468467662676
16231,703-004-5399,9818.295,2,1,1,1.6362031933145573
16342,703-004-5382,2953.1343,2,2,0,1.0293579407434041
16869,703-004-5396,1994.9728,5,1,4,0.3807601814404417
16970,703-004-5388,7800.4824,3,2,1,0.43741915723297026
17031,703-004-5388,68.60971,7,5,2,1.2572154228377426
17119,703-004-5384,6696.5337,6,2,4,0.6332404918159438
17366,703-004-5396,1728.6378,3,1,2,0.9168511706871245
17777,703-004-5394,7059.8506,3,1,2,0.6230963099222336
18592,703-004-5391,6530.2954,2,2,0,1.4797885819122343
18868,703-004-5392,8902.399,4,2,2,1.7631249561766502
1910,703-004-5385,5615.704,3,3,0,2.0852437824829133
19698,207-008-2399,592.24603,5,1,4,0.5716223107181949
19733,703-004-5389,2026.782,4,0,4,0.27920371738274696
20175,703-004-5385,8617.329,3,0,3,0.27920371738274696
20805,703-004-5386,6870.6772,3,1,2,0.4314860782385869
20952,703-004-5398,1393.8558,3,1,2,0.49519069246511693
2139,703-004-5394,4240.309,4,3,1,1.194413293868133
21606,207-008-2399,1172.5956,2,2,0,0.6482764912713174
21868,703-004-5383,6648.5776,3,1,2,0.5462697723415896
22009,207-008-2399,901.7175,5,2,3,1.0383152513662897
22018,703-004-5384,7713.562,3,1,2,0.45098444372495033
22088,703-004-5383,6784.9985,4,1,3,0.8792448942915728
22245,703-004-5389,2578.9333,5,3,2,0.7669459265478615
2272,703-004-5384,665.45905,1,1,0,0.555717216620188
23252,703-004-5380,226.73488,5,4,1,0.8583557071850633
23602,703-004-5382,1048.9332,4,1,3,0.4470380309230627
23788,703-004-5392,3122.337,2,1,1,2.898824337365656
23970,703-004-5397,5361.933,3,2,1,0.9880372832679567
24736,703-004-5393,6689.9473,1,0,1,0.27920371738274696
25284,703-004-5381,3288.4849,5,4,1,1.0829053146357908
25364,703-004-5397,5.415082,6,1,5,0.35831143730785864
25383,703-004-5381,8462.837,7,0,7,0.27920371738274696
25401,703-004-5392,7649.6694,7,4,3,1.2924260409956199
25414,207-008-2398,3514.8757,4,1,3,2.008524734950066
25501,703-004-5380,363.52933,5,4,1,1.4231011115195094
25578,703-004-5389,7038.9463,5,2,3,0.6544563207051927
25765,703-004-5390,7345.845,8,3,5,1.3656784085819014
25879,703-004-5396,9563.398,6,5,1,1.5282260329007165
26107,703-004-5391,1067.7904,6,2,4,0.7250746038106575
26996,207-008-2398,9363.497,4,1,3,0.8785804004779737
27345,703-004-5387,1267.6871,5,4,1,2.840880846375176
27424,703-004-5387,7488.5415,5,4,1,1.3548612871256467
27480,207-008-2399,8882.468,5,2,3,1.592913295365318
27532,703-004-5383,1528.2571,6,2,4,1.5324104318459093
27555,207-008-2398,9697.4795,8,5,3,2.168077368069981
27624,703-004-5391,7247.335,3,1,2,0.4196389548909281
27638,703-004-5397,2874.6016,6,4,2,1.5543943703156649
27658,703-004-5389,3219.8079,2,1,1,0.46867107838902644
27712,703-004-5391,1569.603,3,2,1,0.988064067111839
27786,703-004-5387,3734.0908,4,1,3,0.39169615957082127
27790,703-004-5399,7812.209,2,0,2,0.27920371738274696
27791,703-004-5382,591.1994,6,3,3,0.7526325045740673
28283,703-004-5385,954.59344,4,2,2,0.4453299292254814
28314,207-008-2399,6699.061,4,1,3,0.3978652972704144
28667,703-004-5391,1028.8972,6,5,1,0.9616733209542956
28699,703-004-5396,7381.5356,5,4,1,1.3115540419069494
29050,703-004-5389,945.48584,1,1,0,0.3302090466625112
29388,703-004-5398,5229.6304,2,0,2,0.27920371738274696
29494,207-008-2399,4520.194,3,1,2,0.731919344341261
29696,207-008-2399,685.2174,6,4,2,2.209131371057829
30141,703-004-5381,1543.9719,5,4,1,2.081924086284095
30173,207-008-2399,6733.452,3,2,1,2.307770346082697
3019,703-004-5397,6674.2134,5,3,2,1.2553268481200812
30619,703-004-5380,6130.7676,5,3,2,0.7318055326663248
30662,703-004-5391,8301.624,2,2,0,1.9818163334069423
3107,703-004-5397,3551.8987,8,3,5,0.6498292671405579
31255,703-004-5387,4375.8447,4,3,1,1.5164216836357778
31363,703-004-5385,7567.0405,8,7,1,2.684756152077022
31482,207-008-2399,3311.0117,4,3,1,0.8361457885853115
323,703-004-5388,8188.8228,4,1,3,0.7008428439648552
32327,703-004-5385,8092.6353,6,3,3,1.046822122041646
32330,703-004-5397,8000.4014,7,5,2,1.9699625352254748
32368,703-004-5394,1859.1195,6,4,2,1.4984704790318069
32662,703-004-5399,5226.9185,1,0,1,0.27920371738274696
32777,703-004-5389,5499.407,1,0,1,0.27920371738274696
32976,703-004-5395,1906.8545,2,1,1,0.5274103685340991
32994,703-004-5399,8333.687,4,3,1,2.0777232519381776
33212,207-008-2398,2476.1975,6,5,1,2.467903307862297
33288,207-008-2398,1552.3976,6,4,2,1.4734335947055432
33306,703-004-5389,3415.085,5,3,2,1.6423128668640599
33310,207-008-2398,9723.456,5,3,2,1.2435347097923335
33596,207-008-2398,6158.5474,4,3,1,1.2582079763935683
3378,703-004-5396,8696.464,4,0,4,0.27920371738274696
33920,703-004-5388,7432.604,7,4,3,1.4223146830615625
34051,703-004-5389,8021.435,4,2,2,0.7561127948892062
34579,703-004-5382,7982.4746,3,2,1,0.7218840642055521
34637,703-004-5395,3400.8132,3,1,2,0.46106024686114017
34879,207-008-2399,5254.273,4,0,4,0.27920371738274696
351,703-004-5383,9359.992,5,3,2,1.1813450335091018
35169,207-008-2398,5520.781,4,4,0,3.2195255080184544
35238,703-004-5382,7663.18,3,2,1,1.0193445412715847
35483,703-004-5394,9637.901,3,2,1,0.5106707389910289
35913,703-004-5395,1389.1786,4,2,2,0.5774512898124307
35959,703-004-5384,8186.2407,2,2,0,1.1331376471673176
361,703-004-5394,7635.1016,8,6,2,2.877702920066426
36440,703-004-5387,9765.59,4,3,1,1.0528163768299479
3660,703-004-5393,5487.859,2,1,1,0.3468408179187174
36635,207-008-2398,1930.0514,2,1,1,0.8079983197089693
36637,703-004-5392,7445.952,8,4,4,2.1837048618854538
36638,703-004-5393,6524.595,3,1,2,0.5978541015194632
36740,703-004-5390,4955.6963,4,3,1,1.4673719537515375
37080,703-004-5384,9331.946,1,1,0,0.6118767967755115
37119,703-004-5387,2240.0771,4,3,1,2.229710223849052
37240,703-004-5397,1047.3823,5,3,2,3.5472856646432493
3728,703-004-5386,5521.3403,2,1,1,1.0669593909002888
37553,703-004-5399,1338.721,8,4,4,0.9566668457049081
38182,703-004-5386,1632.3704,4,2,2,0.4280251154918633
38504,703-004-5387,4811.436,4,3,1,0.9766288620702873
38658,703-004-5398,605.48425,5,2,3,0.8289264974478306
38680,703-004-5381,4542.001,4,1,3,1.5678853629210476
387,703-004-5387,5053.6733,7,6,1,1.3927247133346274
38729,703-004-5384,9227.531,5,2,3,1.6352493554027907
38928,703-004-5388,9734.989,5,5,0,3.0894244630360537
39229,703-004-5398,4201.207,3,1,2,1.3637636152380705
39278,703-004-5393,7623.7065,3,1,2,0.4568165558389244
39283,703-004-5398,2552.1243,4,2,2,0.6995838102543437
39450,703-004-5398,6970.957,1,1,0,0.4147410983188521
39589,703-004-5387,1937.2153,4,1,3,1.0005965667529741
39759,703-004-5391,2467.2043,4,3,1,0.8129136805950608
40250,703-004-5389,6346.824,9,6,3,1.644508750620229
40450,703-004-5399,4876.3345,4,2,2,0.8158278851477945
40538,703-004-5391,8794.224,5,1,4,0.35290739119047443
40547,703-004-5383,609.43304,1,1,0,0.3978652972704144
40621,703-004-5397,4129.0303,5,1,4,0.41621348475351216
40622,703-004-5384,4724.9375,5,2,3,0.773711866313193
40666,703-004-5389,9687.62,4,0,4,0.27920371738274696
40668,703-004-5390,5997.633,2,2,0,0.7088104920864238
40825,703-004-5386,5031.422,7,3,4,1.3875822358135443
40988,703-004-5391,4319.4927,3,1,2,0.3822827750139807
41283,703-004-5380,6516.453,1,1,0,0.35831143730785864
41833,703-004-5397,5254.2554,4,2,2,0.9759760622363668
41883,703-004-5384,3099.7246,4,3,1,1.8909400804520131
42009,703-004-5390,2125.7437,6,4,2,1.2843997652383723
42112,703-004-5387,9054.335,7,5,2,2.3795395627719698
4215,703-004-5384,5025.783,3,2,1,1.0691580079652165
42254,703-004-5382,6943.159,3,0,3,0.27920371738274696
42428,703-004-5386,3801.3535,5,3,2,1.7779449214088778
42537,703-004-5389,5342.276,4,2,2,0.6739498535927582
42615,703-004-5393,2496.72,3,3,0,1.447513267944491
43188,703-004-5395,487.08737,2,0,2,0.27920371738274696
43255,703-004-5389,7733.655,7,2,5,0.7073516638150238
43328,703-004-5396,2357.5723,7,4,3,1.8312276291283767
43372,703-004-5381,248.2611,4,3,1,1.7705227684678688
43796,703-004-5392,3352.4077,2,2,0,3.7333974465726034
43982,703-004-5395,2369.7002,3,1,2,0.42576091108762126
44187,703-004-5382,5216.218,4,2,2,1.2103598737155872
44379,703-004-5389,199.01276,4,3,1,1.8109266735048817
44512,703-004-5397,7907.9224,1,1,0,0.6663238255609825
44759,703-004-5399,1009.3528,3,2,1,1.5707916430622615
45037,703-004-5386,682.56555,7,4,3,1.8382652557055892
45142,703-004-5384,1345.4431,6,3,3,1.7462685529149147
45238,703-004-5391,4788.357,5,2,3,0.797683390602241
45920,703-004-5392,1001.51,4,1,3,0.3486207416170325
45938,703-004-5391,7561.981,3,1,2,0.3367545836282657
46176,703-004-5396,9677.935,6,5,1,2.266595760036324
46186,703-004-5396,2379.7107,6,2,4,0.6528647279348501
46240,703-004-5389,5370.4106,5,2,3,0.8031219542271937
46305,703-004-5393,2486.0955,7,4,3,1.5673742190395354
4638,207-008-2398,1936.9489,3,1,2,0.6764630493617724
46931,703-004-5398,7031.9014,3,1,2,0.6294437467743763
47182,703-004-5382,8105.9985,3,2,1,1.1966102104570804
47276,703-004-5388,2458.4233,4,0,4,0.27920371738274696
4738,703-004-5382,1870.1989,3,3,0,1.3427269163349151
4765,703-004-5381,2520.777,4,1,3,0.45617749386572864
47699,207-008-2398,632.84753,4,3,1,1.1757700937568623
48545,703-004-5389,9357.127,1,1,0,1.129295791603768
48665,703-004-5391,1142.1973,4,1,3,0.5183860521667141
49115,703-004-5386,2284.0261,5,3,2,0.8571120264992247
49521,703-004-5381,6714.8926,5,3,2,0.8059296343777156
49810,703-004-5392,4005.6963,4,1,3,0.597922480565864
49852,703-004-5381,3402.3118,4,2,2,0.7797302653469083
49878,703-004-5386,1888.3002,4,3,1,1.91510801559772
49924,703-004-5386,9466.881,4,1,3,0.7919326452551593
5081,207-008-2399,5041.825,1,1,0,0.36730001704854
5572,207-008-2398,5743.1333,4,2,2,0.6697881869171056
5830,703-004-5385,157.92012,4,3,1,1.0757027469929938
5990,703-004-5384,6219.3584,4,2,2,0.7550325264701345
6280,703-004-5399,893.94806,9,5,4,0.9688882814680565
6385,703-004-5396,5123.2036,4,2,2,1.8780367246765868
6757,703-004-5391,8397.594,1,0,1,0.27920371738274696
6846,703-004-5396,1905.6511,4,3,1,1.1959243000940583
6926,703-004-5392,8995.374,4,2,2,1.6085815101455012
7006,207-008-2399,7175.1665,3,3,0,1.3221957261163937
7037,703-004-5394,1016.2884,3,3,0,1.6248677523500172
7072,703-004-5385,7652.2207,6,3,3,1.427412040589136
7175,703-004-5387,6330.5913,2,1,1,0.4523861636672304
7283,207-008-2399,8910.211,2,1,1,0.764236751019973
7352,703-004-5398,588.66504,7,4,3,2.278168669381624
823,703-004-5387,9073.515,4,1,3,0.3803330488420116
8256,703-004-5386,3683.6643,5,3,2,2.842630824451069
8442,703-004-5391,7401.6523,4,1,3,0.5030843991981873
8671,703-004-5393,6359.7603,4,3,1,1.9776324371599512
8882,703-004-5386,6554.965,"","","",0.27920371738274696
9047,703-004-5398,3221.5225,4,3,1,1.0657768366020242
9339,703-004-5386,4177.2134,4,3,1,3.3288945098483107
9459,703-004-5380,9866.364,2,0,2,0.27920371738274696
9580,207-008-2398,2396.05,5,1,4,0.35831143730785864
961,703-004-5385,9203.375,4,1,3,1.4616138307431645
9712,207-008-2398,651.4126,4,2,2,0.4966510625268977
9864,703-004-5386,8931.692,5,2,3,2.337154601257436
9893,703-004-5396,2298.3772,5,4,1,1.3594491575796723
1014,703-004-5386,4894.0923,7,3,4,1.4655895510642514
10321,703-004-5384,7819.728,2,0,2,0.27920371738274696
10353,207-008-2399,9282.233,1,0,1,0.27920371738274696
10508,207-008-2399,4829.148,2,2,0,4.071694807986812
10567,703-004-5389,7570.3604,"","","",0.27920371738274696
10583,703-004-5391,95.052124,3,1,2,0.4670084036395385
10600,703-004-5393,2402.847,3,3,0,0.643662489202696
10691,703-004-5396,2726.9321,4,3,1,0.6718458714357122
1088,703-004-5392,5264.126,7,2,5,1.2091656782386297
10892,703-004-5394,2040.2521,4,1,3,1.2124028005635945
11117,703-004-5397,3760.534,1,0,1,0.27920371738274696
11172,207-008-2398,8930.096,2,1,1,0.3737466080357567
11243,703-004-5390,5841.704,5,3,2,0.9214727955510529
11483,703-004-5396,4685.6553,2,1,1,0.4389268128060516
11642,703-004-5383,9158.056,8,5,3,1.496893957031683
11807,703-004-5394,8412.83,2,1,1,1.3162783438580643
12066,703-004-5380,3773.3376,6,5,1,1.5912109891170867
12365,703-004-5384,2106.4055,3,0,3,0.27920371738274696
12376,703-004-5396,1391.3566,1,0,1,0.27920371738274696
12583,703-004-5389,6537.145,3,1,2,0.69964576964072
12799,703-004-5383,3879.9263,7,4,3,2.7782463249562936
12987,703-004-5399,3750.6514,3,1,2,0.6856965344894
12996,207-008-2399,7584.1123,1,0,1,0.27920371738274696
1309,703-004-5383,3075.0454,4,3,1,2.460733026044144
13237,703-004-5394,4850.213,6,3,3,1.5779386277771394
13381,703-004-5386,7009.2935,5,3,2,1.1027335253789268
1342,703-004-5384,7785.1753,4,2,2,1.4272844017327473
13623,703-004-5386,2578.255,6,4,2,0.9363781044443843
13753,703-004-5398,9368.567,3,2,1,1.0708977897659362
13953,703-004-5388,685.37177,4,2,2,1.3194466140956336
14258,703-004-5395,2104.4392,5,3,2,1.8762255930456806
14497,703-004-5396,8396.605,1,0,1,0.27920371738274696
14998,703-004-5399,1341.7471,5,3,2,3.7540849209814415
15025,703-004-5383,5926.066,3,2,1,0.5763544766977692
15659,703-004-5389,2120.1443,8,6,2,2.0201690286730583
15696,703-004-5392,9955.187,4,1,3,0.4072779250458527
15939,703-004-5385,1998.4465,5,4,1,1.1944482124934455
16461,703-004-5384,1101.0105,3,2,1,1.1375865882305125
17213,703-004-5390,7284.7373,4,2,2,1.2707773549767971
1731,703-004-5394,1890.3936,5,2,3,0.6147649376824222
1748,703-004-5385,6239.8027,3,1,2,1.1464926958884183
17597,703-004-5382,7389.0356,4,2,2,0.542806995215044
17633,703-004-5381,3801.4006,3,2,1,0.5666000374478046
17851,703-004-5395,581.618,4,3,1,0.9866563377230733
17852,703-004-5388,3091.7268,6,4,2,1.4159466520680593
18267,703-004-5381,9963.665,2,2,0,0.7710982569808099
18522,703-004-5399,1656.7009,4,2,2,0.7299770139395747
1895,703-004-5381,9644.969,4,1,3,0.521309790786542
18965,703-004-5386,7493.968,6,2,4,0.7834177830107716
19032,703-004-5387,2663.5098,4,1,3,0.4536275971022925
19179,703-004-5385,8045.5527,3,1,2,1.1201125010915929
19781,703-004-5385,425.61353,4,0,4,0.27920371738274696
20091,703-004-5391,9604.987,5,0,5,0.27920371738274696
20339,703-004-5384,1965.0763,2,1,1,0.32666834933781397
20404,703-004-5387,1405.9967,6,4,2,1.3385590605384972
20499,207-008-2399,6304.2007,3,2,1,1.5335800529099464
20732,703-004-5385,5389.7344,6,1,5,1.1560356800762759
20780,703-004-5398,7231.982,3,1,2,0.525920785788868
20873,703-004-5385,2681.2988,10,4,6,1.0439003782552305
21135,703-004-5389,9828.128,4,2,2,0.7755725162994365
21171,207-008-2399,3021.2866,7,2,5,0.7409741299238112
21382,703-004-5385,5389.987,2,1,1,0.7182515629671166
21444,703-004-5388,7693.9873,4,3,1,1.9137741482902408
21458,703-004-5390,9407.313,3,0,3,0.27920371738274696
21533,703-004-5397,8064.521,6,4,2,1.6561362476567612
22284,703-004-5397,419.7806,1,0,1,0.27920371738274696
22513,703-004-5391,1768.7905,2,2,0,0.6422573541619779
22621,703-004-5386,8683.945,2,1,1,0.5386119757815407
22718,703-004-5382,8463.001,4,2,2,1.2264444999985291
22862,207-008-2399,2323.3384,4,2,2,0.5904460183219464
22887,703-004-5391,9927.782,5,3,2,1.6564779350399297
23070,703-004-5384,9951.54,4,1,3,1.2682499657962534
23124,207-008-2399,8187.051,4,3,1,1.1467040930742232
23314,703-004-5385,9203.547,2,2,0,0.6629253342656392
23363,703-004-5383,450.40192,5,2,3,0.8128857798030923
24065,703-004-5399,6376.2563,"","","",0.27920371738274696
24198,703-004-5399,2158.5977,4,2,2,0.4855869478193071
2455,703-004-5394,9575.767,4,2,2,1.0024696425543471
24588,703-004-5393,9757.544,4,1,3,0.42295309031409184
24669,703-004-5381,3057.5479,3,2,1,0.45541616351593317
24819,703-004-5389,662.15576,2,2,0,0.9493836004237287
24945,703-004-5395,4869.0303,7,3,4,1.5386793645436119
25050,703-004-5391,3666.0134,4,1,3,1.1309233121308973
25466,703-004-5395,4905.7607,1,1,0,0.4314860782385869
2556,703-004-5381,938.592,4,2,2,0.6738765097949841
26507,703-004-5397,1888.1672,7,5,2,1.1114131804025915
26909,703-004-5391,5287.717,5,2,3,0.5161972616583939
27003,703-004-5383,2380.8157,5,5,0,1.3714925483307039
27052,703-004-5387,4706.9395,1,0,1,0.27920371738274696
27083,703-004-5383,2605.6619,2,0,2,0.27920371738274696
27095,703-004-5392,995.2086,6,3,3,1.0604526993539667
2754,703-004-5390,958.8593,1,0,1,0.27920371738274696
27690,703-004-5388,8419.034,3,2,1,0.8114188539983128
28097,207-008-2398,7087.2563,4,3,1,1.1793660414656482
29042,703-004-5394,3644.924,4,0,4,0.27920371738274696
29098,703-004-5392,628.62036,5,2,3,0.9920394232972484
2939,703-004-5390,7718.0786,2,2,0,0.6269054298789835
29397,703-004-5380,229.68709,5,2,3,0.6345169807536534
29920,703-004-5393,3990.4033,3,2,1,0.7740312472184688
30134,703-004-5387,9326.447,4,4,0,0.7439379803019869
30223,703-004-5397,4066.1633,3,0,3,0.27920371738274696
30372,703-004-5392,8319.744,5,5,0,1.485526889536243
305,703-004-5399,828.01996,5,2,3,1.270748824266523
30784,703-004-5387,6547.885,6,1,5,0.6313978787993377
30854,207-008-2398,4626.686,1,1,0,0.4524145674117556
30880,703-004-5397,4749.0103,6,4,2,2.166797814019542
30991,703-004-5397,5870.611,4,4,0,2.247367247068094
31165,703-004-5387,1088.6747,3,3,0,1.3981577260386775
31210,703-004-5399,7083.923,4,2,2,0.5864985595013918
31403,703-004-5389,3658.7703,11,6,5,7.086985458440995
31438,703-004-5387,735.2376,1,0,1,0.27920371738274696
31626,703-004-5394,2160.4841,3,3,0,1.3088960063181594
31631,703-004-5396,7253.9795,2,2,0,1.4133963999203194
31677,207-008-2399,1863.6715,2,1,1,0.3468408179187174
31715,703-004-5394,2400.5933,4,2,2,0.5241934014166283
31786,703-004-5384,6375.7803,3,1,2,0.44443270210135166
32041,703-004-5397,1367.3645,4,1,3,0.484974927873701
32288,703-004-5394,9202.766,2,1,1,0.9317800108281566
32494,703-004-5390,1231.7192,6,3,3,1.3204502515793433
325,703-004-5397,376.73236,3,2,1,1.0243368267518573
34124,703-004-5385,7463.295,5,2,3,1.0663593831638414
34143,703-004-5388,9306.451,5,2,3,1.0969426515640923
34188,703-004-5386,6805.607,5,2,3,0.62425491826555
34216,703-004-5380,3207.6084,3,0,3,0.27920371738274696
34818,703-004-5381,822.6591,5,4,1,0.8764063388570474
34850,703-004-5381,3743.388,3,3,0,0.75809838168865
34923,703-004-5386,6810.1157,5,3,2,1.2394376411976926
35305,703-004-5391,4582.064,4,1,3,0.35831143730785864
35508,703-004-5384,636.3589,6,2,4,0.9063455622666243
35527,703-004-5383,2960.4614,2,1,1,0.3978652972704144
35552,703-004-5390,6379.3784,3,0,3,0.27920371738274696
35573,703-004-5399,1789.5413,4,2,2,1.2704591403616015
35745,207-008-2398,2697.1013,5,1,4,0.700298117616243
36059,703-004-5391,1825.1265,5,2,3,0.7514587261263602
36481,703-004-5382,258.0142,4,2,2,0.6319238106253318
36631,703-004-5398,12.335181,3,2,1,1.2598780465025985
36861,703-004-5397,280.5793,2,1,1,0.42420309283502433
3698,703-004-5387,1862.4038,1,1,0,0.44365934631320175
36986,703-004-5384,4932.076,3,0,3,0.27920371738274696
37125,703-004-5392,627.83,3,0,3,0.27920371738274696
37388,703-004-5381,4793.52,4,3,1,0.9937353487871663
37512,703-004-5380,1594.3998,1,0,1,0.27920371738274696
37582,703-004-5381,8239.398,3,1,2,1.1006706709410237
37679,703-004-5392,9880.3545,5,4,1,1.5892471303058255
37685,703-004-5382,425.60934,2,1,1,0.715173503682814
37814,703-004-5398,6859.7456,3,2,1,0.5520887271627762
37820,703-004-5382,637.95685,1,0,1,0.27920371738274696
38071,703-004-5383,816.33923,5,2,3,0.7960181346865568
38505,207-008-2399,6352.776,3,2,1,0.5733860477323397
38786,703-004-5398,7443.3433,5,2,3,0.663381553898789
38844,207-008-2399,3928.169,3,2,1,0.9581854410968108
38857,703-004-5381,6842.1323,6,3,3,0.6188837130031418
39035,703-004-5382,1270.979,6,2,4,1.1854124707404068
39307,703-004-5399,4881.1978,1,0,1,0.27920371738274696
3964,703-004-5396,4023.136,3,0,3,0.27920371738274696
39805,703-004-5388,976.4576,4,3,1,0.7725392357657245
3985,703-004-5394,9716.836,3,2,1,2.5915675624916488
39916,703-004-5392,6302.5684,1,0,1,0.27920371738274696
39939,703-004-5386,6764.9487,3,2,1,2.2406930374518463
40011,703-004-5383,5654.9263,4,3,1,0.7147896018558579
40228,703-004-5392,5963.1973,2,1,1,0.3870758832472951
40289,703-004-5396,5368.3906,3,2,1,0.7778445283099037
40445,703-004-5387,7872.5215,6,5,1,1.2342816603913478
40489,703-004-5385,5406.0747,6,4,2,1.2703898010251073
4083,703-004-5398,7499.982,8,3,5,1.087121396653455
40849,703-004-5386,772.72,2,0,2,0.27920371738274696
41264,703-004-5392,2799.0996,6,2,4,0.5906698308973789
41543,703-004-5382,2724.229,5,1,4,0.4793813021390035
41595,703-004-5391,6873.367,7,2,5,0.6842373593378712
41703,703-004-5383,5987.839,8,5,3,1.1987859421911569
41921,703-004-5399,2292.968,6,1,5,0.5837684390944268
41937,703-004-5385,4698.1343,2,1,1,0.3665114117183168
42233,703-004-5389,8640.499,1,1,0,0.44914706329079523
42339,703-004-5383,1485.2703,3,1,2,0.6633177725465202
42378,703-004-5386,1636.0742,2,0,2,0.27920371738274696
42519,207-008-2398,8104.801,5,2,3,1.6482645339230482
42722,703-004-5382,7353.7886,2,1,1,0.33853450732658075
43037,703-004-5394,9751.231,2,1,1,0.6287908135087643
43094,703-004-5395,3201.5532,3,0,3,0.27920371738274696
43275,703-004-5383,7940.1426,7,3,4,0.9107460590143129
43307,703-004-5393,2091.7856,10,8,2,3.2918437740694464
4354,703-004-5386,918.8187,4,1,3,0.35069872013094033
43552,703-004-5390,7332.5547,7,4,3,1.0056359907031889
44049,703-004-5389,7519.1514,2,2,0,0.5982486733321121
44120,703-004-5381,3492.812,3,2,1,1.2282302340613174
44544,703-004-5393,5129.9634,3,0,3,0.27920371738274696
44619,703-004-5390,1605.1967,6,4,2,0.8768371855558083
45181,703-004-5381,9469.677,4,0,4,0.27920371738274696
45293,703-004-5393,7429.6914,5,3,2,1.6614737226089449
45521,703-004-5381,8758.948,5,2,3,0.84926900424765
4623,703-004-5383,4142.7217,3,1,2,0.6752573488369579
46625,703-004-5383,7773.413,2,1,1,0.9339414806708058
47213,703-004-5399,110.28826,3,2,1,1.6957815086696024
4722,703-004-5386,5936.0767,3,2,1,1.355868974206732
47314,207-008-2399,3445.4763,2,0,2,0.27920371738274696
47400,207-008-2399,3990.3223,7,3,4,1.7611929306243144
47690,703-004-5394,8403.98,4,3,1,1.0741681184937522
47903,703-004-5390,6608.824,3,1,2,0.6387391532745744
48175,703-004-5395,3567.9973,2,1,1,1.2039080792259613
48208,703-004-5398,2700.5715,6,3,3,1.4795065429166672
48854,703-004-5398,5181.8174,3,0,3,0.27920371738274696
48895,703-004-5382,3541.7783,3,1,2,0.3978652972704144
49918,703-004-5381,957.8699,4,2,2,0.7991267994678531
5094,703-004-5380,8820.313,7,4,3,1.3526997400926026
5139,703-004-5388,8868.984,4,3,1,0.8071552453745475
5288,703-004-5380,4959.658,1,1,0,0.5359822088845674
5338,703-004-5387,942.28986,3,1,2,0.3694239440086507
5401,703-004-5397,1736.4949,3,0,3,0.27920371738274696
5447,703-004-5385,179.39151,3,2,1,0.5833204447452507
5488,703-004-5399,5778.2085,6,3,3,0.7322253621002837
551,703-004-5396,6187.269,3,2,1,1.5128290547991428
5611,703-004-5380,9427.914,1,1,0,0.7370448081472775
6365,703-004-5383,1541.3368,"","","",0.27920371738274696
7471,703-004-5394,1692.5562,7,5,2,1.7149083173092705
7669,703-004-5383,946.80133,5,3,2,1.3266540817568793
7913,703-004-5384,310.4055,5,3,2,2.087768887546975
7995,703-004-5396,513.4517,4,3,1,1.8217233038096297
8086,703-004-5395,65.19258,12,5,7,1.624969479906817
818,703-004-5386,5636.5913,7,4,3,1.648261738441643
8236,703-004-5399,5026.472,2,1,1,0.4314860782385869
8297,703-004-5391,7431.036,3,1,2,0.4886526168888996
8555,703-004-5386,9758.064,5,3,2,1.029001833740118
8792,703-004-5393,7766.264,4,3,1,4.557080165178038
9366,703-004-5395,4466.5747,9,3,6,0.7691303859022649
9438,703-004-5388,705.6767,3,0,3,0.27920371738274696
9666,703-004-5397,8442.035,3,1,2,0.3807252912866403
9741,703-004-5397,9582.491,3,2,1,0.843900178638426
10157,703-004-5391,962.0345,4,4,0,1.2965684772736263
1038,703-004-5389,7343.2754,3,3,0,1.6096169599191787
1051,703-004-5380,916.00836,3,2,1,2.0792083817106564
10521,703-004-5398,8189.087,4,2,2,0.9053964415974344
10940,703-004-5393,7278.6655,3,0,3,0.27920371738274696
11141,703-004-5386,2457.9866,2,2,0,2.251081981848671
11209,703-004-5399,2056.4795,4,2,2,0.9969215802736764
11293,207-008-2399,7602.5596,3,3,0,1.701664236434769
11298,703-004-5387,9869.854,2,2,0,0.7010037280515176
11311,703-004-5393,9585.808,4,2,2,0.8851895816798095
11694,703-004-5393,2703.8748,2,1,1,0.7541538352899746
12310,703-004-5389,9843.91,4,2,2,0.8773522772387192
12399,703-004-5396,3684.2896,1,1,0,0.9325347972683637
12450,703-004-5393,2592.5642,5,0,5,0.27920371738274696
12636,703-004-5392,610.3945,5,1,4,0.39406153440401537
12714,703-004-5396,8626.96,1,1,0,0.6895057952393291
128,703-004-5387,8136.406,4,1,3,0.5487220525901922
12828,703-004-5388,7900.7144,4,2,2,0.6849726837303662
12907,703-004-5399,1890.105,2,2,0,1.9556637804452153
12946,703-004-5398,6583.428,5,2,3,1.7465605619440754
1316,703-004-5380,9891.892,3,1,2,0.5857833212830535
13216,703-004-5397,6312.2656,9,4,5,1.6749887571824584
13574,703-004-5388,1932.3557,3,2,1,0.8049334146587618
14063,703-004-5397,639.0113,8,4,4,1.1269148482892835
14123,703-004-5390,4751.597,1,1,0,0.4382090225077032
14310,703-004-5390,3840.2688,4,2,2,0.5389303080426038
14671,703-004-5382,8949.5625,6,3,3,1.2922165691302203
14966,703-004-5381,6136.608,5,5,0,1.192827227712565
15221,703-004-5381,2845.3105,4,1,3,0.35831143730785864
15300,703-004-5398,8334.155,2,1,1,0.4221892449598088
15471,703-004-5383,6668.97,8,3,5,1.2188257904375777
15474,703-004-5398,3929.5244,3,2,1,0.7883778141085417
15585,703-004-5386,1667.406,4,1,3,0.44241842454779484
15922,703-004-5387,6028.034,4,1,3,0.6439041063559401
15932,703-004-5398,4631.8467,3,2,1,0.5473914491354824
16428,703-004-5393,5426.1934,5,3,2,1.388966802037551
16473,703-004-5383,9775.999,4,1,3,0.35831143730785864
1685,703-004-5391,943.88306,1,0,1,0.27920371738274696
17139,703-004-5398,7126.7236,4,3,1,1.3806847768009576
17198,703-004-5391,3629.7976,3,2,1,0.9408812678678353
17786,703-004-5380,5945.943,2,1,1,0.5501476581262543
17878,703-004-5381,3382.4546,9,5,4,3.6883129608154555
17881,703-004-5385,7186.885,5,3,2,0.9157063089523743
18284,703-004-5394,344.58994,3,1,2,0.3978652972704144
18352,703-004-5392,1301.0812,5,2,3,0.41764222725169237
19120,703-004-5392,4215.7144,5,2,3,1.1585128568025793
19378,703-004-5380,4736.7246,6,2,4,1.5465764477663015
19493,207-008-2399,7303.8643,2,0,2,0.27920371738274696
19576,703-004-5390,5192.714,7,5,2,2.0426580880789276
19934,703-004-5394,2643.2395,4,1,3,0.584292883567896
20156,703-004-5392,9644.061,8,5,3,2.432648565487313
20272,703-004-5391,6501.3223,3,3,0,2.9509640659648166
20275,703-004-5388,7752.7007,6,4,2,1.5335599699874558
20490,703-004-5396,8907.305,11,5,6,1.5255332418655445
20712,703-004-5393,7244.204,5,1,4,0.446454451332223
20933,703-004-5382,7085.365,3,2,1,0.5591156725790076
21001,703-004-5380,1082.5944,5,1,4,1.3991183994504184
21065,703-004-5382,8460.228,2,2,0,0.8365877464086033
21541,703-004-5391,4238.2427,4,3,1,1.2198969054420683
21747,703-004-5396,6975.8096,3,1,2,0.6256917653896125
21807,703-004-5386,4580.4937,3,1,2,1.0662991608295964
21976,703-004-5389,4861.3228,5,3,2,2.6492535546241265
22066,703-004-5399,2628.1047,4,2,2,0.4935393786425797
22233,703-004-5387,8642.269,2,1,1,0.44259665600796283
22569,703-004-5380,7376.6387,3,0,3,0.27920371738274696
22570,207-008-2398,9536.261,4,3,1,1.3341835242695568
22866,703-004-5385,9474.257,4,1,3,0.7914767615077427
22950,703-004-5386,7556.591,2,1,1,0.7041893734136642
22970,703-004-5395,2502.838,5,0,5,0.27920371738274696
23,703-004-5387,9747.693,2,2,0,0.6524106550051028
23117,703-004-5391,3407.5105,3,2,1,0.623434004605459
23133,703-004-5395,8743.388,1,1,0,0.4070411974325112
23170,703-004-5384,2471.1228,4,1,3,0.5165268771580819
23275,703-004-5385,3844.0413,4,2,2,0.8602352766411796
23519,703-004-5381,4000.4016,3,2,1,0.4641003034121301
2374,703-004-5395,3840.2385,5,1,4,0.35831143730785864
23856,703-004-5383,9376.713,6,2,4,0.9703661634034455
24009,703-004-5395,1819.7328,2,1,1,0.7952683669699576
24723,703-004-5396,954.9606,3,3,0,0.8460212932038114
24885,703-004-5384,1016.1704,5,3,2,2.207098795155206
25001,703-004-5390,3277.5015,3,1,2,0.45325201825202965
2502,703-004-5399,9656.2,5,3,2,1.365656311484861
25030,703-004-5387,6574.0176,5,1,4,0.7479586361189956
25676,703-004-5385,6870.9917,4,2,2,1.010959336575584
25960,207-008-2399,8703.334,5,3,2,0.9812268946691092
2635,207-008-2399,2288.2812,4,2,2,0.5011875769908812
26471,703-004-5385,3530.5183,3,0,3,0.27920371738274696
26489,207-008-2399,6233.093,1,1,0,0.5148296390889471
26710,703-004-5394,3550.4658,5,2,3,1.3425752614502986
26798,703-004-5381,4128.751,2,1,1,0.4187427901947257
27040,703-004-5392,4083.323,1,1,0,1.2770922120363293
27098,703-004-5396,6044.1655,2,1,1,0.3978652972704144
27105,703-004-5395,7322.682,2,1,1,0.3187575773453028
27205,703-004-5395,8087.763,5,1,4,0.4230808829965438
27283,703-004-5394,6515.6064,5,2,3,0.5172086942337638
27395,207-008-2399,4154.493,4,2,2,0.9257409956557706
27642,703-004-5396,6833.2676,5,2,3,1.057389748631171
2782,703-004-5384,4483.235,4,2,2,0.4453299292254814
280,703-004-5381,1441.0746,4,0,4,0.27920371738274696
28229,207-008-2398,7213.988,1,1,0,0.6184062852907382
28275,703-004-5380,2471.2788,3,2,1,1.1457560649172869
28709,703-004-5394,7371.0513,2,0,2,0.27920371738274696
28856,703-004-5386,8827.145,4,1,3,0.5176431336406443
29090,703-004-5387,7472.871,3,1,2,0.5652692540214675
29212,207-008-2399,6913.096,5,1,4,0.6514605967493778
29242,703-004-5389,4619.835,5,3,2,0.8438277438523768
29374,703-004-5398,8437.677,3,1,2,0.35534489781066697
29390,207-008-2398,5670.6387,3,1,2,0.344918747536162
29633,703-004-5388,187.46257,3,2,1,0.9174138235851309
29643,703-004-5395,7581.8125,2,0,2,0.27920371738274696
30725,703-004-5384,2108.6628,3,1,2,0.3919322182760311
30759,703-004-5384,6643.293,5,1,4,0.542426260826449
30926,703-004-5395,7654.401,4,3,1,2.7742704895344494
31103,703-004-5385,505.01407,4,4,0,2.2283710250293782
31306,703-004-5380,9487.892,4,0,4,0.27920371738274696
31365,703-004-5381,40.26115,4,1,3,1.1481012496556933
31366,703-004-5392,7050.185,6,4,2,1.3162887301407689
31436,703-004-5396,7946.523,4,4,0,1.57852251400439
31744,703-004-5397,5640.1978,6,3,3,1.4039432510191503
32073,703-004-5389,108.61337,3,2,1,1.1604467400765759
32209,703-004-5392,400.5122,8,7,1,2.7625415745007498
32252,703-004-5396,9279.08,7,2,5,0.8664162465463886
32441,703-004-5398,7622.6943,2,0,2,0.27920371738274696
32882,703-004-5390,5233.9917,3,0,3,0.27920371738274696
32974,703-004-5391,2418.781,8,6,2,3.0828769926711566
33195,703-004-5380,8778.758,5,3,2,0.7790197786605338
33224,703-004-5392,7072.3276,4,2,2,1.5864283350235715
3323,207-008-2398,2021.3359,3,1,2,0.40048191458402593
33247,703-004-5385,1065.0312,5,1,4,0.3900117466389322
33415,703-004-5382,7661.0254,3,3,0,1.1284686959687815
33643,703-004-5392,5646.954,2,2,0,1.4379733869445732
33675,703-004-5394,6366.1226,3,3,0,2.009267423563594
33676,703-004-5383,1651.7222,4,2,2,0.637754084249292
33800,703-004-5385,1844.7065,7,3,4,2.3686302124744385
34089,703-004-5395,7147.625,2,1,1,0.5799322799105147
34525,703-004-5382,5389.4585,3,1,2,0.6228340613828378
34556,703-004-5392,5138.296,2,0,2,0.27920371738274696
34909,703-004-5396,1066.792,5,1,4,0.8132643045185972
34957,703-004-5391,8034.1973,2,1,1,0.33853450732658075
35330,703-004-5392,4077.7551,5,1,4,0.3978652972704144
35347,703-004-5397,5685.986,7,5,2,1.8227430467884327
35363,703-004-5384,769.66583,7,2,5,0.6640771460542015
35548,703-004-5386,835.1803,2,1,1,0.7618938270499945
35767,207-008-2399,434.6496,3,0,3,0.27920371738274696
3623,703-004-5387,5315.422,3,3,0,0.6016370841540418
36242,703-004-5397,4100.0645,6,4,2,4.828386918344094
36801,703-004-5387,2683.5327,6,3,3,1.348490082454301
36909,703-004-5390,4999.115,6,1,5,0.36951836429724944
37389,703-004-5390,8199.739,2,0,2,0.27920371738274696
37896,703-004-5398,3814.6746,6,3,3,0.7901426017148664
38123,703-004-5395,1881.0969,4,3,1,1.4829872514125266
3828,703-004-5381,46.73481,4,2,2,0.4014127840858062
38475,703-004-5391,4395.518,2,2,0,0.8687720935263613
3896,207-008-2399,4285.834,5,2,3,0.9129281435073566
39110,703-004-5382,25.907755,2,0,2,0.27920371738274696
3921,703-004-5386,6377.3774,4,2,2,0.7560180534633393
39294,703-004-5396,2900.5234,2,1,1,0.4981895361684243
39445,703-004-5390,7236.761,5,4,1,2.6432424603023716
39448,703-004-5391,5458.311,5,2,3,0.692920376692582
3951,207-008-2398,7616.856,6,2,4,0.7138897524036123
39849,703-004-5380,4472.0547,5,4,1,1.4823015493266591
40037,703-004-5399,6930.259,7,3,4,2.293910374869715
40175,703-004-5389,9892.284,4,2,2,0.6686984144530272
40275,703-004-5385,5385.9053,6,4,2,1.8799239273948776
40316,703-004-5386,2853.073,3,2,1,1.4064649750689142
40607,703-004-5386,3568.2695,6,3,3,1.426919148358511
40802,703-004-5380,7856.629,3,2,1,0.44973215023350155
40970,207-008-2398,6064.801,8,4,4,1.9611219743095112
41,703-004-5394,2830.531,3,2,1,1.4683156145217156
41181,703-004-5396,5832.3677,4,3,1,0.961610184078708
41381,703-004-5381,9564.652,4,2,2,0.5340022258801757
41402,703-004-5392,2847.3455,5,1,4,0.4180377658513179
41406,207-008-2399,1545.6301,4,3,1,0.9602274863080473
41422,703-004-5388,8679.293,4,3,1,0.8337779042923876
41552,207-008-2399,3400.2595,3,2,1,0.6887219362358878
42050,207-008-2398,1480.6622,3,2,1,1.070520143715549
42198,703-004-5380,1533.7587,3,1,2,0.5165268771580819
42239,703-004-5388,3527.7664,7,4,3,1.2064734056443251
4231,703-004-5383,2332.3374,7,4,3,0.9890914988658105
42383,703-004-5397,5520.951,4,2,2,1.0507065861536733
42472,207-008-2398,787.6533,5,3,2,0.8874381231138958
42639,207-008-2398,7099.593,2,2,0,1.4838262894251237
42885,703-004-5381,2049.3435,4,1,3,0.37446671698631506
43120,703-004-5392,6620.6787,2,2,0,0.810493515719568
43128,703-004-5391,2463.2168,5,1,4,0.37459294047366537
43162,703-004-5395,5040.8276,5,4,1,1.0707179056746916
43197,703-004-5386,1049.1997,2,2,0,0.5956345970831934
43557,703-004-5388,7332.3525,"","","",0.27920371738274696
43581,703-004-5387,8288.975,3,1,2,0.7141472986360777
439,703-004-5394,4855.8013,6,2,4,1.2820961089137974
44589,703-004-5398,631.2162,6,4,2,1.575535060555363
44678,703-004-5383,5934.6665,1,1,0,0.46496040692005425
44813,703-004-5397,4882.0884,1,1,0,0.8233807619788038
44963,703-004-5393,2935.0674,4,2,2,0.701894328097631
45409,703-004-5397,3931.2595,1,0,1,0.27920371738274696
45876,703-004-5391,777.53125,7,1,6,0.5447331321402208
45909,703-004-5395,199.84424,4,1,3,0.9034606432569139
45954,703-004-5387,1405.4751,2,0,2,0.27920371738274696
46057,207-008-2399,7683.1753,4,2,2,0.9208134317835557
46149,703-004-5396,4099.512,7,5,2,1.8587586994669003
46151,703-004-5393,2708.4172,2,2,0,1.8888645967163293
46154,703-004-5393,4222.8447,"","","",0.27920371738274696
46360,703-004-5391,1099.208,4,2,2,0.5707173022139787
46393,703-004-5395,806.5635,3,1,2,0.4452285724593274
46470,703-004-5386,396.31128,4,2,2,0.8161384157392156
46658,703-004-5389,1103.0763,4,0,4,0.27920371738274696
46885,703-004-5385,9061.618,5,2,3,0.789944189677754
4697,703-004-5392,93.12212,9,5,4,1.2359087301491825
47053,703-004-5382,136.8469,3,1,2,1.0207884624056756
47149,703-004-5396,4495.882,5,2,3,0.7506365255357649
47253,703-004-5399,4662.611,6,4,2,1.57937068431324
47384,703-004-5396,2587.1611,4,1,3,0.8520083794699659
47676,703-004-5393,5186.314,"","","",0.27920371738274696
47680,207-008-2399,1590.8861,4,1,3,0.5007364536817241
4871,703-004-5396,2261.4324,3,2,1,1.4292278585551588
48836,703-004-5399,9988.402,2,2,0,1.232219438883508
49326,703-004-5393,4159.826,"","","",0.27920371738274696
49363,703-004-5391,5858.387,3,2,1,0.9256703866214961
49443,703-004-5389,7244.582,2,1,1,0.33853450732658075
49520,703-004-5388,8305.19,7,2,5,0.5000873041111445
49669,703-004-5383,3921.3604,5,1,4,1.1474197131310413
4981,207-008-2398,1053.0758,3,1,2,0.8985187033639584
5084,703-004-5388,1906.5541,3,3,0,0.852478187985996
5161,703-004-5385,3506.3667,7,5,2,2.6961139870485913
5209,703-004-5390,4941.663,8,3,5,1.4848880513356209
533,703-004-5382,2594.86,6,4,2,0.8488823085813413
5364,703-004-5394,3412.7932,5,3,2,2.602737391732029
5484,703-004-5380,3048.178,3,3,0,0.9359841659690241
5612,703-004-5384,7536.851,4,3,1,1.2996422105931158
5667,703-004-5389,1521.3602,"","","",0.27920371738274696
5905,703-004-5389,6914.984,2,1,1,1.0773693253702965
5968,207-008-2399,8980.759,1,0,1,0.27920371738274696
5989,703-004-5390,4896.6943,2,0,2,0.27920371738274696
6071,703-004-5397,2451.685,5,5,0,2.202331136807196
6085,703-004-5391,6469.904,6,2,4,0.8728914118104534
6126,207-008-2398,5523.588,8,5,3,1.4740403544648064
6216,703-004-5385,4073.4905,3,0,3,0.27920371738274696
6355,207-008-2398,8650.826,4,2,2,0.7410735525893424
6737,703-004-5386,2128.3906,2,2,0,1.6693786965123576
6872,703-004-5388,9075.456,4,3,1,1.9889693838378997
6957,703-004-5397,7274.5503,3,2,1,1.3223879990298295
7027,703-004-5380,5404.8433,1,1,0,0.42067153792063455
7141,703-004-5397,1653.3477,4,0,4,0.27920371738274696
7354,703-004-5396,1828.0143,6,2,4,0.6392015634967126
7455,703-004-5398,5011.3853,5,2,3,1.3187907362822908
7894,703-004-5394,7810.7915,4,2,2,2.3388056552291414
7904,703-004-5382,6361.302,4,3,1,0.7747391041600761
8013,703-004-5384,6503.55,3,2,1,0.398303788889843
8312,703-004-5397,3998.6165,8,5,3,1.1402641057772807
837,207-008-2398,2414.4941,7,2,5,0.9800034518627679
840,703-004-5382,9537.574,3,0,3,0.27920371738274696
8410,703-004-5393,6699.008,5,2,3,3.6550619598192435
8630,703-004-5398,384.19724,7,2,5,0.7881154827674435
9121,703-004-5397,5522.996,5,4,1,2.4367939200190656
9200,703-004-5392,1825.5806,6,4,2,2.3873049497188332
9448,703-004-5382,8785.363,3,1,2,0.681688963664229
9536,703-004-5389,4866.924,6,2,4,2.0634534684990666
9588,703-004-5392,4005.7046,3,2,1,0.8500479765601505
9642,207-008-2399,2839.1582,1,0,1,0.27920371738274696
9693,207-008-2398,2741.6538,3,1,2,0.42825051942594977
9875,703-004-5384,479.29764,5,2,3,0.9078657988005769
10195,703-004-5380,2306.3374,5,3,2,0.7721547012972776
10417,703-004-5398,2974.2117,5,1,4,0.6095190414160718
10481,703-004-5381,6564.282,6,4,2,1.5425181917622959
10668,703-004-5393,5701.2446,6,1,5,0.7384052824635366
10805,703-004-5396,9103.449,2,1,1,0.5728413535730214
10872,703-004-5382,4267.813,5,4,1,2.5839466448696484
11002,703-004-5396,2654.302,3,0,3,0.27920371738274696
11137,703-004-5394,178.10106,7,5,2,2.096614753052235
11218,703-004-5382,7780.4946,2,1,1,0.5141805145979875
11698,207-008-2399,8077.0933,3,2,1,1.0041461012338115
11795,703-004-5384,7565.7256,4,2,2,0.7262360329563192
11847,703-004-5381,4615.0093,4,2,2,1.9724128281564903
11992,703-004-5380,8603.339,8,4,4,1.4058216235786791
12860,703-004-5381,2144.0732,5,1,4,0.7848646893584033
13180,703-004-5387,7531.848,5,3,2,0.9642934082604546
13276,703-004-5394,2860.7703,5,1,4,0.35831143730785864
13337,703-004-5396,2207.2083,3,1,2,1.13028365907552
13429,703-004-5393,5133.4106,3,1,2,0.35831143730785864
13655,703-004-5395,3225.9292,2,0,2,0.27920371738274696
13700,703-004-5399,7316.0903,6,2,4,1.451275600385405
13906,703-004-5397,1865.1122,3,0,3,0.27920371738274696
1445,703-004-5385,6538.7236,3,1,2,0.4230808829965438
14639,703-004-5399,4215.638,4,1,3,0.5787034977350047
14654,703-004-5392,700.1179,3,0,3,0.27920371738274696
14810,207-008-2399,5925.3438,6,3,3,0.7583929419568974
14861,703-004-5385,5958.739,5,4,1,1.0781594867713926
1500,703-004-5392,6792.199,7,5,2,1.7309135871066654
15446,703-004-5396,1092.0083,4,1,3,0.44094945253995643
15488,703-004-5384,2673.2957,4,2,2,0.7924517761175099
15515,703-004-5395,9349.396,7,4,3,0.9977892730100871
15553,703-004-5385,2118.1858,2,2,0,0.8895580823610039
15829,703-004-5384,7403.8374,3,2,1,1.167944999860602
16133,703-004-5391,9574.263,4,1,3,0.3957561907785922
16185,703-004-5396,6891.0874,1,1,0,0.5165268771580819
16273,703-004-5393,4666.6665,1,1,0,0.3870758832472951
16654,703-004-5398,7350.691,3,2,1,1.1366960351658772
16798,703-004-5389,7384.711,3,1,2,0.48178416743284647
16826,703-004-5387,6061.861,5,2,3,0.47675721929364834
1695,703-004-5382,2491.2732,3,3,0,1.3578524120189417
17099,703-004-5381,505.46408,2,1,1,0.5233512176544579
17168,703-004-5394,2339.9316,6,5,1,1.3547367353082842
17274,703-004-5380,5267.5854,7,4,3,1.8558431285303945
17375,703-004-5392,7973.2485,3,2,1,1.3980248763888914
17481,703-004-5389,5833.749,3,1,2,0.7879398081965283
17491,703-004-5383,1965.3881,4,3,1,0.9969281244389824
17583,703-004-5391,4620.931,6,5,1,1.8110283235707458
1773,703-004-5388,9956.761,"","","",0.27920371738274696
17917,703-004-5389,8689.796,7,4,3,2.3737165728340455
18012,703-004-5388,986.8479,2,1,1,0.34560372750781243
18106,703-004-5388,7235.5146,4,3,1,2.391242519753279
18339,703-004-5396,4966.4204,6,2,4,1.3543985038351853
18351,703-004-5380,8394.478,2,0,2,0.27920371738274696
18684,703-004-5387,2869.9482,2,1,1,0.4076219160611782
18750,703-004-5386,3083.805,4,2,2,1.296550784908811
18768,703-004-5391,7483.386,4,1,3,0.37314907902631234
18905,703-004-5395,1648.2812,4,1,3,0.3978652972704144
18925,703-004-5399,3450.7615,5,1,4,0.6641221056083588
1897,703-004-5384,8713.399,"","","",0.27920371738274696
19253,703-004-5380,7736.652,3,1,2,2.4227837366392055
1957,703-004-5393,9884.499,4,2,2,1.161618224296734
20098,703-004-5398,8306.469,6,4,2,1.8291601741664507
20183,703-004-5396,1975.7277,6,4,2,2.0461905461249064
20435,703-004-5389,4863.202,4,2,2,0.9227777170567789
20592,703-004-5382,6631.526,2,1,1,1.1897463438090727
20723,703-004-5387,611.81964,2,0,2,0.27920371738274696
20856,703-004-5395,4485.8916,3,1,2,0.6411873344172868
20881,703-004-5396,7996.186,"","","",0.27920371738274696
21117,703-004-5389,4198.671,1,0,1,0.27920371738274696
21364,703-004-5391,9707.506,2,1,1,1.6297676017183695
2161,703-004-5395,8678.539,4,1,3,0.40538053066330004
21611,703-004-5384,4999.6953,1,1,0,0.6007733853100824
21714,703-004-5396,7063.9688,3,2,1,0.6078504801428607
22043,703-004-5384,7477.8228,3,2,1,0.9562003228566932
22415,703-004-5384,7984.2383,1,0,1,0.27920371738274696
22652,703-004-5398,6075.839,11,6,5,3.90066517005227
22831,703-004-5388,7657.555,5,1,4,0.5165268771580819
22919,703-004-5382,1235.0887,4,2,2,0.7588791838075454
22922,703-004-5395,8155.2725,1,1,0,0.33472744830518475
23343,703-004-5390,5333.6553,4,4,0,1.7684169448807774
23535,703-004-5392,6631.14,3,1,2,0.47665791088860526
23947,703-004-5388,1309.0718,5,1,4,0.632310320125377
23959,703-004-5388,383.92426,6,2,4,0.8608242255829068
24049,703-004-5393,6435.23,7,4,3,1.7120311064203209
24244,703-004-5380,2503.8142,5,1,4,0.8928627287235933
24343,703-004-5382,2794.6455,5,4,1,1.8754640335841
24521,703-004-5385,8855.679,4,2,2,2.0238561884767505
24754,703-004-5397,8165.2476,4,1,3,1.6960909256377423
24758,703-004-5393,714.8176,"","","",0.27920371738274696
24873,703-004-5381,1200.4805,3,0,3,0.27920371738274696
25110,703-004-5395,7197.6113,5,4,1,1.6081646302380694
25122,703-004-5393,5516.3916,2,1,1,0.4953131445808774
25144,207-008-2398,8985.07,7,5,2,1.159913279831844
25718,703-004-5386,8485.146,6,3,3,0.7794483535717086
25994,703-004-5384,7199.1123,3,1,2,0.6072643235232773
26131,703-004-5390,1711.4049,1,1,0,0.554408750458251
26296,703-004-5384,2803.5986,1,1,0,2.5735179539381576
26415,703-004-5387,5805.1484,5,2,3,2.0184694794505984
26536,703-004-5389,2808.882,4,3,1,0.6598256932818236
27014,703-004-5391,813.5575,8,3,5,1.1544092285441232
27018,703-004-5393,388.43216,3,2,1,0.6379107926596097
27025,703-004-5390,5593.462,7,4,3,2.4998531134798196
27155,703-004-5382,7789.9395,5,1,4,0.9529325678410849
27200,207-008-2399,7825.645,6,2,4,1.4021838190590958
27334,703-004-5393,8012.0747,5,0,5,0.27920371738274696
27557,703-004-5398,8487.779,3,1,2,0.6888333796199657
27723,703-004-5388,6633.4067,2,2,0,2.087521408016212
27740,703-004-5385,419.15475,4,3,1,0.9195445110838005
27746,703-004-5382,9435.066,1,1,0,0.5354023491765262
27891,207-008-2398,5036.75,5,2,3,1.0999803200524245
27923,703-004-5398,8697.059,6,4,2,2.268096769977712
28034,703-004-5393,1835.6627,5,4,1,2.512527804044334
28180,703-004-5386,270.26117,3,2,1,0.558239761136258
28251,703-004-5396,5198.127,3,2,1,0.6345128419850595
28341,703-004-5387,842.9104,2,0,2,0.27920371738274696
28695,703-004-5381,9997.158,4,2,2,1.4662073065142285
28884,703-004-5398,7109.454,4,2,2,0.5081056818303248
29092,703-004-5387,6041.8564,2,1,1,0.5612593661461721
29230,703-004-5382,9103.566,2,2,0,0.7103407909746053
29353,703-004-5385,3903.7234,6,4,2,1.4490794491657293
29382,703-004-5385,7264.1826,5,1,4,0.3554141170656014
29525,703-004-5380,255.00476,6,5,1,2.875933833352759
29733,703-004-5381,5141.114,3,2,1,1.3278391018272762
29785,703-004-5389,5688.4053,5,1,4,0.3938510745439433
29827,703-004-5387,2966.6865,4,2,2,0.7034024659083253
29887,703-004-5399,7113.977,3,1,2,0.48743765007961964
30239,703-004-5394,4580.8687,3,2,1,0.7055573677004612
30468,207-008-2399,5310.6094,5,2,3,0.5993383493422952
3057,703-004-5399,513.41534,3,2,1,0.9621947072384166
30625,703-004-5380,3385.9443,"","","",0.27920371738274696
307,703-004-5389,3891.195,5,4,1,1.3124440916440308
30710,703-004-5396,7410.634,3,0,3,0.27920371738274696
30760,703-004-5381,3921.175,6,3,3,0.9255546926930509
31224,703-004-5387,9581.378,7,2,5,0.47666400266456865
31641,703-004-5389,7728.588,3,1,2,0.8760701508275106
3167,703-004-5386,8761.885,3,0,3,0.27920371738274696
31760,703-004-5382,7021.3813,6,4,2,1.8368849057383891
31849,703-004-5385,5081.1367,1,0,1,0.27920371738274696
31894,703-004-5392,6602.2993,4,1,3,1.5661164113420094
31918,703-004-5380,5852.5635,1,1,0,0.6103816292023522
32018,703-004-5390,5971.3457,1,1,0,0.6132803778624543
32201,703-004-5382,479.7292,7,3,4,0.6054512710870953
32373,703-004-5381,8353.951,5,2,3,0.9503736084998856
32757,703-004-5393,7959.943,4,2,2,0.41764222725169237
32873,703-004-5381,9112.401,4,2,2,0.8340954027465826
32962,703-004-5396,6656.1104,5,1,4,0.7557039138565006
32975,703-004-5394,4194.5176,1,1,0,3.00743339569921
33115,703-004-5399,3358.711,4,0,4,0.27920371738274696
33853,703-004-5380,9981.809,2,2,0,1.164348342018772
33864,703-004-5386,9183.034,6,4,2,2.440175591706629
33959,703-004-5398,8354.766,3,1,2,0.37130319863989697
34044,207-008-2399,8396.514,4,2,2,0.6738723346915207
34100,703-004-5392,1124.1042,5,4,1,0.9260409069212066
34498,703-004-5385,1269.0354,1,0,1,0.27920371738274696
34520,703-004-5398,9356.323,6,2,4,1.6162300917521895
34749,703-004-5392,5019.391,14,8,6,2.4618852311425385
34760,703-004-5382,2817.1335,8,2,6,1.2814474620917837
34809,207-008-2398,5538.312,2,1,1,0.32537964429389504
34848,703-004-5381,6689.586,4,1,3,0.3978652972704144
34874,703-004-5381,3210.5803,6,3,3,1.8712918922449264
3491,703-004-5388,2554.5388,3,1,2,0.41396936477997903
34960,703-004-5393,7352.124,5,2,3,0.5345446966963201
34989,703-004-5383,3876.664,3,2,1,0.8460048356844394
35523,703-004-5382,1961.8875,6,3,3,2.3534108035854673
35563,703-004-5382,5252.2974,2,1,1,0.711155452720802
35780,703-004-5399,6713.5547,4,2,2,0.952690250300019
35915,703-004-5390,7504.731,4,4,0,1.6054422345544108
35931,703-004-5383,2836.4534,5,2,3,1.0716697050357344
35976,703-004-5398,9834.942,5,1,4,1.2604367658490254
36159,207-008-2398,6645.068,5,1,4,0.5669580486103406
36243,703-004-5387,261.21378,4,3,1,1.9589965095270683
36610,703-004-5391,1844.6625,4,2,2,1.384785023875331
36678,703-004-5398,8113.517,7,5,2,1.1385091501806146
36719,703-004-5388,8748.449,3,1,2,0.38291350043398287
36744,703-004-5381,4829.193,3,2,1,0.49981756224159846
36807,703-004-5394,6902.222,4,2,2,1.3252370872675379
36885,703-004-5397,6220.507,3,3,0,1.0040886816033732
37089,703-004-5395,3958.7266,3,1,2,1.12862015625178
37121,703-004-5386,497.76138,"","","",0.27920371738274696
37136,703-004-5389,7402.4414,4,2,2,1.1935485232436245
37152,703-004-5391,3002.7336,10,4,6,2.8713694693220457
37712,207-008-2399,2733.044,5,2,3,0.6998962028330866
38015,703-004-5380,6183.1035,3,2,1,1.0810746614436122
38047,703-004-5392,825.0082,4,3,1,1.3001704839152672
38269,703-004-5386,4221.8955,4,1,3,0.3978652972704144
38341,703-004-5390,9065.067,7,2,5,0.5707991221201072
38448,703-004-5398,8069.072,1,1,0,0.5235039327300396
38766,207-008-2398,3040.8162,5,3,2,0.5896454834538633
38895,703-004-5392,1981.1094,6,2,4,0.6906772011411556
3895,703-004-5392,9048.213,6,1,5,0.8492160701392018
3898,703-004-5399,6918.3516,3,1,2,0.44530695914534696
3902,703-004-5398,8482.888,3,3,0,2.6242448837875876
39052,703-004-5380,3286.8333,6,3,3,1.8699659606941148
39094,703-004-5387,8988.894,5,3,2,1.1528870336215475
39336,703-004-5380,6056.366,3,3,0,0.9219526849177065
39403,703-004-5398,8276.303,5,2,3,1.1601721466821795
39548,703-004-5387,9981.42,2,1,1,0.5697292516104518
39608,703-004-5391,8210.728,5,2,3,0.9809111382042248
39727,703-004-5397,1925.4559,8,5,3,2.0104372898542158
39827,703-004-5380,1027.7224,5,3,2,1.162600144008965
39904,703-004-5393,7081.3403,4,2,2,0.9351536640726642
3993,703-004-5396,1031.6265,4,3,1,0.7458768714432616
39959,703-004-5391,4511.176,6,4,2,0.9636934719497684
39967,703-004-5387,2207.8396,3,2,1,0.7663149092091984
40145,207-008-2399,5018.9478,4,2,2,2.653735733333915
40272,703-004-5399,2078.0833,4,3,1,3.5705579418333535
40377,703-004-5384,9573.7705,2,1,1,0.4446653678889136
40448,703-004-5397,8752.926,3,2,1,1.248679266736563
40552,703-004-5387,3429.184,4,2,2,0.6010732528280449
40620,703-004-5392,4839.5713,7,3,4,1.1529328239080479
40926,703-004-5393,5477.8623,2,0,2,0.27920371738274696
40984,703-004-5389,5742.9067,5,3,2,0.8355801322404843
41680,703-004-5383,6684.6064,4,3,1,1.2107662248140345
41964,703-004-5390,4092.4019,6,4,2,2.576313978934515
42088,703-004-5389,9987.93,3,3,0,1.5559335259798226
42158,703-004-5391,1223.513,2,2,0,0.9622208458784137
42404,207-008-2398,8151.1885,6,3,3,0.946503015740608
4262,703-004-5396,1885.2198,4,1,3,0.8836334068435222
42751,703-004-5381,2310.1323,1,0,1,0.27920371738274696
42974,703-004-5384,324.6039,5,2,3,0.43869367695897993
43114,703-004-5383,6481.913,6,2,4,1.0873108931372513
43185,703-004-5397,8163.076,3,1,2,0.40482056232525676
43336,703-004-5382,1373.5831,5,1,4,0.5284445165851658
43375,703-004-5397,5505.723,5,4,1,0.9783663984877503
43429,703-004-5392,4838.249,4,1,3,0.4235721677678489
43491,703-004-5389,9707.728,5,1,4,0.4978871206507275
43607,703-004-5382,5510.7017,6,2,4,1.0027493935417437
43680,703-004-5389,1094.3657,4,3,1,0.9765032131181978
43826,703-004-5384,2253.1038,3,1,2,0.3978652972704144
44364,703-004-5380,22.470356,9,4,5,1.1944957077782872
44373,703-004-5392,4879.3804,6,4,2,2.4216075117319367
44473,703-004-5396,6469.8804,4,3,1,1.1523926500404689
4464,703-004-5393,4657.8145,6,1,5,1.591879156345468
44770,703-004-5384,7440.472,4,3,1,1.4570842091881049
44860,703-004-5386,6853.7217,5,4,1,2.1743118661391234
44865,207-008-2399,6459.136,4,1,3,1.3972445343891242
44942,703-004-5398,2997.752,5,1,4,0.5616615395497295
44988,703-004-5390,3596.105,4,1,3,0.3187575773453028
45150,703-004-5380,6651.322,3,1,2,0.3978652972704144
45219,703-004-5393,1212.4181,6,4,2,2.9631050333620306
45604,703-004-5395,9932.762,7,5,2,1.9622473065660953
45757,703-004-5396,8641.848,1,1,0,0.4814365897196228
4594,703-004-5395,3520.7217,3,1,2,0.9807290082915677
45978,703-004-5391,4803.899,4,2,2,1.7115790828488715
46033,703-004-5384,2614.8962,9,7,2,2.332743455609857
46084,703-004-5399,3534.5488,2,0,2,0.27920371738274696
46187,703-004-5384,2541.2244,5,0,5,0.27920371738274696
46283,703-004-5394,4062.6423,2,0,2,0.27920371738274696
46392,703-004-5396,5564.441,3,0,3,0.27920371738274696
46614,207-008-2399,1408.9573,5,4,1,1.1119197125275564
46640,703-004-5398,260.64575,7,2,5,1.0490784733470613
46672,703-004-5393,6172.167,2,2,0,1.2350445510400545
46906,207-008-2398,9926.847,4,3,1,3.159609457265025
46927,703-004-5399,657.8827,3,2,1,1.5229507141413297
475,207-008-2398,6405.188,4,3,1,1.8321029821222272
47538,703-004-5383,3470.7493,2,1,1,0.8758512941031626
47593,703-004-5389,9355.67,2,1,1,0.6607154727838894
47624,703-004-5394,8543.498,3,0,3,0.27920371738274696
47733,703-004-5398,6837.0986,5,1,4,0.4228388042112697
48099,703-004-5391,1389.283,5,3,2,2.1645741583878615
48160,703-004-5380,4748.7725,5,1,4,0.33853450732658075
48184,703-004-5387,5820.3306,3,2,1,0.4975686706921542
48325,703-004-5398,9522.022,3,0,3,0.27920371738274696
48335,703-004-5384,5642.003,3,2,1,0.967214866399367
48495,703-004-5397,9611.858,3,2,1,1.6744116227226153
48534,703-004-5381,8599.1875,4,3,1,1.6476426717278787
48727,703-004-5393,4708.5244,4,3,1,0.9717742272067421
48796,703-004-5380,8172.235,2,2,0,0.7801423433933093
48842,703-004-5399,4145.0747,9,3,6,0.7239792373727155
48961,703-004-5384,9212.987,3,0,3,0.27920371738274696
49145,703-004-5384,3395.5347,1,1,0,1.8351399631345247
5048,703-004-5396,3815.3328,1,0,1,0.27920371738274696
5052,207-008-2398,1164.0388,5,1,4,0.5252797188383539
5134,703-004-5388,1172.3239,5,1,4,0.38625824453236074
5450,703-004-5395,7067.5195,6,3,3,0.5305069021191088
574,703-004-5389,2289.0627,5,3,2,1.2839404822238378
5986,703-004-5391,991.56854,7,4,3,1.8543848469999031
6033,207-008-2398,9629.855,5,3,2,1.9942977806542337
613,703-004-5399,9019.65,8,5,3,1.5777981967781236
6348,703-004-5386,736.70685,5,2,3,0.7190608128686619
6402,703-004-5389,9603.409,4,0,4,0.27920371738274696
6464,703-004-5386,2490.328,"","","",0.27920371738274696
6758,703-004-5394,1807.375,7,1,6,0.39226842608571283
7013,703-004-5385,3206.4802,2,1,1,0.35790687720067654
7014,703-004-5388,1642.6945,2,1,1,0.5165268771580819
7093,207-008-2398,4007.78,4,3,1,2.6114775521662428
718,703-004-5393,4714.915,1,0,1,0.27920371738274696
7316,703-004-5380,9757.815,2,0,2,0.27920371738274696
7541,703-004-5387,2048.9807,4,3,1,1.402057228976813
7544,703-004-5390,308.00403,3,1,2,1.044240756533327
7574,703-004-5390,6863.0693,7,4,3,1.3703524808624494
8082,703-004-5385,5180.6104,3,2,1,0.9095339678144789
8179,703-004-5392,293.7615,4,1,3,1.135277076882075
8279,703-004-5399,4211.8975,4,1,3,0.36112964983019075
8502,703-004-5397,9736.616,1,1,0,0.6575509150985642
8701,703-004-5384,3292.9546,4,1,3,0.5933438605689214
8744,703-004-5383,8024.0483,2,1,1,1.2039755540435124
9043,703-004-5388,9819.272,4,1,3,0.6162644622786899
9109,207-008-2398,6010.9927,4,2,2,0.5984831679778456
9686,703-004-5380,2990.3943,5,2,3,0.809273734642598
9911,703-004-5395,20.446182,5,4,1,1.800503285594328
10025,703-004-5383,6356.288,9,4,5,2.501571691500035
10095,703-004-5387,255.29623,3,2,1,0.5021886029216555
10539,703-004-5383,9598.685,4,1,3,1.8320979628255198
10750,703-004-5395,5452.276,1,1,0,0.3978652972704144
10871,703-004-5391,4504.8784,7,1,6,1.5791693269123914
11166,703-004-5399,3904.3772,3,0,3,0.27920371738274696
11211,703-004-5380,109.82573,6,4,2,1.2234424466962575
11234,703-004-5388,9234.331,2,1,1,0.7162841176768912
11324,703-004-5393,1298.6892,1,1,0,0.7742680082943498
11360,703-004-5389,4258.596,6,3,3,2.0526562370552743
11434,703-004-5380,6806.972,1,1,0,0.3401166617250829
11611,703-004-5396,1208.2327,5,4,1,1.9525478785964296
11815,703-004-5380,8900.455,2,2,0,1.1932896024536002
1204,703-004-5397,451.9218,"","","",0.27920371738274696
1212,703-004-5383,7565.2695,6,2,4,1.2105275253047396
12234,207-008-2399,9981.845,3,0,3,0.27920371738274696
12978,703-004-5384,9657.531,3,0,3,0.27920371738274696
1320,703-004-5396,5364.2993,5,4,1,1.54595727376412
13387,703-004-5388,5071.248,3,1,2,0.5351180440647654
13616,703-004-5381,1048.106,5,3,2,2.1363483791820794
13633,703-004-5395,8584.585,7,3,4,1.8746652022737642
13804,703-004-5398,874.67316,1,0,1,0.27920371738274696
13915,703-004-5391,6587.7017,6,4,2,1.355016487502873
13945,703-004-5380,6809.33,7,3,4,0.7147103204770218
14366,703-004-5382,7041.018,3,2,1,1.488939846441931
14787,703-004-5393,7613.58,4,3,1,1.5814551823276346
15092,207-008-2398,9832.455,7,2,5,0.7060151540509796
15231,207-008-2399,6980.471,1,0,1,0.27920371738274696
1531,703-004-5393,1411.6484,3,2,1,0.5087386920020095
15317,703-004-5395,252.99728,5,4,1,0.6026663928402726
15454,703-004-5395,6952.745,4,3,1,0.8375776241154602
15592,207-008-2399,5452.514,4,3,1,4.461429648501243
159,703-004-5394,5494.9766,3,1,2,0.5435367951304665
16164,703-004-5393,8297.442,5,4,1,1.5405219646826955
16208,703-004-5392,8649.003,2,0,2,0.27920371738274696
16300,703-004-5383,234.04419,4,2,2,0.665577536127474
1643,703-004-5382,817.78467,2,1,1,1.043968390356471
16631,703-004-5387,7680.5527,5,3,2,1.2716662042851898
1760,703-004-5380,6441.9805,5,2,3,1.379515523961049
17656,703-004-5391,7211.675,1,0,1,0.27920371738274696
17894,207-008-2399,6402.6465,3,1,2,0.5375290296692742
18205,703-004-5385,5398.7627,10,5,5,3.2457826201457367
18280,703-004-5388,5636.4917,4,1,3,0.36007282013431624
18355,703-004-5380,2590.3625,2,2,0,1.119450667076807
18448,703-004-5384,2753.0903,2,0,2,0.27920371738274696
18662,703-004-5397,8796.731,3,2,1,0.5551102666278365
18827,703-004-5395,7568.436,1,0,1,0.27920371738274696
19208,703-004-5388,8812.362,3,2,1,0.82908130172863
19581,703-004-5399,5283.8613,4,3,1,0.485805127906544
19668,703-004-5392,3968.221,2,0,2,0.27920371738274696
19837,207-008-2399,8832.957,1,0,1,0.27920371738274696
19868,703-004-5397,589.47144,3,3,0,0.6287583797299102
20176,703-004-5398,3398.7039,3,1,2,0.5804944706351419
20679,703-004-5385,1548.2664,4,2,2,1.5282328967055654
20696,703-004-5389,5255.961,6,3,3,1.7832288324015946
2070,703-004-5393,2472.4287,4,3,1,1.2987819794738553
20859,703-004-5393,2895.854,3,2,1,0.7230353432426762
209,207-008-2399,747.6938,"","","",0.27920371738274696
21073,703-004-5388,9132.71,3,1,2,0.35831143730785864
2125,703-004-5395,5770.8066,3,1,2,0.4979909716006626
21465,703-004-5391,2179.1917,6,1,5,0.3978652972704144
21691,703-004-5392,611.88995,3,1,2,0.3978652972704144
21699,703-004-5390,5849.5664,4,3,1,1.0785765301317547
2186,703-004-5390,7572.434,4,1,3,0.9040063778162692
22553,703-004-5396,5751.322,4,2,2,1.6499844231400493
2265,703-004-5385,1628.4401,4,3,1,0.7675617217000088
22775,703-004-5391,686.3111,6,4,2,2.9212396308761512
22818,703-004-5399,9367.095,4,3,1,1.5361816340728427
23147,703-004-5384,3433.8552,5,3,2,1.4651978763589464
23281,703-004-5397,4804.792,6,4,2,1.788971677069122
2383,703-004-5388,2591.5288,4,3,1,0.6883478874044837
239,703-004-5398,3987.2437,1,0,1,0.27920371738274696
24206,703-004-5383,9531.489,2,1,1,0.48110280071832084
24533,703-004-5393,1061.579,3,2,1,0.633860394977666
24558,207-008-2398,8402.96,2,1,1,0.35831143730785864
24730,703-004-5382,4990.6006,9,2,7,2.261654058557524
25206,703-004-5395,88.26018,5,4,1,2.2462094899377947
25404,207-008-2399,1937.3208,4,2,2,1.427942784122554
25415,703-004-5390,2588.786,4,2,2,1.1475343664028255
25475,703-004-5382,6011.4854,8,4,4,1.2271079405779353
25513,703-004-5384,9179.472,6,3,3,1.5413674238986959
25516,703-004-5395,2890.777,1,0,1,0.27920371738274696
25614,703-004-5382,8913.084,4,1,3,0.32204793316948477
26396,703-004-5391,9688.395,4,3,1,1.5983049202556903
26606,703-004-5383,624.6084,8,5,3,2.121484403431989
26748,703-004-5381,4697.4067,4,1,3,0.8316146140759142
26765,703-004-5386,6463.254,4,2,2,0.8773554774595897
26934,703-004-5395,1217.872,2,1,1,0.42902947675215286
26955,703-004-5389,4715.392,"","","",0.27920371738274696
27010,703-004-5397,8130.5176,8,4,4,2.0859408851767225
27197,703-004-5386,4327.578,3,0,3,0.27920371738274696
27581,703-004-5383,3368.0994,6,2,4,1.324608014305558
27683,703-004-5399,3912.016,8,3,5,1.1474450837945445
27927,703-004-5383,4540.729,7,3,4,1.3790663965943961
28173,703-004-5385,4607.6963,4,4,0,2.035803703138479
28185,703-004-5380,9714.749,2,2,0,0.8189110183120165
28783,703-004-5387,3288.0247,3,1,2,0.4917931362750305
29637,703-004-5388,4461.548,3,2,1,0.5686519842832893
2984,703-004-5387,3612.051,3,2,1,1.0140615396857102
30610,703-004-5385,4712.9375,2,0,2,0.27920371738274696
30728,703-004-5381,2753.5354,4,1,3,0.44616763711919794
30899,703-004-5388,3736.1216,5,3,2,0.8462701330222949
31111,703-004-5396,8716.306,5,2,3,0.6517091255743332
3119,703-004-5385,504.26782,3,1,2,0.6859574339872897
31354,703-004-5385,6234.384,8,5,3,2.1603150467577636
31437,703-004-5397,4952.87,1,0,1,0.27920371738274696
31856,703-004-5382,9606.534,8,4,4,1.066922323272286
32150,703-004-5385,1398.0692,5,4,1,1.9562964487136054
32895,703-004-5393,7083.521,4,2,2,0.859023009323434
3320,703-004-5388,5781.041,3,2,1,0.7148932941964163
33277,703-004-5391,4422.0264,2,2,0,0.9587461811937199
33330,703-004-5393,7056.166,2,1,1,0.3978652972704144
33398,703-004-5392,3185.689,4,2,2,0.8456290397545946
33877,703-004-5390,4792.637,3,1,2,0.35831143730785864
34035,703-004-5394,8459.157,8,6,2,1.717085822732486
34481,207-008-2398,3284.9663,1,1,0,0.5831074350631061
34597,703-004-5398,1833.8442,5,2,3,0.7916610509477612
34614,703-004-5391,7391.25,2,0,2,0.27920371738274696
34795,703-004-5387,1549.0901,5,2,3,0.5093261785905947
34878,703-004-5397,8171.5596,"","","",0.27920371738274696
3525,703-004-5388,2447.2666,3,1,2,0.37512182779194486
35375,703-004-5386,4449.239,4,0,4,0.27920371738274696
35612,703-004-5387,6265.054,4,3,1,1.487239902347891
35794,703-004-5383,625.8309,3,2,1,2.140407341312775
35801,703-004-5380,7375.7363,6,4,2,0.8483198776379247
35898,703-004-5395,2861.6912,5,2,3,1.5762825526174904
35989,703-004-5399,8121.389,3,2,1,0.5087723978483394
36313,703-004-5393,2979.9373,4,2,2,0.7993620684391143
36444,703-004-5390,3067.8135,4,2,2,1.059865739416122
36582,207-008-2399,8060.2056,2,1,1,0.3978652972704144
36602,703-004-5392,4104.9717,5,2,3,2.572468798454752
36640,703-004-5396,700.67523,6,3,3,1.6900820224801376
36658,703-004-5398,2621.3271,1,0,1,0.27920371738274696
36989,703-004-5398,740.602,6,3,3,1.1814462982482439
37111,703-004-5389,7670.255,3,1,2,0.38138272983692884
3731,703-004-5393,9105.724,2,2,0,0.9241112783510359
37381,703-004-5386,4788.0225,4,2,2,0.420861879447568
37403,207-008-2398,7215.357,4,4,0,0.8364576736312446
37450,703-004-5388,6559.9136,5,1,4,0.6026801283890237
37677,703-004-5395,2885.1658,4,3,1,1.380678737942379
37695,703-004-5382,1227.774,7,4,3,1.762409102186843
377,703-004-5380,9844.137,6,4,2,1.612505793075583
3795,703-004-5386,8750.182,1,1,0,0.9646334415617867
38238,703-004-5380,6299.9546,3,2,1,0.6945363635300825
3834,207-008-2399,5210.2344,8,5,3,1.6194774861154486
38374,703-004-5381,474.11145,2,2,0,0.702677007827833
38438,207-008-2398,6884.0635,7,4,3,1.6603401962683533
38496,703-004-5383,1175.8751,4,3,1,0.9108511508513334
3856,703-004-5390,3944.0579,4,2,2,1.2743694188541794
38814,703-004-5386,3539.7632,3,3,0,1.984268676856906
3897,703-004-5386,3069.293,4,3,1,1.660929291422291
38984,703-004-5394,9614.489,2,0,2,0.27920371738274696
39163,703-004-5394,3714.8828,6,2,4,0.8954447310392699
39175,703-004-5399,3052.6328,4,1,3,0.4747090009467986
39521,703-004-5393,1658.2001,1,0,1,0.27920371738274696
40021,703-004-5399,2700.5642,1,1,0,0.47080244914681413
40154,703-004-5393,2922.6577,4,2,2,0.9633216816964794
40360,703-004-5390,6764.314,1,0,1,0.27920371738274696
40467,703-004-5386,4836.64,1,1,0,0.3401166617250829
40774,703-004-5397,1051.7615,1,1,0,0.38128563763610984
40833,703-004-5392,9028.817,4,1,3,0.9143694656412049
41165,703-004-5392,5265.1626,3,3,0,0.9523634659006275
41383,703-004-5392,3073.2239,3,2,1,1.1299135682220645
41672,703-004-5380,8792.782,5,3,2,1.1678920708120992
41825,703-004-5394,2084.4233,2,2,0,1.0215892909812079
42257,703-004-5380,548.01404,6,5,1,2.803701390381025
42352,207-008-2399,7543.067,3,3,0,1.2389522756198343
4241,703-004-5381,301.2979,4,3,1,0.949891151104879
42542,703-004-5399,8571.58,7,3,4,1.3787726752651739
42668,703-004-5394,9817.321,3,3,0,0.9857131339822681
43031,207-008-2399,9329.765,3,1,2,0.4050972261413182
43261,703-004-5397,702.33344,4,2,2,0.593274028644241
43444,703-004-5393,9132.943,4,3,1,1.1742274831043908
43493,703-004-5383,7345.9224,3,2,1,1.4695933524627938
43589,703-004-5384,3498.3628,3,3,0,0.9529949145310126
43761,703-004-5392,6236.012,3,1,2,0.41754789508754747
43769,703-004-5388,7271.5186,3,1,2,0.3978652972704144
44047,703-004-5380,2526.1282,3,1,2,0.6414536082630611
44052,703-004-5390,63.406227,2,0,2,0.27920371738274696
44175,703-004-5399,2193.6006,1,0,1,0.27920371738274696
44322,703-004-5390,6467.0347,2,1,1,0.3851781631818206
44520,703-004-5390,5692.117,6,0,6,0.27920371738274696
44594,703-004-5397,6775.878,4,3,1,0.7332439722266669
44708,703-004-5399,5860.835,6,2,4,0.9415377397705126
44766,703-004-5387,6983.499,1,0,1,0.27920371738274696
45179,703-004-5384,4539.023,5,2,3,0.49257905604836494
45350,703-004-5396,9312.447,7,4,3,1.506630294766593
45387,703-004-5380,8906.455,1,0,1,0.27920371738274696
45674,703-004-5389,2152.9614,6,4,2,1.473506928425952
46056,703-004-5385,8689.501,6,1,5,1.5836293379819169
46218,703-004-5391,5258.55,3,2,1,1.097054252219889
46234,703-004-5385,5240.3716,8,6,2,2.178365292089966
46313,703-004-5380,4680.37,3,2,1,1.7708161736913168
46446,703-004-5386,4033.3403,4,1,3,0.38274253814473064
4675,703-004-5392,3866.9224,6,1,5,0.33853450732658075
46998,703-004-5394,5391.43,7,2,5,0.9121505682239273
47010,703-004-5383,3471.827,3,2,1,0.8967203590551761
47078,703-004-5393,3939.424,3,2,1,0.8686142088739565
47128,207-008-2399,5900.095,2,0,2,0.27920371738274696
47234,703-004-5393,3649.653,2,2,0,1.4145688978224709
47637,703-004-5396,489.27902,"","","",0.27920371738274696
47700,703-004-5381,8688.213,3,2,1,1.5655780818475677
47848,207-008-2398,3218.37,5,1,4,0.37696726257082286
48011,703-004-5386,5077.8003,4,4,0,1.0797193105962726
48013,703-004-5381,5514.439,7,5,2,1.0176490242961087
48266,703-004-5397,4069.6199,8,4,4,2.6895366423873956
48311,703-004-5396,2721.247,7,5,2,1.9621549479223885
48490,703-004-5392,4726.0244,3,1,2,1.080535113438043
48913,703-004-5391,2408.787,3,1,2,0.37512182779194486
49136,207-008-2398,5471.1167,3,1,2,0.7239982709027897
49800,703-004-5387,9842.493,4,3,1,1.5034205908810978
5005,703-004-5393,5285.7812,3,2,1,0.7149071077882956
5099,703-004-5396,7590.129,4,2,2,1.4256849984275333
5111,703-004-5389,3575.8347,1,1,0,0.4656876412325145
5155,703-004-5391,864.99036,8,4,4,1.203130336917018
5460,703-004-5399,9634.424,2,2,0,1.376948910346055
5678,207-008-2398,7522.773,5,3,2,1.806272740299863
5760,703-004-5397,3783.0364,4,1,3,1.0977991501190967
5932,703-004-5387,816.4203,5,4,1,2.1031830703680128
6053,703-004-5394,4737.647,2,1,1,1.1616495482641305
6128,703-004-5391,6869.8633,1,1,0,0.3978652972704144
6888,703-004-5382,6437.7485,6,4,2,1.6679859052104224
7011,703-004-5380,8826.812,6,3,3,0.9023360401183212
7355,703-004-5384,4296.522,6,2,4,1.7763646963372204
7436,703-004-5387,6974.812,7,4,3,1.4287630334133918
7626,703-004-5381,6890.34,4,2,2,0.6365830787881077
783,207-008-2398,7370.3877,"","","",0.27920371738274696
7940,703-004-5389,3055.9075,1,0,1,0.27920371738274696
7988,703-004-5396,9665.985,4,0,4,0.27920371738274696
8197,703-004-5393,6017.1123,3,1,2,0.5737935910489543
8539,703-004-5397,2715.2957,4,4,0,1.9526176077708024
867,703-004-5382,4213.838,4,0,4,0.27920371738274696
8755,703-004-5396,3700.3523,4,2,2,0.6644775252562966
9318,703-004-5393,8920.208,5,3,2,0.6800862082969964
97,703-004-5381,7081.765,3,2,1,0.7074434172738058
992,703-004-5397,3289.445,3,2,1,0.7634393159272855
10169,703-004-5383,3130.8716,6,5,1,2.816713722227033
10433,703-004-5386,9178.929,3,3,0,0.6949497221932327
10628,703-004-5392,6860.42,7,1,6,0.9269819833151383
10687,703-004-5399,1266.898,5,2,3,1.1455653084371007
10891,703-004-5396,3401.6274,6,5,1,2.0638308741253275
11048,703-004-5390,2942.1055,5,3,2,1.1340296372215999
11245,703-004-5380,2064.4314,2,0,2,0.27920371738274696
11281,703-004-5389,8030.396,5,3,2,1.2577775030309717
11376,703-004-5382,3046.2974,3,2,1,2.398468494663626
11393,703-004-5384,4969.842,7,4,3,1.131945580021828
11428,703-004-5392,6448.328,2,2,0,3.027074061634064
11537,703-004-5388,7248.53,5,2,3,0.4410951940932403
1158,703-004-5388,6702.8394,6,2,4,0.7749520212234403
11588,703-004-5393,1940.7064,5,3,2,1.144066211781341
11749,703-004-5385,3181.0134,3,1,2,0.752520050722512
1207,703-004-5385,8016.3657,2,2,0,0.45274299318519856
12192,703-004-5396,7088.541,4,1,3,1.6266417892970144
12195,703-004-5393,2446.0273,8,3,5,0.6248395465910342
12296,703-004-5397,7396.8174,5,4,1,3.3384050612347
12408,703-004-5389,5353.6367,6,4,2,1.3094294093251502
12420,703-004-5393,2248.3694,3,3,0,2.2490648067388777
12763,703-004-5392,831.73096,1,1,0,0.6512710874079777
12850,703-004-5384,1224.9727,4,1,3,0.6355708520465503
12944,207-008-2398,8796.018,6,0,6,0.27920371738274696
1304,703-004-5387,5160.0596,4,1,3,0.5883333140876362
13126,703-004-5399,1178.9614,2,1,1,0.726541953703672
13367,703-004-5393,4722.641,3,1,2,0.35831143730785864
13563,703-004-5397,7662.1,4,1,3,0.3822827750139807
13687,703-004-5397,5038.6035,3,1,2,0.5788905443360659
1377,703-004-5386,1430.8655,4,2,2,0.8849022739350397
14105,703-004-5388,7779.967,4,3,1,0.8355811153279223
1412,703-004-5392,6221.301,4,3,1,1.63132585940001
14460,703-004-5389,527.7604,2,1,1,0.5894327589962818
1496,703-004-5382,46.16499,4,2,2,0.3978652972704144
15006,703-004-5388,7255.9614,"","","",0.27920371738274696
15014,703-004-5381,3319.856,4,0,4,0.27920371738274696
15210,703-004-5385,4565.1807,6,3,3,0.5338402663314163
15348,703-004-5393,8134.4956,4,1,3,0.6455674166811833
155,703-004-5384,4910.786,"","","",0.27920371738274696
15801,703-004-5381,753.7204,6,4,2,1.013334978157504
15874,207-008-2398,9032.273,6,3,3,1.2226330304734299
17014,703-004-5384,2005.241,5,2,3,0.6323872047859489
17067,703-004-5387,6204.202,2,2,0,0.6114635574169588
17160,703-004-5397,9407.093,4,1,3,0.4817110974618143
17179,703-004-5392,9199.264,5,2,3,0.8041096003601046
17599,703-004-5382,2633.2568,4,3,1,2.5357243047040514
17623,703-004-5395,8841.103,6,3,3,1.8025872559766767
1791,703-004-5392,7258.93,5,3,2,1.163371338075113
17953,703-004-5386,4231.044,3,3,0,1.2341653033173416
18059,703-004-5382,8859.425,2,2,0,0.5927802410070666
18258,703-004-5399,1756.32,3,2,1,0.6648538520176662
18607,703-004-5391,6789.8477,4,3,1,2.264374662507007
18669,703-004-5388,6663.7153,1,0,1,0.27920371738274696
18715,703-004-5384,4607.8633,5,4,1,1.9872027462014898
18808,703-004-5398,7546.9746,4,3,1,0.8045917006988395
18936,703-004-5397,9786.884,3,0,3,0.27920371738274696
19170,703-004-5383,7159.063,4,2,2,0.5128590934676566
19250,703-004-5395,8112.91,6,4,2,1.8686586868909913
19358,703-004-5386,5619.221,1,1,0,0.41467568775450064
1936,703-004-5391,3833.5574,8,4,4,0.9097176762267166
19777,703-004-5391,2520.6453,2,1,1,0.5328916739587274
19811,703-004-5391,9839.217,7,4,3,0.8122579007612493
19857,703-004-5395,6486.5356,7,1,6,0.5547754686168749
19916,703-004-5393,6961.95,4,3,1,0.6113294175444651
19938,703-004-5388,3014.9597,7,1,6,0.7054683288108337
2016,207-008-2398,2990.3918,4,3,1,1.2647655753505216
20243,703-004-5389,9012.012,5,2,3,1.4203768146215128
20294,703-004-5380,2577.0242,7,4,3,1.7614737365629296
20349,703-004-5393,8999.799,2,0,2,0.27920371738274696
20675,703-004-5396,5542.713,3,1,2,0.977296543512951
20861,703-004-5399,9492.765,7,3,4,2.9126961627166463
21283,703-004-5388,1139.5645,9,5,4,1.9347376672508736
21646,703-004-5388,4230.731,5,2,3,0.5905226980106397
21966,703-004-5399,4304.979,5,4,1,2.020738204794447
22375,703-004-5391,360.7756,4,2,2,1.47662177055733
22698,703-004-5386,9205.95,3,2,1,0.6651498710968845
22923,703-004-5382,3474.015,3,1,2,0.33853450732658075
23080,703-004-5390,3264.2437,7,5,2,2.5174276461977696
23284,703-004-5390,4279.444,5,0,5,0.27920371738274696
23303,703-004-5390,4361.4644,8,4,4,1.1805565803175813
23339,703-004-5395,5232.547,9,8,1,2.5695717945310266
23496,703-004-5388,7218.7754,2,2,0,1.6727055109923836
23679,703-004-5385,1371.8772,2,1,1,0.35831143730785864
23821,703-004-5388,3318.1333,3,1,2,0.5947491417364431
23969,703-004-5387,2341.4802,2,0,2,0.27920371738274696
24051,703-004-5382,5781.24,5,2,3,0.5557993136928848
24092,703-004-5390,9040.456,8,3,5,3.0875943123923006
24111,703-004-5390,8239.194,6,1,5,1.0022019440840462
2415,703-004-5391,8226.844,6,2,4,0.6246199472184507
24338,207-008-2398,2824.999,4,3,1,1.4726188014000907
2436,703-004-5380,2496.3105,1,0,1,0.27920371738274696
24776,703-004-5396,8703.63,3,1,2,1.3114993314901313
25060,703-004-5393,2409.2341,7,2,5,1.7746038474942378
25117,703-004-5380,289.99567,3,1,2,0.4167972665019792
25146,703-004-5396,7480.7627,6,2,4,1.4313429195709997
25200,703-004-5392,5756.4326,4,3,1,0.9880023993428945
25285,207-008-2399,778.9123,3,1,2,0.535796156640508
2545,703-004-5380,2189.911,3,1,2,0.43696689880159406
25766,703-004-5391,4487.0776,2,1,1,0.3817161978825772
25780,703-004-5384,7362.8745,3,1,2,0.32666834933781397
25970,703-004-5393,1714.8721,4,2,2,1.8696449445845127
26410,703-004-5391,9630.204,5,2,3,0.7114209686639408
26837,703-004-5385,3831.381,1,0,1,0.27920371738274696
27046,703-004-5380,6075.205,8,6,2,2.4060058302002325
27133,703-004-5380,5230.9126,6,3,3,1.0312492417828845
27183,703-004-5394,9695.288,4,1,3,0.36807237761375045
27191,703-004-5399,9170.606,1,0,1,0.27920371738274696
27260,703-004-5380,337.9476,5,2,3,0.7197348248488741
27270,703-004-5384,4493.3423,4,0,4,0.27920371738274696
27358,703-004-5391,1721.7487,2,1,1,0.35831143730785864
27737,703-004-5392,4184.432,1,0,1,0.27920371738274696
27914,703-004-5388,6633.9897,3,2,1,1.2794297552813045
2812,703-004-5398,6581.4727,6,5,1,2.221035635214865
28349,703-004-5380,5442.5635,4,2,2,1.2550792908777482
29112,703-004-5390,2670.7583,4,1,3,0.6847516553752113
29424,703-004-5380,4139.205,7,4,3,1.1651947237372096
29700,207-008-2399,8604.015,5,2,3,0.5298260937129083
2988,703-004-5389,4012.186,7,3,4,1.8300575629674578
30017,703-004-5399,6643.0034,8,3,5,2.7523379313997327
30031,703-004-5393,7933.568,2,0,2,0.27920371738274696
30393,703-004-5398,5692.1367,2,1,1,0.418830456627198
30520,703-004-5397,931.3053,2,2,0,0.5323132213110562
30643,703-004-5387,2977.2454,3,3,0,1.1408346702872814
30929,703-004-5382,3496.585,3,2,1,1.1113646298181978
31077,207-008-2399,2229.3042,3,2,1,0.7427737200857772
31179,703-004-5387,9764.058,8,3,5,0.8444355496678098
3145,703-004-5393,8995.498,3,1,2,0.4884410594232229
31878,703-004-5384,8683.165,10,7,3,2.88612172987758
32144,703-004-5389,877.2826,5,3,2,0.6333969466996774
32159,703-004-5389,5206.8315,3,1,2,0.4249538252637286
32174,703-004-5380,6805.634,"","","",0.27920371738274696
32179,703-004-5396,9023.153,4,2,2,0.7674772691870118
32235,703-004-5393,943.38354,8,3,5,1.3673958040633105
32446,703-004-5392,3279.6997,4,2,2,0.6430992290382606
32724,703-004-5385,9491.309,5,3,2,1.4136336348234178
32891,703-004-5386,9858.664,1,1,0,0.3978652972704144
33351,207-008-2399,7031.6074,7,3,4,0.6635510290557115
33419,703-004-5395,2793.4153,6,1,5,1.3926641653121852
33445,703-004-5380,3086.8787,2,2,0,0.5769348034669673
33448,703-004-5387,6822.6494,2,2,0,0.9455218743785415
33528,703-004-5393,6274.0195,5,3,2,1.3546501487602154
33715,703-004-5395,3152.5486,4,3,1,0.9595251098416021
34092,703-004-5393,8335.679,1,0,1,0.27920371738274696
34119,703-004-5395,8874.807,4,2,2,0.9619932039615109
34260,703-004-5385,9663.374,5,4,1,2.260950321972955
34524,703-004-5390,6458.141,2,1,1,0.4591737802123759
34636,703-004-5386,7301.435,3,1,2,0.8651313448507114
34799,703-004-5390,2172.2031,3,2,1,0.732588056969231
35033,703-004-5394,2872.4253,4,2,2,0.7772369555438295
35359,703-004-5394,3421.1152,5,2,3,0.4518686767005415
3570,703-004-5384,2831.7468,3,2,1,2.144476229352395
36908,703-004-5396,6468.1055,3,0,3,0.27920371738274696
37038,703-004-5387,6671.2534,6,4,2,1.5184237151726916
37128,703-004-5386,2753.1255,3,1,2,2.5510786172453432
37179,703-004-5385,3008.147,4,2,2,0.7270991089630922
37387,703-004-5399,141.30176,5,2,3,0.8296312772356775
37480,703-004-5397,37.87756,4,1,3,0.44829646872267315
37614,703-004-5390,7151.645,3,1,2,0.5145386915253491
37630,207-008-2399,8956.999,5,2,3,1.0962147826167181
37800,703-004-5381,792.4193,2,0,2,0.27920371738274696
38018,703-004-5383,4747.2046,3,1,2,0.39829505709890495
38535,703-004-5397,2921.0823,1,1,0,0.32666834933781397
3863,703-004-5390,7936.007,4,2,2,1.0823721515948819
38728,703-004-5381,9647.953,5,3,2,0.8524051447899036
38903,703-004-5384,9728.8,1,0,1,0.27920371738274696
39005,703-004-5382,8721.544,5,3,2,1.8481781074463437
39183,207-008-2399,4917.4023,1,0,1,0.27920371738274696
39231,703-004-5391,6348.9897,1,1,0,1.2364918873222488
39492,207-008-2398,6976.9214,2,1,1,0.7375407535116681
39512,207-008-2398,5644.453,6,1,5,0.44544668978660146
39711,703-004-5385,2300.9944,4,3,1,2.6921877775618337
39745,703-004-5380,7147.3037,3,1,2,1.328632728058641
39796,703-004-5398,8141.964,4,0,4,0.27920371738274696
39817,703-004-5395,664.41473,3,2,1,1.0260515185476973
3983,703-004-5386,696.3885,6,4,2,1.7122467632693794
39868,703-004-5382,1852.5607,2,0,2,0.27920371738274696
3996,703-004-5386,6472.491,5,0,5,0.27920371738274696
39971,703-004-5394,1839.4774,1,1,0,0.35925857632168884
40427,703-004-5398,9186.203,2,1,1,0.3978652972704144
4066,703-004-5395,7117.68,5,0,5,0.27920371738274696
40927,703-004-5394,4964.459,4,1,3,0.4059736283681288
41098,703-004-5381,1443.6841,4,0,4,0.27920371738274696
41623,703-004-5392,954.09216,3,1,2,0.838949267679826
41628,703-004-5387,5155.438,3,2,1,0.6351884570457493
41647,703-004-5399,353.53363,3,1,2,0.35831143730785864
41827,703-004-5389,5493.035,3,1,2,0.6080164599379749
41919,703-004-5396,5548.946,3,3,0,0.887358809318528
41996,207-008-2398,5412.7896,8,5,3,2.5375384750789314
42001,703-004-5385,2189.864,7,4,3,1.3513745483123225
42027,703-004-5387,3240.366,6,3,3,2.6306216943163423
4205,703-004-5382,4725.5254,3,0,3,0.27920371738274696
42206,703-004-5393,4660.43,2,1,1,0.3978652972704144
42208,703-004-5388,8221.131,7,5,2,3.3238040921257483
42852,703-004-5399,4324.5425,8,1,7,0.36951836429724944
43105,703-004-5388,4060.198,1,0,1,0.27920371738274696
43378,703-004-5398,7905.22,4,2,2,0.8413276679644838
43398,703-004-5389,6563.825,4,1,3,0.32666834933781397
43506,703-004-5381,1597.913,5,2,3,1.2659752073287318
43593,703-004-5384,7418.9844,2,1,1,0.6075239895277534
43762,703-004-5384,350.95334,3,2,1,1.0360755009118265
44075,703-004-5383,2859.2021,5,4,1,2.298027837605024
44246,703-004-5390,1308.5109,4,2,2,0.5711952558588294
44441,703-004-5388,5163.706,2,1,1,0.6585738801287696
44560,703-004-5391,5572.113,7,4,3,1.7235450700438355
45069,703-004-5398,3838.163,4,3,1,0.7611860007909464
45194,703-004-5398,4104.881,3,2,1,0.9113080016260358
45415,703-004-5393,5508.0796,4,2,2,0.9643954996093085
45508,703-004-5382,7084.77,1,0,1,0.27920371738274696
46573,703-004-5398,9409.351,3,2,1,0.5746022102904741
47051,703-004-5392,9373.232,6,3,3,1.6704132102875369
4730,703-004-5395,85.39736,2,2,0,1.066968516087546
47499,207-008-2398,4171.25,3,1,2,0.4370627947203106
483,703-004-5388,42.71269,5,4,1,2.5560988538769287
48533,703-004-5390,6000.713,2,0,2,0.27920371738274696
48678,703-004-5386,4377.49,2,0,2,0.27920371738274696
48708,703-004-5382,3091.7673,3,2,1,0.8556882168936496
48844,703-004-5384,3576.8997,2,1,1,0.5531050507933297
48889,703-004-5389,6069.4814,5,5,0,1.9906431391615853
48981,703-004-5394,4467.5356,7,4,3,1.7647949047333555
49360,703-004-5381,42.098763,3,2,1,0.858324575438511
49361,703-004-5394,2154.0076,5,2,3,0.862344011333524
49559,703-004-5398,3460.2458,4,2,2,0.8155532550372234
5041,207-008-2399,1913.9939,5,3,2,0.6820310731773027
5096,207-008-2399,6027.6978,4,1,3,0.3418245973982661
5179,207-008-2398,5662.239,3,1,2,0.3978652972704144
5352,207-008-2399,5786.611,1,0,1,0.27920371738274696
5377,703-004-5385,8548.778,6,4,2,2.164587608576462
5497,703-004-5393,3484.8303,4,3,1,1.5799776124129397
5799,703-004-5389,2568.1816,2,1,1,0.6091010708724759
5859,703-004-5382,971.9706,3,2,1,1.4993862715192599
5904,703-004-5382,543.471,2,0,2,0.27920371738274696
635,703-004-5393,7947.0166,4,2,2,1.2258647593820722
6423,703-004-5399,1828.5227,4,2,2,2.149278493466621
6609,703-004-5399,7262.735,"","","",0.27920371738274696
6875,703-004-5399,7817.2026,7,5,2,1.59739162957612
6952,703-004-5383,9400.756,6,1,5,1.4659160028289
7791,703-004-5380,8511.559,3,2,1,0.8486227396245947
8089,703-004-5385,7273.7197,4,0,4,0.27920371738274696
8173,703-004-5394,360.48175,4,2,2,0.5973168488381465
8229,207-008-2399,3048.8901,3,2,1,0.6713614259121
8424,703-004-5390,6174.5522,2,1,1,0.59064408685624
8432,703-004-5387,163.36679,5,4,1,1.3365052899390204
851,207-008-2398,8426.915,4,3,1,2.2755123105413717
8547,703-004-5386,9870.018,8,3,5,1.0304716046590494
862,703-004-5391,7794.457,3,1,2,0.32666834933781397
8662,703-004-5383,3691.9968,3,2,1,0.5794451520173198
886,703-004-5392,15.502572,3,2,1,0.591092336195887
8975,703-004-5389,6303.492,4,2,2,0.7616818942066068
9016,703-004-5391,7152.2397,4,2,2,0.8294687921207874
940,703-004-5397,944.37006,8,6,2,2.580919241435987
9472,703-004-5392,3740.8376,3,0,3,0.27920371738274696
9618,703-004-5396,1057.8478,5,3,2,1.4713107781151527
10029,703-004-5395,2351.3406,4,2,2,0.9559960094552024
10265,703-004-5394,5191.372,6,2,4,0.7123555933076424
10444,703-004-5386,1676.1327,3,1,2,0.6132440314373474
10535,703-004-5382,8070.1343,5,3,2,0.6683357694085964
10663,703-004-5390,6314.578,4,1,3,0.5836090467645129
10812,703-004-5381,1350.3873,3,1,2,1.022463026408675
10930,703-004-5380,8604.066,1,0,1,0.27920371738274696
11008,703-004-5399,6849.395,3,1,2,0.3919322182760311
11188,703-004-5382,4367.377,6,2,4,1.1767740074810218
11227,703-004-5392,7393.8735,6,1,5,0.9355314634876956
11316,703-004-5382,9523.879,4,2,2,2.187846025462794
11328,703-004-5394,7680.847,6,2,4,1.0162581420333259
11348,703-004-5387,6109.4214,1,0,1,0.27920371738274696
11529,207-008-2399,355.20853,3,3,0,1.5742583816239815
11808,207-008-2399,9427.255,3,2,1,0.8410543796377946
12232,703-004-5394,7611.3857,2,1,1,0.6755119256437427
13038,703-004-5387,8189.8193,5,5,0,1.037737404433568
13257,703-004-5381,5031.985,7,4,3,2.338502361679422
13542,703-004-5393,7626.1455,3,1,2,0.9497501829186361
13781,703-004-5382,920.2671,1,0,1,0.27920371738274696
13802,703-004-5380,5928.4717,4,2,2,2.131629452374489
14044,703-004-5388,3107.1848,3,1,2,0.4272661755152368
14542,703-004-5397,8728.59,7,5,2,2.113545438546278
14553,703-004-5390,5018.4814,2,0,2,0.27920371738274696
14568,703-004-5383,2641.8865,5,2,3,0.9742790554012013
14753,703-004-5397,4239.9805,7,2,5,0.5580025647793272
15067,703-004-5386,428.76422,3,1,2,0.7430195687909432
15128,703-004-5395,9407.837,5,3,2,0.9789456792278045
15303,703-004-5389,6605.345,4,3,1,1.2023683330906736
15516,703-004-5399,4630.552,3,2,1,1.1884381995778315
15987,703-004-5392,1400.8451,1,0,1,0.27920371738274696
16015,703-004-5386,5674.873,4,4,0,2.1918282967801175
16181,703-004-5394,1718.7595,7,5,2,2.7600329810467685
16427,207-008-2399,4186.458,4,1,3,0.361814271523527
16601,703-004-5387,5926.5684,5,1,4,0.8380126094968544
16701,703-004-5390,8822.636,5,1,4,0.6674001317527557
16816,703-004-5399,2785.0234,6,2,4,1.171121216015066
16847,703-004-5390,8671.823,3,1,2,0.8691503122063057
16882,703-004-5383,6570.75,6,4,2,1.3950824697313233
17234,703-004-5392,1993.2085,3,2,1,0.5592711145816559
1732,703-004-5399,2959.0613,2,1,1,0.9933817248655135
17324,703-004-5382,7741.663,3,1,2,0.5805488957404679
17399,703-004-5391,8805.269,3,1,2,1.317389996902321
17486,703-004-5383,7496.6006,5,3,2,2.6158350119076292
17688,703-004-5398,620.1279,5,2,3,1.3715292429201233
17840,703-004-5381,6824.3496,2,0,2,0.27920371738274696
17934,703-004-5390,770.89606,5,2,3,0.7372526185935577
18023,703-004-5383,7475.0776,7,4,3,2.3602042566478127
18075,703-004-5394,9330.476,6,5,1,2.2737762383457243
18322,207-008-2399,7045.9443,3,3,0,0.7572018807991405
18373,703-004-5390,1484.4906,6,2,4,0.8084058501957888
18505,703-004-5399,1392.299,4,3,1,1.0031467962340372
18940,703-004-5398,5804.644,2,2,0,0.7490476341413494
19060,703-004-5394,6837.463,3,1,2,0.9394243959662487
19069,207-008-2398,1993.0297,6,4,2,1.108220754608233
19241,703-004-5381,9440.534,7,1,6,0.7901744401806643
19593,703-004-5389,144.62471,4,0,4,0.27920371738274696
20018,703-004-5393,9753.305,2,1,1,1.0091588319306013
20109,703-004-5381,5064.1973,3,1,2,0.5469770511856413
20215,703-004-5381,8462.463,5,3,2,3.0447227654608273
20331,703-004-5397,8041.364,2,1,1,1.347424634375524
20422,703-004-5390,8070.9795,10,5,5,1.7308978191494209
20517,703-004-5383,5563.4546,5,1,4,0.38773342300523805
20525,703-004-5392,2751.1,4,2,2,1.5927570418540793
20658,703-004-5393,4798.8936,7,5,2,4.185984562253538
20688,703-004-5396,2638.731,4,0,4,0.27920371738274696
20862,703-004-5382,6133.6016,3,2,1,1.199491535415312
20886,703-004-5380,5172.245,2,2,0,1.391020418252506
21134,703-004-5381,6982.343,4,2,2,0.7265129800805041
21583,703-004-5389,217.0968,2,1,1,0.4443079868409651
21698,703-004-5388,7781.0986,2,2,0,2.0360413638496455
21855,703-004-5382,982.93243,2,2,0,0.6351884570457493
21956,703-004-5385,3534.7783,1,0,1,0.27920371738274696
2222,703-004-5380,3515.582,5,3,2,0.6260623300408317
22310,703-004-5399,1730.4373,1,1,0,0.5650233743662004
22325,703-004-5393,2501.5598,5,4,1,0.6605834597264799
22443,207-008-2399,8059.2256,4,2,2,0.9428979258322281
22753,703-004-5382,2051.8357,3,0,3,0.27920371738274696
22925,703-004-5395,3552.1204,9,5,4,1.3646711612334463
2299,207-008-2399,8322.96,5,1,4,0.38402211285361443
23348,703-004-5391,58.318375,5,2,3,0.8299947727885728
23735,703-004-5389,7051.1226,5,1,4,0.5385947315758616
24286,703-004-5387,6776.501,8,3,5,0.8527325172146109
2439,703-004-5395,9513.964,2,1,1,0.5891093160625285
24393,703-004-5395,7199.535,10,6,4,1.200482294862498
24725,703-004-5397,7596.3794,2,2,0,0.9555747227424516
24921,703-004-5382,6387.3345,7,3,4,1.511352912025197
25009,703-004-5382,7067.398,3,1,2,0.5331419299760946
25150,703-004-5395,9493.749,3,3,0,1.5559219740588877
25246,703-004-5390,984.5084,3,2,1,0.653749764082302
25269,703-004-5382,1035.2391,1,0,1,0.27920371738274696
25562,703-004-5389,7560.292,4,2,2,1.4115841229478887
25611,703-004-5393,3260.6023,4,2,2,0.8529820654952239
2617,703-004-5395,2550.1108,6,1,5,0.5017838963581265
26218,703-004-5398,8723.549,3,1,2,0.32666834933781397
26219,703-004-5396,94.992516,8,4,4,2.5435879574119724
26259,703-004-5399,554.8173,6,2,4,0.544214579131871
26386,703-004-5381,3400.554,3,1,2,0.687333582553674
26406,703-004-5394,2400.1921,3,2,1,0.37808836728913653
266,703-004-5390,2842.843,3,3,0,1.3937870895750306
2664,703-004-5390,8426.686,3,2,1,0.4961368623473843
26963,703-004-5392,2214.2397,2,0,2,0.27920371738274696
27465,703-004-5388,2929.641,7,5,2,0.7990179730492363
27942,703-004-5397,7482.2373,1,1,0,0.8055168007284614
28821,207-008-2399,9653.494,3,1,2,0.9851842284457366
28846,207-008-2398,1770.8558,5,2,3,0.5645415424477548
28939,703-004-5395,5103.52,1,1,0,1.3996107036183512
28996,703-004-5389,880.0155,2,1,1,0.6001495949957997
29126,703-004-5398,7480.436,6,4,2,1.0057341549519303
2945,703-004-5381,6677.7046,3,0,3,0.27920371738274696
29561,703-004-5384,2741.5215,5,5,0,2.3189514611731146
29642,703-004-5398,5411.332,4,2,2,0.8258403654217062
29687,703-004-5387,8354.674,3,2,1,0.6564565366781034
29818,703-004-5394,6650.423,4,2,2,1.735020174167816
29961,703-004-5382,354.29715,4,3,1,1.2456089108928752
3016,703-004-5383,9335.718,2,0,2,0.27920371738274696
30164,703-004-5390,3307.172,1,1,0,0.816959024094893
30293,703-004-5381,4384.387,3,2,1,0.4523833713033042
30826,207-008-2398,2029.1215,2,2,0,1.9499163458848514
31236,703-004-5385,8412.517,3,3,0,1.4247716269668402
3127,703-004-5397,7068.306,1,1,0,0.32666834933781397
31717,703-004-5392,2535.0576,3,2,1,0.6901947519101569
31721,703-004-5384,3317.8198,8,4,4,1.3389280225512927
31771,207-008-2398,8572.929,5,1,4,0.3978652972704144
31825,703-004-5396,6840.207,4,1,3,0.3805604835367963
31919,207-008-2398,1812.1559,1,0,1,0.27920371738274696
32053,703-004-5382,689.4976,2,1,1,0.7294925505381149
32760,703-004-5381,7932.8228,7,4,3,1.393316981396604
33096,703-004-5384,928.73334,3,0,3,0.27920371738274696
33343,703-004-5396,2231.872,6,5,1,1.9636224030757006
33582,703-004-5381,6173.3647,3,2,1,1.4214020588815477
33917,703-004-5381,4188.894,6,2,4,1.1286235762255692
33942,703-004-5387,259.55914,5,4,1,1.0759021858244557
33971,703-004-5389,6135.545,5,2,3,1.0303776401178706
33992,703-004-5391,8706.525,5,1,4,0.3978652972704144
3407,703-004-5390,5411.4062,4,3,1,1.1146279940649142
34199,207-008-2398,5501.4907,5,3,2,0.9842893285260309
34583,703-004-5382,1074.8959,4,1,3,0.5402791340788808
34856,703-004-5387,7609.1646,5,3,2,1.620908642214895
35027,703-004-5397,824.1129,7,2,5,0.5775544171823304
35288,703-004-5390,3338.0078,4,3,1,1.0960734356699031
35731,703-004-5393,4485.0195,3,1,2,0.5536526828317228
35774,703-004-5383,2812.6633,2,0,2,0.27920371738274696
36261,703-004-5385,5218.7607,5,4,1,1.78997608348447
36294,703-004-5396,7941.22,2,1,1,0.5384472623988829
36634,703-004-5399,2631.7144,1,1,0,0.7546557322866368
36737,703-004-5386,3863.4348,4,1,3,0.40358742234499756
36765,703-004-5381,7325.528,4,2,2,1.1119911518161685
36796,703-004-5398,8645.123,4,1,3,0.42761998956457375
36934,703-004-5388,7437.9487,2,0,2,0.27920371738274696
37211,703-004-5393,1897.7451,11,6,5,2.146376478848045
37378,703-004-5385,593.93646,2,1,1,0.37163321607306865
37431,703-004-5382,7352.965,8,6,2,2.766413484482842
37445,703-004-5388,8863.981,6,2,4,0.49410752958763876
37570,703-004-5398,9423.349,3,3,0,0.6433186957537975
37636,703-004-5397,9976.114,3,1,2,0.7233646353515998
38110,703-004-5386,4850.1685,6,4,2,2.304804638158083
38469,703-004-5388,9246.504,6,5,1,1.0552468203539311
38486,703-004-5394,2523.2773,1,1,0,0.8160448651700433
38495,703-004-5393,1500.8843,7,4,3,1.684598586420722
38828,703-004-5392,4874.986,4,3,1,1.2700891688301525
38893,703-004-5395,5459.5977,6,1,5,0.9131974786155156
38995,207-008-2398,5365.268,2,1,1,0.8337409802590338
39066,207-008-2398,7035.889,4,2,2,1.2610826925263912
39401,703-004-5393,5128.452,8,3,5,0.6848627478100987
39634,703-004-5395,3793.4924,3,1,2,0.4514769785137747
39862,703-004-5399,7787.568,3,1,2,0.5802993201996501
39928,703-004-5380,202.02875,4,1,3,0.5675400090242141
39996,703-004-5390,8500.06,6,2,4,0.8359114980466363
40127,703-004-5383,9926.439,5,4,1,0.7844712511966558
40226,703-004-5380,276.02435,4,1,3,0.34104123320170765
4038,703-004-5392,2116.1216,7,4,3,1.4387299425091524
40463,703-004-5381,9433.479,3,1,2,0.3338475952168463
40574,207-008-2398,9626.203,2,1,1,0.5254357127536745
41117,703-004-5393,4986.961,4,2,2,1.255350716309487
41818,703-004-5385,1215.9419,4,0,4,0.27920371738274696
42032,703-004-5390,8614.041,3,0,3,0.27920371738274696
42372,703-004-5388,2185.359,3,2,1,0.4158623035533773
42682,207-008-2398,176.32365,1,0,1,0.27920371738274696
42739,703-004-5384,2020.2815,6,3,3,1.069590484617555
43269,703-004-5387,6019.1543,3,0,3,0.27920371738274696
43286,703-004-5396,4687.157,2,2,0,0.6794703366013324
43342,703-004-5383,5904.507,5,3,2,1.0505327120805432
43687,207-008-2399,2037.4811,2,1,1,0.4877167025616555
43810,703-004-5386,7659.628,3,2,1,1.2997100849408076
43902,703-004-5383,7958.523,4,2,2,0.4565830023848286
44155,703-004-5393,4834.9736,2,1,1,0.5472209452468116
44184,703-004-5395,7471.581,4,3,1,1.3421175246948052
44391,703-004-5382,9035.284,2,2,0,0.5276909607542533
4473,703-004-5385,8137.921,6,4,2,1.5216335460085624
45096,207-008-2399,8259.635,"","","",0.27920371738274696
45192,703-004-5380,1030.5697,2,2,0,2.1586757881901115
45610,703-004-5399,4505.8604,4,1,3,0.35831143730785864
45708,703-004-5399,2452.2756,3,2,1,1.388176750197512
45948,703-004-5381,1073.2865,4,1,3,0.7584273194779403
46258,703-004-5383,2922.0598,4,0,4,0.27920371738274696
46635,703-004-5381,5174.3696,3,2,1,0.9806033300256615
4684,703-004-5384,7186.488,6,1,5,0.4168273559335575
47536,703-004-5391,3438.105,2,2,0,1.315908622770922
47999,703-004-5399,9939.181,5,2,3,0.652355933590849
48401,703-004-5387,411.48007,2,1,1,0.4420130632859122
48882,703-004-5387,4635.0195,1,1,0,0.5623313684921459
48910,207-008-2398,6852.609,3,1,2,0.7361455102464801
48964,703-004-5393,8129.1865,4,3,1,1.8600877327810774
49320,703-004-5395,2920.7349,1,0,1,0.27920371738274696
49534,703-004-5385,5362.846,4,2,2,0.6736995074781628
49587,703-004-5398,136.33609,3,2,1,0.4716245936937143
49664,703-004-5396,637.18976,9,3,6,1.2367741568654034
497,703-004-5394,7715.0176,2,2,0,0.5177703008643959
49720,703-004-5390,619.47406,4,1,3,0.35831143730785864
49751,703-004-5385,3535.446,3,0,3,0.27920371738274696
49762,703-004-5396,9451.113,5,2,3,0.7813159668580826
5431,703-004-5386,6156.8213,1,0,1,0.27920371738274696
5635,703-004-5387,9939.902,4,2,2,0.9792487675616617
5689,703-004-5389,2028.0754,3,1,2,0.6426481407570079
6077,703-004-5389,3958.8904,7,3,4,1.3036378646084086
6231,703-004-5381,6379.2183,6,0,6,0.27920371738274696
6273,703-004-5389,4796.283,6,2,4,0.9813170780411573
6765,703-004-5390,8609.815,3,1,2,0.8717405046111686
6968,703-004-5395,8647.56,3,2,1,0.83571967097103
6975,703-004-5390,8770.479,3,0,3,0.27920371738274696
7030,703-004-5383,7133.146,2,2,0,0.5936745063538571
7049,703-004-5397,4590.7476,5,4,1,1.4154000036763814
7088,703-004-5384,9758.271,3,2,1,1.4311866921688592
8115,703-004-5386,4764.833,7,5,2,1.605670846523744
8554,703-004-5388,3649.139,6,3,3,0.6486653337705895
9085,703-004-5399,4570.287,1,0,1,0.27920371738274696
922,703-004-5382,5952.4453,2,2,0,0.7096625819350948
9334,703-004-5391,3515.901,4,2,2,1.2109240575872144
9579,703-004-5395,3843.5918,1,1,0,0.35831143730785864
9999,703-004-5398,2087.9382,2,1,1,0.35114230018964543
1011,703-004-5399,611.5574,2,2,0,0.8575017510040436
10141,703-004-5386,2320.5554,4,3,1,0.7768644397466564
10159,703-004-5387,3566.0708,"","","",0.27920371738274696
10525,703-004-5385,3540.4158,5,1,4,0.433727463636465
10644,703-004-5397,2998.4211,4,2,2,1.1752036040151186
10672,703-004-5385,3099.4607,7,6,1,1.6737605330806824
10951,703-004-5397,3355.1616,5,3,2,0.733525424687551
10999,703-004-5397,8100.997,3,1,2,0.8214098741101218
11244,703-004-5397,5437.4634,2,2,0,0.48347170640162673
11407,703-004-5383,1855.2161,2,1,1,0.6013878708404703
11790,703-004-5381,6003.143,4,3,1,4.1698752995552395
1194,703-004-5384,514.72125,4,1,3,0.9650843757789284
11951,703-004-5393,2276.6597,4,1,3,0.590246809916491
12099,703-004-5396,4046.1821,"","","",0.27920371738274696
12237,703-004-5388,9536.215,3,1,2,0.3978652972704144
12366,703-004-5381,9302.586,"","","",0.27920371738274696
12396,703-004-5384,1870.3705,8,3,5,1.1815236802123839
12505,703-004-5398,2456.7627,3,2,1,0.8590255759359856
12581,703-004-5386,1085.0721,2,2,0,1.5849644438386925
12726,703-004-5397,397.08316,3,3,0,0.86393799830812
13719,703-004-5397,9647.934,3,2,1,0.5355083820484332
13819,703-004-5383,4654.451,4,1,3,0.3131070259220805
14078,703-004-5384,3620.4421,4,3,1,1.0031809259786644
14119,207-008-2399,3673.9285,3,0,3,0.27920371738274696
14177,703-004-5395,5402.291,5,2,3,1.346478403297584
14216,703-004-5386,9893.251,6,1,5,1.6039336298135267
14467,703-004-5389,6219.04,4,3,1,0.8098461284499315
14658,703-004-5394,4821.029,4,2,2,0.7428873951604559
14749,703-004-5384,8956.252,2,0,2,0.27920371738274696
15068,703-004-5392,1454.811,8,5,3,1.3120042996230077
15149,703-004-5398,4823.5933,"","","",0.27920371738274696
15371,703-004-5398,5701.233,3,1,2,0.4450071287583398
15464,703-004-5390,1143.486,7,5,2,2.087896992181986
15499,703-004-5384,9647.554,8,6,2,2.0224260132845746
15909,703-004-5392,3023.575,5,3,2,1.7711033410225645
16054,703-004-5384,4560.2397,8,2,6,1.0637322818394503
16102,703-004-5391,2470.948,2,1,1,0.7435770636543415
16487,207-008-2398,3776.5444,4,3,1,2.4728962990369094
16644,703-004-5392,5067.927,2,1,1,0.832927982991268
16761,703-004-5383,3783.8364,3,1,2,0.47382472161155614
17116,703-004-5381,3057.7295,1,1,0,0.5635516157347553
17156,703-004-5387,8520.485,3,2,1,1.4254073867833392
17158,703-004-5391,6566.8374,3,2,1,0.4587496682474539
17767,703-004-5384,1164.6688,4,3,1,1.4920934730715387
1787,703-004-5384,7348.092,4,0,4,0.27920371738274696
17942,703-004-5385,1750.241,6,4,2,1.2172626251091205
1818,703-004-5388,7230.1606,1,1,0,0.8185059215498508
18213,703-004-5396,8587.764,6,2,4,0.7423853694216539
1826,703-004-5397,1503.334,1,0,1,0.27920371738274696
18430,207-008-2399,9237.564,6,1,5,0.9377330510539721
18490,703-004-5399,5544.217,8,3,5,1.4483722067352574
18559,703-004-5396,8221.456,7,6,1,1.7357759936928279
18762,703-004-5389,5208.0464,4,3,1,0.9170889885034421
18806,703-004-5395,5419.9624,6,3,3,1.3933736637828205
18855,703-004-5397,8770.784,3,1,2,0.7703017356855358
18879,703-004-5389,5057.626,1,1,0,1.0227117686745957
19238,703-004-5388,7940.627,7,2,5,1.000137643787557
19247,703-004-5385,6969.5884,5,1,4,0.4561759272427139
19248,703-004-5381,19.376873,9,7,2,6.502832359607307
19362,703-004-5390,3376.0278,6,3,3,0.6623807873743679
1960,703-004-5397,5419.6636,4,1,3,0.5972627951306951
19617,703-004-5388,4601.1353,6,5,1,2.1996194572387395
19696,703-004-5385,5455.3867,7,4,3,1.1354490542946902
19803,207-008-2399,5279.23,4,1,3,0.9508217179004795
20011,703-004-5394,3525.2446,5,3,2,0.9547005624126383
20044,703-004-5389,1720.9691,2,2,0,0.6172800355120218
20342,703-004-5397,2441.0957,5,5,0,1.5049504014411308
20543,703-004-5384,875.19586,5,3,2,1.2266146047413446
20670,703-004-5383,2444.2434,3,1,2,0.4314860782385869
20781,703-004-5384,7603.7007,4,2,2,1.2915663171815936
21120,703-004-5380,2976.3389,4,1,3,0.48056640860513716
21263,703-004-5387,7140.344,4,1,3,1.2492504687525745
21337,703-004-5386,8354.564,3,0,3,0.27920371738274696
2147,703-004-5384,9798.028,3,1,2,0.4004620252831178
21796,703-004-5382,8361.951,4,2,2,1.0770606718886788
2184,207-008-2399,7065.17,7,2,5,1.5887383869092653
22072,703-004-5396,3338.8757,6,2,4,0.7039856662419262
22109,703-004-5391,441.0386,6,3,3,1.1149136632986807
22142,703-004-5389,8628.118,4,2,2,1.159818579437814
22273,703-004-5384,7178.9346,3,1,2,0.5045559270569014
22329,703-004-5393,6346.0,5,4,1,1.0991956958302402
22695,703-004-5396,5284.1055,2,1,1,0.5099858179690837
22871,703-004-5385,4684.9727,7,5,2,3.173306915204132
23248,703-004-5397,1592.9384,6,1,5,0.7583451710247853
23534,703-004-5396,613.2436,4,2,2,0.9220307712773055
24,703-004-5391,6370.2637,5,2,3,0.7826056112073148
24185,703-004-5386,8990.528,5,2,3,0.8653312640127859
24231,703-004-5390,5239.636,4,1,3,0.49233655971430207
24251,703-004-5387,5320.296,5,3,2,2.992936962811074
24482,703-004-5399,392.85123,7,5,2,3.1956923743604455
25041,703-004-5396,2235.2456,5,3,2,1.9920940948714785
2563,703-004-5395,6074.4473,6,4,2,0.5837684390944267
25678,703-004-5381,8689.942,3,3,0,2.0098799092016804
25873,703-004-5397,7387.724,4,2,2,1.4708561064222223
26043,703-004-5395,2655.8745,7,4,3,2.5498921395991507
26190,207-008-2399,2804.349,4,2,2,0.6256236195785142
26352,703-004-5399,4590.741,8,3,5,1.0595894876365906
26822,703-004-5391,4223.088,4,3,1,1.4603915303774344
27078,703-004-5397,652.74,1,1,0,0.7340056555169588
27112,703-004-5387,9466.241,7,3,4,2.6174065112560343
27164,703-004-5381,7632.972,4,2,2,1.3651125217420037
27414,703-004-5380,6469.396,4,2,2,0.41764222725169237
28169,703-004-5389,275.0939,4,1,3,0.5165268771580819
28850,703-004-5384,7342.443,4,2,2,0.9309519372841142
28906,703-004-5389,695.5469,5,1,4,0.5837684390944268
28913,703-004-5387,4919.1694,3,1,2,0.33816665642892896
28990,703-004-5388,8149.9023,7,3,4,2.9704912311082645
29049,207-008-2398,5070.29,2,2,0,0.47697301719552604
29398,703-004-5383,9613.875,1,1,0,0.9250567230004203
29784,703-004-5397,30.130745,5,3,2,1.8479565878519724
30066,703-004-5383,7403.6147,6,5,1,1.5298789439625924
30258,703-004-5380,7145.862,2,2,0,0.7440167825389756
30395,703-004-5380,4681.7046,3,2,1,1.3540344813538814
31102,703-004-5390,8475.335,3,3,0,0.9677033259645119
31233,703-004-5399,6212.874,1,1,0,1.5066024618296905
313,207-008-2398,7955.0522,3,1,2,0.44909815383402596
31302,703-004-5387,7012.465,5,4,1,1.278496171658931
31379,703-004-5390,9266.272,2,1,1,1.3925832018787285
31492,703-004-5388,2900.1511,4,4,0,0.9209187519823706
31659,703-004-5399,4414.6196,2,2,0,0.8123705538876447
32180,703-004-5381,6802.9478,5,4,1,3.314612202551473
32395,703-004-5387,2759.8286,2,1,1,0.8084196957920079
32443,703-004-5395,685.14404,4,2,2,1.181487237189563
32736,703-004-5398,2630.3328,5,2,3,2.5795136081885293
32775,207-008-2398,7881.9536,4,2,2,0.8405063638207575
32924,703-004-5399,1768.9229,5,2,3,0.7210453168085253
32932,703-004-5391,7505.147,6,3,3,1.6812458566394899
33023,207-008-2399,9201.757,4,4,0,1.3014366538990625
33088,207-008-2399,2429.4048,1,0,1,0.27920371738274696
33290,703-004-5385,5690.4375,4,3,1,1.204173696664033
33319,207-008-2399,2485.2432,4,1,3,0.4855327595142803
33350,703-004-5391,4111.3867,5,2,3,0.7049913464758111
33352,703-004-5392,6148.625,4,2,2,0.8073124897148806
336,703-004-5391,8492.779,2,2,0,0.9873150029781865
34368,703-004-5394,3391.9055,3,2,1,0.5815523242181914
34458,207-008-2398,8163.6284,4,0,4,0.27920371738274696
34548,703-004-5387,5721.236,3,2,1,0.5933352869762518
34598,703-004-5390,7157.5586,6,5,1,1.260402072762436
3486,703-004-5394,1628.7554,3,1,2,0.4906398104938338
35321,703-004-5382,1722.0432,1,0,1,0.27920371738274696
35334,703-004-5381,5056.784,1,1,0,0.350347746576921
35449,703-004-5393,7912.084,2,1,1,0.3558791134793793
35585,703-004-5382,7432.254,3,2,1,0.7467980488462957
35880,703-004-5392,2232.8616,8,3,5,1.2374433153346036
36272,703-004-5382,3995.4668,4,1,3,0.7586792694549234
36368,703-004-5399,4215.5684,4,2,2,0.8388207213110266
3703,703-004-5394,8260.852,3,2,1,1.0386306745044807
37665,703-004-5384,8898.775,5,3,2,0.8695054205661024
37873,703-004-5387,1172.9103,3,0,3,0.27920371738274696
38078,703-004-5390,5165.0684,3,2,1,0.7145526893084021
38126,703-004-5390,8818.1045,2,0,2,0.27920371738274696
38397,703-004-5393,5507.01,2,1,1,0.9624911362198127
38569,703-004-5386,1785.1489,4,3,1,1.5472852934212007
39129,703-004-5392,8818.152,5,1,4,0.3898348227132271
39226,703-004-5387,7765.544,7,2,5,0.9035168987992327
39339,703-004-5396,1633.8832,4,3,1,0.838599694684676
39607,703-004-5382,7590.8496,2,2,0,0.7948601662118199
39717,703-004-5398,3986.643,5,5,0,2.699155299011062
39881,703-004-5380,6270.0977,3,1,2,0.36832524920175286
39968,703-004-5380,6938.6685,2,2,0,0.9098140977183088
40034,703-004-5392,5566.1685,6,2,4,0.9936530359098722
40861,703-004-5383,9748.702,9,4,5,1.4052313605342257
40959,703-004-5387,4943.9443,6,4,2,2.266141980272552
41006,703-004-5392,9795.422,2,0,2,0.27920371738274696
41129,703-004-5394,2849.7964,3,1,2,0.5312473955023133
41200,703-004-5388,5440.101,2,0,2,0.27920371738274696
41336,703-004-5392,123.4591,3,3,0,1.0872348733753048
42479,207-008-2399,6007.6475,3,2,1,0.5841486297435176
42738,703-004-5386,4929.195,5,1,4,0.5165268771580819
42935,703-004-5399,5655.172,4,3,1,2.1525395390482283
4326,703-004-5387,8803.072,1,1,0,0.5165268771580819
43377,703-004-5386,7779.0854,4,2,2,0.4433584165179728
43422,703-004-5391,4076.187,2,1,1,0.3978652972704144
43745,703-004-5389,7642.766,6,3,3,0.8217873835066614
43791,703-004-5396,7495.513,7,3,4,2.1602983074747835
43830,703-004-5392,1181.5166,2,1,1,0.6409312460135775
43866,703-004-5391,6728.0996,2,2,0,0.8074919826676515
43899,703-004-5399,1225.3279,6,4,2,2.0563869661437724
43966,703-004-5385,9661.196,4,2,2,1.4561327736718304
44007,703-004-5391,1719.0236,3,1,2,0.3978652972704144
44326,703-004-5395,8287.229,5,3,2,1.147114696822882
44345,703-004-5398,9489.051,3,1,2,0.33853450732658075
44366,703-004-5382,9385.552,4,1,3,0.37305184245390444
444,703-004-5388,9093.0,6,3,3,0.8064623598538175
4453,703-004-5386,9024.757,4,2,2,0.7990636473101255
44662,703-004-5396,3958.3433,5,2,3,1.076141470772961
4485,703-004-5381,9550.914,1,1,0,0.4071856418140655
44990,207-008-2399,118.47496,6,2,4,0.47445540271652653
4524,703-004-5387,2730.9597,3,1,2,2.4948417324043697
45368,703-004-5395,184.15808,4,2,2,0.7421223174545188
45611,703-004-5382,4879.6655,5,4,1,1.3605572112297597
45818,703-004-5385,9803.913,4,1,3,0.4156348688585927
46119,703-004-5391,1757.5944,3,2,1,1.3760924367297114
46165,207-008-2399,8139.186,4,3,1,0.6087684356827914
46215,703-004-5388,2554.6099,5,3,2,1.4991200838145848
46292,703-004-5391,9660.978,1,0,1,0.27920371738274696
46410,703-004-5389,1526.702,3,2,1,0.7098409548161889
465,703-004-5383,9541.123,4,2,2,0.4461210064247325
46502,703-004-5397,6592.644,4,3,1,1.384774044334197
4658,703-004-5387,8733.463,5,1,4,0.4049039066507512
47503,207-008-2398,576.604,3,2,1,0.6291016984187187
47510,703-004-5392,9748.6,4,1,3,1.380442015184897
47811,703-004-5386,855.0125,2,0,2,0.27920371738274696
47894,703-004-5381,4033.084,7,5,2,2.244667633054717
47921,703-004-5387,8912.479,4,0,4,0.27920371738274696
48119,703-004-5387,400.05923,5,3,2,0.9361936036441817
4813,703-004-5389,8123.426,6,3,3,0.9749775687151631
48293,703-004-5386,9049.973,4,4,0,2.364306773376372
49025,703-004-5397,7273.79,4,1,3,0.5637277520015664
49112,703-004-5387,2422.104,1,0,1,0.27920371738274696
49125,207-008-2398,1038.0178,7,3,4,0.903388297493527
49324,703-004-5394,1684.4159,4,2,2,0.5477644573763828
49403,207-008-2399,7366.9517,4,1,3,0.39905191306929116
49407,703-004-5386,7963.644,7,4,3,1.9070880273730415
49424,703-004-5388,6804.553,7,4,3,2.3095063309930874
49612,703-004-5393,303.11285,1,0,1,0.27920371738274696
49709,703-004-5384,7813.11,4,1,3,0.6059430421603113
49767,703-004-5381,530.49207,6,3,3,1.7935448619402323
49826,207-008-2398,5324.565,3,1,2,0.4353281777068632
49849,703-004-5395,3841.8071,4,3,1,1.4168081121005351
5103,703-004-5394,5838.1396,4,2,2,0.5267101020938176
5123,207-008-2398,3034.1072,7,4,3,1.2604725578266351
5486,703-004-5385,4156.175,4,2,2,1.5490103372474275
562,703-004-5396,9790.227,5,3,2,0.7936263873582621
5939,207-008-2399,4987.803,4,3,1,1.391850199651994
5949,703-004-5385,7634.344,4,3,1,1.626977446580392
5958,703-004-5395,3414.6494,1,0,1,0.27920371738274696
6289,703-004-5396,7797.7383,4,2,2,0.7445642684730309
6654,703-004-5380,6651.3843,9,5,4,3.1769599346351804
6994,703-004-5381,8215.068,3,2,1,1.2772611872362976
701,703-004-5397,2999.2795,6,2,4,1.7960448191573115
7104,207-008-2399,6228.2603,4,2,2,0.687588845669001
7127,703-004-5398,6958.3584,4,1,3,0.3978652972704144
7514,703-004-5387,61.79154,6,3,3,1.0317595906204862
7558,703-004-5395,4207.9023,2,2,0,0.7831817339463947
7942,703-004-5382,3420.6038,5,3,2,2.9300667511476166
8529,703-004-5388,2291.8547,4,2,2,0.5369336891452678
8598,703-004-5381,8795.876,4,3,1,2.5716403511597528
8806,207-008-2398,4836.297,3,3,0,1.4520968858832441
8877,703-004-5399,4048.9275,2,0,2,0.27920371738274696
9,207-008-2398,8273.197,2,0,2,0.27920371738274696
9286,703-004-5395,8273.477,3,1,2,0.32666834933781397
9481,703-004-5386,8223.647,8,3,5,0.9007089544461722
9482,703-004-5388,411.3418,7,3,4,0.8701294581552367
9658,703-004-5396,8946.739,6,2,4,2.134448593406239
9668,703-004-5391,2473.073,"","","",0.27920371738274696
10068,207-008-2399,915.21204,6,2,4,0.5898127289463961
10440,703-004-5383,2151.094,3,2,1,0.7203733595859231
10569,703-004-5383,4790.3965,6,4,2,3.136230947650773
10630,703-004-5387,9718.803,3,2,1,1.0028885681309176
10723,703-004-5381,6056.126,2,0,2,0.27920371738274696
1112,703-004-5397,4717.945,6,2,4,0.4430082753902399
11184,703-004-5385,3391.2249,2,2,0,1.3512092312590875
11384,703-004-5390,2289.523,5,0,5,0.27920371738274696
11539,703-004-5391,3630.9338,4,2,2,0.6793067494856758
12319,703-004-5395,2863.0476,5,3,2,1.384574282959613
12425,703-004-5382,5877.737,2,0,2,0.27920371738274696
12472,703-004-5394,9725.108,4,2,2,1.0911717023573115
12874,703-004-5382,1792.8809,3,0,3,0.27920371738274696
12955,703-004-5398,1788.8594,2,2,0,0.6058255515748193
13144,703-004-5398,5977.9263,2,2,0,0.446515149124449
1318,703-004-5399,8774.237,2,1,1,2.577032957906088
13244,703-004-5385,1475.7145,3,0,3,0.27920371738274696
13275,703-004-5391,374.98294,4,2,2,0.819559871942919
13937,703-004-5397,735.2531,5,2,3,1.258864152463191
13952,703-004-5385,516.9189,4,3,1,1.823640757821022
13999,703-004-5396,9779.327,6,3,3,3.0235878205675313
14809,703-004-5395,5848.3696,7,3,4,0.9890626345873345
15229,703-004-5397,2270.9863,2,1,1,1.0857052900588826
15235,703-004-5384,7622.014,4,1,3,1.865202158668545
15350,703-004-5384,8265.441,4,2,2,1.8212366513754974
15790,703-004-5398,861.9666,1,0,1,0.27920371738274696
15802,703-004-5380,5293.735,4,2,2,1.2171921988206895
16081,703-004-5391,574.99945,2,2,0,0.8572033322939364
16097,703-004-5390,1329.9215,6,0,6,0.27920371738274696
16527,703-004-5392,1524.5825,1,0,1,0.27920371738274696
17021,703-004-5391,323.73608,3,2,1,0.9840923257398924
17671,703-004-5386,3743.9954,3,2,1,1.0392796393760446
17759,703-004-5396,1992.5171,6,5,1,1.4429290394083794
17769,703-004-5391,4974.143,5,2,3,0.4128449090933766
17774,703-004-5398,1598.9679,1,0,1,0.27920371738274696
17846,207-008-2399,4476.843,6,4,2,2.254846785935528
18113,207-008-2399,2930.0957,5,4,1,1.1811408480971828
18248,703-004-5393,1144.9349,5,2,3,0.8673850137416741
1856,207-008-2399,4635.282,6,1,5,0.5448102682479593
18624,703-004-5382,4127.714,3,2,1,0.6577998807036408
19384,703-004-5389,1978.3866,3,1,2,0.7363029610551423
19410,703-004-5389,7678.841,"","","",0.27920371738274696
19430,207-008-2399,7685.8735,1,1,0,0.9655199712875291
19570,703-004-5395,6024.0923,9,6,3,3.121644623992576
19614,703-004-5382,5567.922,5,4,1,2.1521937321844686
19751,703-004-5380,4264.4272,3,2,1,0.8732708551509838
19965,703-004-5392,3257.1821,1,0,1,0.27920371738274696
20599,207-008-2399,6155.4907,3,1,2,0.3721926388699621
20643,703-004-5390,3827.6577,4,2,2,0.777502131820826
21151,207-008-2398,9905.927,3,1,2,0.5428735226167565
21455,703-004-5397,1274.6215,4,3,1,1.0497394427628264
21800,703-004-5390,2942.798,"","","",0.27920371738274696
21834,703-004-5388,5345.2134,3,1,2,0.4626494691221645
22148,703-004-5398,63.905716,4,3,1,0.7714502483377985
22404,703-004-5394,1808.0724,6,2,4,0.7927387523718251
22584,703-004-5394,4825.291,5,2,3,0.5265894623346675
22636,703-004-5399,4854.651,2,1,1,0.46513203123654295
22777,703-004-5387,4431.231,7,3,4,1.1184620573257642
22797,703-004-5387,1801.039,2,2,0,1.1814863914325837
22859,703-004-5399,8653.082,8,4,4,1.4514564472336935
23043,703-004-5399,3062.6858,4,3,1,0.6510905233505495
23071,703-004-5399,6856.0493,2,0,2,0.27920371738274696
23223,703-004-5390,6921.6816,4,1,3,0.7949438973020344
23395,703-004-5380,1861.8739,5,3,2,0.6558078189275094
23560,703-004-5395,4143.904,5,2,3,0.8589148873925249
23779,703-004-5381,7578.816,6,1,5,0.4281004591568425
23937,703-004-5385,6428.331,6,4,2,2.214608981086495
2407,703-004-5398,9973.948,6,5,1,1.5171564665987556
24438,703-004-5387,7952.2764,4,4,0,0.9007601521687846
24470,703-004-5397,6838.497,4,3,1,1.0221359104004875
24534,703-004-5386,790.31885,1,0,1,0.27920371738274696
24833,703-004-5392,4128.7744,5,1,4,0.7433560183733344
25096,703-004-5392,5034.115,2,1,1,0.3496782717458438
25126,703-004-5397,5896.3506,3,1,2,0.6638024533837804
25132,207-008-2398,8420.519,5,3,2,1.1107982447506437
25267,703-004-5395,1571.843,1,1,0,0.4679105171446834
25302,703-004-5398,3252.1384,7,4,3,1.419697638317798
25353,703-004-5394,8346.542,7,2,5,1.3982840294374073
25549,703-004-5383,8601.918,3,2,1,0.7365984383670561
25670,703-004-5387,380.7914,5,4,1,1.6369817257063288
25713,703-004-5380,6306.264,9,5,4,1.5693491765879943
25769,703-004-5393,5331.6235,3,3,0,0.8188485882333613
25773,703-004-5385,7056.459,8,5,3,2.5127490538290016
25993,703-004-5398,6492.71,3,1,2,0.3804615988868899
26118,703-004-5394,603.67346,2,1,1,0.5122448825566442
26150,703-004-5394,4462.6636,2,1,1,0.3919322182760311
26240,703-004-5391,4654.917,3,0,3,0.27920371738274696
2648,703-004-5385,6838.668,6,4,2,1.076271335636532
26494,703-004-5397,7765.885,5,3,2,0.966849488749114
26805,703-004-5384,3353.2954,6,3,3,0.7611528048104215
26961,703-004-5389,9326.322,4,0,4,0.27920371738274696
27121,703-004-5391,8599.715,7,3,4,0.7506916815281336
27505,703-004-5384,2289.963,2,1,1,0.660258765394852
27516,703-004-5387,2623.3394,3,1,2,0.42142749026423426
27544,703-004-5391,6938.8247,1,0,1,0.27920371738274696
27779,703-004-5380,2787.431,9,3,6,1.5751120360279849
27824,703-004-5390,2054.3296,3,1,2,0.553825078409239
279,703-004-5395,2682.5798,7,4,3,1.2717614237300223
28123,703-004-5399,102.3215,3,2,1,1.4244191608863777
28220,703-004-5396,2232.1045,2,0,2,0.27920371738274696
28400,207-008-2398,7332.971,9,3,6,0.9708702181365919
28408,703-004-5393,691.7262,3,1,2,0.6206774017007487
28457,703-004-5389,2406.7437,8,6,2,4.79924146758126
28591,703-004-5382,2150.1338,4,3,1,2.7083089769823445
2863,703-004-5386,9808.164,1,1,0,0.49244157832630386
28759,703-004-5381,11.820793,6,1,5,0.3978652972704144
28767,703-004-5396,5327.886,2,2,0,0.7176069645047096
28840,703-004-5385,9133.13,3,2,1,1.1827396432329735
29024,703-004-5381,196.4414,5,3,2,0.8003973329367445
29226,703-004-5386,9406.391,6,6,0,2.917148357980449
29502,703-004-5380,2792.8596,6,4,2,1.214866600923455
29536,703-004-5387,5650.9653,2,0,2,0.27920371738274696
29716,703-004-5393,6594.1807,2,1,1,0.6814589588740424
29914,207-008-2398,4951.763,6,1,5,0.3978652972704144
30133,703-004-5385,5106.2266,3,1,2,0.44451413086375374
30158,703-004-5399,734.5521,3,1,2,1.0286251488575435
30290,703-004-5384,7530.02,3,1,2,0.3131070259220805
30299,703-004-5384,4901.121,5,4,1,4.377650040520171
30783,703-004-5386,9673.322,5,2,3,0.7914380052439033
31029,703-004-5395,5053.1597,5,1,4,0.3131070259220805
31032,703-004-5397,81.56836,1,1,0,1.128662611224024
31181,207-008-2398,6987.059,5,0,5,0.27920371738274696
31826,703-004-5399,3476.9595,4,3,1,0.8246831365540821
3187,703-004-5391,5504.9497,3,1,2,0.4310230746121928
31906,703-004-5382,1101.6655,8,4,4,1.5179004445925675
31929,703-004-5397,8002.017,9,6,3,3.119149986300796
31976,703-004-5389,7628.727,5,1,4,1.1700120505018676
32003,703-004-5386,7455.476,2,2,0,0.6831097278484265
32142,703-004-5399,5101.221,5,5,0,1.943395947091213
32779,207-008-2399,7123.0493,4,4,0,2.364496892328712
33028,703-004-5391,7344.658,3,1,2,0.5792152372515927
33033,703-004-5389,1310.113,4,2,2,1.0924471156690911
33127,703-004-5389,9454.405,3,1,2,0.6540891842751972
33381,703-004-5390,8876.358,5,3,2,1.9238710998900217
33463,703-004-5385,2338.9136,1,1,0,0.581213148707735
33611,703-004-5382,2339.9133,4,2,2,0.9373394662561204
33804,703-004-5384,5844.5547,2,0,2,0.27920371738274696
33829,703-004-5382,4333.0747,3,2,1,0.9845116657326047
34023,703-004-5385,1799.658,3,2,1,0.8565746168190225
34201,703-004-5383,7394.304,5,1,4,0.3978652972704144
34509,703-004-5393,5659.334,5,3,2,2.069378312765209
34639,703-004-5387,8694.628,4,3,1,0.7277226873212389
34780,703-004-5390,4428.265,6,3,3,1.5320675819878535
3489,703-004-5386,1142.0662,6,3,3,2.1161288652018304
34951,703-004-5387,8122.3535,1,1,0,0.7085098376405944
35066,703-004-5381,2911.477,8,5,3,3.4977928135138536
35608,703-004-5380,2118.5059,6,2,4,1.4708664402333695
35921,703-004-5398,4544.9326,1,0,1,0.27920371738274696
36497,207-008-2399,7930.659,3,1,2,0.6123672231768514
36657,703-004-5389,6095.2686,5,3,2,0.9124461182623906
36709,703-004-5393,3644.902,5,4,1,1.5934202067630336
36716,703-004-5389,2398.5647,1,0,1,0.27920371738274696
36852,703-004-5397,2073.682,4,1,3,0.48899634924038826
3709,703-004-5385,2071.69,3,3,0,0.8774549581577366
37396,703-004-5384,4323.148,3,2,1,4.78750625170177
37492,703-004-5393,1342.5022,2,2,0,4.577325269823094
3764,703-004-5393,1282.5465,3,1,2,0.33853450732658075
37882,703-004-5395,6172.527,1,0,1,0.27920371738274696
38575,703-004-5388,2050.044,3,1,2,0.6381612467701302
38858,703-004-5389,3637.5576,4,2,2,0.6221893880215893
39160,703-004-5388,422.22263,1,0,1,0.27920371738274696
39315,703-004-5398,7530.1807,4,2,2,2.006168572567022
39371,703-004-5395,7434.0747,2,1,1,0.44909815383402596
39979,703-004-5396,1313.8074,5,4,1,1.189330156779658
40361,703-004-5385,4222.7407,2,0,2,0.27920371738274696
40658,703-004-5388,8396.302,"","","",0.27920371738274696
40678,207-008-2399,849.3537,4,4,0,1.6264755429986781
40965,703-004-5390,9138.585,4,2,2,1.028922064593789
41104,703-004-5384,9057.582,8,5,3,3.0598547005113477
415,703-004-5387,9339.069,5,1,4,0.3978652972704144
4157,703-004-5389,913.8322,3,1,2,0.706929081800782
41740,703-004-5396,9400.481,7,0,7,0.27920371738274696
4189,703-004-5392,7457.013,3,3,0,0.877793957528126
42036,703-004-5395,8015.6616,4,2,2,1.3249482317250072
422,703-004-5399,2385.741,8,5,3,2.633656448368287
42287,703-004-5383,8151.0938,3,2,1,0.7768968203977191
42327,703-004-5386,6427.799,"","","",0.27920371738274696
42593,703-004-5393,8152.4863,4,0,4,0.27920371738274696
42611,703-004-5396,315.83548,6,5,1,2.779983819324034
43033,703-004-5394,4442.463,2,1,1,0.784487656246195
433,703-004-5388,3803.1948,4,3,1,2.066084948391469
43320,703-004-5390,2690.1155,3,2,1,0.5762440530560391
43468,207-008-2399,857.2507,1,1,0,0.6707268196601847
43718,703-004-5384,4561.397,3,1,2,0.45870311138584713
43888,703-004-5387,8986.32,3,2,1,1.0938923524649982
44006,703-004-5391,5542.03,6,5,1,1.3465909140631334
44171,703-004-5395,7699.2065,5,2,3,0.8452280940351252
44583,703-004-5393,9294.279,2,1,1,0.4986581194486321
44612,703-004-5384,7204.9307,4,2,2,0.6567599654819607
44844,703-004-5388,2562.0168,6,3,3,0.5897015180888101
44885,703-004-5384,3990.4976,1,0,1,0.27920371738274696
45003,703-004-5384,5858.085,8,6,2,1.6439004241578659
45146,703-004-5392,7532.324,5,3,2,1.1987764654949076
45643,703-004-5386,3301.3254,5,2,3,0.6641432697959034
45733,703-004-5399,7506.7593,2,0,2,0.27920371738274696
45749,207-008-2398,2051.8167,2,1,1,0.44346166857325
46158,703-004-5381,4671.2964,3,1,2,0.4962060816023188
46230,703-004-5384,5957.521,6,0,6,0.27920371738274696
46396,703-004-5396,8358.205,3,3,0,1.5388127844822432
47015,703-004-5398,6709.4927,4,2,2,0.9753106196298882
47751,703-004-5397,1060.9883,6,1,5,0.501047692275535
47891,207-008-2398,5671.8804,2,2,0,1.62024565355064
47922,703-004-5392,5667.2163,7,5,2,1.617537667850718
48016,703-004-5388,3613.5476,3,1,2,0.36625344521877656
48333,703-004-5390,1682.8674,5,4,1,1.9920829707113523
48454,703-004-5395,5832.3403,5,3,2,0.6958743001162412
48497,703-004-5385,3530.8916,2,0,2,0.27920371738274696
48565,703-004-5383,2090.8838,4,4,0,2.7841265580494188
48908,703-004-5390,6870.5645,6,2,4,1.171089966714629
48955,703-004-5388,413.66696,5,1,4,0.48978237573311456
49195,703-004-5385,1861.0305,"","","",0.27920371738274696
49227,703-004-5388,7846.21,5,3,2,1.1921648768470634
4969,703-004-5393,7483.4316,7,3,4,1.232701618807642
49793,703-004-5398,4767.718,6,0,6,0.27920371738274696
49851,207-008-2398,5367.3804,4,1,3,0.7588055706638713
5060,207-008-2398,8341.584,"","","",0.27920371738274696
543,703-004-5396,7.070899,7,4,3,1.066327868287468
595,703-004-5392,7272.773,3,2,1,0.6930068826068495
5998,703-004-5382,4642.016,5,2,3,0.7075725156347351
6045,703-004-5395,5797.692,5,4,1,1.3767087914930618
6090,703-004-5397,1959.9127,3,1,2,0.35237835831347525
6662,703-004-5380,5902.12,2,1,1,0.48438806606922424
6711,703-004-5391,7480.3237,4,3,1,2.574042042202185
685,703-004-5382,3489.25,6,3,3,1.6081577914662137
6869,703-004-5388,7703.0044,4,3,1,1.252429251702239
6965,703-004-5398,2472.6755,4,2,2,0.6415121431511162
7134,703-004-5398,3292.4783,4,3,1,2.381265106898176
7160,703-004-5383,4737.39,5,3,2,0.4846662429582432
7293,703-004-5386,1698.3973,1,1,0,0.5116275762494673
7334,703-004-5391,2079.5667,4,3,1,1.3786731916649713
7644,703-004-5398,8601.905,2,1,1,0.37723973485623447
7781,703-004-5397,6752.4194,2,1,1,0.8792448942915728
8206,703-004-5394,6699.354,4,2,2,1.0654327311383838
8511,703-004-5390,4899.802,4,2,2,0.8096071221108242
8669,703-004-5394,1033.4348,1,0,1,0.27920371738274696
8743,703-004-5396,1769.3997,2,1,1,0.43231300520731586
8815,703-004-5395,5034.239,1,1,0,0.44829646872267315
8898,703-004-5391,3863.2463,5,4,1,1.091057914933013
9019,207-008-2398,4972.3237,3,1,2,0.4013651462998476
9105,207-008-2398,9814.375,4,3,1,1.8125751003318311
9692,703-004-5395,3958.3289,2,1,1,0.4573351231991195
979,703-004-5384,123.42691,2,0,2,0.27920371738274696
10094,703-004-5391,8148.3955,4,2,2,0.7020711987532051
10170,703-004-5391,9543.994,6,4,2,1.411021459894139
10368,703-004-5398,6150.575,4,3,1,1.9532208019788857
10494,703-004-5383,7838.4834,1,0,1,0.27920371738274696
11146,703-004-5399,1185.0989,2,0,2,0.27920371738274696
11156,703-004-5383,1588.0537,2,0,2,0.27920371738274696
11524,703-004-5381,2599.2893,4,2,2,0.44862608422236105
11953,703-004-5382,8174.2573,4,2,2,1.752645523803726
12014,703-004-5381,8438.811,4,1,3,0.5382053812215565
12064,703-004-5383,7785.3174,5,3,2,2.2182139192731505
12751,703-004-5383,1932.7516,3,1,2,0.6575949368295552
12943,703-004-5391,8181.9653,3,2,1,0.47136484490797786
13003,703-004-5384,6237.491,2,2,0,2.671946805126421
13088,703-004-5393,9835.044,5,0,5,0.27920371738274696
13112,703-004-5397,5986.8096,3,2,1,0.6249357787459922
13142,703-004-5382,5676.753,3,1,2,0.8075428588529001
13362,703-004-5380,3832.2424,4,1,3,0.6212201623714253
13868,703-004-5396,8956.574,6,0,6,0.27920371738274696
14068,703-004-5381,2917.676,3,1,2,0.4631816574234416
14195,703-004-5394,7511.19,7,4,3,1.9557651782508718
14411,703-004-5396,2006.4956,5,1,4,0.4230808829965438
14456,703-004-5399,9015.364,2,1,1,1.0414209723736392
14551,703-004-5389,8649.677,1,0,1,0.27920371738274696
14580,703-004-5398,4593.6733,5,1,4,1.1906226180494928
14848,703-004-5397,8887.96,4,3,1,0.8593112931745986
15069,703-004-5386,2273.6282,3,1,2,0.32666834933781397
15150,703-004-5381,3128.1418,4,1,3,0.3978652972704144
152,703-004-5391,4180.5264,2,2,0,0.7883179976149182
1529,703-004-5380,5156.296,1,0,1,0.27920371738274696
15311,703-004-5387,6464.1597,2,1,1,0.4181003926427323
16004,703-004-5390,854.89514,5,3,2,0.7453053688703568
16029,703-004-5389,8919.444,"","","",0.27920371738274696
16123,703-004-5395,5655.9126,"","","",0.27920371738274696
16188,703-004-5392,9297.044,3,3,0,1.357574346181678
16472,703-004-5394,9875.226,1,1,0,0.3978652972704144
17186,703-004-5382,3953.365,4,4,0,0.8336495775222563
17485,703-004-5398,117.68103,3,2,1,1.2990323634409444
17580,703-004-5396,8578.088,2,1,1,0.7235745265866023
17637,207-008-2399,7141.599,3,2,1,0.928920810096908
17647,703-004-5394,8311.268,7,4,3,2.72473971188531
18026,703-004-5382,702.79004,5,2,3,0.6395939403463762
1824,703-004-5394,7809.8823,4,0,4,0.27920371738274696
18470,703-004-5390,1265.2867,5,2,3,0.9449329671026265
186,703-004-5382,5436.2627,3,2,1,1.341313844007354
18745,703-004-5380,302.1234,4,3,1,1.6161341099502542
18850,703-004-5384,1742.3922,8,3,5,1.5730320439678709
19080,703-004-5394,4739.0557,1,1,0,0.6940068136056275
19315,703-004-5398,4388.3257,3,2,1,1.625032885938327
1934,703-004-5396,1563.4174,6,2,4,2.2480322879861423
19641,703-004-5387,3422.8152,5,4,1,3.329318057211714
19801,703-004-5395,2165.6025,2,0,2,0.27920371738274696
19964,703-004-5392,8002.1177,1,1,0,0.4599635773575985
19997,703-004-5390,8848.932,3,1,2,2.4344417509469465
20080,703-004-5399,3381.1099,2,1,1,0.4314860782385869
20179,207-008-2398,195.54794,6,1,5,0.5404077500497254
20439,703-004-5386,5287.389,10,2,8,0.5133931955376982
20539,703-004-5386,3364.9773,8,3,5,1.147682367763804
20555,703-004-5395,9341.962,"","","",0.27920371738274696
20748,703-004-5394,394.60062,3,3,0,1.2330263819031093
21503,703-004-5389,7614.1367,7,2,5,1.8503886430067287
21525,703-004-5394,7488.1343,5,4,1,2.934173591651535
21597,703-004-5396,5764.162,"","","",0.27920371738274696
21941,703-004-5384,3556.4243,"","","",0.27920371738274696
22211,703-004-5395,4510.4766,5,2,3,0.972630346066046
22535,703-004-5396,3212.1313,4,3,1,0.6026365461852452
2260,703-004-5388,8549.047,2,2,0,0.3978652972704144
23290,207-008-2398,4029.8552,5,3,2,0.6584191181338349
23292,703-004-5382,1185.7194,3,2,1,0.8568925645552852
2333,703-004-5396,7886.7153,2,2,0,1.166716970633798
23441,703-004-5394,5108.776,5,1,4,0.6953269708745787
23624,703-004-5393,255.49352,3,0,3,0.27920371738274696
23625,703-004-5394,9691.457,6,6,0,1.8474628965556443
23808,207-008-2399,4476.6997,2,0,2,0.27920371738274696
23958,703-004-5394,7153.271,6,1,5,0.5165268771580819
24032,207-008-2398,8235.24,6,2,4,1.3678098190435757
24047,703-004-5398,6343.7056,1,1,0,0.5165268771580819
24158,703-004-5391,3595.6782,2,2,0,0.5021886029216555
2417,703-004-5384,5192.056,3,2,1,1.1803322317565133
2419,703-004-5389,8266.038,2,0,2,0.27920371738274696
24190,703-004-5383,358.58453,4,2,2,0.5768197323416299
24287,703-004-5387,7939.1587,6,1,5,0.3896447485111028
24686,703-004-5384,5476.2354,1,0,1,0.27920371738274696
25064,703-004-5387,4016.1257,6,2,4,0.5060355205011515
25395,703-004-5396,9067.385,3,2,1,0.5155790138302317
25418,703-004-5388,7331.181,2,0,2,0.27920371738274696
25486,703-004-5387,3335.4873,4,2,2,0.5933498906884744
25649,703-004-5397,7405.4893,8,4,4,3.7417613040999838
2565,703-004-5397,9886.399,1,1,0,0.47917240283928425
26126,703-004-5380,286.2048,7,5,2,3.237833663596955
26208,703-004-5382,7883.5166,8,4,4,2.1919085663322053
26211,703-004-5392,8102.168,6,3,3,3.825174042249783
26307,703-004-5381,3753.6414,7,2,5,0.41764222725169237
26493,703-004-5384,8495.723,6,4,2,2.571107742148721
2663,703-004-5388,5707.592,7,3,4,2.286880228106615
26708,703-004-5393,6493.152,2,2,0,1.3769360351326723
26817,703-004-5385,9803.868,3,2,1,1.5156552472407288
26888,703-004-5384,5773.513,7,3,4,1.7016847712516325
27879,703-004-5387,6295.5415,3,1,2,0.7353480748855195
27885,703-004-5384,5000.2383,4,1,3,0.6371607723583955
28177,703-004-5385,5959.819,3,2,1,0.7198089260573163
28320,703-004-5394,2296.8281,1,0,1,0.27920371738274696
28409,703-004-5387,7962.2812,3,0,3,0.27920371738274696
28542,703-004-5388,5791.9224,3,1,2,0.37512182779194486
28677,703-004-5385,1373.0717,5,1,4,1.4626433091210773
28685,703-004-5392,1477.859,1,0,1,0.27920371738274696
28823,703-004-5389,4005.931,4,3,1,1.2667387439803417
29275,703-004-5392,3140.7397,3,1,2,0.6676168344196107
29487,207-008-2398,1607.2279,5,1,4,0.7425052371877581
29715,703-004-5383,3396.5354,4,3,1,1.2019260908158778
29821,703-004-5398,6145.177,2,1,1,0.5444088677041673
299,703-004-5389,9753.06,7,4,3,1.8863785529503467
29955,703-004-5398,483.80554,2,1,1,1.0059169515109063
3011,703-004-5387,2316.5857,4,2,2,1.058302328423913
3012,703-004-5398,3012.2954,3,0,3,0.27920371738274696
30285,703-004-5382,9721.741,6,2,4,0.7921780943862348
30295,703-004-5388,927.2242,5,3,2,0.9596102214245322
3030,703-004-5392,3183.9668,1,1,0,0.32666834933781397
30635,703-004-5397,6322.4077,3,2,1,1.0324832797494592
30640,703-004-5396,4318.413,4,2,2,0.858302788488945
3066,703-004-5393,8983.65,9,6,3,2.4121610346657842
30963,703-004-5394,5607.314,5,3,2,1.1386567660013074
314,703-004-5387,6154.0444,4,1,3,0.9239587034959406
31419,703-004-5384,5407.79,4,1,3,0.7223444523073762
31420,703-004-5395,1003.1217,5,3,2,0.8869665737087411
31470,703-004-5387,7954.9873,3,3,0,0.8630043306758644
31649,703-004-5392,4236.1426,5,3,2,0.8077823658697866
32165,703-004-5391,3191.4812,7,6,1,3.573015376679823
32496,703-004-5395,201.74861,9,6,3,1.5589339192326974
32542,703-004-5391,1725.4049,7,4,3,2.3593865062161297
32747,703-004-5393,8977.529,5,4,1,0.740568740071979
3275,703-004-5394,1184.9744,5,4,1,2.269648771181447
3317,703-004-5394,4761.2725,6,2,4,0.3859991392816477
33185,703-004-5395,5407.0054,5,4,1,1.4447272348970954
3383,703-004-5399,7129.7104,2,1,1,2.570567987987143
34270,703-004-5393,6113.863,3,0,3,0.27920371738274696
34397,703-004-5398,8491.564,3,2,1,0.6232607028862462
34623,703-004-5399,7686.4487,6,3,3,0.7730334642757445
34713,703-004-5399,9115.649,2,1,1,0.33853450732658075
34807,703-004-5382,2331.89,2,1,1,1.1389434604772535
35031,703-004-5399,62.14559,6,1,5,0.8934878538876874
35141,703-004-5380,5143.692,3,0,3,0.27920371738274696
35234,703-004-5391,2633.4392,4,3,1,0.6853634824011275
35480,703-004-5398,8376.927,4,3,1,2.1592000730847567
35910,703-004-5385,8743.566,6,3,3,1.1397683836902144
36061,703-004-5382,8500.951,3,3,0,0.6917707219593145
36366,703-004-5388,8264.172,5,2,3,0.6140389408272728
36589,703-004-5384,3828.3574,2,1,1,0.4882000191906698
3671,703-004-5389,115.674736,2,0,2,0.27920371738274696
3706,703-004-5381,3696.6794,7,4,3,1.1937272983445417
37245,703-004-5390,7368.0854,6,3,3,4.9235156530313136
37390,207-008-2399,2708.292,2,1,1,1.4118001179890907
37400,703-004-5397,939.07355,4,2,2,0.7214523212552424
37563,207-008-2399,6264.3887,4,3,1,0.7892340296012714
3759,703-004-5390,1379.2175,4,0,4,0.27920371738274696
37862,703-004-5384,2684.7458,6,5,1,1.4560154034558006
37972,703-004-5382,1228.0774,1,1,0,1.0568541312362116
3831,703-004-5391,9232.733,3,3,0,0.9442360677745798
38359,703-004-5383,961.6667,4,1,3,0.5520642246150708
38404,703-004-5391,5207.231,1,0,1,0.27920371738274696
38413,703-004-5392,8329.904,3,1,2,0.3422921240230235
38430,703-004-5384,9347.387,4,2,2,0.424961428669771
38506,703-004-5398,6299.878,5,1,4,0.6963980553378044
38538,703-004-5384,3273.8203,4,2,2,0.440056081230474
38590,703-004-5395,1009.69073,6,2,4,0.5036779888689676
3986,207-008-2398,2450.2249,5,3,2,0.6379727229261715
40438,703-004-5394,2450.1426,5,4,1,2.4526604457143284
40721,703-004-5390,5722.407,4,4,0,1.8510954837086682
41109,703-004-5396,9944.399,2,1,1,0.5738578530149535
41465,703-004-5386,1602.9894,4,2,2,0.9238142797973615
41596,703-004-5392,3857.1436,2,0,2,0.27920371738274696
41643,703-004-5387,5933.9233,4,2,2,1.6045511107238235
42301,703-004-5383,3491.866,3,1,2,0.7023827655681074
42376,703-004-5381,9966.1045,3,3,0,1.3462170565684408
42490,703-004-5382,6888.7544,5,2,3,0.6016161209285831
43225,207-008-2399,6860.453,5,4,1,1.2636675235133632
43433,703-004-5384,1327.8372,4,2,2,0.5850574429929817
43565,703-004-5395,7501.9746,3,2,1,0.8151364589525685
44076,703-004-5389,913.76306,4,3,1,1.7384475303897187
44111,703-004-5380,7322.9624,8,2,6,1.2179431471672566
44161,703-004-5394,9461.525,3,2,1,0.6988484488843398
44207,703-004-5380,591.7227,1,1,0,0.48077672314711306
44469,703-004-5393,9333.184,1,1,0,0.5428340109406106
44597,703-004-5398,6085.384,4,2,2,1.3810342779668918
45333,703-004-5384,8798.786,3,1,2,0.9456041927138744
45550,703-004-5389,2421.0017,4,2,2,0.8597486493172245
45830,207-008-2399,3858.7017,2,0,2,0.27920371738274696
45858,703-004-5381,6197.2935,1,1,0,0.5313319352449004
46027,703-004-5396,2521.2925,2,2,0,0.612226370961696
46133,703-004-5394,7826.616,4,2,2,0.6538358369195938
46140,703-004-5397,1129.0222,8,4,4,1.8566778164914852
46184,703-004-5396,8556.59,3,3,0,0.8416571437249306
4620,703-004-5387,990.836,4,3,1,0.9012279497329664
46319,703-004-5391,6628.2705,5,2,3,0.927439445707369
46334,703-004-5391,6472.2,2,2,0,1.2268306150389001
46429,703-004-5390,9513.14,4,2,2,0.7399807262586874
46453,703-004-5394,122.491714,5,1,4,0.9300045151582955
46555,207-008-2398,2016.1742,3,2,1,1.2650600785072896
46835,703-004-5389,5756.3354,3,1,2,0.35831143730785864
46956,703-004-5390,7800.04,5,3,2,0.8605136950631367
46980,703-004-5388,1320.2614,"","","",0.27920371738274696
47070,703-004-5397,7861.645,5,2,3,0.8529988031241429
47109,703-004-5394,3927.6875,5,2,3,1.4880772980889732
47242,703-004-5397,2808.4731,4,2,2,0.6353744759791571
4749,207-008-2399,1023.45703,3,2,1,0.9612489696604283
47643,703-004-5393,7364.003,5,4,1,1.0090015603211182
47905,703-004-5398,3968.317,4,2,2,1.0120324738922775
48044,703-004-5394,726.28973,7,3,4,0.6065686024388427
48630,703-004-5394,381.34515,5,3,2,1.7511450741041261
49067,703-004-5385,2846.059,5,3,2,0.9597206496917677
49166,703-004-5396,6624.613,5,1,4,0.4085878963389202
49337,703-004-5383,3598.0266,4,1,3,0.5397551199921017
513,703-004-5399,4570.367,5,2,3,0.7382646642301144
5301,703-004-5384,9713.048,6,0,6,0.27920371738274696
5332,703-004-5382,4980.216,6,4,2,1.2126427258532189
5391,703-004-5397,5538.065,6,1,5,0.4543426794819127
5533,207-008-2398,220.48116,4,2,2,0.5529172221643054
5693,703-004-5381,6418.4307,4,2,2,0.5320990120816737
6035,703-004-5394,5139.9805,6,3,3,2.74793297629036
6247,703-004-5392,6347.1772,3,1,2,0.5345953997634446
6401,703-004-5397,300.94742,6,3,3,1.0299267963078584
6787,703-004-5398,5722.4453,3,3,0,1.2129893970759484
6913,703-004-5395,3132.7117,3,2,1,0.5736149594625775
7008,703-004-5391,8575.411,5,1,4,0.4319350840101794
7298,703-004-5387,2586.0388,3,1,2,0.32666834933781397
7448,703-004-5398,7952.108,5,2,3,0.46947196912290784
7575,207-008-2398,2533.588,3,1,2,0.5455257786845369
7744,703-004-5383,657.9691,4,1,3,0.7336494158635989
780,703-004-5397,8712.435,4,2,2,1.0612062776870572
7991,703-004-5385,183.17938,3,3,0,1.6365256477859689
8002,703-004-5389,2547.2063,1,1,0,0.3480464979022897
8201,703-004-5381,8560.368,4,2,2,1.68178120128658
8422,703-004-5396,9590.342,5,2,3,1.037578874378275
8807,703-004-5383,8784.072,10,4,6,1.0345509878255055
8848,703-004-5391,6791.039,2,2,0,2.400950821659339
9061,703-004-5395,1597.491,1,0,1,0.27920371738274696
907,703-004-5387,6181.7144,5,3,2,1.448191530588657
9163,703-004-5387,2154.5989,5,2,3,0.592403522827355
9492,703-004-5392,2717.135,4,3,1,1.9594900598929208
9674,703-004-5386,34.9164,4,1,3,1.4753872825813128
10012,703-004-5390,6733.0664,4,4,0,1.3294061933269103
10058,703-004-5388,1956.1249,5,2,3,0.8423736582508708
10502,703-004-5386,4541.678,5,4,1,1.0878644376993933
10725,703-004-5391,1879.2069,5,3,2,1.5155142724240662
10752,703-004-5387,1308.5562,6,2,4,0.715866354237711
10825,703-004-5399,1223.7406,4,1,3,0.35831143730785864
11001,703-004-5386,6654.052,4,4,0,2.5001597586533006
11037,703-004-5391,6034.7397,6,3,3,1.2593388471246278
11055,703-004-5392,9789.73,5,3,2,1.3776349225421867
11130,703-004-5396,3194.346,5,2,3,0.7343726460329423
11133,703-004-5381,8727.188,4,1,3,0.42828487090485756
1135,703-004-5390,6810.0107,2,0,2,0.27920371738274696
11571,703-004-5390,8825.091,5,2,3,1.6495927935018604
11652,703-004-5383,2153.278,2,2,0,1.5590944166674585
11865,703-004-5393,2872.5117,2,2,0,0.7098715311693312
11887,703-004-5385,4167.6064,2,1,1,0.6070288273939616
12123,703-004-5385,9783.944,3,1,2,0.48597354284577754
12733,207-008-2399,9670.747,6,4,2,1.3036720022134851
13018,703-004-5389,7192.71,4,1,3,0.5281634954989682
13178,703-004-5389,2663.4597,8,4,4,2.436016737599627
13190,703-004-5386,7941.216,6,3,3,1.1770052676408929
13304,703-004-5392,286.53503,6,2,4,0.8928289644319611
13833,703-004-5395,5065.8467,2,0,2,0.27920371738274696
13913,703-004-5388,2074.4521,5,1,4,0.6533312886635609
13989,703-004-5383,4921.9365,4,3,1,1.074798905195391
14090,703-004-5392,7596.1626,4,1,3,1.3672192362712619
14127,703-004-5394,8651.843,5,3,2,0.5433137219684454
14832,703-004-5385,4680.1074,5,2,3,0.8819956228421106
14833,703-004-5399,4438.5654,3,2,1,0.4666253703458635
15047,703-004-5385,4776.1875,5,3,2,0.7102519497907243
1508,703-004-5390,5634.787,5,3,2,0.8170224052507971
15127,703-004-5390,5673.336,2,2,0,0.5758576671019155
1526,703-004-5389,498.2668,2,1,1,0.5204782285621946
15365,703-004-5393,2587.8774,8,4,4,2.6571085442360163
15388,703-004-5393,8952.157,2,0,2,0.27920371738274696
16088,703-004-5385,5031.326,5,2,3,0.5343205381285281
16144,703-004-5387,1562.1495,7,4,3,2.187465397782556
16322,703-004-5386,3781.4646,4,3,1,1.1121984374222724
16698,703-004-5388,9632.788,3,1,2,0.6611840245782351
16748,703-004-5390,1477.0061,5,2,3,0.9033202557196847
16862,703-004-5389,3070.2239,4,0,4,0.27920371738274696
17619,703-004-5395,8659.642,3,0,3,0.27920371738274696
17746,703-004-5384,8718.92,2,1,1,0.6342735642844429
18063,703-004-5399,5875.6865,5,5,0,1.4450480243001236
18313,703-004-5394,486.99976,3,2,1,1.1033880435982506
18387,703-004-5398,1473.6027,3,1,2,0.3978652972704144
18489,703-004-5397,5100.4585,6,1,5,0.7495724303824981
1915,703-004-5386,9110.471,8,5,3,3.100976890165308
19151,703-004-5396,9953.236,4,2,2,0.9750116840385076
19184,703-004-5381,9862.58,4,4,0,1.5236487726143653
19240,703-004-5399,5056.539,5,4,1,3.7172318331233165
19286,703-004-5380,2716.4465,1,0,1,0.27920371738274696
19385,703-004-5394,5711.8296,4,2,2,0.8184000106786196
19399,703-004-5385,618.8506,"","","",0.27920371738274696
19402,703-004-5380,1429.8267,4,2,2,0.6863321915611391
19525,703-004-5392,4867.254,2,0,2,0.27920371738274696
19702,703-004-5388,2605.7095,2,0,2,0.27920371738274696
19834,703-004-5393,4058.7163,4,2,2,0.47697301719552604
19984,703-004-5394,9460.65,5,2,3,0.9267291529349503
20149,703-004-5390,2875.3555,1,0,1,0.27920371738274696
20296,703-004-5397,5257.608,3,0,3,0.27920371738274696
20516,703-004-5388,4311.533,1,1,0,0.4442941469506098
20571,703-004-5395,5110.825,5,3,2,1.7274334905383617
20875,703-004-5385,8885.056,3,2,1,0.7757127471548544
20978,703-004-5399,2905.454,4,1,3,0.40334458898521314
21031,703-004-5384,724.4354,5,2,3,0.8450090849686296
21250,703-004-5390,6441.5415,5,3,2,0.7194564158439135
21495,207-008-2398,7939.016,5,4,1,1.2478125167023484
21507,703-004-5381,7861.442,5,1,4,0.35831143730785864
21826,703-004-5398,4190.9683,5,5,0,2.2959948177632574
22209,703-004-5392,4597.6665,4,3,1,1.8079063631184524
22352,703-004-5383,4831.999,6,1,5,1.8568932872582673
22429,703-004-5381,8746.162,4,3,1,1.1320759033727152
23075,703-004-5394,9316.927,4,3,1,0.7476712123860831
23088,207-008-2399,5961.6636,5,0,5,0.27920371738274696
23189,207-008-2399,9332.522,5,2,3,0.6600959068318839
23319,703-004-5393,1737.8872,5,2,3,0.7268436486619818
23507,703-004-5382,3253.3909,3,2,1,0.7332418166619258
23816,703-004-5395,7355.7944,6,1,5,0.7433856203281973
24328,703-004-5384,2511.3035,3,2,1,1.2297410970273093
24421,703-004-5384,2147.1448,4,1,3,0.6505261753977831
24882,703-004-5391,7616.48,2,1,1,0.563471416472569
25034,703-004-5385,797.1334,3,1,2,0.6622246457647006
25225,703-004-5380,4292.4683,3,3,0,1.16255002541168
25305,703-004-5395,3384.4329,3,1,2,0.4230808829965438
25341,207-008-2399,2169.0042,3,0,3,0.27920371738274696
25847,703-004-5397,599.12683,7,4,3,0.8181565817977232
25849,703-004-5395,8140.0923,7,5,2,2.0509833454124804
25850,703-004-5380,422.6649,9,3,6,1.1087573287983807
25883,703-004-5390,4560.862,3,1,2,0.7487398395725504
25915,703-004-5394,2366.3384,2,0,2,0.27920371738274696
26403,207-008-2398,4357.4316,4,1,3,0.5827795925953628
26896,207-008-2398,6116.3647,9,7,2,2.626481304399602
27296,207-008-2399,854.6603,2,0,2,0.27920371738274696
27313,703-004-5385,8760.285,2,0,2,0.27920371738274696
27371,207-008-2399,4220.927,3,2,1,0.5417424628842112
27474,703-004-5385,1962.0824,3,2,1,1.0156587871515692
2772,703-004-5383,9322.2,2,0,2,0.27920371738274696
2784,703-004-5387,1734.3741,5,3,2,0.8928694712081626
28020,703-004-5384,272.16553,3,3,0,1.6565345825867102
28076,703-004-5386,7351.3867,2,0,2,0.27920371738274696
28353,703-004-5387,5890.133,3,2,1,0.885803060603333
29070,703-004-5392,2669.0847,1,1,0,0.528054198476211
29337,207-008-2398,4503.597,4,1,3,0.4056599986737422
29714,703-004-5393,3182.3457,3,1,2,0.48583898582827517
29746,207-008-2399,5004.9336,8,5,3,1.59729417368859
29871,703-004-5383,4497.7905,8,6,2,2.5623821606094954
29875,703-004-5382,5167.3623,4,2,2,0.7661616759509403
29987,703-004-5384,4025.1643,4,0,4,0.27920371738274696
30060,703-004-5380,818.22516,5,3,2,1.1724781440923393
30215,703-004-5392,6177.968,2,0,2,0.27920371738274696
30326,703-004-5391,3775.645,3,3,0,1.5482508618234587
30338,703-004-5392,3273.174,3,1,2,0.35114230018964543
30345,703-004-5382,7561.193,3,2,1,0.4908168681824206
30358,703-004-5398,8174.269,5,3,2,1.8128701776079879
30607,703-004-5384,6637.57,3,2,1,0.5583433384077692
30659,703-004-5386,7420.9614,4,1,3,0.49067083200583855
30722,703-004-5382,3525.1702,4,3,1,1.210578889653949
3078,703-004-5394,5412.0337,"","","",0.27920371738274696
30816,703-004-5396,3675.121,4,3,1,1.1661219799402673
31201,703-004-5398,2113.6511,2,0,2,0.27920371738274696
31807,703-004-5399,5533.8438,3,2,1,1.7728190151101337
3207,703-004-5391,7881.764,"","","",0.27920371738274696
32285,703-004-5388,2225.8103,2,2,0,0.8062338655303559
32672,703-004-5396,4897.572,3,0,3,0.27920371738274696
32797,703-004-5393,2631.1482,"","","",0.27920371738274696
32820,703-004-5389,5264.3066,3,2,1,1.441243873735569
32837,703-004-5385,5685.4893,5,0,5,0.27920371738274696
32960,703-004-5392,2891.8225,4,2,2,0.9843355128470875
33162,703-004-5382,7452.6167,7,5,2,3.012476446467597
33378,703-004-5390,9562.38,7,4,3,1.4484597040577627
33410,703-004-5384,9283.108,2,2,0,0.9155758568052434
33525,703-004-5395,2392.0977,6,3,3,0.6076606464357941
33680,207-008-2398,3273.9866,5,4,1,2.49060657761748
33700,703-004-5382,1360.2239,3,2,1,0.4972353571535614
33795,703-004-5386,4480.8364,3,1,2,0.9977755921859219
34037,703-004-5397,456.68005,5,2,3,0.4942280266157405
34460,703-004-5382,9315.575,2,1,1,0.659376126929496
34600,703-004-5394,1290.8584,1,1,0,0.8567481890691576
34638,703-004-5386,7906.218,3,2,1,1.3099926512576499
34666,703-004-5383,7915.932,4,2,2,0.8485664730969001
34707,703-004-5391,7133.1323,4,2,2,0.9242966681119456
34727,703-004-5385,8350.107,1,0,1,0.27920371738274696
34782,703-004-5383,4849.4155,2,0,2,0.27920371738274696
34940,703-004-5385,5184.7524,2,1,1,1.1615034716830002
35068,703-004-5396,4779.773,2,1,1,0.6446778518421232
35394,207-008-2398,8716.266,4,2,2,2.73170522454905
35436,703-004-5387,3285.6833,5,3,2,1.510620182800667
35461,703-004-5398,8047.969,4,1,3,1.2291076770830933
35628,703-004-5388,5509.0757,6,4,2,2.37059780386874
3583,703-004-5383,2949.0208,5,2,3,0.7978509016830507
36052,703-004-5382,6456.1235,4,1,3,0.767390174707828
36344,703-004-5394,9580.803,3,2,1,0.8119698442904782
36438,703-004-5380,6731.741,3,1,2,0.42406448268638414
36504,703-004-5381,9970.945,3,2,1,0.7325983990845027
36884,207-008-2398,8506.319,6,4,2,1.9493678312204632
36938,207-008-2399,5739.029,7,1,6,0.9531787946251342
3716,703-004-5388,108.770134,3,1,2,0.35286547508609745
37202,703-004-5394,1365.1425,7,3,4,1.3474975111416778
37275,703-004-5396,4755.936,7,4,3,2.42499790493645
37380,703-004-5381,1835.7014,5,4,1,1.3464869285198335
37771,703-004-5386,1073.345,5,2,3,0.5996592359826325
37825,703-004-5389,2811.4075,5,1,4,0.33853450732658075
37953,703-004-5398,6980.235,5,3,2,2.6765156083502415
38068,703-004-5395,4411.902,6,4,2,1.1919638415043892
38439,703-004-5386,6372.214,5,1,4,0.42425271803288533
38443,703-004-5380,6450.666,8,5,3,4.603186691972131
38689,703-004-5392,777.7625,2,1,1,0.42916284074528077
38827,703-004-5399,4018.187,"","","",0.27920371738274696
39016,703-004-5380,4312.649,4,3,1,0.8591999693000262
39518,703-004-5396,3128.8481,5,2,3,0.82869444840066
39657,703-004-5398,7705.361,3,0,3,0.27920371738274696
39792,703-004-5397,979.2328,2,0,2,0.27920371738274696
40122,703-004-5396,6268.525,3,3,0,1.5460777379386148
40194,703-004-5389,3179.074,3,2,1,1.2068390421080744
40724,703-004-5395,6648.12,3,1,2,0.3790442522382316
40915,703-004-5381,7613.745,5,4,1,2.7541816559580745
41279,703-004-5395,6428.6597,3,2,1,0.6254067230762382
41358,703-004-5384,6280.905,4,1,3,0.7588761159406366
41518,703-004-5381,2259.9702,2,1,1,0.33853450732658075
41816,207-008-2398,4999.4385,2,0,2,0.27920371738274696
41915,207-008-2398,7157.33,1,1,0,0.4310230746121928
42055,703-004-5389,7213.9614,3,1,2,0.5165268771580819
42363,703-004-5389,3957.0618,2,2,0,1.030118509190506
42501,703-004-5396,4949.247,2,1,1,1.0713648772048152
42891,703-004-5397,3084.864,4,3,1,1.524046934818975
42908,703-004-5389,4974.046,9,7,2,2.464773095549032
42920,703-004-5399,6324.1006,6,2,4,1.886000191799087
43058,703-004-5381,1195.3903,"","","",0.27920371738274696
434,703-004-5389,7946.6,5,2,3,0.7443871177342557
4355,703-004-5393,4432.4126,1,0,1,0.27920371738274696
43662,703-004-5393,1681.0596,7,1,6,0.7081653286766648
4376,703-004-5382,5594.7065,2,0,2,0.27920371738274696
43928,703-004-5391,3534.9263,2,0,2,0.27920371738274696
44720,703-004-5398,5052.3667,4,3,1,0.9422982163299846
4476,703-004-5385,1397.5912,6,4,2,2.1900575379529816
45161,703-004-5385,5137.347,3,2,1,1.0124188339731577
45203,703-004-5383,4022.1465,5,3,2,2.2947365327554996
4531,703-004-5394,8072.77,2,2,0,0.7787789745440442
45433,703-004-5383,1889.7969,4,0,4,0.27920371738274696
45934,703-004-5385,7168.6084,4,2,2,0.8301852877502354
4595,703-004-5380,815.45355,1,1,0,0.47192910227778606
46324,703-004-5392,2690.5042,5,3,2,1.4043768548702107
46487,703-004-5386,8317.578,4,3,1,2.0698787906162814
46517,703-004-5381,4910.476,5,2,3,0.5663929201676591
46535,703-004-5389,1241.0217,3,3,0,0.8272886174755201
46584,703-004-5394,602.2155,2,0,2,0.27920371738274696
468,703-004-5386,7582.8027,4,2,2,0.7017219573666367
46823,703-004-5386,8967.034,5,1,4,0.47116061096108364
47091,703-004-5387,721.86945,4,4,0,1.572115737650876
47118,703-004-5381,2500.987,3,1,2,0.7243016579935138
47200,703-004-5386,1805.9242,1,1,0,0.33853450732658075
47374,703-004-5388,8318.565,2,1,1,0.7297227301614955
47385,703-004-5384,6115.968,2,1,1,0.36730001704854
47501,703-004-5391,4503.77,5,2,3,0.9008914367641985
47797,703-004-5393,8206.1455,2,0,2,0.27920371738274696
47841,703-004-5389,9053.862,4,3,1,0.7899311613391903
48102,703-004-5380,6005.1387,6,3,3,2.4315768999032126
48153,703-004-5387,2146.672,4,3,1,2.166711256147502
4828,703-004-5399,7978.6787,4,1,3,0.8707001730166262
48800,703-004-5391,1041.2592,3,3,0,0.9998914843554075
48805,703-004-5386,1758.7966,6,4,2,1.842688821452579
48860,703-004-5384,6936.5015,3,1,2,0.34693970256862383
49081,703-004-5391,6446.6353,4,2,2,0.4533989166578428
49215,703-004-5381,6641.5537,4,1,3,0.35831143730785864
49854,703-004-5399,8253.743,3,2,1,0.949090894443131
49985,703-004-5383,9694.797,1,0,1,0.27920371738274696
49991,703-004-5385,5116.706,2,0,2,0.27920371738274696
5211,207-008-2398,1946.4099,3,2,1,1.1110651784047612
5213,703-004-5399,923.7504,5,2,3,0.7469750424472743
5566,703-004-5380,9695.039,5,3,2,1.2440415512319418
5642,703-004-5393,4272.7573,6,4,2,0.9915625879797175
5663,703-004-5384,9367.366,3,1,2,0.7350978437499244
5682,703-004-5399,47.823788,3,2,1,0.9461204107039765
5984,703-004-5380,9384.652,3,2,1,0.8689014387627342
6116,703-004-5399,1554.0188,7,1,6,0.4281922696920456
626,703-004-5390,24.427773,4,2,2,0.6687963986899593
6261,703-004-5389,1125.3434,6,3,3,1.8541295301932232
6403,207-008-2399,6571.965,2,2,0,1.154982042809763
6491,703-004-5399,6001.0693,3,2,1,0.8554574665825064
6533,207-008-2399,6558.7197,8,5,3,2.0849055647561765
6806,703-004-5383,9085.384,5,2,3,1.4843046764676193
686,703-004-5384,3478.5254,6,2,4,2.595605608476701
6877,703-004-5384,1532.7365,4,1,3,0.8929928763520173
7197,703-004-5382,2835.6123,4,3,1,1.600708099985879
73,703-004-5389,2342.357,"","","",0.27920371738274696
7659,703-004-5394,3829.67,3,2,1,0.8210374639539412
7750,703-004-5385,9756.887,3,2,1,0.5744905868169597
7868,703-004-5395,8847.307,1,1,0,1.3936656497647297
7889,703-004-5393,3879.9136,9,5,4,1.9027552959004301
8203,703-004-5380,2108.1477,4,0,4,0.27920371738274696
8215,703-004-5392,4671.9116,4,2,2,0.6265176813856166
8481,703-004-5387,3615.21,2,1,1,0.655613441227389
8654,703-004-5391,5004.326,1,0,1,0.27920371738274696
87,703-004-5396,7417.2754,3,2,1,0.8516988014621412
8828,703-004-5388,6947.764,7,2,5,1.1012027787916432
890,703-004-5395,7833.7993,4,2,2,1.047258225613769
8950,703-004-5392,2525.6956,4,3,1,1.4619605007807355
9319,703-004-5385,2506.7627,5,1,4,0.5600227089097799
9354,703-004-5389,38.897396,2,2,0,0.7515887672959563
9357,703-004-5394,1847.4507,2,1,1,0.3439270169014758
9391,703-004-5389,1098.8104,1,0,1,0.27920371738274696
9408,703-004-5390,9751.418,2,1,1,0.42334650192381074
9581,703-004-5386,8063.5728,5,3,2,2.1259088225046514
974,703-004-5397,9747.3545,4,1,3,0.3978652972704144
9882,703-004-5399,2810.1938,6,1,5,0.8523491068580408
10052,703-004-5391,2629.7427,6,2,4,0.7460205469341636
1012,703-004-5386,4676.352,4,1,3,0.48657944044154544
10179,703-004-5381,3520.0977,5,2,3,0.8952599623230506
10251,703-004-5395,851.03094,1,1,0,0.4897927300944012
10294,703-004-5392,6360.442,4,3,1,0.9938269517640891
10363,207-008-2399,1794.3966,6,5,1,2.0591013411449066
10449,703-004-5390,4461.676,4,1,3,0.5970539198403767
10653,703-004-5390,1900.5144,7,6,1,3.358491576733872
10791,703-004-5390,8283.273,4,1,3,0.4747599180436008
113,703-004-5388,6357.762,1,1,0,0.3807252912866403
11427,703-004-5389,7509.0166,3,2,1,0.8121904137135536
11492,703-004-5387,209.78452,2,0,2,0.27920371738274696
11582,703-004-5382,9651.121,3,1,2,0.5042259059523899
11689,703-004-5383,6234.592,6,4,2,2.2592467192781314
11813,703-004-5380,2902.9602,5,4,1,1.48646992680837
11834,207-008-2398,2433.802,6,2,4,1.3977992069990444
11998,703-004-5394,6840.6562,2,2,0,1.025062652389189
1215,703-004-5394,3275.2048,5,3,2,0.6554674087854185
12176,703-004-5392,5877.589,2,0,2,0.27920371738274696
12285,703-004-5390,4497.7207,4,2,2,0.9897744666621145
12566,703-004-5391,7502.871,1,1,0,0.3663058492334156
12797,703-004-5397,4992.055,3,1,2,0.414920053698786
1298,703-004-5388,5037.567,3,2,1,1.0065785832194543
1314,207-008-2398,701.4728,5,2,3,1.8909999769783565
13441,703-004-5383,3549.6128,8,2,6,1.6597636670394904
1365,703-004-5381,609.7555,6,4,2,0.9171737669077487
14476,207-008-2399,2320.4458,4,1,3,0.534644300875013
14545,207-008-2398,4341.393,4,1,3,0.36593428997378474
14582,703-004-5395,5395.9907,4,2,2,2.0025488866901724
1556,703-004-5392,7332.408,6,2,4,0.7709871269899439
1569,703-004-5388,4555.1216,4,4,0,1.9263683098984237
16149,703-004-5394,7767.5454,7,4,3,2.0369673273747364
16284,703-004-5389,5132.7046,3,2,1,1.5247281498651044
16573,703-004-5394,3322.4255,4,1,3,0.7338561710441948
17251,207-008-2399,5338.762,7,3,4,1.7626131006872894
17433,703-004-5398,7981.2983,2,0,2,0.27920371738274696
17535,703-004-5393,3373.614,2,1,1,0.9624102482022208
17755,703-004-5395,512.55524,3,1,2,0.48236389995783113
17976,703-004-5380,3101.327,5,3,2,1.543498143267266
18064,703-004-5393,1294.9318,8,4,4,1.3143043947495816
18179,703-004-5391,3744.049,2,2,0,0.42627686918213126
18706,703-004-5393,9091.55,5,2,3,1.0418490140153602
18929,703-004-5390,660.5083,8,4,4,3.2220524895593616
19121,207-008-2398,5889.3555,3,2,1,1.5750294887065197
19712,703-004-5389,8552.435,5,2,3,0.9545487461902373
19799,703-004-5397,357.849,1,0,1,0.27920371738274696
19951,703-004-5392,832.7186,3,1,2,0.9007066584327637
20078,703-004-5394,3006.2402,3,0,3,0.27920371738274696
2026,703-004-5387,4942.872,4,2,2,0.6825630744507885
20261,703-004-5380,80.556274,5,3,2,0.9218574455720032
20481,703-004-5388,8946.715,2,1,1,0.409182516735386
20799,703-004-5388,5371.628,3,1,2,1.0562767319955675
20842,703-004-5386,2524.74,6,2,4,0.581620695013645
21108,703-004-5380,3312.18,6,4,2,1.5066840053685024
21177,703-004-5399,5281.7114,1,1,0,0.8048164481009107
21220,703-004-5384,1101.2274,4,1,3,0.5265218389558336
21363,703-004-5383,8734.063,6,3,3,0.6985357297796507
21524,703-004-5386,3471.3608,4,2,2,0.5086716489151857
21616,703-004-5399,1713.6776,"","","",0.27920371738274696
21795,703-004-5384,6195.1772,1,1,0,0.4573061600874196
21801,703-004-5382,8964.192,6,5,1,2.0254433711671265
21922,703-004-5393,3118.263,8,3,5,1.2389617658531231
22004,703-004-5385,1356.8961,2,0,2,0.27920371738274696
22047,703-004-5395,9841.144,5,4,1,1.6934041147031496
22115,703-004-5381,8218.673,4,1,3,0.7104097153624332
22247,207-008-2398,3400.4546,5,2,3,0.552724904276161
22268,703-004-5391,2919.252,1,0,1,0.27920371738274696
22890,703-004-5380,5377.4966,2,0,2,0.27920371738274696
22902,703-004-5389,6201.117,2,1,1,0.5006587879378276
22915,703-004-5393,2157.4546,6,4,2,2.0384085504468485
23258,703-004-5398,8577.325,4,0,4,0.27920371738274696
23636,207-008-2399,2497.0085,6,3,3,1.8197386700030203
23813,703-004-5391,5255.4707,4,2,2,1.7448021942027898
24256,703-004-5398,9942.432,3,2,1,0.5632840672293222
24267,703-004-5387,492.3165,6,2,4,0.6574578477702823
24305,703-004-5397,8637.676,2,2,0,0.9440630565703274
24446,703-004-5383,5167.616,1,0,1,0.27920371738274696
2447,703-004-5395,711.8505,2,0,2,0.27920371738274696
24478,703-004-5392,3150.0762,5,2,3,0.7398090140309819
24987,703-004-5393,3650.1384,4,2,2,1.1684548745886134
25029,703-004-5382,1010.85425,3,2,1,0.7791523101138627
25191,703-004-5383,7069.3804,2,1,1,0.8266667615604943
25331,703-004-5392,5646.0977,2,0,2,0.27920371738274696
25359,703-004-5399,5560.906,2,1,1,1.6213755094051454
25589,207-008-2398,6591.2397,6,4,2,0.9057552410593347
26153,703-004-5390,4356.0107,4,2,2,0.5473424764033433
26271,703-004-5390,4179.9355,5,2,3,0.5037506018719403
26526,703-004-5394,8172.685,5,4,1,1.200414042934021
26691,703-004-5388,2318.2827,7,4,3,4.220680898960677
26815,703-004-5381,265.93506,5,3,2,1.0638656433414144
26982,703-004-5388,8404.84,8,5,3,2.9058787112526896
27246,703-004-5392,8554.694,4,4,0,1.017597879612346
27268,703-004-5382,6721.3594,3,1,2,0.38071808094758464
27323,703-004-5395,8067.7085,8,1,7,1.0340561830735262
27335,703-004-5381,5294.6514,5,2,3,0.6519619462189344
27343,207-008-2399,3071.0793,3,2,1,0.5102360175517539
27394,207-008-2398,9743.689,4,2,2,1.8216477048785689
27433,703-004-5397,4398.3394,"","","",0.27920371738274696
27461,703-004-5389,9760.281,5,2,3,1.1601638986923368
27576,703-004-5398,7598.1265,3,0,3,0.27920371738274696
2759,703-004-5396,2260.8787,6,3,3,1.210050515212245
27646,703-004-5380,8582.601,3,1,2,1.6175351214495541
27827,703-004-5390,8019.6343,7,5,2,2.013485230231778
28027,703-004-5392,2933.9343,3,1,2,0.4741139965085353
28165,703-004-5385,7578.374,4,3,1,1.1125910087130337
28575,703-004-5380,7805.913,6,4,2,1.0934748690897484
28604,703-004-5390,9459.852,5,2,3,1.055090687333555
28642,703-004-5384,4639.998,3,2,1,0.8916989531155239
28946,703-004-5399,4860.4634,3,1,2,0.33853450732658075
28950,703-004-5390,3773.8877,8,5,3,1.7501140836956202
28994,703-004-5380,2776.5464,3,2,1,1.361131875889577
29058,703-004-5385,1075.1945,3,2,1,1.5321150593476098
29387,703-004-5399,7772.4604,6,4,2,0.8359541956416052
2943,703-004-5393,5920.2075,3,2,1,0.6320925430550058
29558,703-004-5386,3158.6992,8,6,2,2.058303694956149
29728,703-004-5386,2485.3545,3,0,3,0.27920371738274696
30,703-004-5387,2203.963,3,2,1,1.90570734555746
30113,703-004-5399,9179.739,4,3,1,1.1364699260997688
30350,703-004-5399,4292.525,6,5,1,1.947292708604065
30412,703-004-5395,6021.9263,3,2,1,0.5103145769498949
30503,703-004-5385,4979.1284,5,3,2,1.3739788112529894
30636,703-004-5392,2765.7563,4,2,2,0.5021886029216555
31160,703-004-5387,4243.849,4,2,2,0.5425721074927402
31344,703-004-5390,1152.3944,8,4,4,2.0469134500695145
32077,703-004-5386,3342.5134,5,3,2,0.867472798524309
32231,703-004-5386,6976.2534,6,3,3,0.8100323320795189
32262,703-004-5393,4404.305,"","","",0.27920371738274696
32266,703-004-5398,7895.367,3,1,2,0.45372188426021015
32279,703-004-5388,499.72116,4,1,3,0.5666193384588657
32427,703-004-5382,8134.2725,7,3,4,1.2795942007622076
32434,703-004-5386,3409.1406,2,0,2,0.27920371738274696
32465,207-008-2399,7450.782,6,1,5,0.43930751590600997
32622,703-004-5394,7818.6626,3,1,2,0.4203442794729041
3288,703-004-5384,3762.7244,4,2,2,0.693373746029049
33406,703-004-5385,34.846664,3,1,2,0.9053112740515201
3346,207-008-2398,7191.701,2,2,0,0.6485252245201871
33465,703-004-5386,4622.792,2,2,0,1.1842532445515623
33532,703-004-5384,645.18036,3,2,1,0.8322252232796479
33585,703-004-5391,2328.669,3,1,2,0.6009752483263647
33664,207-008-2399,2479.651,2,1,1,0.8788686290093835
33685,207-008-2398,7629.343,3,1,2,0.47903805830107116
3386,703-004-5385,7330.677,4,1,3,0.46152528910900503
34259,703-004-5398,1669.8456,3,2,1,1.1672743569904103
34275,703-004-5388,8332.972,2,0,2,0.27920371738274696
34382,703-004-5386,3714.7432,3,2,1,0.846758909329835
34409,703-004-5396,1633.9004,11,4,7,2.5934619871443028
3466,703-004-5392,8801.474,3,2,1,1.2053426462793735
3478,703-004-5398,1072.6631,4,3,1,1.532102785481561
34955,703-004-5385,6238.091,3,0,3,0.27920371738274696
35072,703-004-5383,9225.033,2,0,2,0.27920371738274696
35225,703-004-5392,2173.3987,2,1,1,1.3852822088812968
35472,703-004-5397,9870.994,4,2,2,1.7994833561092693
35474,703-004-5385,6679.0386,2,0,2,0.27920371738274696
35543,703-004-5390,8408.121,4,3,1,0.7550288419114496
35584,703-004-5387,5637.107,9,4,5,1.9136005723625706
35652,703-004-5382,7586.8853,5,3,2,1.6203433705257264
35787,703-004-5385,8801.771,7,4,3,2.0897907521156185
35833,703-004-5394,4036.95,6,2,4,0.806736992125484
35904,703-004-5385,4216.685,3,1,2,0.5546584063077109
3597,703-004-5382,5402.6494,4,3,1,1.6927920383724406
36098,703-004-5387,8573.959,3,1,2,1.0663735094536968
36129,703-004-5391,2600.0845,4,3,1,1.6427676773223396
3615,703-004-5394,4366.0854,7,4,3,1.3057792207989356
36224,703-004-5388,4459.649,2,1,1,0.35831143730785864
36614,703-004-5393,6100.0254,3,1,2,0.42569868883098055
36953,703-004-5383,6027.274,6,3,3,1.0525905983977857
37398,703-004-5394,5548.2656,2,1,1,0.4643145987393668
37579,703-004-5392,7282.65,5,2,3,0.9289277566067266
37958,703-004-5398,8198.648,5,0,5,0.27920371738274696
37975,703-004-5393,2991.488,4,1,3,0.5864060146514601
38227,703-004-5380,4802.0923,5,2,3,0.8473636891464525
38229,703-004-5384,6660.844,3,3,0,0.7787454752792492
38372,207-008-2398,9207.192,7,3,4,1.6564269973589099
38682,703-004-5384,8632.084,6,2,4,0.7547346904162942
38687,703-004-5383,4955.6885,"","","",0.27920371738274696
38998,703-004-5393,3228.8289,2,0,2,0.27920371738274696
39085,703-004-5397,5143.0713,4,1,3,0.4337975069301488
39388,703-004-5398,9424.227,"","","",0.27920371738274696
39489,703-004-5391,1268.1567,3,2,1,0.8032923618866116
39841,703-004-5386,2458.501,4,3,1,1.9498533135863036
3988,703-004-5388,1846.3457,6,3,3,1.32578919120035
40093,703-004-5383,7072.4863,3,3,0,0.6621251280508338
4015,703-004-5396,5711.8086,2,1,1,0.3978652972704144
40178,207-008-2398,8880.603,4,2,2,1.3964026368298357
4024,703-004-5389,6368.8125,5,2,3,3.2939863511089937
40276,703-004-5398,9827.69,3,1,2,0.35831143730785864
40409,703-004-5389,1652.2455,4,1,3,0.5584153984259294
40469,703-004-5388,4850.489,"","","",0.27920371738274696
406,703-004-5387,9401.1455,5,4,1,1.493519899005539
4094,703-004-5385,693.8058,3,3,0,0.8176341711411526
40944,703-004-5393,3851.896,2,1,1,0.5360505921176262
41007,703-004-5383,497.9056,3,3,0,1.5907285312182662
41203,703-004-5396,2694.7642,5,3,2,0.8902235324168802
4130,703-004-5389,5898.568,1,0,1,0.27920371738274696
42130,703-004-5387,7544.331,2,1,1,0.6216470645062541
4216,703-004-5388,5878.839,4,3,1,1.9420418030832878
42298,703-004-5399,6873.1206,5,2,3,0.8225414890970709
4269,703-004-5398,1897.6008,2,0,2,0.27920371738274696
42701,703-004-5399,6082.651,1,1,0,0.33853450732658075
42830,703-004-5385,9926.534,5,2,3,0.6617878054059814
43163,703-004-5396,4146.571,2,1,1,0.8104467725732255
432,703-004-5396,4751.2837,1,0,1,0.27920371738274696
43420,703-004-5389,8367.434,2,2,0,0.9973441539453901
43435,207-008-2399,4105.472,1,0,1,0.27920371738274696
43480,703-004-5386,7708.6953,4,2,2,1.126224214842561
43554,703-004-5387,3862.8828,3,1,2,1.1954458507822232
44023,703-004-5384,1904.5609,5,2,3,0.42484668031630074
44484,703-004-5389,937.25977,3,1,2,0.8320758883069224
44661,703-004-5380,7029.887,2,1,1,0.43428547561258657
44690,703-004-5392,6642.124,5,0,5,0.27920371738274696
4478,207-008-2399,1715.8318,3,0,3,0.27920371738274696
44900,703-004-5397,7240.9106,6,1,5,0.43255732861257284
44936,703-004-5398,6005.4253,9,4,5,1.4239356851352443
44954,703-004-5384,2838.7468,1,0,1,0.27920371738274696
45050,703-004-5383,7529.915,4,2,2,0.8238501406105857
45079,207-008-2398,8816.5,3,2,1,0.6933603622978795
45138,703-004-5383,2813.0447,8,6,2,1.6553348400630137
45208,703-004-5398,1301.4823,1,0,1,0.27920371738274696
45317,703-004-5380,5236.138,4,2,2,0.7877645854009144
45736,703-004-5386,6071.5728,5,4,1,1.278553471021958
45750,703-004-5392,9226.87,3,2,1,0.6664062414950402
45945,703-004-5388,7599.364,5,1,4,0.3704205391732067
45953,703-004-5387,1818.9388,6,2,4,0.6659987329408048
46055,703-004-5380,1551.3468,3,0,3,0.27920371738274696
46332,703-004-5393,3284.676,6,4,2,4.204187886099925
46364,703-004-5396,6211.404,4,2,2,0.8656992390234959
46459,703-004-5381,79.62882,2,1,1,0.33853450732658075
46484,703-004-5394,1196.8934,7,3,4,2.3614797708210187
46566,703-004-5387,9902.903,1,1,0,0.935028490648928
46673,703-004-5397,7571.636,7,3,4,1.3779936331688245
46834,703-004-5396,68.13526,4,2,2,0.8696034783759371
46892,207-008-2398,5178.4385,2,2,0,0.6459793541152357
47040,207-008-2398,5597.8564,8,4,4,1.8284278290655926
47100,703-004-5396,2739.455,4,2,2,0.8053877534583106
47348,703-004-5398,2208.225,3,2,1,2.324571018950454
47707,703-004-5390,9061.381,3,2,1,0.6627338270367373
48082,703-004-5395,5398.673,3,3,0,0.9952692920124054
48091,703-004-5393,5081.4243,5,2,3,1.0964630907741868
48131,703-004-5390,7596.103,4,3,1,3.9423280359010797
4823,703-004-5384,1892.2753,4,1,3,0.35831143730785864
48235,703-004-5385,4192.834,8,2,6,1.0500480595288109
4830,207-008-2399,4747.9595,4,1,3,0.6916740413465579
48334,207-008-2398,2255.478,1,0,1,0.27920371738274696
48389,703-004-5388,1361.4237,5,2,3,0.6504942883834932
48396,703-004-5384,5713.1157,3,1,2,0.4446047751261679
48460,703-004-5383,2384.7776,4,2,2,1.0184540958208395
48607,703-004-5384,7392.0117,1,1,0,0.8835527924631895
49264,703-004-5385,69.47577,4,1,3,0.389351122903787
49350,207-008-2399,9989.101,2,1,1,0.4260602184603415
49437,703-004-5396,7646.46,4,4,0,4.117862691367833
49566,703-004-5399,9114.902,5,2,3,0.5594685664283682
49839,703-004-5385,2234.8188,5,3,2,2.222883527677356
5415,703-004-5395,3317.5813,5,4,1,1.7152264723697948
5471,703-004-5388,6040.2007,2,1,1,0.5072328620467984
584,703-004-5389,1747.6177,2,0,2,0.27920371738274696
6023,703-004-5399,8063.292,3,1,2,1.4646586275112843
6038,703-004-5384,6425.6035,6,5,1,1.9784099042391825
6109,703-004-5389,210.88063,4,2,2,0.42818992324170724
6125,703-004-5393,4453.805,2,1,1,0.468398782852311
6208,703-004-5381,8169.2563,6,2,4,0.863076842130934
6319,703-004-5388,2180.5364,3,2,1,1.5191484994797144
6976,207-008-2399,2448.414,6,2,4,0.5985636859588069
8213,207-008-2398,1683.3008,6,5,1,1.6713270574877013
8332,703-004-5398,8227.039,5,2,3,0.8594163593269666
8899,703-004-5397,2858.2896,5,3,2,1.8108624281564933
9248,703-004-5382,8803.926,"","","",0.27920371738274696
9272,703-004-5392,5005.871,6,3,3,1.0238565610885684
9517,703-004-5394,1282.9327,3,2,1,1.7058352415570186
10013,207-008-2398,6083.293,7,2,5,2.33693438474324
10245,703-004-5385,5809.2397,2,1,1,0.43918330948328216
1031,703-004-5388,429.82758,6,4,2,2.415404890873807
10538,207-008-2399,5123.173,4,3,1,0.9831793020654355
10572,703-004-5384,7782.007,6,4,2,2.0413681252895937
10587,703-004-5390,6480.1475,3,3,0,2.530573328956932
11020,703-004-5384,7694.588,3,0,3,0.27920371738274696
11851,703-004-5396,3778.078,6,3,3,0.7850313383838462
11854,703-004-5385,5650.718,1,1,0,0.6376857074418555
11935,703-004-5383,3779.5908,4,3,1,1.361998382486121
12153,703-004-5393,7337.102,"","","",0.27920371738274696
12239,703-004-5393,6068.0713,5,1,4,0.35831143730785864
1226,703-004-5382,1546.0914,2,1,1,0.4627554219665545
12269,703-004-5382,5795.502,6,1,5,0.3902511792276225
12495,703-004-5389,9155.833,5,4,1,1.7553413465242051
12844,703-004-5386,5841.915,2,2,0,0.948792536682899
12906,703-004-5390,4572.403,1,1,0,0.3978652972704144
13077,703-004-5387,142.08496,3,2,1,0.5633130092672678
13314,703-004-5399,8136.4775,3,2,1,0.44085787093346496
1338,703-004-5391,4547.943,5,3,2,1.6748950765537225
13389,703-004-5396,8571.124,3,2,1,1.201383004768947
13401,703-004-5380,7123.6753,4,2,2,0.6044671328955625
13796,703-004-5390,9763.013,5,2,3,4.018550150402633
13947,703-004-5394,5634.636,7,2,5,0.8042812083856756
142,703-004-5383,9005.325,7,3,4,1.275823151822409
14234,703-004-5389,9282.796,5,4,1,2.79983731827461
14264,207-008-2398,8309.8,3,1,2,0.9824508731395362
14706,703-004-5394,704.74567,4,1,3,0.4394648783131382
14973,703-004-5389,8071.595,2,2,0,2.3249609075997415
15508,703-004-5380,1156.8875,4,1,3,0.35831143730785864
16114,703-004-5395,6160.0537,2,2,0,0.9168179387041436
16265,703-004-5391,3333.7605,7,2,5,0.6611852367267329
16551,703-004-5389,131.52301,5,3,2,2.0433158396076094
16803,703-004-5398,8974.119,2,0,2,0.27920371738274696
17382,703-004-5397,982.37036,5,1,4,0.8441210111293709
1745,703-004-5399,7006.3335,2,1,1,0.6343229520087768
17525,703-004-5389,5177.347,9,3,6,1.4585668808377703
17761,703-004-5382,5398.149,2,0,2,0.27920371738274696
17954,207-008-2398,6379.336,3,2,1,1.5282738736204702
17987,703-004-5399,2486.8435,2,1,1,0.8231532413304904
18046,703-004-5383,7108.616,4,3,1,0.6625962700332502
18093,207-008-2398,8104.443,3,3,0,3.309438656530057
1811,703-004-5387,3532.9146,5,2,3,1.0866084777948735
18118,703-004-5398,5570.704,"","","",0.27920371738274696
1837,703-004-5398,8923.606,"","","",0.27920371738274696
18472,703-004-5391,3328.7065,4,1,3,0.3978652972704144
18757,703-004-5390,7509.9004,3,2,1,0.6630589189113335
18812,703-004-5393,7177.8716,3,1,2,1.1051278008304763
19373,703-004-5383,4754.573,8,2,6,0.8494691122407568
1952,703-004-5381,9021.517,2,1,1,0.43488781172902796
19694,703-004-5383,9605.809,10,6,4,2.0055220439631536
19778,703-004-5381,2999.1316,2,0,2,0.27920371738274696
19943,703-004-5383,985.4376,3,1,2,0.8918631785442078
20122,703-004-5382,9885.8545,3,1,2,0.7147739572590095
20144,703-004-5399,4713.742,4,3,1,3.0375446150456833
20492,703-004-5382,4208.668,8,5,3,1.6743104281014607
20678,703-004-5398,1385.8068,4,2,2,0.9528772598377613
21096,703-004-5383,1412.3804,3,2,1,0.5538385276840103
21180,703-004-5393,4271.785,5,4,1,1.7530940420281427
21739,703-004-5385,4043.5266,4,1,3,0.5984370220513744
21847,703-004-5384,7222.6367,4,1,3,0.5165268771580819
22173,703-004-5387,2684.0156,3,2,1,0.6762156982919103
2220,703-004-5393,337.60132,3,2,1,0.611201708824756
22319,703-004-5394,5720.8486,4,1,3,0.7244131408360993
22322,703-004-5391,3809.6387,5,3,2,1.21751724017903
22332,703-004-5383,9172.329,4,3,1,0.6732777259794408
22651,703-004-5398,4460.1597,1,0,1,0.27920371738274696
22745,703-004-5396,4549.087,6,3,3,0.9304914153730997
22899,703-004-5390,3167.23,3,2,1,1.3318218697459268
23024,207-008-2399,4394.7334,4,3,1,2.844641551585934
23104,703-004-5381,4102.675,4,1,3,1.0454632670238757
23168,703-004-5392,7388.043,4,3,1,1.4374963995708718
23257,703-004-5388,547.1623,3,2,1,1.1687501017118553
23389,703-004-5387,8138.5986,2,2,0,0.8498009450680828
23445,703-004-5383,9669.869,3,2,1,0.4515914513086941
23473,703-004-5391,6290.3594,3,2,1,1.341005408579784
23780,703-004-5385,6876.807,5,4,1,2.3942034457160246
23977,703-004-5384,5923.193,5,2,3,0.7690915138844207
24058,703-004-5394,1664.9043,4,4,0,1.136876196568879
24341,703-004-5385,4176.4165,5,4,1,1.0813849240395406
24474,703-004-5398,8254.747,3,2,1,0.6727442008208996
24619,703-004-5388,8063.442,4,3,1,1.4253959754810794
24667,703-004-5381,5959.0557,5,3,2,1.6631468194197323
24668,703-004-5385,4177.997,3,1,2,0.8290419367016176
24692,703-004-5381,7936.8657,3,1,2,0.44997242293132855
24709,703-004-5398,8418.235,3,2,1,1.568780825872304
24715,703-004-5389,2115.242,3,1,2,1.0615792570010258
25024,207-008-2398,6645.441,10,4,6,1.6334126169324754
25440,703-004-5381,7154.0786,8,4,4,1.531480068223287
25933,703-004-5384,3852.1558,4,3,1,2.3190213423997452
26353,703-004-5393,2820.3027,2,1,1,0.6401589261413251
26411,703-004-5385,6441.531,4,1,3,0.4144678713524046
26685,703-004-5382,5097.218,4,1,3,0.44829646872267315
27322,703-004-5397,8758.307,8,3,5,1.6843174145441586
27402,703-004-5397,7481.4624,4,1,3,0.3706133717083753
27778,703-004-5384,2004.3248,2,2,0,1.3958482397633134
28057,207-008-2398,1435.9349,2,2,0,0.9663956253309105
28178,703-004-5395,6700.426,6,1,5,0.6173892200625992
28282,703-004-5395,8229.42,1,1,0,0.37512182779194486
28445,703-004-5381,5953.448,5,2,3,0.5953102804425132
28472,703-004-5386,7681.402,6,3,3,1.232701733121105
2850,703-004-5382,1627.0894,6,3,3,0.617815906676672
28779,703-004-5385,7059.941,1,1,0,0.49937785595526346
2894,703-004-5383,7187.869,5,0,5,0.27920371738274696
29247,703-004-5396,3280.9167,3,1,2,0.4031391452654219
29470,703-004-5394,7949.515,4,2,2,0.8721510191198156
29664,703-004-5381,1453.7377,5,4,1,1.458961130999028
30407,703-004-5388,9022.2,"","","",0.27920371738274696
30473,207-008-2398,9794.083,5,2,3,0.5539244585360119
30748,207-008-2398,3230.4722,10,4,6,2.11043747488187
3086,703-004-5384,3947.658,1,1,0,1.2510556415174172
3143,703-004-5382,5892.4907,7,3,4,0.7661737908461018
31512,703-004-5394,1500.1362,2,1,1,0.401637817296236
31759,703-004-5388,5571.04,3,3,0,2.322062942564332
31770,703-004-5384,5693.7617,8,3,5,2.069899168895298
31851,703-004-5385,1648.125,7,4,3,1.8789330741212014
32102,703-004-5383,3884.8972,1,1,0,0.7293866955804815
32221,703-004-5393,405.92313,11,4,7,2.785847308047167
32396,207-008-2399,3105.1511,4,2,2,0.7108981816310278
3267,703-004-5387,297.09518,9,6,3,1.901384107238108
32921,703-004-5385,8577.869,2,2,0,1.1324211949877012
32956,703-004-5381,5562.3555,5,2,3,1.0674403933268963
33020,207-008-2398,1840.589,9,5,4,1.4306889451919134
3311,703-004-5392,3244.5205,7,2,5,0.8970178304550567
3313,703-004-5382,8829.915,3,1,2,0.8639092536753595
33132,703-004-5393,3816.1309,6,2,4,2.8371088766100523
33164,703-004-5394,5865.1836,7,5,2,1.5953585467714777
33637,703-004-5392,7006.99,7,4,3,1.2094756998283354
33677,703-004-5398,9949.421,6,4,2,1.0503780864777381
33701,703-004-5386,9430.787,3,1,2,0.4770197179583805
34248,703-004-5392,6665.819,7,4,3,1.9654038303784032
3440,703-004-5394,6333.958,4,2,2,1.023798774062074
34415,207-008-2399,4519.046,4,3,1,1.1427470330993945
3445,703-004-5382,1144.5386,3,3,0,1.3902461556504795
34482,703-004-5392,7621.0986,5,2,3,1.260491775547886
34611,207-008-2399,9440.655,7,4,3,1.1098115443926515
34813,703-004-5393,4485.7495,3,1,2,0.41113199460683936
34816,703-004-5383,3961.7295,2,1,1,0.44829646872267315
34864,207-008-2398,2645.1462,7,3,4,0.6045674078555872
35104,207-008-2399,2816.7634,5,2,3,0.39881385301286426
35202,703-004-5386,2676.1401,3,1,2,0.32666834933781397
35339,703-004-5394,8823.364,2,0,2,0.27920371738274696
35558,703-004-5398,6587.146,7,3,4,0.7654013501030752
35692,703-004-5390,5024.574,2,1,1,0.5582936400532001
35790,703-004-5397,3627.3904,8,4,4,3.0673561932412468
3621,207-008-2399,7890.1714,4,2,2,0.9990045501724105
36399,703-004-5391,4952.0195,5,1,4,0.3679173747273365
36405,703-004-5398,6777.179,8,3,5,0.9828912447912443
36530,703-004-5397,9650.218,3,2,1,0.7342731311278433
36773,703-004-5382,3911.559,3,2,1,0.6128773843592242
36991,703-004-5382,4167.2866,5,2,3,0.7548834068178147
37139,703-004-5395,6553.4116,5,1,4,0.3657827219674525
37279,703-004-5383,1418.2573,3,2,1,1.5122300271252536
3732,703-004-5398,5636.7563,4,2,2,0.804640407606872
37508,703-004-5392,8518.309,3,1,2,0.37320593770000854
37692,703-004-5386,2269.9053,4,1,3,0.85950684440642
37696,703-004-5398,4899.4355,2,2,0,1.0337574528101126
37851,703-004-5396,4365.328,7,4,3,1.4376762898587387
38096,703-004-5386,2691.2075,3,0,3,0.27920371738274696
38337,703-004-5396,5786.984,7,3,4,0.9122782213270052
38645,703-004-5380,7035.099,5,5,0,2.222145364559678
3885,703-004-5385,7060.9653,5,3,2,1.925154924930798
39113,703-004-5383,949.0824,2,2,0,0.49846344994471964
39145,703-004-5391,2264.607,4,2,2,1.3952750621781647
39353,703-004-5393,701.0305,2,1,1,0.5165268771580819
39494,703-004-5385,8333.096,2,2,0,0.7749237800909017
39713,207-008-2399,9292.126,6,3,3,1.0332752746546756
39903,703-004-5383,1871.159,6,4,2,2.3771201824780497
39941,703-004-5388,3516.2961,2,0,2,0.27920371738274696
40039,703-004-5390,2674.3716,3,2,1,0.5361736551983162
40070,703-004-5386,7630.6484,4,2,2,0.7523337780043806
40168,703-004-5399,5240.9556,3,2,1,0.727318788475892
4033,207-008-2398,2466.8835,6,0,6,0.27920371738274696
40383,703-004-5390,4642.999,5,2,3,0.5335963803724226
40905,703-004-5382,7506.7383,2,1,1,0.8995803256836764
41163,703-004-5392,8460.826,6,2,4,0.7665590941084595
41523,703-004-5390,3869.5479,1,1,0,0.6173892200625992
4164,207-008-2399,4649.2993,1,0,1,0.27920371738274696
41872,703-004-5395,5647.64,5,3,2,0.6635026940319856
41911,207-008-2399,2951.8157,3,1,2,0.5864257024737378
42030,703-004-5399,3471.9138,3,1,2,0.4000925007918898
42162,703-004-5391,7503.348,2,0,2,0.27920371738274696
42250,703-004-5386,9142.96,2,1,1,0.4894661656676055
42390,703-004-5391,5999.199,"","","",0.27920371738274696
42554,703-004-5381,2485.8445,3,1,2,0.5165268771580819
42855,703-004-5385,3981.2178,4,1,3,0.5669580486103406
42889,703-004-5397,9273.991,3,2,1,0.6286162824193553
4302,703-004-5393,5473.3555,5,3,2,1.5796686934141337
4320,703-004-5390,9875.503,3,3,0,3.311963918331654
43723,703-004-5385,4878.332,3,1,2,0.7233141595098286
44013,703-004-5395,7284.2573,4,1,3,0.7172486107012693
44036,703-004-5380,963.18066,4,4,0,0.905933947325363
44089,703-004-5381,5311.659,5,3,2,1.1594525235006714
44809,703-004-5386,7481.4297,3,0,3,0.27920371738274696
44845,703-004-5389,5393.405,6,4,2,1.582814937169961
45022,703-004-5395,9793.442,9,5,4,2.608508233867784
45059,703-004-5383,7083.686,4,2,2,1.472859269741889
45235,703-004-5385,9429.957,6,2,4,0.5011648437667244
45355,703-004-5384,7276.028,3,1,2,0.49022132553664516
45363,207-008-2398,310.22488,3,2,1,1.552582014720758
4544,703-004-5384,5683.019,6,2,4,1.0448292348148154
45622,703-004-5398,7143.93,1,0,1,0.27920371738274696
45624,703-004-5385,1760.5566,3,3,0,2.075688785475249
45941,703-004-5383,4095.7063,2,0,2,0.27920371738274696
46275,703-004-5391,9967.907,3,1,2,0.7713518318681111
46382,703-004-5383,3600.5479,4,2,2,0.46728232150469984
46422,703-004-5380,7822.7373,3,1,2,0.7930717734103717
46501,703-004-5399,1617.393,4,1,3,0.4230808829965438
46652,703-004-5396,7244.2363,3,1,2,0.6720678591664105
46753,703-004-5393,2870.2063,4,3,1,1.0149296495939868
46888,703-004-5393,9562.526,6,4,2,2.0480988898673913
47017,703-004-5395,8014.211,3,1,2,0.5165268771580819
47238,703-004-5389,5740.9014,3,0,3,0.27920371738274696
47290,703-004-5389,6559.624,5,4,1,1.91141782686408
47473,703-004-5395,1012.8015,9,3,6,2.2876666655001086
47474,703-004-5389,2037.6182,"","","",0.27920371738274696
47639,703-004-5389,4701.917,5,1,4,0.406282929234035
47748,703-004-5389,9784.847,5,3,2,0.6224133188413117
47942,703-004-5381,2326.2458,6,3,3,3.5524899861177075
48180,207-008-2399,7194.1284,2,1,1,0.43679707333221196
4841,703-004-5392,3702.8748,4,3,1,2.1301708592541426
48470,703-004-5383,7286.404,7,3,4,0.7322161453926148
4861,703-004-5389,2624.8752,2,2,0,1.409550330688053
48858,703-004-5384,7775.0635,4,1,3,0.6267935240841579
48939,703-004-5395,3645.1072,6,2,4,1.1802809935335759
49076,703-004-5395,2473.3103,4,1,3,0.7533394343815778
4911,703-004-5387,1186.8209,6,0,6,0.27920371738274696
49601,703-004-5381,7240.816,2,0,2,0.27920371738274696
49779,703-004-5380,8338.962,7,4,3,1.4670363573661505
4991,703-004-5399,2479.363,2,2,0,1.0818822113865376
5141,703-004-5393,8517.479,"","","",0.27920371738274696
516,207-008-2399,6337.4775,8,6,2,2.7226106009693725
5284,703-004-5386,607.0274,3,2,1,0.747029759231607
5299,703-004-5389,3218.9788,3,3,0,0.6012712578978926
5531,703-004-5383,4577.8877,5,3,2,1.3050669405392086
5545,703-004-5399,8605.142,6,1,5,0.33853450732658075
5702,703-004-5392,9184.438,4,3,1,1.205435100394472
5923,703-004-5392,3480.8892,5,2,3,0.7844536274568692
6640,703-004-5381,4174.9507,4,1,3,0.46910440508552187
6726,703-004-5380,2298.8887,7,3,4,1.26361946766766
6738,207-008-2398,840.66394,9,4,5,2.2474572825949526
6775,703-004-5396,4120.118,1,1,0,1.4822006741856149
6790,703-004-5387,536.6516,3,2,1,0.5147224677369329
7199,703-004-5389,9540.999,5,3,2,0.9571476643855711
7254,703-004-5397,4448.3125,5,3,2,0.9582040305443974
7442,703-004-5380,2500.1526,6,4,2,1.1716806669958482
7458,703-004-5392,6126.5254,8,7,1,3.1816002372078036
7500,703-004-5382,3667.0203,5,2,3,0.5504062310869162
7792,703-004-5397,4883.6567,3,2,1,1.159806997184297
7835,703-004-5393,1375.5918,4,3,1,0.9419733013902332
7905,703-004-5386,5429.4824,5,3,2,2.559536762507144
8132,703-004-5381,2215.807,7,3,4,1.261101101869246
8264,703-004-5390,3854.8047,2,0,2,0.27920371738274696
8521,703-004-5381,1012.6382,3,2,1,1.0076101538234674
8722,207-008-2398,605.1832,5,3,2,3.007956754910464
8785,703-004-5392,2351.8752,5,2,3,2.304932212601388
8814,703-004-5393,5685.243,6,4,2,0.9071639954088004
8930,703-004-5382,3623.0518,3,3,0,0.6888828219449189
9159,207-008-2399,7436.3677,1,0,1,0.27920371738274696
9342,703-004-5393,598.2536,3,3,0,0.7573115559062961
960,703-004-5390,9949.713,3,2,1,1.6922808477705702
9890,703-004-5380,1531.6332,6,2,4,1.3317431248012703
9916,703-004-5390,1240.4275,9,4,5,1.7647622026670866
9997,703-004-5388,2462.235,1,1,0,0.5221911162992812
10072,703-004-5383,6763.1196,8,6,2,2.1300229688768813
10092,703-004-5383,7784.0723,3,2,1,0.6275758843651308
10246,703-004-5391,6224.4014,4,2,2,0.5313150731129688
10308,703-004-5390,1838.4653,11,3,8,1.523644313174797
10409,703-004-5390,9015.166,3,1,2,0.4090167762890445
10652,207-008-2399,2271.3042,7,5,2,1.3912776008961538
10708,703-004-5382,8837.2295,8,6,2,2.3748602509760848
1095,703-004-5386,3450.3079,3,2,1,0.5881076858230261
10958,703-004-5395,6469.5454,4,2,2,1.412211001209509
11030,703-004-5380,5077.002,4,1,3,1.2405945809440808
11523,703-004-5399,908.0893,4,1,3,0.7948551353764152
11758,703-004-5388,1574.586,4,2,2,1.0957828417925395
11782,703-004-5394,674.3264,5,3,2,1.4817735561926746
12148,703-004-5398,243.74484,3,2,1,1.1700264555882856
12664,703-004-5391,939.98846,7,2,5,1.4839520728412425
12689,703-004-5394,8400.5205,6,3,3,3.4181364589944137
13089,703-004-5382,8765.631,3,3,0,0.8369380487461147
13163,703-004-5388,2854.793,5,3,2,1.6769472760874857
13164,703-004-5383,2955.693,3,1,2,0.6790249527264887
13194,703-004-5393,1011.2941,1,0,1,0.27920371738274696
13264,703-004-5388,5828.691,4,1,3,0.7054860456240547
13423,703-004-5387,9414.482,2,1,1,0.5165268771580819
1374,703-004-5391,4399.489,5,0,5,0.27920371738274696
13791,703-004-5382,3456.9453,9,3,6,1.0809412438208283
13939,703-004-5394,4304.6064,6,3,3,1.274118037407416
14073,703-004-5384,926.3128,4,1,3,0.5669580486103406
14096,703-004-5380,4723.202,2,0,2,0.27920371738274696
14257,703-004-5396,5766.821,5,1,4,0.5900800816858505
14278,703-004-5386,5191.6807,"","","",0.27920371738274696
14521,703-004-5391,6702.6455,5,1,4,0.6741385505120665
14885,703-004-5387,3040.97,7,5,2,1.1674497605353125
14923,703-004-5389,7425.0913,5,3,2,1.2049629920895728
15285,703-004-5391,4388.103,2,1,1,0.48480495614769525
15327,703-004-5399,8033.321,4,3,1,4.109769567681842
15358,703-004-5393,9199.151,8,7,1,2.424140358662694
15386,703-004-5389,6069.5654,4,0,4,0.27920371738274696
15579,703-004-5394,8307.768,2,1,1,0.35831143730785864
15750,703-004-5399,1824.3623,2,1,1,0.4517589948720852
15817,703-004-5388,9594.593,4,0,4,0.27920371738274696
15892,703-004-5387,4478.0874,"","","",0.27920371738274696
15904,703-004-5392,9456.783,1,1,0,0.7554469651425664
15979,703-004-5395,642.64716,7,3,4,2.606337561253512
16151,703-004-5393,8270.451,3,3,0,2.0904629772764194
16321,703-004-5390,2818.8347,3,2,1,0.6373997546237031
16361,703-004-5382,1793.6742,3,1,2,0.47561363687199143
16587,703-004-5387,2168.8955,2,0,2,0.27920371738274696
16596,703-004-5389,5903.3643,5,0,5,0.27920371738274696
1666,703-004-5386,1661.5736,6,2,4,1.0564943872148393
16977,207-008-2399,5632.406,4,2,2,0.7096683753552419
17091,703-004-5392,9366.273,5,3,2,2.1855658381464877
17163,703-004-5389,3789.4458,3,1,2,0.5694079680718038
17216,703-004-5393,3823.1802,7,1,6,0.8581015716640579
1726,703-004-5380,878.9843,2,1,1,0.5731773395365177
17571,703-004-5386,1073.2001,5,3,2,1.008641213236935
17766,703-004-5392,7600.8804,4,1,3,0.3978652972704144
17980,207-008-2399,6120.5,8,5,3,1.5625924838227994
1801,703-004-5385,6880.444,"","","",0.27920371738274696
18018,703-004-5393,3953.9128,5,3,2,2.3156979913263487
18048,703-004-5395,1055.2585,4,1,3,0.5385694211118721
18217,703-004-5386,5462.3086,6,5,1,1.758565832840529
18368,703-004-5396,3011.408,4,2,2,0.8078517350569839
1843,703-004-5390,6094.4663,2,1,1,0.45563085500082035
18606,703-004-5387,2947.7222,5,2,3,1.3840905256838045
18983,703-004-5388,3621.8416,1,0,1,0.27920371738274696
19327,703-004-5393,5245.0405,3,2,1,0.9169050444024917
19473,703-004-5382,2198.8672,4,3,1,0.8599279104045501
19794,703-004-5382,1467.4913,4,2,2,0.3978652972704144
19969,703-004-5397,1521.5928,4,2,2,0.7108235804050185
20077,703-004-5392,5827.097,3,2,1,1.4251761958755536
2024,703-004-5394,2111.857,8,5,3,2.4201966849381544
20368,703-004-5393,892.0002,5,2,3,0.6039282494768716
20523,703-004-5386,4031.0771,1,1,0,0.7317661006766136
20566,703-004-5396,2318.3489,5,3,2,1.00345966897894
2061,703-004-5392,5181.1313,6,1,5,0.4256984391649715
20827,703-004-5384,4037.3123,4,3,1,1.5751193106463255
21256,703-004-5380,2262.8564,2,1,1,0.3978652972704144
21292,703-004-5390,4864.5273,7,4,3,1.355494503873146
21326,703-004-5398,8798.864,5,0,5,0.27920371738274696
21771,207-008-2399,915.2591,3,1,2,0.3978652972704144
21954,207-008-2399,9432.949,4,1,3,0.4752771454496315
22069,703-004-5385,1426.6246,3,2,1,0.48776998490718004
2219,703-004-5389,297.68466,4,0,4,0.27920371738274696
2230,207-008-2398,8344.663,6,1,5,0.3688063948179234
22451,703-004-5383,1058.8407,2,1,1,1.8769193384887077
22941,703-004-5399,1295.3019,3,3,0,1.1389781394310368
23708,703-004-5383,599.22156,5,3,2,0.9325401751093398
2388,703-004-5392,8950.947,1,0,1,0.27920371738274696
24270,703-004-5392,3685.4028,2,1,1,0.37949598295036957
24514,703-004-5398,9344.082,4,1,3,0.7174445620993907
24675,703-004-5391,9484.953,1,1,0,0.7927533510421719
24679,207-008-2399,5982.505,4,4,0,1.2430275340398589
24861,703-004-5382,9520.053,4,2,2,1.4349225919683566
25232,703-004-5382,9600.016,6,3,3,2.260492150094797
25448,207-008-2399,5193.0376,2,2,0,0.5679923983446945
2559,703-004-5391,665.20215,3,2,1,1.2474853862819448
25898,703-004-5393,8040.875,4,2,2,2.006824856753801
26015,703-004-5386,7328.574,4,0,4,0.27920371738274696
26164,703-004-5386,156.74054,2,1,1,0.36795269067373165
2622,703-004-5384,9890.839,7,2,5,0.48911739567253154
26273,703-004-5393,7661.9375,1,1,0,0.472581214097393
26407,703-004-5381,4954.891,2,2,0,1.3024076697030857
26612,703-004-5397,1008.04266,3,0,3,0.27920371738274696
26858,703-004-5396,1908.9073,4,3,1,0.623214925413102
26965,703-004-5387,4282.766,6,4,2,2.686386766247672
27223,703-004-5398,7447.553,9,4,5,1.6841797061099932
27463,703-004-5389,7091.91,3,2,1,0.74237562242194
27661,703-004-5399,2245.5203,5,2,3,1.256324451196241
27705,703-004-5387,9949.028,6,4,2,1.2709007227215083
2783,703-004-5399,7418.037,2,1,1,0.7105452194543689
28000,703-004-5388,5126.665,5,3,2,2.2751708511996624
28032,703-004-5391,2491.1243,3,0,3,0.27920371738274696
28050,703-004-5389,3558.3777,5,4,1,1.7842623451562996
28078,703-004-5396,7611.2314,2,1,1,0.446454451332223
28108,703-004-5393,6968.2793,4,1,3,0.5307549634520267
2815,703-004-5391,3547.477,5,4,1,1.858672228557234
28276,703-004-5392,4776.7295,6,1,5,0.3637500930527101
28299,703-004-5398,488.84213,2,1,1,0.3705334289347922
28491,703-004-5399,1536.7871,4,2,2,1.2385577111332264
28525,703-004-5390,5271.759,3,0,3,0.27920371738274696
2938,703-004-5387,7104.98,3,3,0,1.9647178687145073
29437,703-004-5385,9555.754,5,3,2,0.7450708078789318
29442,703-004-5384,8728.946,3,2,1,1.1774674094000441
29916,703-004-5390,4467.4497,3,1,2,0.4880460378881687
30042,703-004-5383,3939.9058,6,2,4,0.8056255968956862
30075,703-004-5383,2801.4438,3,3,0,0.530788515790831
30349,703-004-5399,5351.492,3,1,2,0.3534887505280491
30405,703-004-5381,8609.897,6,4,2,1.8260490372080505
30646,703-004-5387,8823.434,2,0,2,0.27920371738274696
30661,703-004-5391,2795.8232,2,2,0,0.7968831233626845
30844,703-004-5394,6101.167,7,4,3,2.4170160156775427
3100,703-004-5397,5662.6147,7,3,4,1.0603419157124065
31979,703-004-5388,6078.0176,5,2,3,0.8867242520490267
32249,703-004-5390,6135.1133,"","","",0.27920371738274696
32357,207-008-2399,5210.9946,5,3,2,1.0478743971065247
3244,703-004-5396,6609.0947,1,0,1,0.27920371738274696
32456,703-004-5386,1196.0316,1,0,1,0.27920371738274696
32522,703-004-5383,3221.2097,1,1,0,0.35831143730785864
32601,703-004-5382,2079.175,6,4,2,1.5414423613998018
32635,703-004-5389,9104.551,1,1,0,0.9469410667279692
32679,703-004-5388,6682.0347,3,1,2,0.6002341197952249
32748,703-004-5380,4811.583,9,5,4,2.18777640406626
3286,703-004-5393,8353.662,3,0,3,0.27920371738274696
32937,703-004-5392,7867.328,5,5,0,1.6043840307608452
3342,703-004-5393,8451.909,2,1,1,0.35534489781066697
33962,703-004-5396,2984.417,4,2,2,0.7954924747077203
3423,703-004-5399,2863.769,4,1,3,0.48827679773795524
34430,703-004-5390,4509.9907,5,2,3,0.8783152379532949
34722,703-004-5398,5937.27,4,3,1,2.472623140035506
35129,703-004-5398,5846.084,7,1,6,1.178773800586326
3543,703-004-5396,6445.7656,5,2,3,0.8354976948869105
35549,703-004-5387,582.7928,3,0,3,0.27920371738274696
35644,207-008-2398,7996.748,2,1,1,0.4422045116239453
35941,703-004-5387,2293.0378,1,0,1,0.27920371738274696
36028,703-004-5381,7605.124,2,2,0,1.2687502874258914
36341,703-004-5392,912.68243,6,5,1,1.6649617847443083
3651,207-008-2399,6728.275,4,2,2,0.6334344376297162
3677,703-004-5391,6579.94,3,3,0,0.7355932560999017
36819,703-004-5390,6108.3965,4,1,3,0.4663168649958331
36979,703-004-5384,5084.86,3,0,3,0.27920371738274696
37130,703-004-5395,3658.2756,7,3,4,1.3231426984756922
37430,207-008-2398,1185.1477,6,2,4,0.9886871112539362
37504,703-004-5396,2337.2483,5,2,3,0.5344938688809693
38075,703-004-5382,8643.448,2,1,1,0.3591912151841763
38086,703-004-5396,3435.43,6,3,3,1.3007490659181633
38194,703-004-5389,7060.7666,"","","",0.27920371738274696
3825,703-004-5399,398.7211,2,0,2,0.27920371738274696
38323,703-004-5395,8612.264,4,3,1,0.8130211414262075
38654,207-008-2399,4699.863,2,0,2,0.27920371738274696
38674,703-004-5387,2747.768,6,3,3,3.146792694025435
38807,703-004-5387,6412.2124,6,2,4,0.6493345192502491
38956,703-004-5389,5766.003,7,4,3,2.597651975709433
39203,207-008-2398,37.112236,3,2,1,0.5668984915530901
39452,703-004-5397,1353.1757,5,1,4,0.6802574309288539
39466,703-004-5383,3631.3235,"","","",0.27920371738274696
39505,703-004-5398,4056.7434,2,0,2,0.27920371738274696
3972,703-004-5385,6231.7817,4,1,3,0.4860292435772
39867,703-004-5398,2309.079,2,0,2,0.27920371738274696
40009,703-004-5382,4719.322,7,3,4,1.4148396374978522
40080,703-004-5390,7750.418,5,1,4,0.34930366373044847
40454,207-008-2398,1322.6521,3,0,3,0.27920371738274696
4047,703-004-5395,9420.864,7,5,2,1.7517014691287072
40955,703-004-5386,5619.3105,3,2,1,1.5295237284781253
40998,703-004-5391,4364.9434,4,2,2,0.6454938719428005
41193,703-004-5385,9384.197,4,0,4,0.27920371738274696
41464,703-004-5393,7526.7656,5,1,4,0.4655371585076228
41612,207-008-2399,9200.861,5,1,4,0.46156255875533947
41705,703-004-5388,1507.8336,3,2,1,0.704977149079393
42028,703-004-5397,2364.2476,2,0,2,0.27920371738274696
4219,703-004-5397,5918.1704,3,0,3,0.27920371738274696
42192,703-004-5393,6835.9053,10,5,5,1.1939543628479057
42256,703-004-5388,6956.843,4,4,0,2.0117926238190154
42303,703-004-5387,1264.4613,2,0,2,0.27920371738274696
42367,703-004-5380,2693.9988,3,1,2,0.3983714694813131
42446,703-004-5398,6748.6274,3,1,2,0.4092894941618434
42602,703-004-5386,5567.649,5,3,2,0.8955988401118442
43207,207-008-2398,8562.368,5,4,1,1.1969645928841404
43313,703-004-5395,730.01263,4,1,3,0.3902511792276225
43497,703-004-5395,2507.5276,1,1,0,0.36795269067373165
43562,703-004-5392,4531.925,3,1,2,0.48759882124520515
4383,703-004-5395,941.0906,6,1,5,0.8284490326533509
43980,703-004-5393,1824.8641,6,2,4,1.1477840537178956
44124,703-004-5383,716.36615,3,3,0,1.7671851422195706
4433,703-004-5385,3083.759,4,1,3,1.4419827109032377
44486,703-004-5387,7860.3477,6,5,1,1.3627329471123892
44519,703-004-5386,6582.234,8,3,5,1.478586591355052
44718,703-004-5387,8606.577,8,4,4,3.0171531700379015
4477,703-004-5390,2121.1846,5,5,0,1.9433505653620555
44922,703-004-5394,8993.3545,4,2,2,1.3219483945293564
45245,207-008-2398,6671.9673,3,1,2,1.8268890987583422
45283,703-004-5380,7996.427,4,0,4,0.27920371738274696
45360,703-004-5380,3850.9016,7,4,3,1.8749949694052817
45397,703-004-5398,9598.571,6,2,4,0.9726847171802234
4541,703-004-5385,9267.623,3,3,0,1.2675529663260996
45473,703-004-5385,9.380579,4,1,3,0.7974015106707825
46020,703-004-5381,6844.6455,5,2,3,0.8426144836391046
46073,703-004-5391,1782.0829,5,4,1,2.1782111428415845
46123,703-004-5398,8778.627,5,2,3,0.8790459870905541
46213,703-004-5392,2599.3508,3,1,2,0.36951836429724944
46432,703-004-5393,9239.057,3,0,3,0.27920371738274696
46556,703-004-5399,8300.832,3,2,1,1.769176305181429
46708,703-004-5394,2169.4004,2,1,1,0.5165268771580819
47068,703-004-5393,2783.9524,3,1,2,0.4031050304217212
47163,703-004-5396,7497.2485,4,2,2,0.5965874451152986
4725,703-004-5389,3175.072,5,2,3,0.868403290772083
47629,703-004-5389,8887.0,5,3,2,1.132746810389429
47634,703-004-5394,8968.492,4,2,2,1.2107808884718083
48058,703-004-5383,8663.858,4,3,1,0.5305487205148078
48286,703-004-5399,6500.596,2,1,1,0.45367263594163726
48369,207-008-2398,3134.0737,3,1,2,0.4752771454496315
4839,703-004-5392,8415.222,5,2,3,1.5330379032261656
48747,703-004-5392,584.0403,9,5,4,2.776571444634767
48967,703-004-5394,7918.1226,8,4,4,1.0863037661054906
49213,703-004-5384,6411.617,4,0,4,0.27920371738274696
4936,703-004-5394,126.52278,4,3,1,2.0175572134879545
49444,703-004-5395,1328.5714,2,1,1,0.3383696995767367
49702,703-004-5380,819.57635,2,1,1,1.5305718457744697
49777,703-004-5380,4233.9575,2,1,1,0.3187575773453028
49825,703-004-5393,8924.431,5,3,2,1.2369580534219684
49910,703-004-5386,1083.4915,4,1,3,0.77060337358669
5074,703-004-5397,4028.9211,3,2,1,0.6401360680999406
5214,703-004-5390,8804.489,5,3,2,0.7914049042065852
5304,703-004-5390,5835.278,9,4,5,1.9102614237327573
5310,703-004-5397,6292.633,2,1,1,1.0076851905951507
5313,703-004-5388,9033.372,2,2,0,0.9751709080104889
5315,703-004-5397,4022.0154,3,2,1,0.8538667391608993
5369,703-004-5399,219.80464,1,0,1,0.27920371738274696
5404,703-004-5399,6405.277,6,4,2,1.07260138974764
571,703-004-5386,5601.569,3,3,0,0.944958195053279
5751,703-004-5390,1558.2228,3,0,3,0.27920371738274696
588,207-008-2399,879.16675,7,3,4,1.3749763460966646
5895,703-004-5396,2092.7285,2,1,1,0.6170370064748333
6096,703-004-5383,9340.42,8,3,5,2.227892229364221
6515,703-004-5396,6966.001,6,4,2,1.110976401104497
6614,207-008-2398,2960.387,3,2,1,0.562631845176936
668,703-004-5381,8560.012,5,3,2,0.7733550089288943
6728,703-004-5399,4009.53,4,2,2,0.68726920551778
6931,207-008-2399,2165.2031,2,1,1,0.35831143730785864
7228,703-004-5398,5519.802,4,2,2,0.73099789234669
7234,703-004-5384,3365.9048,4,4,0,1.5659631391820565
7611,207-008-2398,9165.723,4,0,4,0.27920371738274696
7636,207-008-2398,340.09457,2,0,2,0.27920371738274696
7801,207-008-2398,1132.6337,3,2,1,1.095258627379715
7828,703-004-5399,3139.922,2,1,1,0.6220217714215035
8154,703-004-5394,8672.257,8,3,5,0.7271810641474027
8199,703-004-5395,1232.3635,8,2,6,1.1518988468023708
8531,703-004-5397,2382.8716,2,0,2,0.27920371738274696
8543,207-008-2399,4559.0156,5,1,4,0.35831143730785864
8773,703-004-5380,2114.2913,4,2,2,1.176840487136616
9271,703-004-5381,7513.6387,4,2,2,1.7859302298573152
9570,703-004-5384,8424.447,1,0,1,0.27920371738274696
10098,703-004-5396,458.42825,4,2,2,1.5049013246677245
10401,703-004-5390,7030.178,2,1,1,0.3978652972704144
10667,703-004-5399,3705.4526,4,2,2,0.8135532923918979
11010,703-004-5386,6031.921,3,2,1,0.8206771485301267
11253,207-008-2398,6683.461,5,4,1,1.9713527041970607
11876,703-004-5390,7816.2925,2,1,1,0.6371607723583955
11889,703-004-5382,3669.185,3,1,2,0.7787121310785489
11975,703-004-5389,828.97125,3,2,1,0.9767597897444995
12029,703-004-5394,3079.6855,1,1,0,0.35831143730785864
12070,703-004-5393,5024.5596,2,1,1,0.5818034287183679
12126,703-004-5398,8969.256,3,0,3,0.27920371738274696
12172,703-004-5392,5809.899,3,2,1,1.183328878462466
12369,703-004-5397,7169.888,3,0,3,0.27920371738274696
12594,207-008-2398,5878.841,5,5,0,2.3224308134012435
12673,703-004-5382,8776.728,4,3,1,1.7086340514729357
127,703-004-5390,1032.6993,3,2,1,1.9571309692314114
13058,703-004-5382,1545.4531,2,2,0,1.3748510124204634
13114,703-004-5382,3227.315,2,0,2,0.27920371738274696
13165,703-004-5381,2615.9722,1,1,0,0.3939134428687984
13169,703-004-5392,2173.7104,4,3,1,3.0389885672172294
13756,207-008-2398,6375.808,6,3,3,0.9569244815512097
13846,703-004-5396,6690.899,3,1,2,0.3978652972704144
14046,703-004-5380,3367.0479,7,4,3,1.0208087038761666
14099,703-004-5394,8662.081,6,3,3,1.307994449872051
14121,703-004-5392,8153.46,8,4,4,1.5789191212237754
1463,703-004-5397,9374.771,5,4,1,1.2386539006830182
14928,703-004-5386,8347.86,5,1,4,0.35831143730785864
15205,703-004-5391,6211.596,3,2,1,0.5520863303621517
15795,703-004-5383,1524.8823,3,1,2,0.4286078318773781
15951,703-004-5382,6247.318,4,3,1,0.653739149003565
15988,703-004-5387,5492.743,4,3,1,1.733796552621553
16046,703-004-5380,6480.3467,5,3,2,1.036134486703595
16718,703-004-5383,1565.7002,4,1,3,0.7580124193127432
1690,703-004-5388,2246.6147,7,4,3,1.4727055512518292
16900,703-004-5384,4807.049,7,3,4,1.0343345785635976
17208,207-008-2398,9723.305,12,5,7,2.1064124580211
17225,703-004-5399,7252.919,2,2,0,0.8955576581596226
17231,703-004-5381,502.49756,4,1,3,0.5733050756089327
17388,703-004-5398,9465.909,8,3,5,0.7392480702972402
17510,703-004-5384,9818.891,3,3,0,0.7768660846076916
17778,703-004-5388,454.48602,5,4,1,1.24587425250688
17960,703-004-5398,6097.7666,2,2,0,1.7275060746191215
18171,703-004-5382,7919.247,2,1,1,0.6492623033110076
18187,703-004-5383,6839.128,1,1,0,1.043807416275219
18772,703-004-5395,4462.56,2,2,0,1.1697536736120413
1929,703-004-5399,5082.814,7,5,2,2.308830962160821
19509,207-008-2398,2325.3738,2,0,2,0.27920371738274696
19598,703-004-5389,7668.968,3,0,3,0.27920371738274696
20015,703-004-5393,4400.1357,4,1,3,0.49691680419918954
20168,703-004-5386,6180.2046,3,2,1,0.5574706158109886
20197,703-004-5384,8322.827,3,1,2,0.48421181584606
20320,703-004-5395,3649.4058,2,1,1,0.4829545410409155
2064,703-004-5397,151.96979,3,2,1,0.9113544934320181
2095,703-004-5387,1986.3701,3,1,2,0.7984127376207891
20950,703-004-5391,634.5415,4,4,0,3.8171786919791333
21492,703-004-5382,6247.456,3,2,1,0.7635376351247664
21530,703-004-5386,4926.837,3,0,3,0.27920371738274696
21723,703-004-5388,2969.7825,12,4,8,1.4370851156388569
21827,703-004-5398,8776.786,9,5,4,3.5819080211883803
22213,703-004-5399,6668.606,3,2,1,0.6195141126048102
22297,703-004-5383,433.5177,2,2,0,0.6705201189609922
22471,703-004-5384,3529.8293,2,1,1,0.8325569456216867
22583,703-004-5395,3760.1982,7,2,5,0.7332077155492518
2264,703-004-5398,848.7958,4,3,1,0.9202395218804944
23034,703-004-5395,4391.009,1,1,0,0.4314860782385869
23082,703-004-5394,1349.9713,8,4,4,0.9354341924054241
23114,703-004-5387,5214.985,2,1,1,0.46724258803091884
2318,703-004-5387,2029.4655,3,1,2,0.3807252912866403
23324,207-008-2398,9594.765,4,2,2,0.49501946580344214
23492,703-004-5389,8948.87,4,1,3,0.7255248231883799
23594,703-004-5395,392.887,3,2,1,0.8229046042389198
23696,703-004-5385,910.2297,8,4,4,2.1173451695191985
23720,703-004-5384,361.9927,8,7,1,1.3993874258708383
23986,207-008-2399,1064.2015,1,0,1,0.27920371738274696
24023,703-004-5381,7728.644,3,0,3,0.27920371738274696
24075,703-004-5387,1717.8041,2,1,1,0.5588765357865376
24217,703-004-5392,2838.2236,5,2,3,0.8341146841801346
2458,207-008-2398,1287.3429,3,2,1,0.6725991822655206
2471,703-004-5381,2344.169,10,5,5,2.049092870786986
2474,703-004-5386,7974.802,2,2,0,0.8092590222185951
24781,703-004-5394,1323.9193,7,3,4,1.9532577799753588
2508,703-004-5388,4976.6533,4,2,2,0.5252000975441165
25171,703-004-5392,3443.3384,7,3,4,0.9817261079486441
25423,703-004-5393,9771.162,4,3,1,1.1751292116063126
25471,703-004-5399,3523.9119,7,2,5,0.6207368629208914
25521,207-008-2398,1022.6399,4,3,1,1.4475036318974812
25720,703-004-5397,7114.1694,4,1,3,0.8951244389328536
25752,703-004-5383,5304.2046,3,1,2,2.0047524469126494
25833,703-004-5389,7995.403,6,2,4,1.4314888712015554
26335,703-004-5384,9209.745,2,2,0,1.2678289547928014
27137,703-004-5382,2050.268,2,0,2,0.27920371738274696
27381,703-004-5392,504.4955,4,1,3,0.3587413534392875
27399,703-004-5394,9575.529,6,3,3,1.061718522609777
27513,703-004-5385,1501.7396,6,3,3,0.9038741631085299
27643,703-004-5384,4078.219,6,3,3,0.7426250756823496
27918,703-004-5395,7929.219,4,1,3,0.39429323843534003
28095,703-004-5391,5579.5527,4,3,1,1.5681200246820886
28126,207-008-2399,2562.4316,3,2,1,0.7984477351731363
28443,703-004-5387,4720.7075,8,5,3,2.628136438396647
2868,703-004-5388,5339.2583,3,2,1,1.103082703986194
28886,703-004-5384,3138.317,4,3,1,1.5724545388188758
2891,703-004-5398,7063.752,6,2,4,1.2373635037363182
28923,703-004-5383,1643.0592,5,3,2,1.686360833948727
29096,703-004-5397,8675.342,5,3,2,1.1821642192930233
29233,703-004-5391,6916.3447,2,0,2,0.27920371738274696
29253,703-004-5398,5906.6934,4,0,4,0.27920371738274696
30103,703-004-5391,9960.037,3,1,2,0.3525563506833067
30146,703-004-5386,9648.118,3,1,2,0.5592316035006744
30795,207-008-2399,164.8295,5,0,5,0.27920371738274696
31159,703-004-5383,8700.223,5,4,1,1.3169087714921939
31488,703-004-5388,23.561716,8,5,3,3.651784238378235
31564,703-004-5388,355.38315,3,0,3,0.27920371738274696
31998,703-004-5393,1690.7179,3,2,1,0.7592542493494688
32124,703-004-5384,2541.4277,3,1,2,0.6057759011194064
32227,703-004-5396,9834.426,4,2,2,0.48903694448410556
32750,703-004-5392,5126.861,1,1,0,0.8212600012893622
33370,703-004-5391,6390.9834,4,2,2,1.7439029406187339
3345,703-004-5392,1093.4597,5,3,2,1.4721568243144747
33460,703-004-5383,5763.988,4,2,2,1.2007954222474306
34118,703-004-5394,1433.3052,7,3,4,0.5410552537092025
3425,703-004-5386,9184.785,5,1,4,0.3978652972704144
34444,703-004-5397,8422.521,3,1,2,2.7386733618780825
34817,703-004-5389,9162.667,3,2,1,1.3571514780968705
35393,703-004-5380,8640.406,1,1,0,0.806972696174358
35417,703-004-5397,3075.8906,3,2,1,2.088414216990102
35679,703-004-5385,7872.9043,3,2,1,0.4833782703932124
36267,207-008-2398,4472.5723,3,0,3,0.27920371738274696
36367,703-004-5386,3919.7166,1,0,1,0.27920371738274696
36834,703-004-5380,2131.2302,5,2,3,1.5569851838551618
37176,703-004-5387,1950.0059,1,0,1,0.27920371738274696
37682,703-004-5387,6900.7544,9,3,6,1.048331375055971
37731,703-004-5393,8257.442,2,1,1,0.35062813054411957
37772,703-004-5397,9210.789,2,2,0,0.5193280183626123
3785,703-004-5396,1703.0275,2,1,1,0.3790389647249273
37949,703-004-5390,1977.3918,5,0,5,0.27920371738274696
37964,703-004-5380,805.462,2,1,1,0.7283893186748592
3803,703-004-5393,9688.8,3,1,2,0.35831143730785864
38618,703-004-5395,4827.9043,3,2,1,1.9209817857349434
38620,703-004-5398,2784.4185,2,1,1,0.32666834933781397
38879,703-004-5394,8338.293,1,1,0,0.35831143730785864
38880,703-004-5388,3973.8225,3,2,1,0.5491680661716998
38988,207-008-2398,3154.9758,4,3,1,1.8013043623644844
39329,703-004-5391,9388.667,2,1,1,0.35831143730785864
39533,703-004-5398,2709.4453,5,3,2,0.5690490469364861
39810,207-008-2398,2084.1719,4,0,4,0.27920371738274696
40172,703-004-5393,4191.346,11,6,5,2.2196480094024866
40257,703-004-5381,8628.56,5,5,0,1.3414533534332103
41114,703-004-5389,9736.784,3,1,2,0.7584025350637935
41233,703-004-5386,7428.0093,5,2,3,0.41764222725169237
41290,703-004-5395,4528.676,3,2,1,1.721088487138399
41353,703-004-5381,6627.045,7,5,2,2.9242417109677694
41566,703-004-5381,5007.873,1,1,0,0.5165268771580819
41914,703-004-5387,4469.27,2,1,1,0.9630938704390403
41990,703-004-5382,1298.4187,4,3,1,0.9410110609097566
42087,703-004-5390,3242.132,4,1,3,0.32666834933781397
42153,703-004-5395,3023.774,2,0,2,0.27920371738274696
42434,703-004-5382,3873.9175,8,4,4,0.7774426618758851
42740,703-004-5395,7305.9126,4,1,3,0.6032986537677977
42772,703-004-5397,9230.775,2,1,1,0.47523988993051874
42841,703-004-5385,4562.2314,1,1,0,0.940918448762824
42871,703-004-5396,3844.8948,2,1,1,0.35831143730785864
42909,703-004-5395,4645.8965,6,2,4,0.47697301719552604
43149,703-004-5384,1496.0569,4,1,3,1.4088105416291585
43419,703-004-5380,2418.093,2,0,2,0.27920371738274696
43989,703-004-5384,5194.7056,2,2,0,0.6744656528914477
44016,703-004-5383,6904.1,3,2,1,0.8860708297496708
44030,703-004-5396,8989.667,1,0,1,0.27920371738274696
44055,703-004-5393,1842.9727,5,4,1,2.44419050833606
44128,207-008-2399,7870.459,7,2,5,0.9204767373055159
44251,703-004-5397,2117.0164,6,0,6,0.27920371738274696
4440,703-004-5396,2726.581,4,2,2,1.1834757656904726
44430,207-008-2399,6989.6323,5,1,4,0.7646410262970139
44562,703-004-5381,5768.3994,7,4,3,3.0691790083611665
44672,703-004-5388,4998.7017,3,1,2,0.48150914366128683
45005,207-008-2398,2846.5974,5,2,3,0.8843010943043453
45017,703-004-5387,946.2059,4,3,1,1.2411551428341412
45265,703-004-5388,9828.557,3,3,0,0.6278276124524718
45328,703-004-5395,8549.801,3,2,1,0.771389382193238
45705,703-004-5394,9129.378,3,2,1,0.5660358178980617
45754,703-004-5380,8771.145,2,1,1,0.5675699305406123
45995,703-004-5383,8618.666,3,1,2,0.4869477590432084
46028,703-004-5389,3718.1426,2,1,1,0.6560270067390137
46098,703-004-5385,1716.3849,6,1,5,0.6523128062932885
46366,703-004-5393,4551.067,5,3,2,1.3190590189469902
46769,703-004-5387,1739.5902,3,1,2,1.2188621071301524
46787,207-008-2399,5717.6357,4,3,1,1.0654470781135439
46795,703-004-5389,9667.225,2,0,2,0.27920371738274696
47321,703-004-5390,3968.8801,2,1,1,1.394985558212028
48435,207-008-2399,9253.866,7,2,5,0.7330043624363705
485,703-004-5383,4278.224,3,0,3,0.27920371738274696
48924,703-004-5396,193.16911,4,1,3,0.7199392030379477
48945,703-004-5380,4397.0703,5,2,3,0.9112789384928244
48963,703-004-5382,6948.0728,3,0,3,0.27920371738274696
48978,703-004-5382,6766.933,2,2,0,0.8471918826735432
49085,703-004-5397,8349.4375,5,3,2,1.588720420204717
49249,703-004-5394,9058.745,3,0,3,0.27920371738274696
49353,703-004-5395,87.34405,5,1,4,0.5903904350841266
49602,703-004-5388,8347.848,3,1,2,0.4314860782385869
49729,207-008-2398,1823.5905,5,3,2,1.581711467524633
49984,703-004-5399,2247.9658,3,2,1,0.5638602926956998
5150,703-004-5386,7971.389,8,2,6,0.5168425552544865
5241,207-008-2398,4753.589,2,1,1,0.5212012396656645
5254,703-004-5381,2901.082,9,5,4,2.9266448742154982
6197,703-004-5391,5748.4604,4,3,1,3.3735556049361564
6323,703-004-5397,5879.1406,5,2,3,0.9071327474171124
6532,703-004-5383,1592.6927,5,3,2,1.1318715906346186
6716,703-004-5397,8374.721,3,3,0,0.7710679269226719
713,703-004-5386,3159.2178,9,5,4,2.0111770769684663
7140,207-008-2399,7487.411,6,4,2,1.0839724962189023
7146,703-004-5389,5393.6587,6,4,2,3.0189038425318233
7180,703-004-5388,1446.0986,3,2,1,1.8659488906386472
7580,703-004-5385,4979.0557,3,1,2,1.3741371584299156
7618,703-004-5389,4779.915,8,6,2,1.4202987076183897
776,703-004-5389,3607.2605,2,1,1,0.42712823734814376
8079,703-004-5380,7629.8584,4,3,1,1.1261709816909846
8340,703-004-5395,2134.4954,3,1,2,0.5854330348021595
8644,703-004-5395,8386.286,7,5,2,1.9953432432413483
9901,703-004-5387,4204.244,4,1,3,1.085061608267715
10267,703-004-5388,3513.2808,2,0,2,0.27920371738274696
10593,703-004-5397,1424.5153,5,3,2,2.2351131365364005
10619,703-004-5385,2307.1992,4,2,2,2.1020868417157663
10720,703-004-5395,8429.191,4,1,3,0.4314860782385869
10934,703-004-5387,4455.2617,4,2,2,1.2128335650605953
11049,703-004-5384,8800.86,3,1,2,0.379028871819847
11084,703-004-5382,7487.043,3,1,2,0.3978652972704144
11194,703-004-5382,5608.99,3,0,3,0.27920371738274696
11198,703-004-5384,6969.246,5,1,4,0.3868302342462827
1124,703-004-5383,1000.2798,4,2,2,0.6480434615335801
11329,703-004-5392,2803.5134,5,3,2,2.788336791424684
11599,703-004-5399,3144.8984,3,2,1,0.7791196164846348
11602,703-004-5387,6333.762,3,0,3,0.27920371738274696
11625,703-004-5393,7438.9355,7,5,2,4.228787359566452
11670,703-004-5397,4838.8345,"","","",0.27920371738274696
12139,703-004-5388,7649.182,1,1,0,0.7824602668266947
12170,207-008-2399,3450.7375,6,3,3,1.5880621260769872
12318,703-004-5391,8317.628,5,0,5,0.27920371738274696
12683,703-004-5396,4726.4814,2,2,0,0.5616368672299707
12701,703-004-5383,3538.8345,3,2,1,0.8733381815948402
12831,703-004-5383,8908.576,3,3,0,1.9077488498117603
12994,703-004-5389,6803.713,4,2,2,0.5976845102729195
1300,703-004-5380,7904.715,5,3,2,1.0101025432684672
13028,703-004-5383,5784.255,2,1,1,0.5403861674910797
13091,703-004-5380,1774.0464,4,2,2,0.7953742653053143
13141,703-004-5396,4492.7905,3,1,2,0.4423708060770327
13177,703-004-5384,5390.03,4,2,2,0.6652867034594759
13242,703-004-5386,4108.0,6,4,2,1.11630830238016
13372,207-008-2398,1234.5958,9,2,7,0.8547805925146436
13393,703-004-5384,4035.0151,6,5,1,2.1783832035009483
13591,207-008-2398,2230.8767,2,1,1,0.4980808732195917
13595,703-004-5380,4795.3623,5,2,3,0.664667485180537
13884,703-004-5382,3439.4377,6,2,4,0.6652373750087653
13941,207-008-2398,5419.403,8,4,4,4.112493380510111
14020,703-004-5381,8872.569,8,5,3,4.1553011076853394
14118,703-004-5390,5738.15,2,2,0,0.9309705718534106
14428,703-004-5382,9521.5,3,2,1,0.4301306693294605
14507,703-004-5399,9594.447,3,1,2,0.40538053066330004
14657,703-004-5386,6530.5156,4,2,2,0.614958184108585
14720,703-004-5380,373.24548,6,2,4,0.6154810589839159
14745,703-004-5388,6873.472,4,2,2,0.6969741255377282
1477,703-004-5384,8214.308,2,1,1,0.4314860782385869
14824,703-004-5395,6991.2744,4,0,4,0.27920371738274696
15617,703-004-5390,2717.449,4,2,2,0.6060268047366071
15946,703-004-5390,1344.3029,8,1,7,0.6137481477673201
15998,703-004-5397,3482.4187,1,0,1,0.27920371738274696
16161,703-004-5383,8889.115,4,1,3,0.35831143730785864
16388,703-004-5390,4438.706,1,0,1,0.27920371738274696
1642,703-004-5390,7609.7573,2,0,2,0.27920371738274696
1655,703-004-5397,1347.1371,7,5,2,1.478837243446835
16603,703-004-5393,189.81755,4,2,2,0.5203634062658212
16786,703-004-5397,933.4678,5,3,2,0.9384898676588189
17453,207-008-2399,5101.614,7,6,1,1.5076888951570135
17750,703-004-5384,5350.002,4,3,1,1.0736892957388091
17921,703-004-5391,7501.7095,1,1,0,1.2014713807277553
18349,703-004-5396,1167.8922,1,0,1,0.27920371738274696
18601,207-008-2398,1968.8112,1,0,1,0.27920371738274696
19138,703-004-5392,2260.0627,2,2,0,1.9452316307341704
19356,703-004-5396,9889.186,8,4,4,2.5452309195199305
19475,703-004-5392,1267.013,2,0,2,0.27920371738274696
19515,703-004-5381,2370.402,2,0,2,0.27920371738274696
19543,703-004-5388,8197.175,6,3,3,1.3907169541246998
19684,703-004-5389,453.70578,8,5,3,1.6319889820038
19887,703-004-5389,5145.8066,4,2,2,0.7557625005106773
19891,703-004-5391,265.47372,3,2,1,0.6259838491626148
20111,703-004-5387,257.53497,6,3,3,1.2690191392420551
20117,703-004-5380,2512.4807,4,2,2,0.5578904322322502
20159,703-004-5385,4520.49,3,2,1,1.7964771933465509
20173,703-004-5386,482.95676,6,4,2,4.133915779369224
20411,703-004-5384,1863.7145,4,1,3,0.6010040712285082
20500,703-004-5398,8038.5996,6,3,3,0.5162942716201457
20550,703-004-5387,9902.052,6,3,3,1.1711776675961507
20556,703-004-5382,7560.8223,1,1,0,1.0437709313548353
20685,703-004-5399,4432.6353,3,0,3,0.27920371738274696
21179,703-004-5383,4242.4233,2,2,0,1.539391937630923
21254,207-008-2399,5218.8047,8,5,3,1.9202698974290764
21324,207-008-2398,8790.89,2,0,2,0.27920371738274696
21344,703-004-5397,941.7349,5,3,2,1.0055868297925628
21345,703-004-5382,4316.402,1,1,0,1.9683760732479505
21407,703-004-5397,7230.023,3,2,1,0.7968499424198782
22106,703-004-5398,1205.6035,2,2,0,0.42772846154214406
22134,703-004-5392,6183.716,6,2,4,1.1239866163113288
22256,703-004-5387,5472.1763,4,2,2,0.6646725634928379
22315,703-004-5384,8418.805,5,1,4,0.8144005240104667
22367,703-004-5393,9172.445,2,2,0,0.6921285810600344
22432,703-004-5382,5970.971,5,3,2,0.9004320273376529
22506,703-004-5384,6321.83,8,6,2,3.3694113213739123
22519,703-004-5381,992.89954,3,1,2,0.35831143730785864
22641,703-004-5383,6762.5405,3,2,1,1.2028824313353992
22649,703-004-5384,9469.501,1,0,1,0.27920371738274696
2288,703-004-5382,981.1539,6,3,3,1.7676824673352665
23087,703-004-5395,4289.894,3,1,2,0.33853450732658075
2329,703-004-5391,124.3788,4,2,2,0.8914653964696071
23356,703-004-5391,4716.2324,1,1,0,0.5175750383885773
23506,703-004-5393,5727.126,7,2,5,0.5319476636314002
23848,703-004-5381,3602.3755,10,5,5,2.30781003190558
24887,703-004-5395,3958.7046,1,0,1,0.27920371738274696
24924,703-004-5390,8346.187,3,2,1,0.561379251855404
24967,703-004-5382,82.84569,1,0,1,0.27920371738274696
25247,703-004-5394,1631.4662,5,2,3,0.47697301719552604
25264,703-004-5384,665.0233,3,1,2,0.5928849702702378
25394,703-004-5394,7167.7417,3,1,2,1.2379396933600813
25397,207-008-2398,9780.635,5,3,2,1.2661200072843914
25935,703-004-5382,702.25714,2,2,0,1.470211610077993
26540,703-004-5395,4594.941,4,1,3,0.7804629805063682
26785,703-004-5389,2396.1753,8,7,1,1.6255119058477465
27428,703-004-5383,3457.0027,6,4,2,4.176165370938817
27430,703-004-5387,1539.3662,4,3,1,1.2330004845937597
27660,703-004-5384,8924.055,"","","",0.27920371738274696
27692,703-004-5387,2397.1946,2,1,1,0.6411763548497923
28015,703-004-5382,6310.2773,2,1,1,0.47161293247857694
2842,703-004-5395,6429.9404,3,1,2,0.4257719764917892
287,703-004-5397,8714.482,5,5,0,1.0782886990170926
28833,703-004-5398,4638.1055,4,3,1,1.3627930039034317
29343,703-004-5391,1240.6516,5,3,2,2.57256432353342
29458,703-004-5382,5289.9756,3,2,1,1.1317512444624953
29513,207-008-2398,9842.439,3,2,1,0.6706905075598774
29640,207-008-2399,695.5081,4,2,2,0.6034598281441244
29843,207-008-2398,9943.306,3,1,2,0.49401106924256516
30717,703-004-5394,6005.6436,2,0,2,0.27920371738274696
30804,703-004-5390,6623.02,3,1,2,0.552353910719986
30869,703-004-5390,8669.343,2,2,0,0.9181096703697558
31045,703-004-5392,6736.9175,5,3,2,0.9708890522300478
31469,703-004-5385,9798.987,2,2,0,1.1202868998856002
3154,703-004-5392,2487.2952,3,3,0,0.8590713058797798
31701,703-004-5399,16.292334,4,2,2,0.6626821156195906
31789,703-004-5387,7811.045,2,1,1,0.4704984052271615
31940,703-004-5394,934.84937,4,4,0,1.0824791699090857
31980,703-004-5393,1184.153,5,2,3,0.788920534485488
32130,703-004-5381,5758.475,8,4,4,1.85585704025328
32638,703-004-5399,9989.273,3,0,3,0.27920371738274696
32652,703-004-5394,1519.0941,3,2,1,0.5541123544909681
32695,207-008-2399,4448.1724,5,3,2,1.258684016687953
32705,207-008-2399,736.21216,5,4,1,1.5853948389978052
32722,703-004-5396,2420.6282,4,1,3,1.2165643515689146
32940,703-004-5393,4060.3687,7,5,2,4.810252255396701
33239,703-004-5385,361.18448,4,2,2,1.9398759411971043
33241,703-004-5386,8522.231,6,1,5,0.47819350615482453
33287,703-004-5382,3679.999,5,2,3,0.6625933255888583
33324,703-004-5391,3568.7197,4,3,1,1.0931166990334138
33433,703-004-5397,7882.2764,7,3,4,0.8476356761682502
33449,703-004-5384,4287.8623,7,0,7,0.27920371738274696
33793,703-004-5381,360.85962,2,2,0,0.5370550328058837
33831,703-004-5394,2604.115,4,1,3,1.1558092291922462
33978,703-004-5399,8345.592,2,0,2,0.27920371738274696
34237,703-004-5399,1412.589,4,4,0,1.3050120632653563
34508,703-004-5390,6346.4814,4,2,2,0.6090383398612538
34519,703-004-5394,5188.374,6,4,2,1.6708860675335748
34823,703-004-5397,9622.921,5,4,1,2.5880034068415005
35062,703-004-5388,9075.711,3,1,2,0.47863573222171824
35233,703-004-5398,8839.181,4,2,2,1.657563710767793
35509,703-004-5380,6754.7983,3,0,3,0.27920371738274696
35588,703-004-5396,339.24698,2,1,1,0.42149048821054935
3559,703-004-5398,293.26797,4,1,3,0.5146248278546521
35810,703-004-5388,4741.643,3,2,1,1.0128273880227223
36057,703-004-5387,2293.7363,3,2,1,0.8689826588205588
36148,703-004-5381,2596.6519,3,1,2,0.7601622950835513
36158,703-004-5392,5526.7207,5,4,1,0.688532614723429
3642,703-004-5392,103.21021,6,4,2,1.5704532695591187
365,703-004-5399,9096.484,3,1,2,0.418623193381366
36687,703-004-5392,8334.721,5,2,3,0.7386904152704283
36952,703-004-5384,8223.8125,1,1,0,0.5194250365464654
3720,703-004-5390,5407.2935,3,1,2,0.32666834933781397
37541,703-004-5387,1177.3729,2,1,1,0.35290739119047443
37542,703-004-5399,5605.7983,2,0,2,0.27920371738274696
37634,703-004-5388,66.23328,9,6,3,2.991634097504379
38164,703-004-5397,9345.581,4,2,2,0.6205526681969099
3833,703-004-5382,6042.211,1,1,0,0.5652692540214675
389,703-004-5396,1217.3885,6,4,2,1.0965209298167984
39002,703-004-5389,2414.6682,6,1,5,1.5387908108268886
39042,703-004-5396,6007.7744,4,2,2,1.2446202088643896
39095,703-004-5385,7072.3267,4,3,1,2.1223402883743443
39477,207-008-2399,7767.0557,2,0,2,0.27920371738274696
39761,703-004-5382,2376.4753,1,0,1,0.27920371738274696
39982,703-004-5399,873.5621,8,4,4,1.4276691138523299
39986,207-008-2398,4816.8047,4,3,1,1.29234155464025
40219,703-004-5386,5985.624,2,1,1,0.3918926644160685
40769,703-004-5390,5180.802,4,2,2,0.6563515103639955
41024,703-004-5384,6481.0137,5,3,2,2.056905760218146
41300,703-004-5392,1888.4802,1,0,1,0.27920371738274696
4147,703-004-5396,4689.953,1,1,0,0.3737466080357567
41485,703-004-5381,3608.173,2,0,2,0.27920371738274696
4166,703-004-5382,8290.525,2,2,0,0.9245763699977607
41679,703-004-5392,3372.3408,4,1,3,0.960222029752285
41752,703-004-5382,9896.443,1,0,1,0.27920371738274696
4200,703-004-5392,2170.8472,6,3,3,1.1135942549353999
42449,703-004-5397,7070.9355,2,2,0,0.7978105781392832
425,703-004-5387,5053.0464,7,3,4,1.4118602428211684
4264,703-004-5384,3232.7139,7,4,3,2.8569343090997488
43650,703-004-5394,3856.5464,5,4,1,1.7029462884899342
43951,703-004-5399,4732.788,3,1,2,0.4864445866025783
44196,703-004-5389,550.1479,5,1,4,0.6171454678190796
44272,703-004-5393,4588.858,4,1,3,0.3978652972704144
44388,703-004-5395,2357.2778,5,2,3,0.5830962459959693
4510,703-004-5395,7725.7246,4,2,2,0.9241048815246218
45239,207-008-2399,6933.6157,2,1,1,0.5281850589727998
45393,703-004-5391,9596.112,2,1,1,0.5385343812145207
45869,703-004-5398,4785.2773,3,2,1,0.801166485091377
4593,703-004-5399,3410.8062,6,2,4,0.7171198393827449
46031,703-004-5391,9505.619,6,2,4,1.1587707506149807
46074,703-004-5399,597.7267,4,0,4,0.27920371738274696
46242,703-004-5380,8201.076,6,4,2,0.9046389585618857
46303,703-004-5390,460.31177,11,8,3,4.073236671600351
46970,703-004-5384,246.93011,2,1,1,0.758844415689837
47324,703-004-5388,2909.5518,6,5,1,3.136155478267146
47327,703-004-5393,8277.019,3,3,0,0.8907623430634324
47763,703-004-5396,4334.8037,5,3,2,1.2968071436478414
47806,703-004-5386,9919.159,7,4,3,1.2916002604357804
47850,703-004-5383,5942.027,6,1,5,0.43572472755750447
47875,703-004-5387,5563.423,4,1,3,0.5068249162681945
48116,703-004-5395,1426.7522,2,1,1,0.3971552283309847
4834,703-004-5382,7759.853,5,3,2,1.2733926858149898
48365,703-004-5395,9970.917,8,5,3,2.5288438835937894
48413,703-004-5399,796.8146,2,0,2,0.27920371738274696
48484,703-004-5399,2958.8025,6,2,4,0.473688700751337
48584,703-004-5383,7129.8423,6,2,4,1.167529520845908
4887,703-004-5393,7935.8037,4,3,1,1.4989638300315504
49282,703-004-5399,4464.7896,5,2,3,1.490393783191807
49618,703-004-5399,7414.2407,3,1,2,0.46054345407939656
5162,703-004-5385,9811.362,7,5,2,2.8309775831192607
5186,703-004-5395,8992.448,4,3,1,0.8427774771897817
524,703-004-5382,9147.507,4,2,2,0.9118947258248644
5280,703-004-5390,259.70697,1,1,0,0.6818208140853969
5413,703-004-5398,5007.554,5,0,5,0.27920371738274696
5440,703-004-5398,598.4646,3,3,0,3.7632954740550706
5502,703-004-5390,6977.204,3,2,1,1.1099788725359194
5637,703-004-5399,751.61993,7,3,4,1.2332808172201557
5722,703-004-5390,2104.0447,5,4,1,2.1951431748177868
5764,207-008-2398,5593.1855,4,3,1,1.3490762777319967
5820,703-004-5399,4963.138,3,1,2,0.679362347962305
5834,703-004-5395,1178.1799,4,3,1,1.2872174684282163
6149,703-004-5393,3006.8416,7,2,5,0.612525806508512
6440,703-004-5390,5324.199,6,3,3,1.3475045499371556
6606,703-004-5397,6786.9175,7,3,4,2.006819411303813
6653,703-004-5382,5924.5684,2,1,1,0.49978488263517384
670,207-008-2398,8635.389,4,1,3,0.35790687720067654
6993,703-004-5386,8446.332,5,4,1,1.424051979372313
737,703-004-5380,8858.647,3,2,1,1.3938255752039317
7414,703-004-5391,3138.587,9,3,6,1.7333818472368583
789,703-004-5399,3495.94,2,0,2,0.27920371738274696
7919,703-004-5397,9695.247,4,1,3,1.2436646907776572
8110,703-004-5387,1397.2336,7,2,5,0.9906819279411357
8164,207-008-2398,5094.1,2,2,0,0.7052738150620915
8196,703-004-5385,3927.3596,4,3,1,0.7175036402368806
8540,703-004-5386,7680.419,4,2,2,1.3968667525859007
8735,703-004-5396,2515.9907,5,4,1,2.114532840652277
8896,703-004-5389,5359.21,8,5,3,1.359383379325936
895,703-004-5387,6756.167,10,5,5,1.3240929729254574
8954,703-004-5393,81.53081,4,1,3,0.39907663423176776
9228,703-004-5381,3559.4744,3,3,0,1.3387330754679143
966,703-004-5388,4631.29,5,2,3,1.727404402466576
995,703-004-5392,9881.897,7,4,3,3.5487895555447313
9950,703-004-5399,8111.7827,3,3,0,1.6574227645452497
10038,703-004-5385,2074.9688,4,3,1,2.262546228131649
10150,703-004-5391,370.41904,1,0,1,0.27920371738274696
10152,703-004-5391,5633.07,5,2,3,1.0896809243568482
10178,703-004-5395,5504.693,3,1,2,0.35831143730785864
10515,207-008-2399,6545.6343,5,2,3,1.0387988888628734
10586,703-004-5393,7716.474,3,1,2,0.3817161978825772
10662,703-004-5392,5861.455,4,0,4,0.27920371738274696
10758,703-004-5398,726.75885,6,1,5,0.9937593682430169
10808,703-004-5383,4505.035,5,3,2,1.2194167651555028
10954,207-008-2398,4916.1226,4,2,2,0.6794714601356562
11282,703-004-5387,5238.864,6,3,3,1.5161748672863802
11648,703-004-5380,5348.8804,1,0,1,0.27920371738274696
11881,703-004-5396,3182.8093,5,3,2,1.5084416066092419
12025,703-004-5397,9709.082,3,1,2,0.598490525566867
12052,703-004-5394,9901.352,"","","",0.27920371738274696
12122,703-004-5383,2284.7192,6,2,4,0.5625094033981427
12754,703-004-5381,773.9252,3,3,0,1.0192458295584452
12785,703-004-5396,4111.3306,5,4,1,1.1208128994729958
1282,207-008-2399,2768.1863,5,2,3,0.8566311228000891
12832,703-004-5397,4016.7915,5,3,2,2.2645610616902205
12866,703-004-5394,9237.939,6,4,2,2.4940589356001603
12960,703-004-5399,9158.144,1,1,0,0.35831143730785864
13138,703-004-5397,7072.074,3,2,1,1.7045349963582104
13147,703-004-5385,1566.0304,4,0,4,0.27920371738274696
13229,703-004-5385,8686.754,6,4,2,1.0050310388051775
13531,703-004-5383,3198.5962,2,1,1,0.5669580486103406
14082,703-004-5389,1442.6517,7,5,2,0.9015388454555664
14425,703-004-5388,3337.5703,5,3,2,1.4041858218770933
1459,703-004-5387,817.76556,5,4,1,0.9659413944675808
14667,703-004-5397,708.72186,5,2,3,1.3085551973933336
14924,703-004-5383,5253.761,4,3,1,2.1749832910644966
15063,703-004-5388,1083.7495,2,1,1,0.5689956802011541
15283,703-004-5384,635.4529,8,5,3,1.3164265975264853
15333,703-004-5386,7185.264,4,3,1,1.4104429122530522
1535,703-004-5389,7141.314,6,2,4,0.759997883969811
15676,703-004-5381,9275.981,5,4,1,1.2429529754840016
15759,703-004-5387,9597.785,2,0,2,0.27920371738274696
15814,703-004-5390,5665.914,5,5,0,1.1273621943414787
15830,703-004-5396,496.04178,3,2,1,0.8280645390806664
15938,703-004-5388,7281.313,6,4,2,2.1975003749533903
16168,703-004-5390,1044.6066,4,2,2,1.0700959451024388
162,703-004-5398,1239.3236,3,3,0,0.5587317418802688
16636,703-004-5384,2309.2747,7,5,2,1.9648463942707028
1678,703-004-5384,8609.871,6,2,4,0.7463099400029225
16856,703-004-5384,3051.1665,1,0,1,0.27920371738274696
16965,703-004-5386,1728.7338,3,1,2,1.2001249225145254
17058,703-004-5394,495.01776,3,3,0,1.185906093095655
17276,703-004-5395,7503.033,6,2,4,1.2074463730183405
17350,207-008-2399,6963.7007,4,2,2,0.9796619624894933
17376,703-004-5385,7541.3105,6,2,4,0.4320992574898935
17630,703-004-5396,7371.9746,3,1,2,0.41565741047940447
1775,703-004-5394,8584.674,4,3,1,1.358681256050879
1836,703-004-5392,7877.905,6,3,3,0.9148533469508681
18521,703-004-5383,9234.731,6,2,4,0.6747991073554623
18951,703-004-5394,7067.267,2,2,0,1.4884673059609501
19331,703-004-5383,1949.0934,7,2,5,0.5814017216125126
19747,703-004-5398,1810.8618,3,2,1,0.7376766963994368
20041,703-004-5397,4820.689,3,0,3,0.27920371738274696
20497,207-008-2398,7030.513,2,2,0,0.7758258707025999
20573,703-004-5384,5633.4136,8,4,4,1.358055409414225
20707,703-004-5389,924.21234,4,1,3,0.5837684390944268
21051,703-004-5383,6200.686,11,4,7,1.5648294245156325
21387,703-004-5390,783.5257,2,0,2,0.27920371738274696
21468,703-004-5383,6090.9785,5,1,4,0.8252000040548548
21559,703-004-5380,4964.673,2,1,1,0.8848578264811295
2164,703-004-5381,2437.957,3,3,0,1.8740026131003755
21765,703-004-5397,9218.008,6,4,2,1.6539355494598003
21815,703-004-5394,4656.989,6,3,3,2.4947951950211373
21961,703-004-5398,8164.993,5,3,2,2.365228959672823
21991,703-004-5398,9052.636,4,2,2,0.6024412431247628
22366,207-008-2399,3688.907,3,3,0,0.9068644092869248
22604,703-004-5385,6077.263,6,0,6,0.27920371738274696
22697,703-004-5388,9345.115,4,2,2,0.9322758511470078
2281,703-004-5388,3117.773,9,3,6,3.1218376998281983
22817,703-004-5383,6622.9907,3,1,2,0.5669580486103406
23469,703-004-5389,6505.054,6,4,2,1.5127458201789157
2353,703-004-5394,905.92206,1,1,0,0.5742337497415048
24375,207-008-2398,3749.6108,5,2,3,0.7297821162842657
24460,703-004-5396,5409.77,3,0,3,0.27920371738274696
24863,703-004-5399,9492.616,1,1,0,0.6975483084955311
24961,207-008-2398,9965.408,4,2,2,1.1146400328573767
25039,703-004-5386,9826.648,3,1,2,1.1763798411263808
25153,703-004-5388,9969.502,7,1,6,0.3978652972704144
25686,703-004-5381,6964.8413,4,1,3,1.899054961106588
25714,703-004-5388,3961.9058,4,1,3,0.734646946936127
2572,703-004-5386,1716.6514,2,1,1,1.5157506497487214
25724,703-004-5396,5223.6475,8,4,4,3.4961268197532225
26343,703-004-5382,1095.5482,3,2,1,0.47400647769833437
2669,703-004-5380,3410.3936,5,2,3,0.8650451923189649
26937,703-004-5397,8681.881,3,1,2,1.0950879205571804
27071,703-004-5380,1639.3578,3,3,0,1.3022632957687859
27510,703-004-5390,3607.595,7,5,2,2.347181994037419
27594,703-004-5394,5860.8433,3,1,2,0.43775574587329413
27805,703-004-5389,8728.937,6,1,5,0.30557295735778417
27961,703-004-5383,8534.764,4,1,3,0.926608849197929
28071,703-004-5396,8016.978,4,0,4,0.27920371738274696
28252,207-008-2398,9573.638,5,3,2,1.3847779120150236
28347,703-004-5394,5398.1724,4,2,2,0.5753604821453756
28420,703-004-5394,2328.8274,2,2,0,0.8724559060109283
28689,703-004-5388,7257.077,4,2,2,0.7836711769391143
28981,703-004-5389,1809.4819,5,2,3,1.7629334608256704
29477,703-004-5394,2792.1104,3,1,2,0.5695462183423712
29852,703-004-5386,497.62012,9,6,3,1.5506393009207267
29941,703-004-5394,1832.9567,6,5,1,1.7543484287104931
30124,703-004-5386,8861.796,2,1,1,0.5831879744257137
30364,703-004-5381,7821.645,6,3,3,1.0476632826601562
30382,703-004-5386,3710.6733,5,3,2,0.5378269503174286
30543,703-004-5387,6250.4165,2,1,1,1.8571193620008055
30553,703-004-5383,529.0735,2,1,1,0.4909777057822408
3060,703-004-5388,4725.12,6,5,1,1.2276614300818376
31038,703-004-5396,949.2719,3,1,2,0.33853450732658075
31284,703-004-5391,8363.754,5,3,2,1.4321667676750662
31551,703-004-5380,2667.3347,4,1,3,1.0211283928594181
3162,207-008-2399,6612.458,3,3,0,1.273871985202368
31662,703-004-5383,7213.1094,4,2,2,0.8326874151255247
32113,703-004-5383,6391.6553,7,3,4,0.9071346471340812
32229,703-004-5394,4922.698,2,1,1,0.8671411914846683
32234,703-004-5386,2001.1085,5,1,4,0.4112983811785064
32255,703-004-5381,9449.808,2,1,1,0.45659047761036764
32303,207-008-2399,512.76324,5,2,3,0.7130610172061137
32367,703-004-5392,786.06665,3,2,1,0.6903336019222164
32719,703-004-5385,640.9752,4,3,1,2.9120458571922088
32755,703-004-5389,9801.076,3,3,0,1.261206065751119
32952,703-004-5396,3709.0803,4,3,1,3.2340263302162526
33069,703-004-5391,5833.157,4,1,3,0.5165268771580819
33266,207-008-2398,4790.5063,4,0,4,0.27920371738274696
33286,703-004-5380,2366.9243,2,1,1,0.40729425581926093
33315,703-004-5385,2722.4856,3,1,2,0.5513249681778203
33439,703-004-5386,3256.588,3,1,2,0.9149906757999068
33494,703-004-5388,4375.144,3,1,2,0.5453156090519997
33691,703-004-5383,814.0749,9,6,3,3.3957608581114274
33850,703-004-5382,5535.2173,3,3,0,1.8981933839912046
34022,703-004-5389,7174.685,3,1,2,1.0928911023122956
34180,703-004-5397,2122.6025,6,4,2,1.7017775943920337
34246,703-004-5380,5653.6694,8,5,3,2.6680558073262786
34264,703-004-5393,9769.554,2,1,1,1.045397849109732
3468,703-004-5387,4576.1206,5,5,0,1.3069990095347572
34840,703-004-5389,4757.818,3,1,2,1.0615792570010258
35028,703-004-5391,3505.8855,2,0,2,0.27920371738274696
35222,703-004-5391,2977.612,6,2,4,1.5895836617719918
35709,703-004-5394,8080.172,6,1,5,0.8127897435804625
35784,703-004-5396,9755.909,1,0,1,0.27920371738274696
35995,703-004-5382,6668.7227,6,2,4,1.8461297328872974
36053,703-004-5398,2066.5222,4,2,2,0.5566363452472993
36060,703-004-5395,9804.833,1,1,0,1.1917112185572782
36111,703-004-5388,377.15674,5,4,1,1.81099682575649
36868,703-004-5398,5632.111,2,1,1,0.6034084527122909
36917,703-004-5381,6701.772,5,5,0,3.61173387808773
37140,703-004-5399,1088.0941,5,3,2,1.9484938110516
37154,703-004-5391,9506.632,4,2,2,0.533049472109003
37276,703-004-5382,1898.6064,2,2,0,0.7033708746158076
37439,703-004-5397,8835.057,2,2,0,1.119444888318068
37661,703-004-5398,499.8368,5,3,2,1.7758205949956303
37954,703-004-5380,6768.446,3,2,1,0.5640502218740308
38336,703-004-5394,749.1779,7,4,3,1.1874844579223927
38366,703-004-5399,6822.3574,3,2,1,0.6882304094373566
38470,207-008-2398,3457.5908,1,1,0,0.7364832144493692
38677,703-004-5397,9947.539,9,3,6,1.99298096147315
38839,703-004-5389,7562.4766,3,1,2,0.46921871893107375
38938,703-004-5395,656.4063,1,1,0,2.2944262836710547
39211,703-004-5392,1694.7228,5,3,2,3.1832728578708056
39281,703-004-5386,6562.644,2,2,0,0.6886914288932099
39413,703-004-5398,493.8811,2,1,1,0.35831143730785864
39611,703-004-5385,922.9362,1,0,1,0.27920371738274696
39987,703-004-5390,9751.884,4,1,3,0.7182515629671166
40095,703-004-5385,8373.441,7,1,6,1.3388592397423187
40358,703-004-5395,7208.778,6,5,1,2.023467784827231
40933,703-004-5395,5356.5625,2,1,1,0.5104120778623095
41096,703-004-5390,9701.325,3,1,2,0.5040885455709592
41225,703-004-5397,7949.0664,4,4,0,1.5594730838681858
41278,703-004-5385,3608.1094,8,5,3,2.1836834449481066
41525,703-004-5388,6502.442,4,2,2,0.7164446726971634
41537,703-004-5389,3962.6265,3,2,1,0.7237972650853483
42046,703-004-5396,7714.8306,2,0,2,0.27920371738274696
42085,703-004-5385,3273.0437,6,3,3,1.4746445721464756
42260,703-004-5383,8861.537,4,0,4,0.27920371738274696
42484,703-004-5381,2811.7751,4,4,0,0.98934612728424
42694,703-004-5383,6400.73,3,2,1,1.5401741919713676
4278,703-004-5391,8207.167,6,3,3,1.1597275096166668
42801,703-004-5396,4060.3423,1,0,1,0.27920371738274696
42876,703-004-5388,5526.756,3,2,1,0.49962772592872257
43297,703-004-5390,9412.956,7,3,4,2.613818059545182
43390,703-004-5391,1936.295,6,1,5,0.3978652972704144
43473,703-004-5386,7749.922,3,3,0,1.1602608412720024
43577,703-004-5381,7886.576,3,2,1,1.1720836793592502
43931,207-008-2399,6536.522,4,1,3,0.4585191886389712
44014,703-004-5382,8634.244,4,2,2,1.119371905739757
44033,703-004-5398,6723.218,2,2,0,1.4766281510621493
44285,703-004-5384,8435.29,3,2,1,1.3151482011552085
44300,703-004-5385,9419.048,"","","",0.27920371738274696
44719,703-004-5383,7205.9194,4,2,2,0.7622870834368216
44734,703-004-5392,1396.9558,2,2,0,1.3938503917656482
44866,207-008-2398,9029.308,6,4,2,1.0074388156756895
44928,703-004-5395,196.38718,4,2,2,2.340267932042709
44992,703-004-5392,4452.764,2,0,2,0.27920371738274696
45207,703-004-5382,5294.338,3,1,2,0.35831143730785864
45464,703-004-5394,1858.7941,6,4,2,1.8738102576027502
45471,703-004-5382,3121.4016,8,7,1,2.2265339604004657
45491,703-004-5399,3226.7058,6,2,4,1.154097996152244
45797,703-004-5387,7828.243,5,5,0,1.26929271979613
45986,703-004-5392,8449.769,6,4,2,2.6813764153196566
46088,703-004-5390,9693.259,5,3,2,1.2494115669313723
46229,207-008-2399,8696.996,3,1,2,0.3976477510406204
46529,703-004-5381,1142.9178,4,0,4,0.27920371738274696
46561,703-004-5398,1940.7612,1,1,0,0.40468009772646313
4717,703-004-5389,384.25864,1,1,0,0.3401166617250829
47533,703-004-5383,2066.9502,5,1,4,0.35831143730785864
47617,207-008-2398,7153.486,5,3,2,1.5435266286433118
47622,207-008-2399,715.3362,4,0,4,0.27920371738274696
47872,703-004-5396,1289.5602,2,0,2,0.27920371738274696
48301,703-004-5386,489.38513,4,1,3,0.7039409966357143
48378,703-004-5396,2835.5933,5,4,1,1.0958114084323793
48507,703-004-5380,6247.5513,2,0,2,0.27920371738274696
49364,703-004-5392,8077.7627,3,1,2,0.6123267261039848
49625,703-004-5381,4029.3665,4,2,2,1.0874722919835187
49683,703-004-5383,287.80698,7,4,3,1.956569489152576
5362,703-004-5383,1607.5521,6,3,3,0.7520785707310532
5584,703-004-5397,2513.582,3,1,2,0.35114230018964543
5729,207-008-2398,4813.98,4,2,2,0.8072124735289469
5863,703-004-5391,512.0826,6,3,3,1.0489239055867592
59,703-004-5387,7931.286,4,2,2,0.4774880870792692
5966,703-004-5384,3414.8955,2,1,1,1.2567198672654536
6221,703-004-5389,3871.941,4,3,1,0.9424940368578846
6313,703-004-5392,5419.577,6,3,3,0.8481892620176303
6704,703-004-5393,5777.9414,3,1,2,1.5790250300746926
6904,703-004-5394,4016.7588,6,3,3,2.4191476690357447
7245,207-008-2399,815.2836,3,3,0,1.3056097475189645
7351,207-008-2398,2787.9304,4,3,1,1.3860223517887815
7377,703-004-5397,4048.1038,4,1,3,1.1107013331509024
7672,703-004-5386,4381.4165,3,1,2,0.43684311252609964
7739,703-004-5380,5317.6006,5,4,1,0.9823124150151398
7906,703-004-5395,323.7498,3,1,2,0.735186293521958
7935,703-004-5387,6225.8105,3,2,1,1.1179487170197115
8135,703-004-5383,434.4082,4,4,0,1.7436500540674171
8289,703-004-5386,7239.6753,3,3,0,0.6930777566459763
903,703-004-5390,9344.338,3,1,2,0.5537469470978976
9050,703-004-5396,6602.0127,5,2,3,0.5561913912155684
9104,703-004-5390,7765.698,4,0,4,0.27920371738274696
9483,703-004-5384,3156.649,4,3,1,1.5241303569777986
9605,703-004-5394,801.8172,4,3,1,0.5642750118903648
989,703-004-5398,1328.5846,3,1,2,0.43328207069251173
10556,703-004-5385,9447.784,2,2,0,1.6258524147266422
10622,703-004-5390,1177.6626,6,4,2,1.6983174374247454
11271,703-004-5383,7738.99,5,0,5,0.27920371738274696
1160,703-004-5387,8806.119,1,1,0,0.6659496370482171
11765,703-004-5384,2105.1514,4,0,4,0.27920371738274696
11941,703-004-5394,3365.395,4,1,3,0.36666719022494854
11964,703-004-5393,6775.5825,3,0,3,0.27920371738274696
1230,703-004-5393,1367.6238,3,0,3,0.27920371738274696
12486,207-008-2398,8934.2295,5,4,1,1.5015360884149402
12596,703-004-5397,7839.954,3,1,2,0.4264675248791515
12700,703-004-5389,555.3424,4,2,2,0.9378736920727864
12890,703-004-5399,8140.5933,3,2,1,1.043987099899084
12945,703-004-5386,9528.303,4,1,3,0.3498733282904742
13014,703-004-5392,1775.5675,7,4,3,1.7721474088542193
13217,703-004-5395,4304.2104,1,0,1,0.27920371738274696
13272,703-004-5396,2765.739,7,2,5,0.8706122054256953
13666,703-004-5387,2342.117,4,1,3,0.5430527875003145
13800,703-004-5388,3452.9912,7,0,7,0.27920371738274696
13814,703-004-5394,478.39462,3,0,3,0.27920371738274696
13886,703-004-5386,6657.1294,4,2,2,0.9669077220960898
13974,703-004-5397,2413.5554,4,1,3,0.4258748481786801
1403,703-004-5391,2920.9375,6,2,4,1.11412287633634
14054,703-004-5392,1932.3397,3,3,0,0.6189404952644093
14214,703-004-5382,3334.8066,3,2,1,1.4705174857405272
14577,703-004-5399,8154.3154,8,5,3,2.7805085347052376
14620,703-004-5395,7773.9937,4,2,2,1.1921772915330466
14648,207-008-2398,719.8429,1,1,0,0.459566005113014
14845,207-008-2399,9562.344,1,0,1,0.27920371738274696
14878,703-004-5397,6624.1963,2,2,0,1.5863701638808179
14935,207-008-2398,330.69492,2,2,0,0.6085342894301029
15035,703-004-5396,7554.321,7,5,2,2.249186383874416
15195,703-004-5398,9794.696,3,1,2,0.4866015649139345
15498,703-004-5399,7619.114,6,3,3,1.8083521155060582
15580,703-004-5389,8329.322,2,1,1,0.35534489781066697
15873,703-004-5397,9487.707,5,2,3,1.2162010964053258
15887,703-004-5385,1312.4227,1,1,0,0.825456343495069
16312,703-004-5385,8678.495,3,2,1,0.8339068108611583
16624,703-004-5381,8968.419,4,2,2,0.7539736427457998
16775,703-004-5383,1729.8835,2,1,1,1.1980023295886986
17705,703-004-5382,846.141,4,2,2,0.8437758711201736
18388,703-004-5388,5825.7593,"","","",0.27920371738274696
18398,703-004-5386,6666.7603,4,1,3,0.5233567826652129
18467,207-008-2398,1955.0181,2,0,2,0.27920371738274696
18529,207-008-2399,7784.3013,2,1,1,0.4794104376349994
19057,703-004-5388,7484.2085,6,3,3,1.986743153101951
19146,703-004-5394,4227.8696,7,3,4,1.1838979394842644
19422,703-004-5389,7373.0684,4,2,2,1.029484275976524
19667,703-004-5380,9551.059,7,4,3,2.4298867941563316
20752,703-004-5382,7471.5024,3,1,2,0.37983744309687456
20783,703-004-5389,5461.3774,3,0,3,0.27920371738274696
20806,703-004-5384,3693.4019,4,2,2,0.5276019235025902
21004,703-004-5397,5495.4595,5,2,3,3.5341708820826923
21037,703-004-5383,6736.2456,5,4,1,2.2568864295484334
21166,703-004-5392,4179.3774,3,1,2,0.4148620111560868
21329,703-004-5395,1564.2411,6,1,5,0.38560030452702526
21392,703-004-5398,2008.7069,5,2,3,0.737495035773029
21663,207-008-2399,6312.4688,5,1,4,0.7868106802523679
21822,703-004-5395,2102.714,7,4,3,1.4320853523904058
21828,703-004-5386,275.69592,3,2,1,1.8117130303492508
21897,703-004-5395,1294.6868,7,4,3,1.5057341997796916
22028,703-004-5380,3185.985,5,3,2,1.064004810135478
22485,703-004-5391,4924.0063,6,2,4,1.70695709216385
22530,703-004-5391,9785.79,2,0,2,0.27920371738274696
23058,703-004-5384,4917.926,5,0,5,0.27920371738274696
23334,703-004-5388,8988.547,4,2,2,0.7327804780303219
23598,703-004-5398,3680.9658,1,0,1,0.27920371738274696
23640,703-004-5396,1732.0001,5,0,5,0.27920371738274696
24172,703-004-5396,2351.027,6,4,2,1.236415931662651
24321,703-004-5391,14.920831,3,1,2,1.1217370521734675
2440,703-004-5395,4372.7397,5,2,3,0.6435722901145549
24437,207-008-2399,7470.464,4,3,1,0.6453023529436144
24671,703-004-5394,2359.273,2,1,1,1.0634518261461983
25376,703-004-5388,1852.246,2,1,1,0.5625404725672725
26040,703-004-5384,7711.3027,7,4,3,1.8351818904853896
26042,703-004-5380,481.67645,3,3,0,1.6528273963223998
2652,703-004-5394,6455.5273,4,2,2,1.5618745537034406
26912,703-004-5381,651.8662,2,1,1,1.5367583094614277
27160,207-008-2398,7899.847,9,5,4,1.9151086619593938
27167,703-004-5385,7696.512,4,3,1,1.0836919121549784
27193,703-004-5397,4481.418,2,1,1,0.35726681398221843
2740,703-004-5390,2900.657,3,2,1,1.3250285932306287
27506,703-004-5394,761.46063,2,0,2,0.27920371738274696
27703,703-004-5385,5532.2896,3,2,1,1.786649838921333
27750,703-004-5387,5706.247,3,3,0,1.172315506890764
27872,703-004-5383,7209.9136,6,3,3,0.8098549784513729
27944,207-008-2398,1659.1578,7,4,3,0.8439760701767101
27994,207-008-2399,7831.979,6,3,3,1.145175464031571
28022,703-004-5384,1892.1709,4,1,3,0.5315097944713684
28555,703-004-5397,4694.6504,4,2,2,0.6071619184013227
28916,703-004-5397,5117.3784,10,7,3,3.245510678211963
28929,703-004-5398,4098.2915,4,2,2,0.6651282001854414
29120,703-004-5398,3677.522,6,1,5,2.6749796652576787
29213,703-004-5381,5517.2295,2,1,1,0.4456519924100328
29541,703-004-5384,1925.7754,3,2,1,1.9132929880835023
29579,703-004-5393,2526.045,6,2,4,0.6058969627921512
29663,703-004-5390,7009.4194,3,3,0,0.6416374084542327
29863,703-004-5394,5674.162,1,1,0,0.6303564037326514
2996,703-004-5397,3078.1604,2,1,1,1.1624421138472996
30015,703-004-5380,4016.4978,8,3,5,0.835654738074112
3096,703-004-5380,3540.7888,2,1,1,0.37949598295036957
31105,703-004-5391,2532.345,2,0,2,0.27920371738274696
3116,703-004-5385,1172.6743,4,3,1,1.4449476013217193
31413,703-004-5384,9536.969,3,2,1,0.9356168063838867
31527,703-004-5382,2774.7686,3,1,2,0.5532535678401801
31658,703-004-5385,2575.7063,4,1,3,1.8949219289710453
31761,703-004-5382,2713.095,5,3,2,1.0407762220867562
31943,207-008-2399,7933.7583,11,7,4,2.231849778068406
32156,207-008-2399,4401.6196,4,0,4,0.27920371738274696
32433,703-004-5394,6460.4326,9,3,6,1.3780758554640968
32454,703-004-5383,8761.575,3,2,1,1.0172869507888813
32490,703-004-5392,6245.201,3,2,1,1.8371242219718205
32900,703-004-5381,739.30084,3,0,3,0.27920371738274696
32944,703-004-5393,1912.8013,3,1,2,0.4543548293645273
33002,703-004-5392,8363.413,3,2,1,2.112436600401042
33593,703-004-5382,1153.3881,6,2,4,0.4807344409509902
33645,703-004-5395,2863.9155,2,1,1,0.42582271210472183
33674,703-004-5384,3825.491,3,2,1,0.9047444106111847
33820,703-004-5388,4932.4673,7,3,4,1.358996179641415
33990,703-004-5395,4707.1016,2,1,1,1.448804300153233
34230,703-004-5396,7421.8716,8,7,1,3.295868216529704
34616,703-004-5397,4397.74,4,2,2,1.686410895162338
34677,703-004-5389,7083.8477,7,1,6,0.3187575773453028
34934,703-004-5388,5665.57,3,3,0,1.111412967336239
35014,703-004-5383,2621.2043,4,2,2,1.173191039437838
35120,703-004-5387,74.32639,4,3,1,1.244455436716428
35535,703-004-5395,8132.672,4,2,2,0.6238702310104381
35701,703-004-5390,56.142807,4,3,1,0.9293988525388055
35735,703-004-5386,9818.781,3,0,3,0.27920371738274696
36088,703-004-5395,9054.9375,4,3,1,1.1137621895684964
36128,703-004-5389,4852.312,4,2,2,0.997560378878561
36616,703-004-5387,8296.43,3,1,2,0.5165268771580819
36625,703-004-5393,8322.474,4,1,3,0.4653894152244837
36646,703-004-5388,8204.678,2,2,0,0.8279202840246431
36851,207-008-2399,6059.325,4,3,1,0.9122243872045042
3686,703-004-5396,4269.573,4,2,2,0.6277415222854655
37010,703-004-5393,7794.9756,1,0,1,0.27920371738274696
37603,703-004-5398,2274.8506,3,2,1,0.9372039979978607
37967,703-004-5389,5482.1396,3,0,3,0.27920371738274696
38286,703-004-5391,5949.8916,5,4,1,1.441286306517641
38440,703-004-5383,3792.0903,5,5,0,1.8009796306734671
38472,703-004-5387,4128.085,6,5,1,2.504121024332042
38614,703-004-5384,4129.0854,6,1,5,1.6757967510709997
38633,703-004-5386,2392.3909,6,3,3,1.1472057741125623
38693,703-004-5386,7567.1875,5,2,3,0.5446092326265861
39130,703-004-5392,215.4696,7,4,3,2.099823048833882
39221,703-004-5385,1324.5117,7,3,4,1.7858069093042472
39333,703-004-5398,5692.419,3,1,2,0.8241326618175623
3934,703-004-5384,3092.8499,7,4,3,2.5897493290586935
39522,703-004-5390,6040.558,7,5,2,1.5863122541682786
3956,703-004-5384,901.79504,"","","",0.27920371738274696
40129,703-004-5386,9557.896,3,2,1,0.6520684572079433
40653,703-004-5381,7049.555,4,3,1,1.8227035797460924
40674,703-004-5394,5435.194,4,3,1,2.0053458547478398
40709,703-004-5388,6192.792,6,2,4,1.9553585740065955
40719,703-004-5397,6094.014,4,1,3,1.0722951969524566
4087,703-004-5390,9370.715,3,3,0,1.1037496079231226
40995,703-004-5384,9024.651,6,3,3,1.1630514298865011
41087,703-004-5398,1351.6909,4,2,2,1.003103742685914
4114,703-004-5398,4051.3318,3,1,2,0.33853450732658075
41180,703-004-5386,3537.7168,6,2,4,0.5446905517259524
41188,703-004-5390,494.95758,3,1,2,0.5203226207953658
41412,703-004-5381,140.15913,6,2,4,0.832170005201372
41458,703-004-5382,951.43317,3,0,3,0.27920371738274696
41476,703-004-5387,9535.375,4,1,3,0.40465208040898965
41581,703-004-5395,2980.3313,3,0,3,0.27920371738274696
41606,703-004-5380,2133.528,4,2,2,1.6389389330502506
41713,703-004-5387,537.6488,1,0,1,0.27920371738274696
41722,703-004-5391,8590.162,3,2,1,0.7938511199710255
41890,703-004-5380,2103.1887,4,2,2,2.8128297979356223
41931,703-004-5394,3564.7446,5,4,1,2.0653505250755377
42387,703-004-5396,4875.7134,2,0,2,0.27920371738274696
42562,703-004-5390,8762.486,3,2,1,1.5265205201410734
4259,703-004-5389,2899.2283,4,1,3,0.35831143730785864
43146,703-004-5387,9695.834,5,1,4,1.1440865180596083
43235,207-008-2398,6168.3335,3,1,2,0.5157745340141903
43492,703-004-5395,8604.319,7,5,2,2.1514590707214265
4350,703-004-5381,2446.9077,5,5,0,1.981226143000117
43689,703-004-5394,64.00287,6,2,4,0.6642057759111832
43877,703-004-5384,4260.146,3,2,1,0.7056231606792673
44095,703-004-5389,7832.433,7,4,3,1.809568041630429
44143,207-008-2398,6306.8193,5,1,4,0.35831143730785864
4481,703-004-5385,8633.408,5,5,0,1.4379011221569198
45083,703-004-5388,4526.468,7,3,4,1.075250641397364
45249,703-004-5394,4587.0493,3,2,1,0.7538500369334169
45308,703-004-5383,3921.9224,1,0,1,0.27920371738274696
45689,207-008-2398,2783.3909,1,0,1,0.27920371738274696
46418,703-004-5384,8994.147,4,2,2,0.8126719549301995
46764,703-004-5398,9490.733,5,2,3,0.5289981118694498
47220,703-004-5383,9178.665,4,2,2,0.9495078374341149
47353,703-004-5394,8581.833,7,4,3,2.221826571980998
4774,703-004-5387,84.95212,4,4,0,3.007246417346442
47744,703-004-5394,2615.1162,2,1,1,0.33853450732658075
48171,703-004-5382,9103.899,4,2,2,0.8891036972589577
4831,703-004-5384,4442.262,6,1,5,0.469176384725141
48395,703-004-5396,6400.992,4,0,4,0.27920371738274696
48436,703-004-5392,6572.612,2,2,0,0.47739053016179744
48745,703-004-5383,8635.559,4,3,1,1.8982724382930534
48753,703-004-5390,6755.6953,3,2,1,0.7587109228534852
49024,703-004-5387,9343.288,8,6,2,2.985941957400875
49047,703-004-5391,9959.722,3,3,0,0.9240998701001906
49142,207-008-2398,118.47198,2,0,2,0.27920371738274696
49144,703-004-5399,7232.6904,3,3,0,3.608495775115525
4963,703-004-5393,9311.38,4,2,2,0.7432317747021594
49923,703-004-5393,2649.566,6,3,3,1.2194409512745357
5182,703-004-5380,6058.9067,8,5,3,1.7892124129770504
56,703-004-5392,4167.2734,5,4,1,0.7993773088322426
5606,703-004-5399,2183.2449,5,2,3,0.5209556734157643
5664,207-008-2398,461.10867,4,2,2,0.45311215117311426
5980,703-004-5387,529.9032,5,2,3,0.6687461982579953
599,703-004-5386,1457.3163,3,2,1,0.8690809771823763
6389,703-004-5390,9539.283,4,2,2,0.6262324807213846
6426,703-004-5381,1086.1779,3,1,2,0.45817650191597636
6579,703-004-5397,947.96655,4,3,1,1.2485144583689676
6619,703-004-5383,9148.213,7,3,4,1.0006908873509526
7238,207-008-2398,406.0447,1,0,1,0.27920371738274696
7657,703-004-5395,7897.199,4,2,2,1.0751081210683378
7678,703-004-5386,9580.388,3,1,2,0.7540810726862033
8231,703-004-5391,4486.818,1,1,0,0.767390174707828
8729,703-004-5395,8500.396,5,2,3,0.6589503383755243
9036,703-004-5387,5879.6753,"","","",0.27920371738274696
9186,703-004-5381,1888.4736,3,0,3,0.27920371738274696
9270,207-008-2398,4467.133,3,1,2,0.5244865428449157
9303,207-008-2399,5992.211,3,0,3,0.27920371738274696
9321,207-008-2399,9153.778,"","","",0.27920371738274696
9528,703-004-5396,5185.2773,3,2,1,1.0823946346044353
9867,703-004-5385,2582.1633,4,3,1,0.8952893708040961
9940,703-004-5382,7494.746,7,5,2,2.29311102800183
10181,703-004-5389,6315.457,4,2,2,0.6600217564052091
10238,703-004-5385,2006.3352,1,0,1,0.27920371738274696
10275,703-004-5382,1252.0403,4,2,2,1.268831159630074
10422,703-004-5385,794.2736,3,1,2,0.6848708961763954
10860,207-008-2399,5518.3784,5,1,4,0.3187575773453028
10863,703-004-5399,9706.706,1,0,1,0.27920371738274696
10952,207-008-2399,6122.448,5,0,5,0.27920371738274696
11014,703-004-5395,2568.612,4,3,1,0.9201119578151531
11562,703-004-5385,7954.463,4,3,1,1.123768591551988
11576,703-004-5390,474.8404,3,2,1,0.43445261773577853
11659,703-004-5397,3553.5288,5,3,2,1.687063149965523
11848,703-004-5389,5691.509,5,4,1,3.6912510295633325
12013,207-008-2398,4588.4014,6,4,2,0.9773258902776262
12090,703-004-5380,1970.9158,2,1,1,0.4337975069301488
1211,703-004-5388,9367.47,5,2,3,1.0600667819822667
12435,703-004-5387,1384.0979,3,1,2,0.5942373225222861
12605,703-004-5399,831.2178,5,2,3,0.5300105458124725
12780,703-004-5388,8798.532,3,1,2,0.4157475038340513
13263,703-004-5394,6725.4927,5,1,4,0.35534489781066697
13452,703-004-5391,5566.8247,6,4,2,1.2426668078150418
13456,703-004-5394,9332.502,1,1,0,0.4874785270613651
13459,703-004-5385,842.905,5,2,3,0.7710410423676191
13477,703-004-5390,2941.079,5,1,4,0.4585191886389712
13553,207-008-2399,5466.0117,2,1,1,0.7631953773518544
13649,703-004-5388,2807.4807,6,4,2,1.2545419622612497
13697,703-004-5389,4314.392,5,4,1,0.7302376469763007
13746,703-004-5394,4716.881,4,4,0,2.2313256690754613
13948,703-004-5383,7497.3267,2,1,1,0.5165268771580819
14083,703-004-5380,7614.9854,9,6,3,4.148275787796028
14183,703-004-5388,2571.8474,5,3,2,0.5832628882674415
1423,703-004-5390,2558.2195,"","","",0.27920371738274696
14378,207-008-2399,2130.8118,"","","",0.27920371738274696
14501,703-004-5389,9610.513,5,3,2,1.594645251132779
14533,207-008-2399,8226.481,1,1,0,0.4115069840841671
14792,703-004-5392,5725.0366,4,3,1,2.010960982294965
14831,703-004-5380,1120.9983,4,2,2,0.8676718348281661
15635,703-004-5394,8483.255,5,2,3,2.0093855055896226
15774,703-004-5390,7821.947,2,1,1,0.5121715941122635
15903,703-004-5397,1721.5032,2,2,0,0.585302449156503
1600,207-008-2398,924.0156,8,5,3,2.8595663436971965
16505,207-008-2398,9367.206,2,2,0,0.5021886029216555
16632,703-004-5388,4267.8975,7,4,3,1.0598181149290071
16960,207-008-2399,4822.9688,4,2,2,0.7058964766358399
17121,207-008-2398,2575.925,6,3,3,1.308749725520693
17177,703-004-5396,1171.09,6,4,2,1.487932405754547
17424,703-004-5383,8626.841,2,0,2,0.27920371738274696
17542,703-004-5381,5765.256,2,2,0,1.056490758864822
17569,703-004-5390,4167.7017,4,3,1,0.8139620661353877
17589,703-004-5383,2651.2212,4,1,3,1.0535535247862495
17669,703-004-5381,9849.602,5,3,2,0.9825438801652625
1806,207-008-2398,8998.629,3,3,0,0.9292208189775207
18208,703-004-5383,4825.896,6,3,3,1.3616578765408347
18485,703-004-5386,9001.83,1,1,0,0.45169506928682124
18571,703-004-5382,1758.6279,6,2,4,1.9820098818249092
18635,703-004-5387,5855.951,1,0,1,0.27920371738274696
18650,703-004-5392,4928.6987,6,4,2,1.4085561012150078
18834,207-008-2399,9660.036,6,6,0,1.2789551388804072
1894,703-004-5381,487.65778,2,1,1,0.32666834933781397
19559,703-004-5398,2520.7478,2,2,0,0.5198318905715156
2033,703-004-5381,4481.033,6,4,2,2.0105678672247693
20418,703-004-5383,2419.6946,4,1,3,0.33853450732658075
20591,703-004-5396,3214.3247,1,0,1,0.27920371738274696
20735,703-004-5389,8647.301,7,3,4,0.8109555599634549
20769,703-004-5399,5650.6216,4,3,1,0.8772610178578683
20939,703-004-5384,4676.373,4,2,2,0.5383692911657326
21056,703-004-5382,461.32922,7,3,4,1.2264099716170214
21097,703-004-5390,5491.701,2,0,2,0.27920371738274696
211,703-004-5382,622.42505,2,2,0,1.2844698058533108
21471,703-004-5390,8736.406,4,4,0,1.0960983668561255
2197,207-008-2399,7930.8467,5,3,2,3.963108685191137
22780,703-004-5393,7829.393,4,1,3,0.43577823961998974
22850,703-004-5383,971.3489,5,3,2,0.9418230705262314
22855,703-004-5393,8339.341,5,2,3,1.2338450573908697
23153,703-004-5396,4861.4707,3,1,2,0.6372602243733636
23358,703-004-5392,8771.968,2,0,2,0.27920371738274696
23361,703-004-5399,2548.734,3,0,3,0.27920371738274696
23508,703-004-5384,3207.931,6,4,2,1.6379767493866664
2368,703-004-5396,7778.766,2,1,1,0.612330583948782
23820,703-004-5381,7045.304,1,0,1,0.27920371738274696
23954,703-004-5385,8426.499,1,0,1,0.27920371738274696
23963,703-004-5386,3966.9507,4,2,2,0.6249909520710573
24808,703-004-5391,9302.932,7,4,3,1.1012156495201513
24831,703-004-5392,3763.4934,9,2,7,1.0450819928139206
24932,703-004-5392,5695.229,2,1,1,0.48661630661446575
25338,703-004-5398,4685.1353,4,0,4,0.27920371738274696
25565,703-004-5393,292.94373,6,4,2,1.523565010931185
2567,703-004-5388,5899.575,4,3,1,0.7877780954525486
25819,703-004-5391,9655.8125,3,2,1,0.6216117697306015
25840,207-008-2399,374.8107,4,1,3,0.35831143730785864
25872,703-004-5380,8001.7837,4,1,3,0.4864445866025783
26231,207-008-2399,7708.6104,3,3,0,1.540399165691128
26293,703-004-5392,5999.9424,6,3,3,3.168186941815635
26297,703-004-5387,6654.103,3,2,1,1.0714134902249777
26891,703-004-5396,2195.4023,3,0,3,0.27920371738274696
26960,703-004-5390,878.1928,6,3,3,3.12332551280423
27016,703-004-5383,5503.4785,2,1,1,4.06115220364148
27440,703-004-5390,1890.9597,3,2,1,0.8875224134274154
27574,207-008-2399,3304.8088,3,2,1,0.5442145791318709
27895,703-004-5385,6849.5596,7,5,2,1.9393525976700188
27949,703-004-5392,9968.222,4,1,3,0.7652869823047657
28290,703-004-5381,31.34787,1,0,1,0.27920371738274696
28358,207-008-2398,4585.942,4,1,3,0.5165268771580819
28397,207-008-2398,4700.789,3,1,2,0.35831143730785864
28477,703-004-5391,6235.483,2,0,2,0.27920371738274696
28484,703-004-5391,6628.6035,7,4,3,2.2166667978928696
28504,703-004-5384,7553.703,2,0,2,0.27920371738274696
28516,703-004-5396,1673.5583,3,3,0,1.4208850207285828
28556,703-004-5390,8155.348,5,3,2,1.23847083443238
28592,703-004-5387,9233.103,4,1,3,0.6688773004228656
28791,703-004-5387,9752.857,3,2,1,0.5653354615918034
29025,207-008-2399,6397.0923,2,1,1,0.32666834933781397
2909,703-004-5399,7118.0127,3,2,1,0.8608027142858315
29183,703-004-5390,1251.0514,7,3,4,0.6506689646170497
29207,703-004-5399,2735.8228,7,5,2,0.9259536491036956
29271,703-004-5385,8689.284,4,1,3,0.7088385370372764
29290,703-004-5385,9618.56,5,2,3,0.8002448605823089
29312,703-004-5391,7983.7188,5,1,4,0.3816718096619526
295,703-004-5399,8242.168,7,5,2,2.8174043319144046
2962,703-004-5391,8823.199,6,5,1,2.7671024363499828
29879,703-004-5381,4768.9624,5,3,2,0.9633991116801291
30183,207-008-2399,3482.9158,4,0,4,0.27920371738274696
30309,703-004-5393,5586.1704,2,2,0,0.6545784320579743
30404,703-004-5392,5047.358,4,1,3,0.43128513638958965
30432,703-004-5380,5091.1475,5,4,1,2.4880090720963977
30955,703-004-5388,4046.0093,3,0,3,0.27920371738274696
30978,703-004-5393,6068.908,9,9,0,3.277616386656919
31048,703-004-5390,7945.7573,1,0,1,0.27920371738274696
31401,703-004-5385,2376.24,6,4,2,1.6790006450169417
31447,703-004-5386,6625.9136,3,2,1,0.6544097613895423
31801,703-004-5388,8699.396,3,1,2,0.6156935868681972
31824,703-004-5390,7284.167,6,5,1,2.385621833976665
31965,703-004-5381,5604.2275,4,1,3,0.7661243512333938
32039,703-004-5385,7689.8535,3,1,2,0.35831143730785864
32371,703-004-5387,4463.0444,8,3,5,1.0425034642786664
32519,703-004-5397,588.0916,2,1,1,0.9441109966652367
3254,703-004-5391,5881.4316,2,0,2,0.27920371738274696
32767,207-008-2399,9764.953,6,2,4,0.7277714889682054
33289,703-004-5388,1812.7793,7,4,3,2.2238848109681904
33745,703-004-5398,5667.376,5,4,1,2.8039134144042137
34184,207-008-2398,7591.247,7,1,6,0.3572632600188509
34198,703-004-5398,4002.2725,2,2,0,0.4707588101715072
34282,703-004-5384,9484.133,10,6,4,2.717544511849316
34574,703-004-5383,5429.3447,1,0,1,0.27920371738274696
34633,703-004-5395,3821.9958,2,1,1,1.0578474469147447
34755,703-004-5396,8568.722,5,3,2,1.3014793234034276
34855,703-004-5391,4694.293,3,1,2,0.35831143730785864
34922,703-004-5399,8753.759,8,3,5,0.6890665039111405
35142,703-004-5390,5386.421,2,1,1,0.38745205968310975
3556,703-004-5394,5665.4233,6,2,4,0.539927722312612
3596,703-004-5384,2336.1296,1,1,0,0.3693148415860911
36,703-004-5395,7741.3164,3,2,1,1.864493008283613
36097,703-004-5382,6913.564,5,3,2,1.503391849603595
36207,703-004-5396,752.2869,1,0,1,0.27920371738274696
36244,703-004-5388,1963.8944,3,1,2,0.7670091420969682
3675,703-004-5398,7620.8228,7,4,3,1.1795873452460275
36973,703-004-5386,996.0407,3,1,2,0.8531163386874134
37030,703-004-5396,6308.3516,8,2,6,1.012347654275253
37147,703-004-5393,4852.447,3,1,2,0.5860513416097497
37155,703-004-5393,5529.236,4,2,2,1.1210040081003714
37164,703-004-5387,5866.8755,2,0,2,0.27920371738274696
37214,703-004-5384,207.85869,1,0,1,0.27920371738274696
37317,703-004-5390,9464.804,2,1,1,1.5143002327785564
37350,703-004-5397,8294.641,3,2,1,0.7167603102403995
37393,703-004-5382,9567.19,4,3,1,1.366938509946346
37394,703-004-5399,7081.8657,1,1,0,0.5057319695433011
37424,703-004-5399,6934.9307,3,1,2,0.7474312054250881
37571,703-004-5393,7999.06,2,2,0,0.45180138020268845
37782,703-004-5392,769.9257,2,2,0,1.4465631763553226
38378,703-004-5397,474.39932,2,1,1,0.4822761399346287
38407,703-004-5390,62.526466,3,2,1,1.139386341327207
38411,703-004-5395,8165.3906,6,3,3,1.2829066630544061
38481,703-004-5385,754.3826,3,1,2,0.5561631409955597
38611,703-004-5390,8928.366,4,2,2,1.0819657235090772
38874,703-004-5383,6654.877,3,2,1,1.2558589002373026
38916,703-004-5394,2755.0125,5,2,3,1.063227604864224
39592,703-004-5387,7128.1167,2,1,1,0.35831143730785864
39661,703-004-5382,5413.727,2,0,2,0.27920371738274696
397,703-004-5393,7345.3354,6,2,4,0.8540669533853322
39800,703-004-5390,5619.999,9,4,5,1.2557852076027571
39897,703-004-5396,3189.0493,5,2,3,1.0968359751028156
39901,703-004-5383,2944.6555,6,3,3,0.7112643411687667
40035,703-004-5390,8970.913,4,0,4,0.27920371738274696
4004,703-004-5380,2491.8782,1,1,0,0.7249497440040725
40113,703-004-5394,8474.298,3,2,1,0.5040234604899116
40205,703-004-5393,864.39667,7,6,1,2.3405711831712512
40392,703-004-5384,3679.4485,3,3,0,1.5239382315811993
40625,703-004-5388,6776.2607,5,3,2,2.2941787939629914
40759,703-004-5383,3486.0527,2,1,1,0.5711436504321594
409,703-004-5386,2862.0613,3,1,2,0.3299645043346936
40949,703-004-5395,2153.6917,4,3,1,0.7789271841496772
41000,703-004-5385,2528.6733,3,2,1,0.4512630082198648
41307,703-004-5389,6394.0864,1,1,0,0.7703958376553592
41410,207-008-2399,8004.936,3,2,1,0.8860412076768784
41499,703-004-5397,4195.8047,3,1,2,0.7782646569953043
41626,703-004-5389,3056.9607,4,2,2,0.9529506505356573
4174,703-004-5387,7025.151,2,1,1,0.7885049865318602
41962,703-004-5382,9914.812,4,3,1,2.1814834090199517
42187,703-004-5385,8801.376,5,3,2,0.7589884863840657
42540,703-004-5395,2270.962,4,2,2,2.0334546963177123
42724,703-004-5389,2005.1527,4,3,1,1.486434783874081
43171,703-004-5392,7956.764,4,1,3,0.7986610842106786
43205,703-004-5392,9681.414,7,3,4,0.9751340441176398
43571,703-004-5386,1748.7323,7,5,2,2.0625830191549754
43625,703-004-5387,3075.421,5,5,0,1.2613838140894413
43889,703-004-5393,501.47235,5,2,3,0.6827562859491443
44543,703-004-5391,2259.5786,1,0,1,0.27920371738274696
44564,703-004-5381,5242.823,3,1,2,0.32666834933781397
44775,703-004-5397,9393.528,5,3,2,1.353397312587667
44889,703-004-5382,9768.734,8,6,2,1.5865163464319327
44959,703-004-5397,994.90643,2,1,1,0.4314860782385869
4514,703-004-5398,5872.5024,6,2,4,0.5934260408233147
4519,703-004-5383,2720.2476,2,1,1,0.4564121879094345
45210,703-004-5388,6996.994,"","","",0.27920371738274696
45703,703-004-5395,6296.06,4,3,1,0.7718423277838322
45897,703-004-5383,2584.5981,2,1,1,0.35831143730785864
46167,703-004-5382,4716.3223,6,3,3,0.7908600892771307
4628,703-004-5385,8360.197,7,3,4,0.9641845138950965
46439,703-004-5398,5277.0776,3,1,2,0.44815356570860276
46951,703-004-5385,4538.7803,3,1,2,0.8215227446648511
46984,703-004-5387,8462.215,5,1,4,0.35831143730785864
46988,703-004-5388,4793.7163,3,1,2,0.591480077875356
47216,207-008-2398,2690.5376,3,1,2,0.3978652972704144
4724,207-008-2398,6802.411,6,4,2,0.9089389766993843
47250,703-004-5382,2824.7207,3,2,1,0.9581733270720144
4728,703-004-5382,5418.914,2,1,1,0.49677599336208556
47364,703-004-5388,3420.4316,3,1,2,0.39560452484403674
47393,703-004-5388,1333.5115,5,0,5,0.27920371738274696
47531,703-004-5399,7485.6655,3,2,1,0.7426809020091427
47654,703-004-5397,8869.236,4,0,4,0.27920371738274696
48049,703-004-5388,5510.346,7,2,5,0.6267169525992075
48054,703-004-5380,1315.9758,9,3,6,1.2911246266971397
4826,703-004-5384,5588.554,4,1,3,0.5455010900889831
48383,703-004-5387,3734.243,3,3,0,2.1884515030564935
48786,703-004-5380,8717.163,4,3,1,1.9937790616992355
4890,703-004-5394,5005.771,5,4,1,1.5357439123113106
49064,703-004-5391,2813.1108,8,5,3,2.7815245349636823
514,703-004-5383,3172.922,1,1,0,0.3661643545787207
5327,703-004-5397,8217.187,5,5,0,1.2328971910752338
5670,207-008-2399,8945.277,2,1,1,0.767865383345038
6689,207-008-2399,5636.084,5,5,0,1.8758099230711702
7504,703-004-5392,7406.429,5,5,0,1.9107151963379654
763,703-004-5390,7106.6875,3,3,0,0.9598468050715809
768,703-004-5391,2107.9045,3,2,1,0.5270021401420404
7986,703-004-5396,368.5349,7,2,5,0.8100315084132087
8404,703-004-5384,6636.7964,8,6,2,2.812317458061335
9219,703-004-5393,9958.281,5,3,2,0.749579900321661
9374,703-004-5398,4044.0203,5,2,3,0.5903689607652198
9823,703-004-5398,2697.0625,4,2,2,0.6337428270740818
1045,703-004-5395,6049.5454,1,1,0,0.7588436828948225
10476,703-004-5395,8793.49,1,1,0,0.5165268771580819
10637,703-004-5396,5788.3286,"","","",0.27920371738274696
10775,703-004-5384,6265.905,7,3,4,0.9843493068954783
10810,207-008-2398,5239.506,2,1,1,0.6120139294902424
11830,703-004-5395,5655.4673,4,2,2,0.47364078721592373
11860,703-004-5391,5775.0903,4,1,3,0.4270774526182882
11947,703-004-5396,460.5925,11,5,6,0.8173038160031322
11979,703-004-5393,8823.201,5,2,3,0.7077419763658067
12045,207-008-2398,9939.378,3,2,1,0.8832091714048635
12715,703-004-5384,4154.5073,6,3,3,1.0907495575263864
13044,703-004-5380,6772.7275,2,1,1,0.3558745693176967
13215,703-004-5389,9290.157,5,2,3,1.0753608844942608
1336,703-004-5384,9820.916,3,1,2,0.33853450732658075
13374,703-004-5393,7079.196,6,4,2,3.1086666564655534
13755,703-004-5392,6491.1304,7,4,3,1.0674905804016084
13793,703-004-5382,7355.6714,2,1,1,0.7549004798681272
14644,703-004-5386,3149.2258,4,3,1,0.9199863108335352
14758,703-004-5395,4780.808,6,1,5,0.38980199570542273
1482,703-004-5398,7086.282,1,0,1,0.27920371738274696
14822,703-004-5384,1499.1688,4,2,2,1.0197554468329855
15005,703-004-5388,6323.135,5,3,2,0.9477369370424314
1501,207-008-2398,6989.9995,7,6,1,1.6116131217770144
15237,703-004-5383,319.49817,6,4,2,1.0267330409130884
15381,703-004-5392,2839.9736,1,0,1,0.27920371738274696
15441,703-004-5396,735.27277,8,3,5,1.4697221263491835
15503,703-004-5384,4455.4995,2,0,2,0.27920371738274696
1651,703-004-5393,7522.8457,3,1,2,0.7543938572493023
16752,703-004-5398,3519.5935,6,3,3,1.4418683253795752
16837,703-004-5382,5779.1035,9,5,4,2.593904885360744
16892,703-004-5399,1635.1246,4,1,3,0.753858523730788
1707,703-004-5392,5501.3926,3,2,1,0.9024248836298913
17717,703-004-5397,8846.75,4,1,3,0.5929373063890235
17753,703-004-5385,5352.5854,4,3,1,0.9291467259918323
17773,703-004-5382,7227.4966,4,1,3,0.45624004543492946
18150,703-004-5384,3465.9087,5,4,1,2.2309103057573596
184,207-008-2399,8071.31,5,1,4,1.0499211626705611
18484,703-004-5387,4095.1895,4,3,1,1.352504872845676
18691,703-004-5383,5319.4,6,2,4,1.0361578268321183
18732,703-004-5381,8498.729,3,0,3,0.27920371738274696
19002,703-004-5382,1970.0593,2,1,1,0.7511729283664618
19054,703-004-5390,2657.087,4,1,3,1.0268405634686293
19449,703-004-5383,3166.0176,4,2,2,0.6832530845946942
19533,703-004-5395,1730.2656,6,2,4,0.5835979386411632
19544,703-004-5394,6664.328,5,5,0,1.8705391612986757
1984,703-004-5385,5972.582,2,1,1,0.3637500930527101
19898,703-004-5386,8208.727,6,1,5,0.7235978679257006
20246,703-004-5383,186.83612,5,2,3,1.1442694000464186
203,703-004-5380,622.1467,4,3,1,2.7094898135688186
20364,703-004-5397,8941.266,2,1,1,0.35502712086366967
20536,703-004-5397,8788.294,4,3,1,1.2202522214697256
20645,703-004-5397,1856.7198,3,2,1,0.507047411440037
21372,703-004-5380,3388.657,5,2,3,1.185083270440453
21613,703-004-5383,5865.476,7,3,4,1.0966975372960135
21689,703-004-5385,7988.146,5,2,3,0.49661996835650807
21717,703-004-5384,6305.4746,5,3,2,3.0740488721821957
21732,703-004-5388,4832.5093,2,2,0,1.7596819112801407
22,207-008-2399,8217.853,1,1,0,0.41869466570893527
22144,703-004-5390,8127.579,2,2,0,0.7171379905436556
22424,703-004-5392,2539.0117,2,1,1,0.5206161712117573
2247,703-004-5381,2268.8062,2,1,1,0.5908730269393089
22480,703-004-5398,3727.7734,5,4,1,1.6234264731211736
22507,703-004-5381,1441.44,5,4,1,1.3194933255158983
23049,703-004-5383,8885.455,3,3,0,0.8599093041590514
23404,703-004-5380,4549.032,2,1,1,0.6846307819989441
23413,703-004-5390,7109.1445,6,3,3,1.0650730354726266
23704,703-004-5395,51.850677,3,0,3,0.27920371738274696
23705,703-004-5384,8081.332,3,1,2,0.3971336332649821
23882,703-004-5392,6240.464,5,3,2,0.9735190864100741
23946,703-004-5383,4924.2715,3,1,2,0.593429736466611
24303,703-004-5399,6231.873,3,2,1,0.7876284855127026
24457,703-004-5387,3500.2053,2,0,2,0.27920371738274696
24517,207-008-2399,9437.236,1,0,1,0.27920371738274696
2496,703-004-5380,654.29034,3,2,1,0.5062812534930219
2504,703-004-5393,8305.212,5,3,2,1.1024886844627975
25468,703-004-5390,4228.546,3,2,1,0.781753489874927
25531,703-004-5397,1190.8668,2,2,0,3.0993840591132393
2580,703-004-5382,9656.3545,6,6,0,4.645422533698294
25802,703-004-5384,5519.6016,"","","",0.27920371738274696
26394,703-004-5386,6004.056,3,3,0,1.064630436359901
26461,703-004-5390,351.87662,3,2,1,0.7852068457732697
26712,703-004-5388,5412.479,6,1,5,0.8480913181116082
26885,703-004-5392,6457.252,3,1,2,0.7912238540955895
26929,703-004-5398,4838.389,5,1,4,1.0568541312362116
26930,703-004-5390,8451.658,4,1,3,1.827695675878546
27099,207-008-2398,3541.7266,3,2,1,0.7819474908227337
27236,703-004-5385,6742.9126,4,1,3,0.9434111127068652
27372,703-004-5393,3481.043,5,4,1,1.7125716644985012
27742,703-004-5380,2800.7197,2,0,2,0.27920371738274696
27909,703-004-5381,497.455,1,1,0,0.3391401758072573
28,703-004-5399,2273.3706,5,3,2,1.3817651689302968
28844,703-004-5394,9425.116,2,0,2,0.27920371738274696
29032,703-004-5396,3841.573,6,3,3,2.5361360287170878
29045,703-004-5395,7634.485,3,1,2,0.9176713297331962
29130,703-004-5390,2431.209,3,2,1,0.5148993904034251
29438,703-004-5386,3568.3406,3,0,3,0.27920371738274696
29507,703-004-5393,3811.031,5,2,3,0.4935658614498182
29601,703-004-5384,2702.526,"","","",0.27920371738274696
29629,703-004-5387,8503.743,4,2,2,1.1768528814337866
29903,703-004-5393,4510.4253,8,2,6,0.7715511519624487
29918,703-004-5384,3341.431,6,1,5,0.35534489781066697
29958,703-004-5388,7477.7017,4,2,2,1.3497970638551358
29960,703-004-5393,1397.6968,7,4,3,3.1702197670961594
30030,703-004-5397,1937.7291,5,2,3,0.749354511929469
30150,703-004-5385,9692.331,2,1,1,0.3930685282873277
30291,703-004-5384,7991.512,4,3,1,1.633168237827491
30531,703-004-5387,5491.5547,8,4,4,1.553293853745971
30705,703-004-5392,5371.0054,6,3,3,0.8433080330472481
3095,703-004-5387,7921.243,4,2,2,1.6435071545953097
31214,703-004-5396,5840.9834,6,4,2,0.9754306481290546
31452,703-004-5395,7513.4414,5,4,1,1.4811472592879025
31453,207-008-2398,9631.816,3,1,2,0.42517299732931846
31462,703-004-5395,7276.531,6,4,2,1.8909815328363826
32452,703-004-5390,4702.3164,6,3,3,0.8196281115411659
32554,703-004-5388,232.16724,4,2,2,0.5413222392757177
32564,703-004-5393,7363.8223,1,1,0,0.4271927197880031
32574,703-004-5384,9462.983,1,0,1,0.27920371738274696
32803,703-004-5398,6432.686,4,2,2,0.7305630019679065
33093,703-004-5395,4104.94,4,0,4,0.27920371738274696
3327,703-004-5396,1854.4633,7,3,4,1.1091014562830637
33451,703-004-5396,8766.182,3,3,0,4.044010622934545
33744,703-004-5381,8587.775,3,2,1,1.0364424984088532
34486,703-004-5391,9754.061,2,2,0,0.8012073588545506
34628,703-004-5382,1006.2331,7,5,2,1.4366492967897666
34756,703-004-5390,6811.93,4,1,3,0.589842128190938
34793,703-004-5380,8557.691,6,5,1,3.6348846656899054
34885,703-004-5385,5785.6245,5,5,0,3.007270028707836
3506,703-004-5386,8673.304,4,3,1,1.3755199451528501
35265,703-004-5388,48.26784,3,1,2,0.6078322193537601
3541,703-004-5384,1959.6606,2,2,0,0.4453299292254814
35918,703-004-5390,8435.091,5,3,2,1.470434324990701
36043,703-004-5389,3877.4985,3,1,2,0.6903953564240487
36068,703-004-5389,6300.327,1,0,1,0.27920371738274696
36089,703-004-5382,8227.152,6,2,4,0.5893214811440535
36152,703-004-5390,7141.932,6,3,3,1.3272147997526873
36178,703-004-5391,8645.558,3,0,3,0.27920371738274696
36219,703-004-5398,736.03033,5,3,2,1.3443436908789006
36299,703-004-5382,6980.6416,1,0,1,0.27920371738274696
36684,703-004-5381,1672.3925,1,0,1,0.27920371738274696
36706,703-004-5386,1973.0162,3,1,2,0.33853450732658075
36781,703-004-5388,2275.1755,3,2,1,0.5265689223706067
36881,703-004-5398,3911.9934,2,1,1,1.0836553423720856
36928,703-004-5389,6849.967,7,5,2,3.1001136923476724
36996,703-004-5392,5003.8745,5,3,2,0.7572341442976441
37237,703-004-5392,9541.233,7,3,4,0.7431234991121587
37443,703-004-5389,4444.2744,3,2,1,1.421075603826304
37983,703-004-5389,4364.1577,3,2,1,0.9781717357310737
38001,703-004-5381,17.774105,2,2,0,1.7007445956288898
38061,703-004-5394,3529.169,5,2,3,0.9441463847512086
38350,703-004-5395,2164.1343,3,3,0,1.054133872915543
38630,207-008-2399,7030.4824,5,3,2,1.0639472982221199
38648,703-004-5384,510.48398,3,2,1,0.614827352160608
38663,703-004-5392,9734.651,2,0,2,0.27920371738274696
38919,703-004-5384,7809.9214,7,4,3,1.2639870315291393
39112,703-004-5380,6164.4937,4,4,0,2.424876659965164
39239,703-004-5394,8716.179,3,2,1,0.791053429607049
39334,703-004-5398,771.7377,5,2,3,0.7991986989220929
39382,703-004-5391,2568.5972,1,1,0,0.6027515622480968
39421,703-004-5395,4709.3457,3,3,0,0.776959533322064
39426,703-004-5385,3087.0598,4,4,0,0.8551579514217162
39778,703-004-5386,8190.8506,3,2,1,1.2358601413764418
39808,703-004-5388,6674.8994,5,2,3,1.762855818920676
39934,207-008-2398,9747.462,5,4,1,1.8303913861296652
40104,703-004-5387,8078.9375,3,2,1,0.9174359375470215
40184,703-004-5395,1817.41,5,1,4,0.5474507343073526
40582,703-004-5395,411.3704,2,1,1,0.3828734298330546
40684,703-004-5383,4508.9507,3,1,2,0.38700117040069915
40715,703-004-5394,323.6252,2,1,1,0.9465583214085331
4080,703-004-5391,9373.817,3,2,1,2.205166106199496
40867,703-004-5396,4740.4165,9,4,5,1.3641975197385163
4104,703-004-5390,8960.925,1,0,1,0.27920371738274696
41198,703-004-5394,875.0987,3,2,1,0.6801623336766598
41804,703-004-5398,4424.5303,3,1,2,0.3978652972704144
41948,703-004-5390,1608.2179,4,3,1,2.7612980914110272
4196,703-004-5384,3557.123,3,1,2,0.7789740554737328
4199,703-004-5391,3905.353,3,2,1,0.6121238038675135
4224,703-004-5381,5783.735,4,1,3,0.9206082849812618
42659,703-004-5395,5969.936,2,1,1,0.33853450732658075
4266,703-004-5389,180.00484,4,4,0,1.5013885173485395
43103,703-004-5393,1079.1206,4,2,2,0.5785171603641264
43357,703-004-5386,5494.383,5,2,3,2.1599874831424595
43483,207-008-2399,9583.379,1,1,0,0.3637500930527101
43622,703-004-5399,1875.5758,4,3,1,1.2542832310981136
43670,703-004-5384,4495.231,5,4,1,1.3760174824387448
43731,703-004-5392,1525.7245,1,0,1,0.27920371738274696
43844,703-004-5389,1923.83,3,2,1,0.7270967206367965
43883,703-004-5394,2144.4814,4,3,1,3.6688553760220963
43979,703-004-5392,770.51697,2,1,1,1.595458832327809
44103,703-004-5399,1904.3541,4,2,2,0.8323100497346012
44381,703-004-5390,9020.455,1,1,0,0.33853450732658075
44622,703-004-5399,5332.952,3,0,3,0.27920371738274696
44664,703-004-5390,4687.155,5,2,3,0.5784004192880771
45021,703-004-5394,2000.0541,4,3,1,1.0962346422199327
45247,703-004-5391,4701.1445,6,3,3,0.8840291268628955
45586,703-004-5390,9835.128,5,3,2,0.8706232032944983
4565,703-004-5389,9969.237,2,0,2,0.27920371738274696
45665,703-004-5392,6935.7886,3,0,3,0.27920371738274696
45824,703-004-5383,1288.023,3,1,2,0.5883912964775505
46291,703-004-5390,6688.807,3,2,1,1.2639572171878122
46450,703-004-5390,5973.641,6,2,4,1.3977374458314005
46811,207-008-2399,2266.1943,1,1,0,1.8398541029761473
47084,703-004-5397,4617.2134,2,1,1,0.4562533868851406
47380,703-004-5394,6388.218,4,2,2,0.6990803014665152
48002,703-004-5394,6990.867,5,1,4,0.9691309799855077
48043,207-008-2398,2965.434,7,1,6,0.5708853820156674
48547,703-004-5385,7651.809,3,2,1,0.5948904546840652
48597,703-004-5396,6049.673,5,1,4,0.39247388641385167
49253,703-004-5398,1815.6135,1,0,1,0.27920371738274696
49638,703-004-5389,6055.9297,5,2,3,0.7196473013675523
49758,703-004-5380,1763.3313,5,1,4,0.35831143730785864
49922,207-008-2398,2052.3662,3,0,3,0.27920371738274696
5676,703-004-5387,4707.093,1,1,0,0.5372057568606775
570,703-004-5381,7264.197,2,1,1,0.6619581026406739
5874,703-004-5392,2733.2114,2,1,1,0.7695608657747448
5886,703-004-5394,6959.2964,7,2,5,1.6922778521641197
5941,703-004-5399,5169.8325,4,4,0,0.9509498112399504
6156,703-004-5393,9593.296,4,2,2,1.1083830612330292
6310,207-008-2398,6289.12,3,3,0,1.845872621262182
6334,703-004-5386,274.508,4,2,2,0.9386129212686091
6469,703-004-5395,7556.5215,2,2,0,0.794304377801658
6661,703-004-5390,7330.55,5,2,3,1.0098633508129915
6663,703-004-5396,1768.1396,3,2,1,1.1475622418865505
6771,703-004-5399,3628.471,7,4,3,2.5935296571771036
6801,703-004-5385,5547.1704,5,0,5,0.27920371738274696
7186,703-004-5392,5323.326,1,0,1,0.27920371738274696
7318,703-004-5381,9697.127,5,2,3,0.6157970408137168
7368,703-004-5395,8772.536,3,2,1,0.976357424463678
7398,703-004-5393,5757.185,4,1,3,0.9667156595162608
7425,703-004-5389,5852.9663,6,2,4,0.6364449162028633
7473,703-004-5388,2429.9895,2,0,2,0.27920371738274696
7861,703-004-5395,5002.6396,5,2,3,0.7278073696549557
7885,207-008-2399,1752.0369,6,3,3,1.1360875030407576
8246,703-004-5387,5211.9736,2,1,1,0.4436105893710333
8266,703-004-5380,8082.443,4,1,3,2.176282855364532
8514,703-004-5388,3849.4504,8,1,7,0.35828671614538204
8849,703-004-5382,8824.951,8,5,3,2.3927684111367875
888,207-008-2398,802.083,1,1,0,1.006896408644281
8970,703-004-5392,2962.8123,5,1,4,0.9465583214085331
9026,703-004-5391,5928.957,5,2,3,0.5119064918912059
9134,703-004-5395,7519.4346,3,2,1,0.7127054770711054
9191,703-004-5392,8759.68,3,2,1,1.1573608753000484
9249,703-004-5394,2995.3276,1,0,1,0.27920371738274696
9335,207-008-2398,3392.8604,6,4,2,1.26509974587442
9406,703-004-5383,8198.714,2,1,1,0.43227753826269694
9546,207-008-2399,461.36438,2,1,1,0.3734554147765184
9744,703-004-5380,7001.607,5,2,3,0.5116102432502126
10,703-004-5382,4451.629,6,2,4,0.41018698387974994
1009,703-004-5385,9564.615,1,1,0,0.35831143730785864
10105,703-004-5399,4739.6987,3,0,3,0.27920371738274696
10108,703-004-5395,9146.9795,4,2,2,1.6673487887545775
10120,703-004-5382,2934.6067,6,3,3,2.0745411804261105
10389,703-004-5385,8207.826,5,1,4,0.42555299924420353
10564,703-004-5387,8340.315,2,1,1,0.9155239156340756
10848,703-004-5391,1197.0323,4,2,2,0.6194504156539813
10972,703-004-5381,5489.5024,3,2,1,1.2462215949935624
11195,703-004-5385,6615.8755,2,1,1,0.5133176342760939
11474,703-004-5388,6252.233,3,2,1,1.485689958552135
11544,703-004-5385,1195.6353,6,1,5,0.5013484388001077
11656,703-004-5399,4101.374,4,3,1,1.6072297061908098
11777,703-004-5385,1187.1708,2,1,1,0.5154197635989015
11915,703-004-5390,5587.645,2,1,1,0.6879213598536948
12079,703-004-5399,5444.9624,4,1,3,0.5663956845261995
12175,703-004-5391,758.4256,4,2,2,1.1371789700608028
12519,703-004-5383,2765.1233,6,3,3,1.2323102400784216
12618,703-004-5382,5698.531,3,2,1,0.5612972086680663
12648,703-004-5399,8219.6875,1,1,0,0.36951836429724944
12678,207-008-2398,585.506,6,3,3,0.8011734560280329
12891,703-004-5386,3637.2065,3,2,1,1.5028854005323695
1295,703-004-5396,2345.5964,6,2,4,1.9530768595563037
13166,703-004-5382,6352.8984,5,2,3,0.3859991392816477
13268,703-004-5393,2359.0886,3,1,2,0.5167961282050556
13504,703-004-5382,3870.2124,3,2,1,2.0320666874917537
13664,703-004-5398,591.0033,2,2,0,0.6455370811154018
13731,703-004-5389,3615.3018,6,6,0,3.0931066048258
13744,207-008-2399,2891.2048,3,0,3,0.27920371738274696
14092,703-004-5384,4139.5923,5,2,3,2.5053760479464406
14158,703-004-5387,5973.1924,4,1,3,0.40475810027308573
1440,703-004-5395,6106.795,3,2,1,1.5289826540782765
14514,703-004-5387,6054.7793,7,3,4,1.3751163136921012
14995,703-004-5383,4875.807,1,1,0,1.3131188169534957
15164,703-004-5387,183.20084,5,2,3,0.6029241503930866
15419,703-004-5382,3344.4475,3,1,2,2.026656989656206
15678,703-004-5398,7145.431,3,1,2,0.3978652972704144
15681,703-004-5388,5058.9526,2,0,2,0.27920371738274696
16262,703-004-5384,3568.4836,4,2,2,1.3009554286953116
16319,703-004-5385,9960.234,2,0,2,0.27920371738274696
16451,703-004-5390,8972.397,8,4,4,1.096370747396566
16930,703-004-5388,325.38535,6,2,4,1.0942388557690308
16949,703-004-5394,1283.9735,4,2,2,0.4877102420978615
17150,703-004-5397,8748.376,2,1,1,0.34214471486252285
17192,703-004-5396,2363.2102,9,5,4,2.0743537890393013
17478,703-004-5385,2001.9692,4,0,4,0.27920371738274696
17876,703-004-5391,8930.79,8,7,1,3.6225815319554684
17933,703-004-5386,56.13327,7,2,5,0.6004948909314207
17974,703-004-5395,9249.9795,4,2,2,1.502504815477799
18519,703-004-5381,7756.551,3,1,2,0.752186773872048
18524,703-004-5386,5045.966,3,1,2,0.46165795921879377
18676,703-004-5386,2798.5466,9,6,3,2.935569672931155
18700,703-004-5394,1949.4081,2,0,2,0.27920371738274696
18760,703-004-5386,5600.416,1,1,0,0.6034254152016475
18852,703-004-5383,5405.1753,4,2,2,0.6292442918641966
18884,703-004-5397,1619.5369,2,0,2,0.27920371738274696
19199,703-004-5395,6030.342,7,4,3,1.6176601275138396
19657,703-004-5383,5651.3345,2,1,1,0.6906428757287673
19688,703-004-5383,6881.3896,7,4,3,1.3535942347846346
19798,703-004-5386,280.0566,5,1,4,0.504477243233627
20663,703-004-5391,469.54156,4,3,1,0.8425717993407303
2103,703-004-5395,5.712509,6,3,3,0.9187644123017316
21185,207-008-2398,8068.072,6,3,3,0.8884960669550698
21335,703-004-5398,7173.108,2,1,1,1.0663735094536968
22110,703-004-5383,4549.944,"","","",0.27920371738274696
22645,703-004-5387,7238.013,7,4,3,1.665863676546094
22657,703-004-5383,1759.8468,3,2,1,0.8978894563438333
2270,703-004-5385,8615.095,4,0,4,0.27920371738274696
22991,703-004-5395,507.69745,3,0,3,0.27920371738274696
23107,207-008-2399,1013.07214,6,5,1,1.6309736363778975
23116,703-004-5392,4734.0815,3,2,1,1.0146926330917285
23188,703-004-5391,531.9506,4,1,3,0.7322669296491823
23461,703-004-5387,782.1673,3,1,2,0.6104116641709915
23604,703-004-5387,5002.241,2,0,2,0.27920371738274696
23659,703-004-5386,6424.9424,4,1,3,0.8624365168214918
23712,703-004-5380,8571.539,3,3,0,2.449142973795445
23874,703-004-5392,3812.2683,5,3,2,1.1200616864032797
23886,703-004-5380,6650.362,4,3,1,1.5607047755916603
24046,207-008-2399,5245.3,5,3,2,2.1662383184652096
24076,703-004-5390,34.92117,2,1,1,0.3543362743816218
24176,703-004-5387,9049.139,4,3,1,0.846726805808135
24215,703-004-5391,8398.909,3,1,2,1.4469367394545358
24281,703-004-5395,6925.163,5,3,2,1.6865456480103787
24306,703-004-5389,3252.812,6,3,3,0.92123661405938
24591,703-004-5399,4434.452,5,4,1,2.2146374081838207
24700,703-004-5388,6323.8237,2,0,2,0.27920371738274696
2476,703-004-5388,9108.065,5,3,2,1.222158932615908
24883,703-004-5383,6447.4272,4,1,3,0.5454896143592546
24989,703-004-5399,9898.972,2,2,0,0.9264258637541218
25073,703-004-5388,3426.3552,3,1,2,0.5681548723242101
25084,703-004-5398,7175.6323,4,2,2,0.7844440417469737
25130,703-004-5393,3595.077,5,2,3,2.3146756703512272
25252,703-004-5398,6425.232,1,1,0,0.5459105538826092
25257,703-004-5398,4606.097,1,1,0,0.4049708252925027
25538,703-004-5391,7394.183,5,3,2,1.0596255550546796
25712,703-004-5381,5080.1406,4,2,2,1.09023189146785
26089,703-004-5387,3102.901,4,2,2,0.7491178722512786
26174,703-004-5385,1331.1296,4,2,2,0.46270904479942204
26277,703-004-5396,7744.2783,3,2,1,2.9891180999114453
26310,703-004-5394,9448.039,5,3,2,1.087824350724494
26831,703-004-5383,498.0272,6,6,0,2.12149781393302
27449,703-004-5399,8583.379,2,1,1,0.7326006117829592
27616,703-004-5385,3312.5686,4,3,1,1.0558210688051681
27898,703-004-5384,3316.1765,1,1,0,0.40955511096684816
28012,703-004-5387,5370.932,3,3,0,0.6498418430605607
28061,703-004-5381,8470.345,4,1,3,0.3803330488420116
28337,703-004-5382,2894.581,4,2,2,0.984421930299535
28532,703-004-5397,4812.782,2,2,0,1.4498122452003246
28657,703-004-5398,4979.6846,5,4,1,1.2669906242133726
28799,703-004-5388,9223.11,5,5,0,1.112997467289764
29028,703-004-5386,1784.3252,3,2,1,0.6921955945320766
29186,703-004-5399,9871.576,5,4,1,1.0860203864642572
29237,207-008-2399,1794.9658,"","","",0.27920371738274696
29324,703-004-5388,9506.239,2,1,1,0.47560782370451604
2934,703-004-5390,7241.7393,4,2,2,0.8282439785223469
29386,703-004-5398,3493.3625,4,1,3,1.1301512102406892
29628,703-004-5398,5046.994,4,2,2,0.6225784276995601
29672,703-004-5382,271.16895,2,0,2,0.27920371738274696
30013,703-004-5394,8759.783,7,5,2,1.2789052877515092
3023,703-004-5392,5974.2676,6,1,5,0.35442614610770856
3037,703-004-5396,427.6347,3,2,1,1.8599223960946876
30391,703-004-5383,7690.008,3,0,3,0.27920371738274696
3075,703-004-5386,6919.2295,8,2,6,0.41764222725169237
3091,703-004-5385,3911.4888,7,3,4,0.9477860128238332
31072,703-004-5381,2303.5515,4,2,2,0.8790185100230224
31081,703-004-5385,1078.9025,2,1,1,0.53021910501512
31151,703-004-5398,4422.7515,2,1,1,0.33853450732658075
31204,703-004-5388,8665.019,5,2,3,0.5165268771580819
31213,703-004-5387,6534.7476,7,4,3,1.3396462641833933
31321,703-004-5393,6942.667,4,2,2,1.2216230737586427
31361,703-004-5381,3261.4248,4,3,1,0.5560807371206377
3168,703-004-5387,4246.854,2,1,1,1.5776634897653634
31819,703-004-5388,6693.083,3,1,2,0.49836871301607255
31863,207-008-2398,6201.306,3,2,1,0.6266113932778394
32129,703-004-5392,1211.4143,2,0,2,0.27920371738274696
3214,703-004-5390,4836.0566,4,2,2,0.8828976673602937
32567,703-004-5399,1127.6722,3,2,1,1.1044364912142783
32671,703-004-5387,3712.4187,8,4,4,2.0518812741026484
32831,703-004-5389,9614.265,2,0,2,0.27920371738274696
32966,703-004-5381,8432.505,1,0,1,0.27920371738274696
33339,703-004-5385,1146.574,7,4,3,1.6981407447437258
33362,207-008-2398,446.16937,2,1,1,0.5165268771580819
33612,703-004-5396,2526.1926,5,2,3,1.4600231608516623
33742,703-004-5393,1534.8851,5,2,3,0.8566300216521587
33810,703-004-5392,8252.633,6,3,3,1.1405396726854737
33865,703-004-5396,1671.7786,4,1,3,0.6020696197643463
33951,703-004-5384,3599.828,3,3,0,1.308227494869349
34160,703-004-5392,8094.5913,4,2,2,0.5661433222972233
34577,703-004-5396,2369.2573,1,1,0,1.830075221496325
34742,703-004-5388,3562.9875,4,1,3,1.8927560111561805
35044,703-004-5394,3595.7473,4,3,1,1.839013613577216
35130,703-004-5381,9034.517,1,0,1,0.27920371738274696
35252,703-004-5384,4121.405,3,2,1,0.9516190306746604
35273,703-004-5397,8593.258,2,1,1,0.3457487605663137
35820,703-004-5393,5880.219,9,6,3,2.3068646498734107
35859,703-004-5392,6738.0923,5,5,0,2.2562042383228444
3602,703-004-5398,3451.5637,3,1,2,0.8938829419018562
36070,703-004-5380,6200.664,4,1,3,0.6643653663288717
36108,703-004-5384,4152.0513,1,0,1,0.27920371738274696
36165,207-008-2398,2946.5723,2,2,0,0.6312102102820729
36179,703-004-5393,3086.068,2,0,2,0.27920371738274696
36199,703-004-5394,3623.8252,2,1,1,0.5770768564420999
36360,703-004-5390,7158.4834,4,2,2,0.5661428269629225
36969,703-004-5394,4283.5547,3,1,2,0.7479150707391861
37085,703-004-5393,2043.4642,6,4,2,1.9129022885307865
37247,703-004-5386,9499.475,2,0,2,0.27920371738274696
37256,703-004-5383,2555.84,4,3,1,1.8009479096136278
37301,703-004-5382,9453.286,2,2,0,1.647212559010224
37736,703-004-5398,3303.7925,2,0,2,0.27920371738274696
37955,703-004-5399,3317.548,5,0,5,0.27920371738274696
384,703-004-5398,9952.132,1,1,0,0.8138453552388836
38615,703-004-5387,7324.213,4,1,3,0.5734839509693778
39441,703-004-5390,9683.024,3,2,1,0.713520502969124
39554,703-004-5398,8833.33,5,2,3,4.1668042576590585
39787,703-004-5397,3028.1274,3,3,0,1.0786731817278243
3991,703-004-5391,553.1734,4,3,1,1.2558809270743425
39974,703-004-5388,1138.8219,3,1,2,0.48605470422652935
40047,703-004-5393,7901.644,3,1,2,0.7842318905488795
40336,703-004-5391,7660.8394,5,3,2,2.7517597881517544
40504,703-004-5382,8162.223,5,3,2,0.7598528448404297
40544,703-004-5395,1676.0355,6,3,3,1.8614068378147703
40646,703-004-5386,4707.218,2,1,1,1.2024709510829799
40857,703-004-5381,9217.149,6,2,4,1.0190885878611973
40967,703-004-5395,5467.7754,3,1,2,0.8115492301537951
41118,703-004-5384,7173.956,2,1,1,0.38390725805684234
41356,703-004-5397,7502.4927,3,3,0,3.000228072762428
41431,703-004-5386,700.537,5,4,1,1.7774898032538546
41453,703-004-5393,7333.2964,9,4,5,3.129247237433887
41926,703-004-5390,9787.907,4,4,0,1.553870305880921
420,703-004-5385,8209.267,3,0,3,0.27920371738274696
42094,703-004-5386,5170.5293,5,1,4,1.0815008875074787
42261,703-004-5394,4366.377,7,4,3,1.4887449540412558
42328,703-004-5383,9512.758,3,2,1,0.7009120670714917
42436,703-004-5399,2096.5308,6,2,4,0.8967680790296879
42480,703-004-5380,6731.432,1,0,1,0.27920371738274696
42862,703-004-5395,6299.0356,2,2,0,0.8755900477956221
43333,703-004-5389,2796.8818,1,1,0,0.5672550802444865
43667,703-004-5399,6567.2153,4,1,3,0.3978652972704144
4393,703-004-5383,1196.1001,1,1,0,0.9638474257042842
44252,703-004-5388,3294.0232,3,2,1,0.5215904506189029
44362,703-004-5385,7729.722,7,3,4,2.1826628301562176
44643,703-004-5382,7928.591,4,1,3,0.7109261619370711
44668,207-008-2399,6468.7007,3,1,2,0.6388224679298091
4468,703-004-5385,1294.4901,5,3,2,0.8717671351384738
4499,703-004-5397,2330.484,3,2,1,1.4310296697385614
44998,703-004-5389,9367.25,4,2,2,1.020774808933268
45171,703-004-5395,8856.279,5,1,4,0.49691680419918954
45340,703-004-5386,6114.1055,5,3,2,1.968402333344704
45406,703-004-5391,3256.8682,2,1,1,0.348383987750313
45417,703-004-5390,7702.4644,5,2,3,1.0187741629389189
45774,703-004-5396,931.2135,4,2,2,2.155737196801417
45842,703-004-5390,6159.5093,4,3,1,1.3758709724914144
46099,703-004-5383,3680.6375,5,2,3,0.9631213840494679
46340,703-004-5390,2038.7233,4,1,3,0.6529046541410711
46445,703-004-5395,4548.293,3,1,2,0.4550743589021838
46705,703-004-5389,5819.322,2,0,2,0.27920371738274696
46784,703-004-5399,1003.3965,4,2,2,1.6408700199715613
46912,207-008-2399,1532.5535,7,3,4,0.7756440076370827
47191,703-004-5384,4511.501,3,1,2,0.5151614779121745
47289,703-004-5380,203.8604,4,2,2,0.7543939456467279
47315,703-004-5391,7499.0024,3,2,1,0.452845162618367
47469,703-004-5392,9681.336,2,1,1,0.792315052503405
4751,703-004-5390,2650.5178,3,1,2,1.0338277622416239
47758,703-004-5394,2846.0151,2,1,1,0.5446458171502095
47873,703-004-5394,8842.687,2,0,2,0.27920371738274696
48100,703-004-5391,4207.477,3,2,1,0.7267274181339932
48118,703-004-5399,3052.596,11,3,8,1.4711427848110301
48123,703-004-5386,4798.8994,8,5,3,3.4802721836356385
48204,703-004-5390,6016.896,7,2,5,0.8097664419929038
48527,703-004-5387,1689.3888,1,0,1,0.27920371738274696
49490,703-004-5380,5021.544,4,3,1,0.7319233864773997
49679,207-008-2399,416.46777,4,1,3,0.6409178491359381
49684,703-004-5387,5412.24,3,3,0,1.1377745862156947
5083,703-004-5384,6289.562,8,3,5,0.7553370697435952
5229,703-004-5385,4970.2656,2,0,2,0.27920371738274696
5487,703-004-5386,7402.969,1,0,1,0.27920371738274696
5490,703-004-5391,8048.004,4,3,1,0.8741932749451076
5684,703-004-5383,9261.532,1,1,0,0.4239033200327499
5926,703-004-5398,7725.6685,2,1,1,0.5302716897601633
6142,703-004-5382,1820.5428,1,1,0,0.6876592667094967
6178,703-004-5396,7897.9,6,1,5,0.6095645847232666
6207,703-004-5399,2926.8945,3,2,1,0.6108893247896121
6232,703-004-5388,4703.366,7,2,5,2.853608522642557
6342,703-004-5384,7560.5435,5,1,4,0.9056464067816342
6413,703-004-5383,8128.3076,6,1,5,0.32666834933781397
6484,703-004-5387,324.15628,3,2,1,1.0944783441699186
6987,703-004-5390,3088.311,3,1,2,0.4385865510850963
7016,703-004-5386,2807.0342,2,0,2,0.27920371738274696
7130,703-004-5383,1406.6761,2,1,1,0.44829646872267315
7440,703-004-5393,1157.9424,3,1,2,0.34034786345414975
7495,703-004-5385,9897.667,2,0,2,0.27920371738274696
8708,703-004-5396,5391.03,6,4,2,2.6631978933022022
9095,703-004-5398,3768.2878,4,1,3,0.4108747540878072
9173,703-004-5394,675.88745,2,1,1,0.6241133762562336
9498,703-004-5395,2672.2056,2,0,2,0.27920371738274696
10480,703-004-5382,4472.782,"","","",0.27920371738274696
10514,703-004-5394,9878.336,5,3,2,1.1940580694471212
1062,703-004-5384,5858.4614,2,0,2,0.27920371738274696
10933,703-004-5380,4812.2305,1,0,1,0.27920371738274696
11398,703-004-5396,1787.6757,6,3,3,2.397309144134079
11501,703-004-5393,3807.9792,3,2,1,1.338548812880076
11871,703-004-5382,8541.374,"","","",0.27920371738274696
12137,703-004-5383,4153.45,3,1,2,0.3822662437476815
12208,703-004-5391,3244.0835,7,3,4,2.265208358080109
12314,703-004-5381,3924.9587,2,2,0,1.606292491093643
12315,703-004-5394,9219.991,4,2,2,0.5141661220039606
12647,703-004-5386,2652.9407,5,2,3,1.201576809715102
12732,703-004-5386,1618.4807,2,0,2,0.27920371738274696
1283,703-004-5387,9128.308,3,2,1,1.5086661323519792
12971,703-004-5397,9099.462,4,4,0,1.6798820481605663
13239,703-004-5394,2243.5034,4,3,1,0.7905686985170435
13345,703-004-5381,1369.4775,5,4,1,3.4892433080318326
13483,703-004-5395,6885.429,4,3,1,1.75247091951949
13528,703-004-5392,9176.442,4,3,1,1.375826309160668
1379,703-004-5388,6744.8413,3,0,3,0.27920371738274696
14041,703-004-5398,677.97186,5,2,3,0.8769239671532464
14349,703-004-5396,8278.0205,8,4,4,1.3630901974059066
14479,703-004-5387,1553.4061,1,1,0,0.8610943824075069
14669,703-004-5384,6834.53,6,3,3,1.0063508126196463
14939,703-004-5385,7266.975,3,1,2,1.6921508289119047
15214,703-004-5394,7801.4707,8,6,2,1.6320464422193095
15528,703-004-5384,144.89174,1,0,1,0.27920371738274696
1562,703-004-5396,9211.567,4,1,3,0.3637500930527101
15720,703-004-5389,2039.9899,3,1,2,0.7482910923496706
15902,703-004-5380,4745.595,2,2,0,0.4941353654017329
1609,703-004-5381,925.44916,2,0,2,0.27920371738274696
16166,703-004-5381,7919.527,8,2,6,1.1602541586758595
16422,703-004-5390,5059.203,5,1,4,0.7650446236421071
17268,703-004-5396,8023.3276,6,2,4,0.45466534649557244
17395,703-004-5396,7335.6533,8,1,7,0.5807350490494139
17614,703-004-5394,6881.3027,2,2,0,0.7456072581919848
17692,703-004-5396,7266.78,6,3,3,1.1747083225973283
17802,703-004-5394,9577.184,2,0,2,0.27920371738274696
17833,703-004-5395,9233.327,1,0,1,0.27920371738274696
1794,703-004-5395,1912.4169,4,2,2,1.024698065782888
18367,703-004-5383,9776.476,8,5,3,2.7536744149938417
18663,703-004-5395,2756.908,4,2,2,1.2054898629075816
18787,703-004-5389,802.7333,4,3,1,1.0310532268065098
18814,703-004-5389,8056.6753,5,3,2,0.5962003288692387
18854,703-004-5383,2766.0596,4,2,2,1.1015867453331534
18858,703-004-5399,3086.288,3,2,1,0.9621261764844332
18888,703-004-5387,8896.377,2,1,1,0.5913882971432254
19340,703-004-5388,1.9663572,"","","",0.27920371738274696
19394,703-004-5387,470.0464,4,1,3,0.5308500824937827
19485,703-004-5393,7384.3545,5,2,3,0.47697301719552604
19690,703-004-5385,7150.2856,4,2,2,1.0020192676498316
19867,703-004-5391,8606.931,6,4,2,1.2674820249605387
199,703-004-5397,8902.359,4,2,2,0.7138196078942287
20126,703-004-5388,2275.676,7,3,4,1.3501354434228292
20480,703-004-5393,8258.29,4,3,1,1.3450098678271813
21034,703-004-5399,7491.7524,4,1,3,1.9387701486514208
21042,703-004-5382,2455.9343,6,2,4,0.707052876365218
21112,703-004-5388,9622.997,4,2,2,0.5686831384441052
21419,703-004-5391,4616.5596,1,1,0,0.656393091872313
21421,703-004-5385,8255.108,4,1,3,0.44735537682986126
21617,703-004-5381,1609.7164,5,3,2,0.7131665564580139
22224,703-004-5382,1490.7134,7,3,4,1.1247738900970572
22792,703-004-5382,7605.5737,3,2,1,3.705634438861598
23063,703-004-5394,9375.987,6,2,4,1.8903605426961887
23177,703-004-5389,1380.0638,4,2,2,0.6091611215777495
23644,703-004-5390,9363.122,3,2,1,0.6150089861955742
23689,703-004-5397,31.091572,4,2,2,0.7758468079656653
23902,703-004-5385,3746.6472,3,2,1,0.6438617594808
24549,703-004-5398,4732.0645,4,3,1,1.2257519962053498
24554,703-004-5381,5456.451,4,3,1,1.0214357108398306
24841,703-004-5397,6956.109,1,1,0,0.5721940087616382
24928,207-008-2399,7447.488,1,0,1,0.27920371738274696
25217,703-004-5388,837.6545,8,2,6,0.7719878844662958
2532,207-008-2399,7274.1357,4,0,4,0.27920371738274696
25663,703-004-5399,2259.82,4,2,2,0.6173892200625992
2570,703-004-5396,439.6254,3,2,1,1.2075221060637196
25708,703-004-5383,3838.7751,3,2,1,1.2499526473124587
25746,703-004-5389,2881.6504,4,0,4,0.27920371738274696
26072,703-004-5399,9252.894,1,1,0,1.5171509814523854
2630,703-004-5380,6535.2505,6,4,2,1.009866849064079
26650,703-004-5391,4233.3286,5,4,1,1.703090384400105
2685,703-004-5397,5864.3716,3,1,2,0.383527023033988
27546,703-004-5387,1517.2643,3,3,0,0.6544709637774953
27709,207-008-2398,3320.0996,4,1,3,0.478845819009722
27749,703-004-5395,3142.039,3,1,2,0.420605624603296
27907,703-004-5392,646.1269,6,3,3,1.1253173515833192
27982,703-004-5382,7331.5854,4,2,2,1.3819540550949283
28430,703-004-5398,6208.9854,7,4,3,1.3274198885863902
28756,703-004-5384,1829.9907,5,1,4,0.383313189400447
28871,703-004-5387,6374.392,1,1,0,0.4314860782385869
28897,703-004-5397,3688.8826,7,6,1,3.3172901677199964
28934,703-004-5381,2601.4602,2,2,0,1.213488057276668
28989,703-004-5398,6888.045,4,3,1,1.1431480184173954
29034,703-004-5382,262.37607,1,1,0,0.37512182779194486
29279,703-004-5398,5277.288,4,2,2,0.9641648799839374
29308,703-004-5382,964.09735,5,1,4,0.43428547561258657
29347,703-004-5397,760.9433,5,2,3,1.8662700815744622
2946,703-004-5398,3227.992,2,0,2,0.27920371738274696
29630,703-004-5384,4762.2295,4,0,4,0.27920371738274696
29823,703-004-5386,1675.3137,1,1,0,0.48318530719721714
29901,703-004-5395,7302.3438,2,2,0,0.7645353447817934
29999,703-004-5380,8690.899,2,2,0,0.5076272586665069
30069,703-004-5397,9486.547,5,3,2,2.5749170339975054
30266,703-004-5392,6895.228,"","","",0.27920371738274696
30268,703-004-5389,9876.2,8,4,4,1.6889014166322303
30906,703-004-5387,3484.8672,2,1,1,0.4230808829965438
31150,703-004-5388,5758.9404,10,4,6,1.1247976845879295
31206,703-004-5396,2545.9814,5,1,4,0.5165268771580819
31508,703-004-5399,1714.7701,4,3,1,1.023289360230692
31575,703-004-5397,9632.254,2,1,1,0.3978652972704144
31606,703-004-5386,7342.4985,4,1,3,0.4410119661795691
3171,703-004-5398,5077.233,5,2,3,0.8876625012138348
31823,703-004-5380,3128.5256,3,0,3,0.27920371738274696
32034,703-004-5389,5760.4307,2,1,1,0.6866033494095818
32217,703-004-5391,2483.5796,4,2,2,0.9301835843859739
32350,703-004-5385,7558.2974,7,5,2,2.136012162535387
3247,703-004-5380,1885.6448,3,2,1,0.5746330008178444
32644,703-004-5398,7735.2915,2,1,1,0.3517374511890861
32650,703-004-5383,9466.448,7,5,2,1.2415904078103468
32787,703-004-5399,8993.98,5,1,4,0.8997240726414449
32907,207-008-2398,2685.6667,4,0,4,0.27920371738274696
33100,703-004-5382,1658.2214,4,2,2,1.0156065230155302
33102,703-004-5387,4763.0576,3,1,2,0.5274793674702837
33123,703-004-5392,8767.418,3,0,3,0.27920371738274696
33218,703-004-5399,9451.276,2,0,2,0.27920371738274696
33371,703-004-5387,6001.784,3,3,0,2.3211280280175335
3358,207-008-2398,7459.978,2,0,2,0.27920371738274696
33667,703-004-5386,5401.908,3,1,2,0.43698406477338214
33824,703-004-5395,6244.794,2,2,0,0.8123566813943989
33867,703-004-5383,9956.72,1,1,0,1.0649427946475116
33901,703-004-5383,6999.696,2,0,2,0.27920371738274696
3402,703-004-5391,3501.23,5,0,5,0.27920371738274696
34038,703-004-5392,5445.4927,4,3,1,0.8073095016703109
34039,703-004-5389,4167.269,3,1,2,0.41782147866964203
3405,703-004-5399,7196.988,5,3,2,0.7909235402608207
34153,703-004-5389,4337.4224,8,2,6,1.4279045619469775
343,703-004-5390,2508.0461,2,2,0,1.0190677633370848
34310,703-004-5383,1100.0103,6,3,3,1.0949293351944585
34343,703-004-5392,9515.078,1,0,1,0.27920371738274696
34650,703-004-5382,8403.466,3,1,2,0.47122093831240885
34669,703-004-5388,5386.534,4,3,1,1.8835786347065642
34844,703-004-5396,6243.415,5,2,3,2.496087897676647
35088,703-004-5390,7122.3403,5,3,2,0.8439942264520084
35269,207-008-2398,2589.9392,5,2,3,0.525690671476666
35486,703-004-5381,863.5777,1,1,0,0.6734140585139179
36213,703-004-5383,502.36285,2,1,1,0.33853450732658075
36343,703-004-5398,9227.886,4,2,2,0.4797541332959531
36432,703-004-5397,3829.2742,8,5,3,2.2425439292922977
36672,703-004-5389,481.686,7,3,4,2.2261023242512388
36704,703-004-5383,3271.5981,4,1,3,0.6014507237361699
3682,703-004-5391,6341.852,2,0,2,0.27920371738274696
36875,703-004-5382,7341.5806,5,1,4,0.8655577077726071
37765,703-004-5397,3369.652,4,2,2,0.8554817938044034
38287,703-004-5384,2561.6467,3,2,1,0.6501218879746326
38598,703-004-5396,859.16876,6,3,3,2.7193729336422803
38640,703-004-5388,1051.8468,4,1,3,1.8746898087998594
39058,703-004-5392,8060.5273,5,4,1,1.627423665915255
39127,703-004-5392,7561.751,3,1,2,0.8451168322824801
39304,703-004-5385,6637.2104,2,1,1,0.42517299732931846
39317,207-008-2399,2919.364,6,3,3,1.0823122536987515
39551,703-004-5385,5621.8677,4,1,3,0.6050456239637958
39678,703-004-5383,7441.358,2,2,0,0.7711757681358437
40265,703-004-5392,6935.1113,6,1,5,0.35831143730785864
40366,703-004-5398,7708.611,4,1,3,1.0474587654278997
40380,703-004-5386,3468.4456,5,3,2,1.2257164384118397
40459,703-004-5389,19.962193,4,2,2,1.4031208435611535
40941,703-004-5389,6803.877,2,0,2,0.27920371738274696
41093,703-004-5385,6616.714,3,2,1,0.7536004866946835
41303,703-004-5395,2305.041,2,1,1,0.37512182779194486
41397,703-004-5397,2732.587,6,3,3,1.8283363181397023
41429,703-004-5380,8844.616,4,2,2,2.2449435591951783
41494,703-004-5398,2571.0435,4,3,1,0.7201911163592168
41635,703-004-5398,7050.156,4,0,4,0.27920371738274696
42224,703-004-5398,4907.3916,2,1,1,0.5818430918702825
423,703-004-5397,4452.268,6,5,1,2.323416159786663
42354,703-004-5391,4923.737,6,1,5,0.5933989797779062
42847,703-004-5390,8252.7295,2,1,1,0.4093434494552643
42984,703-004-5381,159.71481,1,1,0,0.3486207416170325
43170,703-004-5399,7550.0415,4,3,1,0.5620457392471483
43222,703-004-5383,7769.9233,2,1,1,0.3374269992476291
43252,703-004-5399,9341.671,3,2,1,0.8347025484741711
43854,703-004-5387,8499.706,4,3,1,1.120312722321502
43922,703-004-5393,3458.693,1,1,0,0.36023661478492536
43963,703-004-5382,3018.0984,4,2,2,1.3431767684053004
44005,207-008-2399,5612.874,6,2,4,0.5976692227646414
44756,703-004-5388,5228.949,3,2,1,1.1717521641663469
44757,703-004-5388,4376.47,3,1,2,1.5512019265774533
44841,703-004-5390,891.4477,4,3,1,0.8241751949024773
44946,703-004-5398,7853.89,5,2,3,1.0652404716374868
44953,703-004-5380,8516.175,4,1,3,0.5445537692039335
45125,703-004-5387,2747.3008,1,0,1,0.27920371738274696
45244,703-004-5386,6414.4844,9,2,7,1.9920056007760907
45987,703-004-5385,9619.909,5,2,3,1.1695556514797614
46465,703-004-5386,1735.6646,2,1,1,1.3020665530792397
4663,703-004-5388,2986.3452,4,2,2,1.2758164994265082
46802,703-004-5390,6786.105,5,4,1,0.812622739733106
46967,207-008-2399,8573.782,3,3,0,3.329887230828205
46976,703-004-5392,2290.38,4,1,3,0.42420309283502433
4703,703-004-5397,1427.452,4,4,0,1.0902043408735043
47404,703-004-5383,9668.863,3,2,1,0.6108278237508966
47452,703-004-5393,2892.1335,6,2,4,0.4993868711743077
48101,703-004-5386,7471.5503,5,2,3,3.145411839237689
4833,703-004-5395,7572.157,4,1,3,0.47818734184964967
48353,703-004-5393,9159.897,5,1,4,0.40622105018750443
48642,703-004-5392,2289.8584,8,6,2,3.252765767825318
4889,703-004-5391,247.49637,3,1,2,0.39834818397745736
48960,703-004-5385,2707.128,7,4,3,1.173504326080898
49033,703-004-5397,2427.4207,2,1,1,0.39752628104032844
4972,207-008-2398,486.7649,3,1,2,0.3618589241232504
49743,703-004-5395,2777.1873,3,1,2,0.5874786145307136
49856,703-004-5389,5791.192,8,5,3,1.0637924951743016
5034,703-004-5381,1564.4723,3,0,3,0.27920371738274696
5105,703-004-5399,3963.747,6,4,2,0.9877864170524505
5133,703-004-5388,761.8117,6,3,3,1.2996642277809747
5366,703-004-5389,6821.4805,6,3,3,0.9207308070199747
539,703-004-5397,7092.6733,7,3,4,1.4198065257069843
5407,703-004-5387,2239.164,3,3,0,1.2661992720418023
5437,703-004-5386,3046.3655,4,3,1,1.1860294721081974
5713,703-004-5391,459.57864,8,4,4,1.9436164101155096
5849,703-004-5393,7863.843,5,3,2,0.8223829362226283
628,207-008-2399,1416.6111,9,5,4,3.837694567752097
6325,703-004-5389,8648.172,"","","",0.27920371738274696
6345,703-004-5391,9152.534,"","","",0.27920371738274696
636,703-004-5395,4892.8774,2,0,2,0.27920371738274696
6700,207-008-2399,4746.196,5,1,4,0.48117867653070806
7645,207-008-2399,8957.783,3,0,3,0.27920371738274696
7827,703-004-5393,9296.86,3,1,2,0.5255962476319963
808,703-004-5384,4178.2617,4,4,0,1.1035640791963355
813,703-004-5395,6149.834,6,4,2,2.526320209417988
8355,703-004-5399,5886.244,5,3,2,1.7128309723122899
8389,207-008-2398,3854.0525,2,1,1,1.6899527952332551
843,703-004-5390,3455.3105,7,5,2,1.9060181991725604
8471,703-004-5383,3451.895,3,2,1,0.4705610307564997
856,703-004-5389,2263.856,2,1,1,0.38769963213903735
8607,703-004-5381,5278.362,7,5,2,2.814820212884562
8613,703-004-5381,1790.3828,5,1,4,0.5145851969183065
8910,703-004-5388,6724.7,2,1,1,0.5819239610478025
9057,703-004-5395,488.6204,6,5,1,3.3394509186117562
9724,703-004-5390,7771.089,5,3,2,1.9232026870000059
9788,703-004-5392,6959.0713,3,2,1,0.9364390658430991
9930,703-004-5392,5309.483,4,2,2,0.9120024772382384
10166,703-004-5388,1740.6952,3,2,1,1.0875852693774766
10257,703-004-5381,3782.2747,1,1,0,0.43959900884524844
1036,703-004-5391,858.56793,7,2,5,0.7215023958327891
10399,703-004-5383,4840.922,6,2,4,0.5000582910801825
10573,703-004-5389,8577.282,3,1,2,0.8117818602900051
10607,703-004-5398,8067.584,6,2,4,0.9805839498237151
10910,703-004-5389,6373.207,4,1,3,0.465276760871231
11009,703-004-5395,5383.5874,6,3,3,1.152884903649785
11140,703-004-5394,4225.7104,4,2,2,0.7745371232345151
11480,207-008-2399,148.06985,7,2,5,0.5927531136112753
11633,703-004-5392,5203.995,6,3,3,1.078332971022597
11793,703-004-5389,1024.7308,4,3,1,0.748349328050522
11925,703-004-5389,2762.419,1,1,0,0.4847189814381933
12011,703-004-5384,646.531,2,2,0,1.4422794178850473
12132,703-004-5398,7937.7607,8,1,7,0.6190946099107453
12329,703-004-5397,130.39886,3,1,2,0.5777188096851136
12964,703-004-5382,8772.365,3,1,2,0.4411442958067029
1299,703-004-5389,9556.39,2,1,1,0.33853450732658075
1328,703-004-5394,9865.393,4,2,2,0.5606261348613347
13378,703-004-5392,5033.173,7,6,1,3.010365938386982
13550,703-004-5390,5374.3247,3,1,2,0.4858440145895691
1392,703-004-5382,2732.0754,3,1,2,0.7320032549981312
14155,703-004-5386,4352.2573,3,2,1,1.5377630159453697
14279,703-004-5386,8198.177,3,1,2,1.0864501221197866
14319,703-004-5383,265.31757,4,3,1,3.065642274464019
14464,703-004-5399,830.1848,6,4,2,3.9995950229667434
14490,703-004-5395,1417.0968,6,5,1,2.290183499460688
1516,703-004-5389,9399.016,6,4,2,1.2760983406732156
15656,703-004-5382,1128.5865,5,5,0,1.0998833036216231
16167,207-008-2399,1032.0741,2,1,1,0.37512182779194486
16318,703-004-5391,9594.104,3,1,2,0.5165268771580819
165,207-008-2398,9291.791,3,0,3,0.27920371738274696
16674,703-004-5396,578.4702,7,4,3,1.277761553392538
16997,207-008-2398,2708.137,3,2,1,1.0125377414312353
17602,703-004-5383,8802.577,2,2,0,0.7997082602531947
17664,703-004-5391,6091.754,4,1,3,0.44292060751226364
17972,703-004-5397,631.5917,6,4,2,1.8641799408217927
18346,703-004-5388,3868.2627,6,3,3,2.2967558111729245
18397,703-004-5399,9021.527,4,2,2,0.7370373795559294
18525,703-004-5395,8190.1343,1,0,1,0.27920371738274696
18526,703-004-5399,4609.926,2,1,1,0.3518419090877331
18956,207-008-2398,9138.555,4,4,0,1.4312344222831104
18964,703-004-5385,1947.49,3,2,1,0.7881974926023708
19013,703-004-5381,7088.018,4,2,2,0.8077610697124888
19105,207-008-2398,7969.43,7,2,5,1.3644866672422573
19106,703-004-5381,2619.4817,3,0,3,0.27920371738274696
19142,703-004-5389,6168.7393,3,1,2,0.41467568775450064
19230,703-004-5393,7738.841,3,2,1,1.1743889298088563
19352,703-004-5390,3335.0295,3,2,1,0.6007650623358366
19365,207-008-2398,8929.032,5,1,4,0.3978652972704144
19481,703-004-5399,1126.7239,4,3,1,1.286751207356117
19650,703-004-5380,9695.802,5,2,3,0.6440165258239907
19659,703-004-5391,7016.7153,4,2,2,0.9858028062211941
19704,207-008-2398,5675.994,5,2,3,0.7034980825921623
20028,703-004-5390,359.55728,3,1,2,0.5265203486099939
20074,703-004-5381,8995.154,5,4,1,1.6249023284324589
20371,703-004-5392,1523.8583,4,2,2,0.6752798717767603
20400,703-004-5385,7507.035,8,4,4,1.3981034091298543
20510,703-004-5388,5113.205,2,0,2,0.27920371738274696
20554,207-008-2398,2801.299,6,3,3,1.492138679331875
20725,703-004-5389,5715.072,3,1,2,0.9620908114701989
20775,703-004-5386,1662.6764,6,3,3,0.7540949552429805
20896,703-004-5384,8636.489,5,1,4,0.3919322182760311
21156,703-004-5383,6572.9434,3,0,3,0.27920371738274696
21198,703-004-5380,877.1676,7,3,4,0.6573459196080986
21274,207-008-2399,7069.795,3,2,1,0.8594483420393275
21608,703-004-5383,9764.752,2,2,0,0.9216932636653545
22048,703-004-5384,6024.143,5,5,0,3.3945853577158465
22216,703-004-5383,6079.0347,4,3,1,0.9634317652043065
2235,703-004-5390,4708.461,3,0,3,0.27920371738274696
22514,703-004-5395,4389.6294,10,6,4,2.548225995102245
22624,207-008-2398,5775.459,5,3,2,1.038914622189848
22639,207-008-2398,530.76086,7,4,3,0.9865581965933758
22873,703-004-5386,3252.8442,2,1,1,0.54359384749897
23210,703-004-5397,7307.456,2,1,1,0.4503589335155921
23362,703-004-5396,155.45667,3,1,2,1.817555138904901
23566,703-004-5383,4514.3286,4,1,3,0.9789239156611488
23785,703-004-5394,1226.0723,5,2,3,0.7359031924563344
24177,703-004-5384,8752.281,3,2,1,1.052131789244937
24399,703-004-5394,4590.5127,7,2,5,0.8049086917088594
24760,207-008-2398,1828.1198,4,1,3,1.335474933747799
25177,703-004-5397,2833.28,6,2,4,0.7221300863777
25493,703-004-5384,2037.7028,1,1,0,0.3978652972704144
25573,703-004-5385,8665.299,3,1,2,0.7259914540088083
25648,207-008-2398,9123.788,4,2,2,1.1162248006076512
25772,703-004-5385,6490.3433,2,0,2,0.27920371738274696
25830,207-008-2398,3386.4326,2,1,1,0.5220881292678484
26145,703-004-5388,2474.8428,6,2,4,0.9665570936241352
26283,703-004-5393,3641.6184,5,1,4,0.46043230847769917
26313,703-004-5388,6965.0312,9,4,5,2.1057760543241617
26951,703-004-5383,9844.815,2,1,1,0.8162156292611323
27228,703-004-5386,550.4268,4,1,3,0.5339858189869549
27276,703-004-5390,7703.0356,"","","",0.27920371738274696
27815,703-004-5381,2098.7886,3,1,2,0.3726178760947696
27882,703-004-5380,3165.5586,5,2,3,0.5543064364861676
28017,703-004-5398,2412.589,1,1,0,0.5165268771580819
28362,703-004-5386,3926.3118,1,1,0,2.6625996360623105
28673,703-004-5385,6027.3296,6,3,3,1.6923703301934812
28736,703-004-5398,1558.4248,7,4,3,1.0177858099688548
29012,703-004-5384,3620.4558,3,1,2,0.5896111932759114
29117,703-004-5383,8828.826,4,4,0,1.3819705466311314
2949,207-008-2398,7213.791,3,1,2,0.3187575773453028
29520,703-004-5393,2323.7007,8,2,6,0.5426586669305474
30012,703-004-5384,982.97894,5,2,3,0.7365820101745825
30070,703-004-5399,1742.7421,1,0,1,0.27920371738274696
30769,703-004-5397,4225.046,5,2,3,1.151594393523315
30770,703-004-5389,3542.2563,6,4,2,0.8534987903689043
30938,207-008-2398,6324.0977,1,0,1,0.27920371738274696
30947,703-004-5398,7404.292,6,5,1,1.9463076907861887
31178,207-008-2398,2363.7092,3,0,3,0.27920371738274696
31550,207-008-2399,6642.9805,3,2,1,0.9441634951360213
31660,703-004-5395,7816.1587,1,0,1,0.27920371738274696
31853,703-004-5381,6670.754,8,4,4,2.750295565463551
31869,703-004-5389,3689.5562,3,2,1,1.6010118213450493
32222,703-004-5386,7688.0283,5,3,2,1.6749942974371
32517,703-004-5384,6254.7017,3,2,1,0.8070675085019258
32547,703-004-5390,3817.7366,6,0,6,0.27920371738274696
3263,207-008-2399,5924.697,10,4,6,1.61135716988597
32913,703-004-5384,1168.3225,5,1,4,0.35831143730785864
3293,703-004-5389,694.7333,3,2,1,0.7406522323259107
33058,703-004-5395,78.374146,6,2,4,0.8308897896345391
33564,703-004-5384,1457.7968,2,1,1,0.33457949803375336
33623,703-004-5381,5287.9907,2,2,0,1.1364261944533178
34056,703-004-5398,3506.3047,5,3,2,2.275905145237275
34406,207-008-2398,3215.837,5,2,3,1.1380899323998133
3458,703-004-5381,6194.339,3,3,0,1.5564569151840995
34798,703-004-5389,3163.0415,5,3,2,1.175261113079588
34862,703-004-5396,8894.255,5,1,4,0.8014766178172392
3488,703-004-5385,1139.4077,3,1,2,0.45540078145928103
3514,703-004-5383,6483.8594,"","","",0.27920371738274696
35185,703-004-5398,3762.2886,4,2,2,0.47697301719552604
35591,703-004-5387,1436.5656,4,2,2,0.8199449155594852
35732,703-004-5399,2331.661,4,3,1,1.9259853327086738
35766,703-004-5383,9145.463,2,2,0,0.504742415185495
36827,703-004-5383,8748.386,3,2,1,0.8217699976329884
36981,703-004-5384,1051.2429,1,1,0,1.2472057855513268
37002,703-004-5394,2648.4949,6,3,3,0.8941211460896593
371,703-004-5385,3548.4426,6,2,4,1.1812843915364313
37142,703-004-5382,8011.9976,2,0,2,0.27920371738274696
37183,703-004-5394,9511.064,3,2,1,1.1874121913972937
37320,207-008-2399,8602.952,2,1,1,0.35831143730785864
37742,703-004-5382,2709.8352,6,4,2,1.341401086170586
38484,703-004-5383,7274.2915,6,4,2,1.3038920765147133
38550,703-004-5383,3912.223,3,2,1,0.5118037960620844
386,703-004-5381,2525.4304,6,5,1,2.069824879374065
38768,703-004-5398,5448.276,2,0,2,0.27920371738274696
39237,703-004-5384,4454.6113,7,4,3,1.2193667135241448
39369,703-004-5391,7063.6753,"","","",0.27920371738274696
3969,703-004-5387,2034.5527,4,3,1,1.745206486128159
40066,703-004-5395,6049.9404,6,5,1,2.7558975730302206
40092,703-004-5386,499.14957,6,1,5,2.0109414134823247
40111,703-004-5380,2533.5388,4,3,1,0.7943348568719604
40144,703-004-5388,4054.0688,4,2,2,1.1968475549346114
40474,703-004-5394,75.37365,6,5,1,1.1857326941509303
40491,703-004-5380,8503.321,3,2,1,0.4751621920441153
40681,703-004-5397,7114.4395,2,2,0,1.3489430698018752
40688,207-008-2398,4164.75,7,2,5,2.3135254481790635
40838,703-004-5397,4110.3765,1,0,1,0.27920371738274696
40864,703-004-5389,4056.8274,3,2,1,0.7464879251138736
40869,703-004-5396,6111.7114,7,3,4,2.688236432177225
40920,703-004-5399,1243.0883,4,2,2,0.9461576122389759
41065,703-004-5389,1208.1885,6,1,5,0.5385947315758616
41309,703-004-5388,8336.1455,1,1,0,0.45181961361465073
41725,703-004-5392,26.074648,1,0,1,0.27920371738274696
41873,703-004-5392,6457.5737,7,2,5,0.9181630110477235
42052,703-004-5386,3560.3328,6,2,4,1.1069563848979702
42248,703-004-5397,5913.111,8,4,4,1.3888446169730306
42282,703-004-5396,1716.2156,7,7,0,2.134800390763671
42513,207-008-2398,2982.9014,2,0,2,0.27920371738274696
42560,703-004-5395,5.7303905,11,4,7,3.2413158204781607
42622,207-008-2398,9414.291,3,0,3,0.27920371738274696
42759,207-008-2398,5026.2783,3,0,3,0.27920371738274696
4277,703-004-5388,5053.903,4,0,4,0.27920371738274696
42805,703-004-5386,6217.3433,3,1,2,0.5165268771580819
42848,703-004-5393,1924.7216,3,2,1,0.8871341773014051
42860,703-004-5380,9138.896,3,2,1,0.7711593037232282
42899,703-004-5393,1129.3495,3,2,1,0.45955933751185174
43124,703-004-5386,6844.5654,8,5,3,2.1626610180083157
43536,207-008-2398,8157.2656,7,3,4,0.6291847316388446
43574,703-004-5383,5525.6533,7,2,5,0.5026515782773961
4386,703-004-5393,4737.598,3,0,3,0.27920371738274696
44022,703-004-5393,5006.923,4,3,1,0.7365452231997986
44236,703-004-5387,2574.9678,5,3,2,0.9970517733259979
44408,703-004-5397,5158.6636,1,0,1,0.27920371738274696
44465,703-004-5386,9340.454,1,0,1,0.27920371738274696
44530,703-004-5382,2275.613,4,0,4,0.27920371738274696
44653,703-004-5384,4039.0957,"","","",0.27920371738274696
44794,703-004-5396,3650.6003,3,2,1,0.45719608721424815
44917,703-004-5395,880.2712,6,2,4,1.2263581370661598
4509,703-004-5387,8818.001,2,1,1,0.6931557579212371
45256,703-004-5383,5241.328,2,1,1,0.6173892200625992
45274,703-004-5390,9238.518,4,2,2,0.7289860070519819
45374,703-004-5389,6205.6196,3,2,1,0.4813954090240495
45606,703-004-5398,506.5352,5,2,3,1.121721692178354
45765,703-004-5382,1444.8053,5,3,2,0.6967486412502621
45841,207-008-2398,7029.376,4,1,3,0.768813658607278
46061,703-004-5385,9317.35,7,7,0,3.6862972561647864
46194,703-004-5394,6433.896,8,5,3,1.9294921765566027
46663,703-004-5391,5125.9204,9,6,3,2.0203618233853304
46685,703-004-5385,9801.98,8,6,2,4.617646785965095
47183,703-004-5390,6737.9897,3,1,2,0.7242174926762441
47212,703-004-5391,6368.8306,1,1,0,1.707639233149269
47343,703-004-5391,4129.1914,2,0,2,0.27920371738274696
47426,703-004-5399,2522.4614,4,2,2,1.0781982540854043
4747,703-004-5384,2831.3958,5,4,1,1.3437451142799641
47615,703-004-5392,1303.314,4,3,1,1.2709489969727965
47772,703-004-5384,334.329,5,2,3,0.5674975193114966
47856,207-008-2399,103.47665,3,3,0,0.8542164152830832
48052,703-004-5391,878.72626,4,4,0,1.4031649422528778
48075,703-004-5396,268.9326,2,1,1,0.3750913957582559
48268,703-004-5387,4008.9583,8,3,5,0.6542116965640915
48422,703-004-5387,9937.549,2,1,1,0.35735331568215845
48440,703-004-5390,4738.6216,5,5,0,1.4912619485234229
48608,703-004-5393,9553.479,4,2,2,1.5208380173782388
48782,703-004-5395,6225.9243,4,2,2,0.779659730526455
48988,703-004-5381,6564.7397,3,1,2,0.5837684390944268
49082,703-004-5397,477.03027,2,1,1,0.5857730546615808
49308,207-008-2398,8707.495,6,5,1,1.8596965969364256
49463,703-004-5381,2223.5066,4,2,2,1.0614625174647347
49681,703-004-5394,3029.8137,8,5,3,2.9383112753339957
49925,703-004-5396,7268.549,5,1,4,0.3777433422648382
5015,703-004-5392,6901.11,3,2,1,0.6640709550009035
5383,703-004-5393,2269.7139,3,1,2,0.5578687513189465
5492,703-004-5393,704.5478,4,2,2,0.5771695154819785
552,703-004-5395,4002.3477,2,2,0,0.7404798045466857
5583,703-004-5385,2621.252,4,2,2,0.7328637597174774
5608,703-004-5382,7192.104,6,1,5,1.2870870169101174
5703,703-004-5383,9703.541,5,5,0,2.919654191520447
5778,703-004-5385,5105.2905,4,4,0,2.0367894342501036
6006,703-004-5397,451.73825,2,0,2,0.27920371738274696
6163,703-004-5389,958.094,3,0,3,0.27920371738274696
6501,703-004-5388,2333.0833,3,2,1,0.6662123813174854
6539,703-004-5395,6704.316,6,2,4,3.225081905959106
6763,703-004-5398,5187.742,3,0,3,0.27920371738274696
6766,703-004-5394,402.11142,6,3,3,1.2780744989810449
6862,207-008-2398,9093.969,4,2,2,0.7595115176987572
6979,703-004-5382,7934.1914,4,0,4,0.27920371738274696
705,703-004-5380,585.6442,5,1,4,0.5091726357987071
7211,703-004-5393,5534.1357,6,2,4,0.6689627719792755
7668,703-004-5398,8221.4,9,1,8,0.5141925427644128
7888,703-004-5392,2227.5884,3,2,1,3.0672212522934963
8251,703-004-5388,2269.056,4,4,0,1.2670508208325737
8382,703-004-5390,4212.455,6,3,3,1.2583373921920267
8472,703-004-5397,2068.3247,3,2,1,0.48771732258879674
8494,703-004-5385,1646.8376,1,0,1,0.27920371738274696
8542,703-004-5386,8508.599,9,5,4,3.586232276882654
8913,703-004-5384,6492.7153,1,0,1,0.27920371738274696
9073,703-004-5385,3107.7856,4,1,3,0.8103001733089433
9130,703-004-5396,8150.319,6,3,3,0.8396762766999123
9208,703-004-5387,2522.0198,4,4,0,1.5825909945443326
9535,703-004-5392,4161.9917,3,2,1,0.7527607199414158
955,703-004-5397,7364.851,4,1,3,1.349945664842047
9621,703-004-5396,187.31058,4,1,3,0.40685610938356986
9648,703-004-5398,1556.3107,2,1,1,0.5165953405815409
9655,703-004-5386,2358.5696,3,1,2,0.37512182779194486
9787,703-004-5397,2552.908,4,3,1,0.8695496387540108
10355,703-004-5381,3764.4785,4,2,2,0.6692346555981874
10574,703-004-5394,6896.676,4,2,2,0.8563094016328393
10633,703-004-5383,1119.367,2,0,2,0.27920371738274696
10664,703-004-5398,376.4856,9,4,5,1.3083396565205263
10728,703-004-5397,4950.242,3,2,1,0.7690019308621601
10870,703-004-5386,7885.72,3,2,1,0.9259924971372745
11213,703-004-5397,4185.253,4,3,1,1.5548801025535115
11333,703-004-5391,6663.454,8,5,3,1.2881800132997707
11353,703-004-5385,6210.252,9,7,2,2.5867466483932016
1213,703-004-5384,2146.2708,2,1,1,1.006128850502925
12155,703-004-5399,4410.696,4,3,1,0.8401491434521574
12355,703-004-5389,1673.7091,1,0,1,0.27920371738274696
12568,703-004-5384,7520.8066,5,2,3,2.1016464881388415
12864,703-004-5393,5902.5767,5,3,2,1.3736444510497383
13247,703-004-5387,8147.37,7,3,4,0.8873387591748193
13293,703-004-5387,537.9397,2,0,2,0.27920371738274696
13327,703-004-5394,107.15425,4,1,3,1.284732589596957
13329,703-004-5394,5822.2505,4,3,1,1.8533689742359558
13371,703-004-5396,965.59705,4,2,2,1.0261705215142407
13552,703-004-5380,6443.622,1,1,0,0.552221699595668
13916,703-004-5393,2717.1533,3,1,2,0.3131070259220805
13994,703-004-5397,9613.461,5,2,3,0.7813607632955716
14038,703-004-5393,3589.716,4,4,0,1.3298163901544244
14324,703-004-5391,1606.2092,7,4,3,1.9430134192009771
14528,703-004-5387,9696.78,4,2,2,0.6513879860096093
14676,703-004-5387,3610.7654,3,2,1,1.4927575103794966
14680,703-004-5385,2500.5483,2,2,0,0.7664718265890601
14691,703-004-5380,6378.812,5,5,0,1.2853956215005666
14739,703-004-5387,3150.9197,3,0,3,0.27920371738274696
14854,703-004-5395,1782.8774,2,0,2,0.27920371738274696
14989,207-008-2398,9449.372,5,4,1,1.2326132239686123
15253,703-004-5387,4379.578,7,4,3,2.169557120867889
15272,703-004-5384,2410.3647,2,1,1,0.46145214380976857
1536,703-004-5393,6038.2217,8,5,3,2.2012613627760658
15458,703-004-5399,8307.072,6,3,3,0.9550355494497693
15595,703-004-5389,6536.3525,2,1,1,0.9599701536992283
15692,703-004-5393,5937.3667,2,1,1,1.0309841835234381
15698,703-004-5398,8466.507,5,2,3,0.5251575261197052
15910,703-004-5395,4568.9805,4,3,1,0.9606845874015646
15960,703-004-5391,3294.0881,6,3,3,1.9531583357208497
16771,703-004-5383,6357.7266,"","","",0.27920371738274696
17189,703-004-5393,5196.4175,2,1,1,0.5208459019311612
17466,703-004-5386,9066.068,7,4,3,1.0479781638205348
1788,703-004-5396,8340.626,5,4,1,3.003545367402509
17990,703-004-5395,894.50775,4,3,1,2.2741738492738968
1804,703-004-5380,9137.172,3,1,2,0.6878368286990837
18304,703-004-5389,7090.806,5,4,1,1.2575632176360854
18400,703-004-5388,3329.1035,3,1,2,0.35905201912930496
18444,703-004-5385,4805.411,4,2,2,0.5818368873436579
18775,703-004-5387,4230.8345,2,0,2,0.27920371738274696
18797,207-008-2398,3916.1914,2,1,1,0.5328898133958303
18954,703-004-5394,1654.7828,4,2,2,0.4264758814413923
19022,703-004-5385,7638.2886,4,2,2,0.5928859226103763
19063,703-004-5382,8475.559,7,4,3,1.5738593961202012
19070,703-004-5385,1539.7388,3,1,2,1.355158396357817
19136,207-008-2399,6472.335,3,2,1,2.6158066844120182
19181,703-004-5391,2495.6614,5,1,4,0.8062688734052335
19211,703-004-5390,7608.2695,6,3,3,3.586437144985076
1941,703-004-5389,1610.7029,5,3,2,1.3386839390845873
1982,703-004-5399,7369.803,4,1,3,0.5669580486103406
19862,703-004-5387,4515.1763,7,5,2,1.4716915936651127
19905,703-004-5392,257.85208,5,2,3,0.9059005298474099
2013,703-004-5399,5477.846,1,0,1,0.27920371738274696
20178,703-004-5392,6157.393,4,2,2,1.027800314708728
20815,703-004-5384,999.7326,"","","",0.27920371738274696
21157,703-004-5386,9894.795,6,2,4,0.827179579044287
2121,703-004-5394,5549.184,6,4,2,1.8627532532163935
21514,703-004-5392,7474.6646,3,1,2,0.7241430831832724
21643,703-004-5389,487.38837,5,3,2,0.7342708762519518
21831,703-004-5388,9837.4375,5,3,2,0.9450369873208175
21885,703-004-5387,8492.512,6,3,3,1.333522005898679
21942,703-004-5394,3243.3308,5,3,2,0.9510503662361459
21960,207-008-2399,6784.905,6,2,4,1.1605163690033524
22123,703-004-5392,9600.039,4,1,3,0.4987276401749318
22266,703-004-5399,5363.843,4,2,2,0.8792823750727254
22363,703-004-5381,6146.348,3,3,0,0.9538110328396078
22389,703-004-5393,98.21534,4,1,3,0.5005133870600676
22491,703-004-5389,2532.8958,4,2,2,1.1468799079133167
22628,703-004-5391,632.92084,6,2,4,0.7840806117419499
23007,703-004-5392,9785.01,2,0,2,0.27920371738274696
23015,703-004-5395,5847.26,4,0,4,0.27920371738274696
23221,703-004-5381,7073.092,2,2,0,2.875507333070249
23329,703-004-5382,9531.665,2,2,0,0.8571228590043324
23412,703-004-5386,6935.6323,4,2,2,0.6787814202721782
23516,703-004-5390,6419.251,4,3,1,0.6073075193858645
23752,207-008-2398,4674.9717,4,1,3,0.7430195687909432
2389,703-004-5393,1628.1492,5,2,3,1.0869289592608045
24082,703-004-5380,3208.8857,3,3,0,2.98304188441651
24153,703-004-5381,2008.9937,1,0,1,0.27920371738274696
24178,703-004-5395,8590.251,3,2,1,0.5858550124996235
24279,703-004-5395,2672.4355,3,2,1,0.782504301588965
24293,703-004-5385,9592.724,3,1,2,0.6302299649138553
24377,703-004-5394,4080.4248,"","","",0.27920371738274696
24955,703-004-5393,7222.609,2,2,0,0.5349863432641188
24993,703-004-5380,6234.903,5,3,2,1.1793687459428608
25563,703-004-5387,6612.7754,4,2,2,0.810016518080246
25597,703-004-5395,8264.221,4,3,1,0.9166089689899323
25932,703-004-5396,2318.8079,4,1,3,0.5165268771580819
26067,703-004-5396,7703.359,7,2,5,1.1602712880691333
2610,703-004-5398,4364.903,5,3,2,1.3279137401247236
26301,207-008-2399,7828.2007,4,2,2,0.8661814229320975
26841,207-008-2398,1637.066,3,2,1,0.47697301719552604
27060,703-004-5381,7849.439,5,3,2,2.0367584180477825
27391,703-004-5380,2933.7002,4,2,2,0.8042712078890479
27446,703-004-5395,4681.3286,2,2,0,1.0319635716995526
27476,703-004-5392,9973.265,5,2,3,0.38639467788127324
27498,703-004-5380,7682.2026,2,1,1,0.412246583255427
27526,703-004-5387,8772.017,5,4,1,1.8017199589841582
27620,703-004-5398,8716.279,6,1,5,0.6678203915148578
27653,703-004-5387,7576.9033,6,2,4,0.6600733053075887
27671,703-004-5387,8079.0757,5,4,1,1.2562993679710464
2774,703-004-5399,3947.5781,4,1,3,1.2135642807039466
27883,703-004-5384,4639.74,1,0,1,0.27920371738274696
27938,703-004-5380,9572.234,2,0,2,0.27920371738274696
28321,703-004-5390,9746.125,6,4,2,1.5536990546081146
28559,703-004-5386,7818.304,3,3,0,0.6969464789220801
28774,703-004-5386,3982.6936,4,2,2,0.7538500369334169
28800,703-004-5388,7254.369,2,0,2,0.27920371738274696
29563,703-004-5399,584.24176,5,4,1,1.157095104600537
2967,703-004-5396,2428.06,2,0,2,0.27920371738274696
29848,207-008-2398,6041.836,1,0,1,0.27920371738274696
29898,703-004-5389,6843.959,7,1,6,0.4008021713726342
29950,703-004-5394,2157.6638,5,3,2,2.7579086372307584
29966,703-004-5381,9195.871,5,3,2,2.2008397528844554
30138,703-004-5393,8807.841,3,2,1,0.41764222725169237
30228,703-004-5394,1259.222,6,3,3,1.122865926632739
30318,703-004-5387,2528.2002,2,1,1,0.9377367115925865
30509,207-008-2398,5080.8076,7,3,4,0.8501909641504062
30727,207-008-2399,1038.1586,1,0,1,0.27920371738274696
30776,703-004-5397,6403.191,4,2,2,1.453558801341172
3080,703-004-5392,3682.6711,5,2,3,1.2927300072408772
31053,703-004-5382,6784.0845,4,2,2,0.5610992980921361
31073,703-004-5396,7353.9326,5,2,3,0.9638804767049965
31148,703-004-5387,6567.972,4,1,3,1.3974163205044907
31244,703-004-5387,8020.9346,1,0,1,0.27920371738274696
31251,703-004-5396,1417.0128,2,1,1,0.33853450732658075
31309,703-004-5391,5577.0654,2,1,1,0.8486092665211583
31623,703-004-5387,5265.742,6,5,1,2.0468462800759077
31971,703-004-5394,577.7371,4,2,2,0.4518761874711713
32121,703-004-5397,3369.9287,1,0,1,0.27920371738274696
32202,207-008-2399,55.915714,1,0,1,0.27920371738274696
32245,207-008-2399,4126.9736,2,0,2,0.27920371738274696
32293,703-004-5385,9067.81,1,0,1,0.27920371738274696
32471,207-008-2398,4589.1406,"","","",0.27920371738274696
32477,703-004-5382,2724.8591,4,4,0,2.867576507637736
32735,703-004-5393,1642.8619,4,4,0,1.2028305523575382
32744,703-004-5391,8536.605,5,1,4,0.49885388988510554
32801,703-004-5391,3589.0144,3,0,3,0.27920371738274696
32969,207-008-2398,5340.312,"","","",0.27920371738274696
33087,703-004-5384,3909.7004,8,3,5,1.51279663642671
33417,703-004-5387,6535.5786,3,2,1,1.198244391803343
33657,703-004-5394,7234.3867,1,0,1,0.27920371738274696
33975,703-004-5380,3545.05,4,1,3,0.5669580486103406
33997,207-008-2399,6316.153,2,1,1,0.47351205444880246
34787,703-004-5392,2649.8967,1,1,0,0.8454299940793563
3504,703-004-5390,3382.2715,7,4,3,2.816496175767115
35505,703-004-5399,6624.9927,2,2,0,0.8495965814162958
35579,703-004-5380,7078.938,5,3,2,2.152389954702256
35619,703-004-5382,5069.2124,6,3,3,1.4442849737038186
3565,703-004-5383,9378.3545,6,4,2,2.6757160051209867
35662,703-004-5396,6377.406,5,5,0,1.477169123329886
35738,703-004-5390,1400.3634,5,4,1,0.7174960661954445
35835,703-004-5396,6601.0635,2,2,0,0.6054320565671218
35924,703-004-5396,2611.4595,3,2,1,0.8928154746540345
35951,703-004-5383,2360.1753,4,1,3,0.5418576884546434
36268,703-004-5386,7085.6543,4,2,2,0.5743909278440745
3630,703-004-5399,7874.919,9,6,3,5.005419296379317
36320,703-004-5391,7704.0864,6,2,4,1.053669636824051
37047,703-004-5384,5639.834,4,0,4,0.27920371738274696
3726,703-004-5393,6451.125,1,1,0,0.5818080155366772
37273,207-008-2399,9935.439,3,1,2,1.4697670022088345
37283,207-008-2399,5694.3755,6,5,1,3.34122169205855
37594,703-004-5380,9195.513,3,2,1,0.8205637645633032
37854,703-004-5398,3240.8618,4,1,3,0.7488228475729961
3801,207-008-2399,6078.399,4,2,2,0.7569996122596212
38079,703-004-5393,4454.6304,3,2,1,1.0273102020006086
38826,703-004-5383,380.02252,5,2,3,1.1123378692022663
38847,703-004-5392,7699.095,3,3,0,1.2106796964653757
38848,703-004-5392,719.78033,6,3,3,0.9328000218162266
38964,703-004-5383,8307.96,3,1,2,0.37515714373834
38974,703-004-5398,2394.874,4,0,4,0.27920371738274696
39097,703-004-5393,2138.0168,7,4,3,1.440581116298761
39117,703-004-5391,8407.094,3,3,0,1.4827849312348937
3936,703-004-5384,1694.6775,3,3,0,0.8922179239983741
39531,703-004-5398,6757.829,11,6,5,6.347511236727764
39572,703-004-5390,2895.6567,5,1,4,0.35534489781066697
39744,703-004-5394,6520.935,4,1,3,0.7804629805063682
39936,703-004-5380,783.0912,5,3,2,0.5299751895453508
39945,703-004-5396,7458.796,6,2,4,0.6731086151271526
39954,703-004-5393,444.04922,"","","",0.27920371738274696
40022,703-004-5384,3053.233,2,1,1,0.6022558838329136
40167,703-004-5384,1475.0338,"","","",0.27920371738274696
40187,207-008-2399,4559.661,4,1,3,1.2193466967191167
40191,703-004-5385,3684.1106,7,4,3,1.987042098500058
40202,703-004-5397,6376.383,2,0,2,0.27920371738274696
40405,703-004-5387,6281.9463,5,2,3,0.7994851824386668
40750,703-004-5389,3713.6738,1,1,0,0.5116411036934071
4088,703-004-5396,3878.0493,4,1,3,0.396982921727992
40886,207-008-2398,2858.7668,3,2,1,0.5972442710797646
40971,703-004-5385,2969.768,2,2,0,0.911551705924675
41204,703-004-5389,4483.891,4,2,2,0.5475707462918799
41327,703-004-5396,9732.449,5,4,1,1.4220238205982314
41434,703-004-5396,6181.8164,3,2,1,1.042221715281729
41515,703-004-5382,6952.385,2,1,1,0.671290723664393
41772,703-004-5382,8958.412,1,0,1,0.27920371738274696
42070,703-004-5385,1443.7294,2,1,1,0.5165268771580819
42097,703-004-5389,422.5552,4,3,1,0.6638121437444986
4221,703-004-5393,3243.7498,5,0,5,0.27920371738274696
42579,703-004-5387,4431.2627,8,6,2,1.7053735396281953
42691,207-008-2398,2518.555,2,0,2,0.27920371738274696
43253,703-004-5387,3680.9265,4,2,2,0.8412259466311925
4343,703-004-5389,2796.403,6,3,3,1.521602160790929
43588,703-004-5390,1147.4115,5,2,3,1.8964102662058089
4362,703-004-5396,7282.6694,8,3,5,1.0746489658478042
43701,703-004-5388,9384.831,4,0,4,0.27920371738274696
44113,703-004-5382,4295.0063,6,4,2,1.5781695635132773
44275,703-004-5393,1394.8696,2,2,0,0.6170374684357421
4429,703-004-5390,3637.8975,6,3,3,0.8209224563058145
44437,207-008-2399,5341.602,1,0,1,0.27920371738274696
4457,703-004-5399,8894.09,4,3,1,1.4722184951653032
44659,703-004-5385,3224.398,3,2,1,2.4160362307871535
44822,703-004-5391,3253.9016,2,1,1,0.8295042801407483
44964,703-004-5391,7664.5664,5,4,1,2.0759100626423517
45312,703-004-5397,1274.6835,1,0,1,0.27920371738274696
45316,703-004-5382,8233.6875,4,1,3,0.5241422489169708
46026,703-004-5399,7702.5186,"","","",0.27920371738274696
46079,703-004-5385,3692.8535,5,2,3,0.8521421272205052
46104,207-008-2398,3316.9639,5,3,2,2.489979669598414
46378,703-004-5393,8444.415,1,0,1,0.27920371738274696
46741,703-004-5395,5056.951,4,3,1,2.198706652713017
46774,703-004-5398,8502.321,4,2,2,0.7351320503960285
47332,703-004-5381,4457.629,2,1,1,0.4126650332064041
47392,207-008-2398,7918.1367,2,0,2,0.27920371738274696
47489,703-004-5380,8323.542,1,0,1,0.27920371738274696
47573,703-004-5398,7382.375,4,4,0,1.7498902257605178
47591,703-004-5382,2593.4023,3,2,1,0.6927029476457564
47768,207-008-2398,4655.746,3,2,1,0.9399408872893289
4802,703-004-5380,9481.151,7,4,3,1.477360175611272
48213,703-004-5380,287.67346,8,5,3,2.077895170902295
48798,703-004-5391,8906.17,3,0,3,0.27920371738274696
48970,207-008-2399,235.61954,3,1,2,0.4165431422059716
49032,703-004-5381,6185.317,6,3,3,0.9621424654539955
4912,703-004-5383,2664.5803,3,2,1,0.6551071764316099
4925,703-004-5386,7895.7456,4,3,1,1.1956958548792531
49300,703-004-5395,7059.6235,3,3,0,1.5748696427209772
4979,207-008-2398,2006.0629,1,1,0,0.631246513979172
5515,703-004-5399,819.869,7,1,6,0.36268718607106
5516,703-004-5395,9373.693,4,2,2,0.8682748717875178
6007,703-004-5396,626.1021,3,0,3,0.27920371738274696
6111,703-004-5380,2255.7788,7,3,4,0.6444133121719678
6124,703-004-5399,6495.491,7,3,4,1.4244481174183545
6182,703-004-5393,3779.177,4,1,3,0.6847172325015577
663,703-004-5394,7672.6934,6,3,3,0.721606721369267
6747,703-004-5398,3752.0522,5,2,3,0.8831480529652115
6823,703-004-5386,3862.2773,5,2,3,1.1413829831354405
6921,703-004-5395,1154.732,"","","",0.27920371738274696
6948,703-004-5385,3382.042,1,0,1,0.27920371738274696
7192,703-004-5381,9419.924,5,2,3,0.5661518473558539
7291,703-004-5380,7536.121,3,3,0,1.2086058717883936
730,703-004-5381,8499.024,3,3,0,0.9532162649553455
7607,703-004-5387,3934.1682,2,2,0,0.8345387826287356
7887,703-004-5399,3826.844,4,1,3,0.6841989979316891
7947,703-004-5390,1859.0355,4,4,0,1.6898958663739214
8119,703-004-5380,951.04755,7,4,3,0.928007436960342
8372,207-008-2399,4773.9644,"","","",0.27920371738274696
8482,207-008-2398,8093.9375,9,4,5,2.00577376066946
9094,703-004-5393,7846.1426,2,1,1,0.5808228416087191
9155,703-004-5380,8543.986,3,2,1,0.49480873471745357
917,207-008-2398,9388.993,5,2,3,0.6673942549365123
9227,703-004-5385,2998.348,4,3,1,0.7165004627190606
9508,703-004-5391,6094.797,3,1,2,0.5196338515927598
9814,703-004-5382,1338.1588,2,1,1,0.4955798148045949
9891,703-004-5386,3553.7827,3,3,0,1.2212550540354679
10792,703-004-5387,3919.5317,7,3,4,1.2628323538791266
11162,703-004-5390,7802.9473,2,2,0,1.2041677316438106
11291,703-004-5392,1702.6764,2,1,1,0.3978652972704144
11357,703-004-5393,6180.3926,3,1,2,0.619113371087818
11470,703-004-5395,671.51843,4,1,3,0.3978652972704144
11517,703-004-5393,1013.20746,2,0,2,0.27920371738274696
11734,703-004-5385,9258.404,2,1,1,0.7735184786816194
11897,703-004-5381,6007.551,3,1,2,0.4325226268877534
11917,703-004-5388,3201.968,4,0,4,0.27920371738274696
12005,703-004-5395,8677.673,7,4,3,2.0653064481134797
12061,703-004-5388,1677.9357,"","","",0.27920371738274696
12225,703-004-5396,1974.1368,5,4,1,1.4437964288288674
12227,703-004-5397,1656.496,5,2,3,1.081916684916697
12246,207-008-2399,4998.6494,4,0,4,0.27920371738274696
12456,703-004-5387,5237.0923,2,1,1,0.5165268771580819
12492,703-004-5396,1993.1865,3,1,2,0.4987276401749318
12827,703-004-5399,8600.319,2,1,1,1.0625428874973917
12842,703-004-5396,8012.931,5,0,5,0.27920371738274696
13161,703-004-5387,8700.425,7,3,4,1.411938736422493
13346,703-004-5397,345.19553,4,2,2,0.7144577364201261
13433,703-004-5387,2118.6257,2,1,1,0.5165268771580819
13546,703-004-5385,4470.4517,6,2,4,0.7769067283952288
13775,207-008-2399,1867.7395,2,0,2,0.27920371738274696
13973,703-004-5387,765.71405,5,4,1,1.3459355963445268
1405,207-008-2399,5160.064,4,2,2,1.1984334301985196
14724,703-004-5394,8985.999,4,3,1,0.5754097253372135
15039,703-004-5380,509.4689,4,4,0,1.6821628166993199
15160,703-004-5382,9594.915,1,0,1,0.27920371738274696
15248,703-004-5393,1676.222,4,2,2,0.7520818519726061
15258,703-004-5399,2521.7183,2,1,1,0.4719219814824461
15593,703-004-5393,4487.3945,6,3,3,0.5827661858326321
15615,703-004-5397,288.201,3,0,3,0.27920371738274696
15636,703-004-5386,6623.2236,2,1,1,0.514952538767116
1598,207-008-2399,5848.48,1,0,1,0.27920371738274696
1635,703-004-5396,2769.1484,2,0,2,0.27920371738274696
16887,703-004-5397,8602.167,7,4,3,0.8456429661045893
17041,703-004-5384,5183.4097,4,3,1,1.6241838717369572
171,703-004-5385,7140.8594,5,3,2,0.6660034684767029
17176,703-004-5395,7900.266,2,0,2,0.27920371738274696
17265,703-004-5399,1460.69,2,2,0,0.9534430036428382
17330,703-004-5386,9339.585,1,1,0,0.4075235258345214
17394,207-008-2399,2910.9377,5,2,3,0.7606516238850123
17422,703-004-5397,5595.1055,5,0,5,0.27920371738274696
183,703-004-5380,2348.451,2,1,1,0.3978652972704144
18347,703-004-5397,4287.6177,4,1,3,0.8918489738188904
18575,703-004-5385,3449.5698,2,2,0,0.9076542668862638
18659,703-004-5385,150.68173,4,1,3,2.6894024527546043
18673,703-004-5395,5008.05,9,5,4,2.380627177108772
18698,703-004-5387,9289.682,3,2,1,0.9621853236159449
18755,703-004-5390,2992.565,5,3,2,1.8015812777261389
19045,703-004-5390,4104.172,5,1,4,1.171004424370845
19223,703-004-5388,6921.254,4,3,1,0.9124438475034999
19610,703-004-5386,7285.319,8,4,4,1.639173532847833
19666,703-004-5397,3320.231,3,1,2,0.3978652972704144
19718,207-008-2399,8838.349,4,2,2,0.6507732843504348
19973,703-004-5382,5700.713,6,2,4,0.8821749263792954
20129,703-004-5388,2425.1013,2,1,1,0.4935178341848061
20529,703-004-5389,4585.9517,3,1,2,0.47483226031244835
20615,703-004-5386,3994.9958,1,1,0,0.33853450732658075
21035,703-004-5383,9630.101,2,0,2,0.27920371738274696
21466,703-004-5392,1761.6326,3,3,0,1.2021230979217064
21576,703-004-5383,539.5323,2,2,0,2.614094208595585
21669,703-004-5387,5236.293,2,2,0,2.3261549671387307
21929,703-004-5388,297.22928,6,4,2,1.891141013855503
21975,703-004-5386,2465.1294,5,3,2,0.9047377054640192
21985,703-004-5380,5770.73,3,2,1,0.4780254556527691
22012,703-004-5395,9143.679,3,0,3,0.27920371738274696
22160,703-004-5399,9958.391,8,3,5,4.280626388233002
2263,703-004-5388,3256.4312,3,2,1,1.42603013826287
23029,703-004-5395,6025.625,3,1,2,0.41270436711954156
23178,703-004-5393,5079.2153,3,0,3,0.27920371738274696
23213,703-004-5398,4556.4155,2,1,1,0.7285508416475578
23335,703-004-5395,8392.435,3,1,2,0.4105890408533509
23678,703-004-5387,6603.336,6,4,2,1.2890713836262062
23866,703-004-5381,9829.188,4,2,2,0.82457524735292
23964,703-004-5382,8372.956,6,1,5,1.3623336080797206
24103,703-004-5380,7499.9385,5,4,1,1.7024622332319623
2421,703-004-5383,9077.526,6,3,3,0.9837676700226384
24241,703-004-5384,3287.1545,1,0,1,0.27920371738274696
24536,703-004-5390,8296.937,6,4,2,0.8528230689936426
24773,703-004-5396,169.79575,5,3,2,1.3432052016459808
24845,703-004-5397,5258.972,1,0,1,0.27920371738274696
24983,207-008-2399,7294.7305,2,1,1,0.7631954736407062
25016,703-004-5392,4507.862,3,1,2,0.45741010184940273
25316,703-004-5392,2074.5737,3,2,1,1.2896325376050906
25757,703-004-5391,365.4802,6,0,6,0.27920371738274696
25842,703-004-5383,3065.8853,7,3,4,1.4878226040649625
26176,703-004-5398,7477.0327,6,5,1,1.2800486865825629
2642,703-004-5389,9356.094,5,4,1,1.5571143450416534
26595,703-004-5396,668.7403,4,2,2,2.4101440196895028
26647,703-004-5393,522.4055,3,2,1,2.076631028697858
26703,703-004-5392,4992.7793,7,4,3,2.4487447908303057
2671,703-004-5393,167.49025,3,1,2,0.3978652972704144
26715,703-004-5382,6610.709,2,1,1,0.5165268771580819
26803,703-004-5394,6925.245,6,5,1,1.8735869287265225
26846,703-004-5389,1448.0215,4,2,2,0.820711839405513
26852,703-004-5383,967.7988,5,4,1,1.4380590567184157
26894,703-004-5386,7618.51,3,1,2,0.3919322182760311
26975,703-004-5395,4841.611,2,0,2,0.27920371738274696
26987,703-004-5383,4887.331,3,1,2,0.3978652972704144
27109,703-004-5393,7997.167,5,3,2,0.8693635636118778
27262,703-004-5388,8968.8,3,2,1,2.118814487338246
27263,703-004-5389,7461.4185,2,2,0,1.0638515606663905
27464,703-004-5396,8047.3286,2,2,0,0.6927846454224752
28172,703-004-5387,4768.777,3,2,1,0.8038992133223033
28336,703-004-5381,708.19556,5,3,2,1.2042426894051974
28345,703-004-5392,3080.0432,4,2,2,0.8495441726736642
28367,703-004-5383,4779.4927,11,6,5,2.2693715950474824
28514,703-004-5394,8569.67,4,2,2,0.7871543640582668
28553,703-004-5384,1024.257,4,1,3,0.35831143730785864
28641,703-004-5382,5955.17,8,1,7,0.47500716040762675
28696,703-004-5398,5405.429,4,0,4,0.27920371738274696
28807,703-004-5397,5438.1855,9,7,2,2.2088285629309383
28988,207-008-2399,5701.565,3,1,2,0.3919322182760311
29248,703-004-5387,5173.6333,7,5,2,1.9884421204938292
29409,703-004-5391,8134.0317,5,2,3,0.6739039461937377
29725,703-004-5390,2020.7036,4,1,3,0.3413949051196612
30006,703-004-5394,3849.7275,4,1,3,3.580745642535881
30089,703-004-5391,8607.353,1,0,1,0.27920371738274696
30470,703-004-5393,1436.5565,4,0,4,0.27920371738274696
30849,703-004-5387,1733.9141,4,1,3,0.43602652057013186
30933,207-008-2398,169.83807,1,0,1,0.27920371738274696
31021,703-004-5389,4103.4336,2,1,1,0.7374975814922375
31037,703-004-5385,217.91756,9,6,3,2.2970622735965884
3126,703-004-5396,1562.7802,3,0,3,0.27920371738274696
31311,703-004-5389,829.79443,3,1,2,1.3291143361769282
32299,703-004-5381,2724.4585,3,0,3,0.27920371738274696
32528,703-004-5382,2847.6416,2,2,0,0.440056081230474
32789,703-004-5399,9959.507,7,5,2,1.0425297381311833
32878,703-004-5385,7125.0815,4,2,2,0.47533339928266755
32935,703-004-5381,3040.1467,5,5,0,1.5150118389773901
33718,703-004-5384,1657.6117,5,4,1,1.4968720278610366
33834,703-004-5390,4873.963,1,0,1,0.27920371738274696
33851,703-004-5394,2518.521,6,5,1,3.1478236652936884
33965,703-004-5398,4140.6245,4,4,0,5.022986918588496
34158,703-004-5397,5202.088,1,0,1,0.27920371738274696
35107,703-004-5393,6959.6064,3,1,2,1.335893195299732
35215,703-004-5395,9146.938,3,2,1,1.093262769753989
35603,703-004-5394,8449.259,4,0,4,0.27920371738274696
35733,703-004-5393,5352.5547,4,3,1,0.9639740888450756
36319,703-004-5397,7814.9546,3,2,1,0.512133884702719
36761,703-004-5382,4255.0845,4,2,2,0.5236615076536715
37039,703-004-5387,613.2871,6,3,3,0.8348854969416714
37049,703-004-5394,6229.545,6,5,1,1.4209672014419847
37363,703-004-5395,6002.921,6,1,5,0.3978652972704144
37500,207-008-2398,6007.004,"","","",0.27920371738274696
38158,703-004-5396,3541.6018,3,2,1,0.5656749990575198
39087,703-004-5385,7639.9116,1,0,1,0.27920371738274696
39198,703-004-5394,5396.1133,5,2,3,1.2812176573662122
39272,703-004-5381,8424.53,3,0,3,0.27920371738274696
39487,703-004-5390,9787.418,4,3,1,0.8836062410070538
39508,703-004-5382,7543.9473,8,4,4,1.7008404565060211
39599,703-004-5384,3869.2063,1,0,1,0.27920371738274696
39667,207-008-2399,7394.46,6,1,5,0.5572441794621776
39710,703-004-5382,1441.9628,3,1,2,0.6164812086515079
39776,703-004-5392,1442.7465,6,1,5,0.8403032369047009
40105,703-004-5393,368.2685,5,3,2,1.9265880035057628
40473,703-004-5396,4885.251,6,4,2,1.733570840208429
40532,207-008-2399,9983.66,5,0,5,0.27920371738274696
40573,703-004-5398,7579.544,3,2,1,0.4689187474535109
40594,703-004-5382,1879.8232,5,2,3,1.8756847100355882
40907,703-004-5384,2376.3394,3,1,2,0.3366886605283281
41062,207-008-2398,1694.3866,8,4,4,1.1506078175265786
41293,703-004-5386,4885.6646,3,2,1,1.0689146715045466
41350,703-004-5397,4958.147,"","","",0.27920371738274696
41385,703-004-5382,9601.496,5,4,1,1.8499676633304871
41442,703-004-5389,1532.8467,5,2,3,1.0163717397349457
41594,703-004-5390,8819.32,4,2,2,0.730707128405242
41813,703-004-5390,5928.606,1,1,0,0.3978652972704144
41862,703-004-5394,1744.1338,5,2,3,0.9092529363345767
42284,207-008-2398,8394.385,3,2,1,1.1730059946189144
42462,703-004-5391,7331.6143,2,1,1,0.7043171338599099
42750,703-004-5389,8798.6455,1,0,1,0.27920371738274696
42785,703-004-5396,7354.8276,4,1,3,0.35831143730785864
43385,703-004-5398,402.18173,6,3,3,2.2719946256137136
43747,703-004-5385,2307.7744,6,3,3,2.545198087526374
43777,703-004-5386,5362.2563,2,0,2,0.27920371738274696
44080,703-004-5391,9516.511,6,2,4,1.2407862187217462
44346,703-004-5386,338.93524,1,1,0,2.6042398936354862
44395,703-004-5397,8307.522,3,1,2,0.4457749101500602
44774,703-004-5382,3347.9636,5,1,4,0.3804904402431126
44793,703-004-5386,9036.99,2,2,0,1.1242279722048638
44898,703-004-5386,7971.4297,4,0,4,0.27920371738274696
45064,703-004-5385,2597.285,1,1,0,0.5165268771580819
45085,703-004-5384,4217.378,4,3,1,1.531050839873523
45190,703-004-5395,3362.1199,3,1,2,0.42651781303210007
45373,703-004-5386,287.21393,3,3,0,0.855803120172382
46090,703-004-5391,4930.8213,5,4,1,1.049701760720007
46225,703-004-5382,9028.181,6,2,4,0.5403898032773666
46506,703-004-5398,3699.7532,6,2,4,0.5476104539762643
46569,703-004-5389,1937.505,5,2,3,0.4542295477170565
47038,703-004-5382,3954.8118,4,2,2,0.9552002476077519
47298,703-004-5383,8446.731,2,1,1,0.4684689373035765
47470,703-004-5397,5425.316,6,3,3,0.9964625686467221
4748,703-004-5399,9817.886,3,1,2,0.8138697966427043
47511,703-004-5391,7766.0586,1,0,1,0.27920371738274696
47741,703-004-5387,1185.5465,4,1,3,0.5088258481099072
47747,703-004-5388,6477.712,5,1,4,0.5736729566674453
47767,703-004-5388,6413.107,2,2,0,1.4094229140595842
48007,703-004-5388,825.40155,2,1,1,0.5786441798103366
48098,703-004-5394,8549.66,2,1,1,0.620920979776199
48188,703-004-5398,6193.1167,5,2,3,1.5383217693276454
4835,703-004-5393,6085.893,4,2,2,0.9062506017345392
48382,703-004-5399,5730.7144,6,0,6,0.27920371738274696
48776,703-004-5386,4941.048,6,4,2,3.549398927100391
48781,207-008-2399,2606.8752,4,2,2,0.4999552224716268
48819,703-004-5393,4144.1143,4,1,3,0.7123198448117857
48900,703-004-5385,9690.581,2,1,1,0.3401166617250829
49211,703-004-5389,9400.484,4,3,1,1.4431388413081796
49412,703-004-5397,1844.3185,3,1,2,0.6809674407871176
49430,703-004-5388,1182.3577,2,0,2,0.27920371738274696
5595,703-004-5386,350.84964,2,2,0,0.7780026126730524
5696,703-004-5386,9965.234,7,4,3,2.2297520365977492
5721,703-004-5382,7704.7056,4,1,3,0.33853450732658075
5831,703-004-5381,9007.346,5,3,2,1.435354157548994
5961,703-004-5394,745.07,7,3,4,1.3517032559464233
6251,703-004-5395,7381.7124,5,3,2,2.279581292357651
6431,703-004-5387,2640.8022,3,1,2,0.5540186429836695
6739,703-004-5386,6798.6665,7,5,2,1.400990587097322
6840,703-004-5382,2964.316,2,2,0,1.1106404720808976
6844,703-004-5384,1645.3683,4,3,1,1.6400647462984075
6899,703-004-5390,6183.5654,2,0,2,0.27920371738274696
7785,703-004-5390,1070.441,7,4,3,2.012012288239402
7899,703-004-5399,9158.602,10,7,3,2.8810952682897266
7985,703-004-5396,3110.9785,2,2,0,0.7644299275174707
807,703-004-5392,213.52351,4,3,1,1.4713492050605688
8150,703-004-5391,2895.8796,3,0,3,0.27920371738274696
8362,703-004-5398,2687.642,6,4,2,1.1652198851872135
8592,703-004-5393,4864.642,3,0,3,0.27920371738274696
868,703-004-5399,8739.228,1,0,1,0.27920371738274696
8836,703-004-5382,7736.7344,2,0,2,0.27920371738274696
933,703-004-5385,9771.381,8,5,3,3.0993576174392463
9478,703-004-5385,2587.1414,3,2,1,0.4470604105988432
9493,703-004-5388,9262.066,1,1,0,0.46867107838902644
9754,703-004-5398,6102.783,3,1,2,0.38588853113068633
9767,703-004-5396,8113.0107,2,2,0,0.9880453089742367
9834,703-004-5397,4808.693,4,1,3,0.3982589865039096
9932,703-004-5398,2815.2495,2,1,1,0.379028871819847
9948,703-004-5399,3827.4146,6,5,1,1.4018353166717024
10019,703-004-5394,9213.366,6,1,5,0.45927401397857215
10162,703-004-5397,4635.9297,3,2,1,0.7256380573654333
10231,207-008-2399,4561.603,2,1,1,0.43121396595124434
10431,703-004-5391,2118.733,3,1,2,0.476537817630875
10596,703-004-5383,7802.711,1,1,0,1.8656393676846978
11225,207-008-2399,317.1468,7,1,6,0.46745479224945796
11300,703-004-5388,7032.842,2,1,1,0.40912457650027084
11321,703-004-5382,6105.644,2,2,0,0.8591132713150992
11930,207-008-2398,683.5192,4,3,1,0.5762271490076919
11937,703-004-5384,8767.834,8,8,0,3.9965036690267923
11954,207-008-2399,9607.872,2,1,1,0.4272075660477935
12035,703-004-5381,6409.4497,5,2,3,0.6652144883341333
12367,703-004-5384,9527.607,3,0,3,0.27920371738274696
12383,703-004-5392,7190.5244,4,1,3,0.4130840396461115
12455,703-004-5385,5898.9907,5,2,3,0.6544347719956296
12563,703-004-5383,495.61203,6,3,3,1.635912787794367
12659,703-004-5380,374.14075,4,1,3,0.44286045678745484
12676,703-004-5399,2277.199,3,2,1,1.325807776985598
1285,703-004-5399,4339.251,6,2,4,1.37491120174543
12871,703-004-5388,6157.468,6,2,4,0.7231925489843862
13188,703-004-5386,4547.7275,3,2,1,0.7291767856804794
13384,703-004-5387,7933.0444,3,0,3,0.27920371738274696
13386,703-004-5385,1829.9216,4,3,1,0.5914852488461465
13761,703-004-5396,8811.349,8,2,6,1.6444791298554113
14306,207-008-2398,3548.101,8,3,5,0.9256906750296644
14334,703-004-5392,2012.22,4,1,3,0.796254939854619
14518,703-004-5394,6046.3145,2,1,1,0.5371147038725022
1474,703-004-5383,7544.2847,6,4,2,2.2725428888047454
14871,703-004-5389,9130.262,3,1,2,1.1184796643957367
15208,703-004-5397,4231.2075,"","","",0.27920371738274696
15215,703-004-5397,7052.3403,6,4,2,1.6582756647979517
15220,703-004-5397,7224.985,3,3,0,1.0735571280688094
15243,703-004-5391,9018.042,3,2,1,1.1721579736698595
15426,703-004-5389,8350.439,4,2,2,2.4966965755337194
15549,703-004-5395,5812.4097,3,1,2,0.39281840084515063
15674,703-004-5392,9294.057,4,3,1,1.7043710080005425
15893,703-004-5385,6826.8804,7,5,2,4.367625887524037
1590,703-004-5386,6480.6675,4,2,2,0.9805039784995851
16011,703-004-5381,4876.569,6,5,1,1.6019971528143784
16175,703-004-5380,8056.2866,4,2,2,0.7195426036133712
16784,703-004-5382,1586.9111,5,4,1,1.598454315329577
16833,207-008-2399,5913.9277,6,4,2,1.680673340772969
16987,703-004-5396,9140.2295,5,3,2,1.1581771417482707
17154,703-004-5386,5246.295,3,2,1,0.7050422218171214
17218,207-008-2399,1746.6515,4,2,2,1.047381036047839
17488,703-004-5385,3217.1702,3,2,1,0.6397581336875987
17848,703-004-5384,3363.0376,3,1,2,0.742162767576779
18315,703-004-5398,9305.79,8,7,1,3.2180936856968216
18436,703-004-5399,8479.407,5,2,3,0.8668575381168085
1848,703-004-5395,2653.7126,1,0,1,0.27920371738274696
18516,703-004-5388,3974.1838,3,1,2,0.5570086254327198
1862,703-004-5397,5359.3535,7,2,5,1.2264264514222356
18682,703-004-5391,7122.941,4,1,3,0.40185912467432106
18924,207-008-2398,9704.203,5,3,2,1.2743068304480565
19094,207-008-2399,4215.849,3,1,2,0.5349795247858543
19167,703-004-5391,8104.4165,1,0,1,0.27920371738274696
19671,703-004-5383,4624.8833,5,2,3,1.1809832035047432
19727,207-008-2399,3304.0874,6,3,3,0.9687730884904506
1985,703-004-5387,3969.344,6,3,3,0.8205529972622148
19998,703-004-5381,8057.6294,3,0,3,0.27920371738274696
20652,703-004-5384,658.62177,5,3,2,2.8364355088322393
21012,703-004-5387,3267.8152,3,1,2,0.41770370470895507
21205,703-004-5390,2580.21,5,3,2,1.229108563677108
21338,703-004-5391,7707.4727,1,0,1,0.27920371738274696
21486,703-004-5392,8741.382,6,4,2,3.2869952985167252
21673,703-004-5393,1537.5686,1,0,1,0.27920371738274696
21856,703-004-5399,6861.5645,4,1,3,0.40026043593831584
21972,703-004-5393,5848.107,7,3,4,0.8287669698762977
22114,703-004-5392,8428.595,4,2,2,0.643352084396837
22197,703-004-5397,8201.508,2,1,1,0.44326235664548436
22504,703-004-5384,1614.9873,6,3,3,1.3207287743618976
23544,703-004-5395,2314.9348,1,1,0,0.7228762268322957
23559,703-004-5380,2087.856,4,2,2,0.8150110126621145
2364,703-004-5399,5315.5947,3,2,1,0.5105937981636984
23681,703-004-5387,2823.5723,4,1,3,0.5914877329868435
23690,703-004-5380,8526.405,5,2,3,1.174882130929253
24113,703-004-5392,5037.175,2,0,2,0.27920371738274696
24124,703-004-5390,2318.058,8,6,2,2.955159934676693
24226,703-004-5398,6197.464,5,3,2,1.6557004468659913
24355,703-004-5380,7696.8013,5,4,1,1.966032653139966
24571,703-004-5393,5025.71,5,4,1,1.321672417598689
24635,703-004-5399,8513.603,3,2,1,1.5362393788215707
2487,703-004-5396,7500.6562,5,1,4,0.4314821115010364
25371,703-004-5391,3430.5125,3,1,2,0.3879651828004459
25453,703-004-5382,2460.701,2,2,0,0.4508564159644572
25526,703-004-5385,1758.0408,7,2,5,0.5147833592807927
25666,703-004-5396,6386.7456,8,2,6,1.1157688693778933
25777,207-008-2398,1174.745,7,4,3,1.3786000549125534
26041,703-004-5390,741.93896,1,0,1,0.27920371738274696
26099,703-004-5390,8054.863,7,4,3,0.8004840378292702
26534,703-004-5390,9399.611,5,2,3,1.0620095252197022
26871,703-004-5397,9284.467,4,2,2,1.6716941804777812
27045,207-008-2398,5561.799,6,2,4,1.020784196084053
27065,207-008-2398,9527.505,6,2,4,1.0415065237186776
27178,703-004-5390,3043.0396,5,3,2,0.8719625611766414
27214,703-004-5384,5305.7964,1,0,1,0.27920371738274696
27390,703-004-5390,1905.7697,6,3,3,1.009387809063746
27523,703-004-5387,7905.6104,3,3,0,1.3899846980432649
27676,703-004-5398,5580.3477,6,2,4,1.198978529629745
27773,703-004-5391,7547.7993,1,0,1,0.27920371738274696
28112,703-004-5390,1999.7257,6,1,5,0.42406448268638414
28691,703-004-5387,1353.0189,1,1,0,0.3978652972704144
28919,703-004-5392,7019.5967,3,1,2,1.684406875283876
28968,703-004-5399,4162.592,1,1,0,0.35831143730785864
29193,703-004-5394,8925.375,2,0,2,0.27920371738274696
2924,703-004-5384,9250.654,4,1,3,0.37053868907653353
29243,703-004-5394,3765.8525,3,1,2,0.35831143730785864
29288,703-004-5381,1842.0625,1,0,1,0.27920371738274696
29297,703-004-5381,7742.808,6,3,3,0.9110851739099991
29774,703-004-5393,1566.1646,6,1,5,1.2687631148102614
30317,703-004-5383,8506.968,5,2,3,0.9347486378672397
30320,703-004-5389,2053.2214,6,4,2,1.4520639661175356
30365,703-004-5381,3836.9424,2,2,0,1.0038856056058918
30396,703-004-5390,8443.907,5,2,3,1.2604389511447467
32023,207-008-2399,531.34143,2,0,2,0.27920371738274696
32090,703-004-5388,9618.786,4,2,2,0.5695695971544591
32218,703-004-5390,2734.0334,4,3,1,2.8076059176833312
32281,703-004-5389,268.64944,2,1,1,0.44099948770419173
32362,703-004-5391,6298.399,3,3,0,0.9498220699306589
32838,703-004-5388,2082.948,3,0,3,0.27920371738274696
33076,703-004-5391,5947.668,4,4,0,1.3316995282112185
33539,703-004-5383,6261.977,6,4,2,1.482900404235339
33627,703-004-5390,915.16675,4,4,0,1.4074017068043065
33648,207-008-2399,5518.975,4,1,3,0.9933076923193104
33726,703-004-5387,3784.8813,1,0,1,0.27920371738274696
33809,207-008-2399,4195.112,3,1,2,0.520952469994584
34015,703-004-5392,8014.685,1,0,1,0.27920371738274696
34172,703-004-5396,9501.882,3,1,2,0.35051625234780187
34626,703-004-5396,6841.134,3,3,0,1.0717472615164647
34648,703-004-5398,7995.31,6,2,4,1.8353092314382566
34953,703-004-5382,8764.513,2,1,1,1.3340061592425565
34984,703-004-5393,8227.047,7,4,3,2.278052528369579
35021,703-004-5394,3333.4954,1,1,0,0.40156447188095895
35389,703-004-5390,2480.5618,2,0,2,0.27920371738274696
35634,703-004-5394,6353.0425,5,2,3,1.1070602423166593
357,703-004-5397,903.3525,3,3,0,1.372263156839069
35751,703-004-5389,900.3496,6,2,4,1.428554129823333
36103,703-004-5391,259.9269,1,1,0,0.5165268771580819
36286,703-004-5383,3527.3755,1,0,1,0.27920371738274696
3629,703-004-5384,2340.6697,5,2,3,1.2596521118631325
36361,703-004-5384,6446.793,"","","",0.27920371738274696
3645,703-004-5380,2285.7947,5,4,1,1.5813513407039077
36537,703-004-5381,3004.7112,4,0,4,0.27920371738274696
3700,703-004-5380,4117.351,1,0,1,0.27920371738274696
37172,703-004-5390,2429.2773,3,3,0,0.7168764399913615
37190,703-004-5394,6508.444,4,3,1,0.9159643966451672
37294,703-004-5389,1719.9773,9,5,4,1.7164686026515183
37475,703-004-5394,7365.665,6,2,4,1.805922868119352
37568,703-004-5390,1317.9738,2,1,1,0.5789519703608036
37757,703-004-5389,9687.38,7,4,3,1.0762868370937717
37890,703-004-5395,4993.5366,3,2,1,0.7509380514325983
38291,703-004-5391,8186.5396,3,1,2,0.5272858585777646
38299,703-004-5397,5552.9443,5,3,2,1.2072602533267363
38335,703-004-5387,4270.2837,5,2,3,0.48628465506171115
38387,703-004-5391,122.965576,6,5,1,3.0965440022975343
38501,703-004-5395,3921.0056,6,2,4,1.5665328246649626
38548,703-004-5396,9457.296,6,2,4,1.2607042614244386
3866,207-008-2399,5969.165,8,5,3,1.5775410949259605
38749,703-004-5388,6326.663,4,1,3,0.4289230791579855
38770,703-004-5380,4160.2524,4,3,1,0.9801250767083812
38823,703-004-5385,8336.517,7,5,2,3.328963570960406
39859,703-004-5393,9.816885,4,3,1,0.9656438054147455
39913,703-004-5398,4538.749,6,3,3,0.9993190591515901
39929,207-008-2398,2090.7456,7,3,4,0.8260358313650812
40042,703-004-5393,1046.9543,4,2,2,1.0476646793551578
40116,703-004-5389,1334.194,4,2,2,1.0287775774172558
40149,703-004-5387,6829.142,1,1,0,0.4314860782385869
40221,703-004-5396,7404.2617,3,2,1,0.6351884570457493
40313,703-004-5388,9833.113,6,4,2,1.2877156534217127
40364,703-004-5388,9104.264,6,4,2,1.9684653484042778
40781,703-004-5390,5519.486,4,1,3,0.982838122838439
40873,207-008-2399,6079.993,4,1,3,0.40992605413530625
4105,703-004-5395,8906.94,6,1,5,1.4752055301180627
41510,703-004-5394,4946.272,"","","",0.27920371738274696
41640,703-004-5380,8555.916,6,3,3,0.7540535372790227
41801,703-004-5385,2358.9104,5,4,1,3.78983479646773
41803,703-004-5396,1954.9835,3,1,2,0.5165268771580819
41860,703-004-5383,3843.0137,2,2,0,0.670339816022476
41936,703-004-5389,8936.332,7,5,2,1.4082654563531283
42152,703-004-5385,4008.9797,4,1,3,0.5915667678361011
42209,703-004-5394,5634.0977,6,3,3,1.1537099729222215
42232,703-004-5396,7608.467,3,3,0,0.9015477926711127
42308,703-004-5391,2511.4846,4,1,3,1.2438344813785718
42315,703-004-5395,379.47357,4,4,0,2.852031851718611
42382,703-004-5399,9266.318,5,4,1,2.387069887977825
42890,703-004-5387,4616.4336,4,3,1,0.8880244838774102
42955,703-004-5397,8199.748,5,2,3,0.6347783111088634
42997,703-004-5390,7153.312,4,3,1,0.8845544619841099
43403,207-008-2399,2237.2114,4,2,2,0.6817103791581198
43555,703-004-5380,3422.023,7,3,4,1.6392379336217462
43594,703-004-5398,3440.4277,1,0,1,0.27920371738274696
43699,703-004-5393,7242.9473,3,2,1,1.3230129726008655
43811,207-008-2399,95.726845,"","","",0.27920371738274696
44220,703-004-5388,3802.3484,5,4,1,1.7976620302429418
44407,703-004-5385,1306.4503,2,1,1,0.4938243093321171
44649,703-004-5384,3381.5933,4,1,3,1.1493006077952508
44807,703-004-5390,3590.9187,5,4,1,1.8175770800660325
45122,703-004-5388,7898.4175,4,2,2,0.7842855129353173
45286,207-008-2398,4185.2812,4,3,1,0.6511452701960513
45523,207-008-2398,9773.442,1,1,0,1.3590911207788716
45712,207-008-2398,7791.442,4,1,3,0.8295042801407483
4572,703-004-5396,6276.694,3,0,3,0.27920371738274696
45871,207-008-2398,1781.86,7,5,2,3.2027683576469324
45899,703-004-5384,2653.7507,3,1,2,1.1974408595661732
4598,703-004-5395,536.76306,5,1,4,0.5806015327035146
46024,703-004-5391,6102.505,4,2,2,1.1260302449354609
46030,703-004-5389,3695.0618,1,1,0,1.0815596452906313
463,703-004-5394,9667.984,6,3,3,1.1052618169071953
4634,703-004-5382,6870.3667,1,1,0,0.4642037490357366
46622,703-004-5392,7393.9766,2,2,0,1.1976909465019616
4708,703-004-5399,9133.786,5,1,4,1.223803511794157
47335,703-004-5397,4608.624,5,2,3,0.8852904810211956
47439,703-004-5387,3292.557,2,1,1,0.37512182779194486
47743,703-004-5390,7501.9805,4,1,3,0.35831143730785864
4805,703-004-5394,1036.3,2,1,1,0.4777450015770127
48060,703-004-5398,6067.5073,3,1,2,0.41186937552890546
48331,703-004-5388,2535.0977,6,4,2,1.3123403874360795
48763,703-004-5397,3422.1453,"","","",0.27920371738274696
48785,703-004-5395,6242.025,4,2,2,1.0030742913949475
49415,703-004-5388,6927.246,5,2,3,0.795039456132804
49417,703-004-5396,1371.767,5,2,3,3.755152192491528
49510,703-004-5388,8294.119,4,1,3,0.3919322182760311
49526,703-004-5392,9591.693,9,3,6,0.9652418166174389
49557,703-004-5388,8566.854,3,1,2,0.5370914903290126
49887,703-004-5387,4066.779,11,9,2,3.205466832980192
49959,703-004-5386,9057.683,2,1,1,0.3187575773453028
5113,703-004-5387,9717.359,3,2,1,0.9312052626797284
5154,703-004-5391,6042.4595,5,4,1,2.0897946937927014
5287,703-004-5385,8930.421,8,5,3,2.3647924347948748
5395,207-008-2398,4379.0435,1,0,1,0.27920371738274696
5617,703-004-5382,2207.929,3,1,2,0.4812295701238639
5752,703-004-5381,5327.8823,5,4,1,2.2790911515644474
5758,703-004-5380,314.5522,4,1,3,0.44305845611277245
6029,703-004-5397,7387.495,5,3,2,1.4145710771483848
6285,207-008-2398,4730.2246,3,3,0,2.8429078846735365
6410,703-004-5391,9532.462,1,0,1,0.27920371738274696
6649,703-004-5398,7555.9814,3,1,2,0.8897728607946088
750,703-004-5390,6072.137,5,4,1,0.8592066933001966
766,703-004-5392,5432.578,4,2,2,1.1971910188091144
7752,703-004-5388,2492.2139,4,3,1,0.7805878235813946
7823,703-004-5397,5854.3325,7,3,4,1.0228432783139152
7950,703-004-5397,1810.8558,2,1,1,1.0706436809613284
8088,703-004-5387,6510.3887,9,5,4,2.164618368053676
8208,703-004-5390,1059.922,3,0,3,0.27920371738274696
8337,703-004-5386,7094.0137,1,1,0,1.2510580309648769
8652,703-004-5398,726.2969,4,1,3,0.47247051961951536
8771,703-004-5387,7633.5103,2,1,1,0.3271627725873459
8826,703-004-5395,98.58966,1,1,0,0.9673268987273027
9182,703-004-5385,3779.8994,6,4,2,2.0544638316879933
9558,703-004-5391,1300.1061,3,1,2,0.4523381704630113
9659,703-004-5399,9925.061,4,1,3,0.33853450732658075
9804,703-004-5395,8487.828,8,4,4,1.001736049603829
10041,703-004-5394,9383.882,3,2,1,1.1192977938315052
10070,703-004-5392,5056.056,2,2,0,2.2880447884013515
10254,703-004-5395,8166.077,1,0,1,0.27920371738274696
10429,703-004-5390,9172.365,3,2,1,0.767593874297559
10434,703-004-5392,7440.9272,1,1,0,0.7740016344115332
10879,703-004-5399,8422.04,6,1,5,0.3978652972704144
10997,703-004-5399,7486.083,5,2,3,0.5456492523215708
11025,703-004-5394,5931.0854,3,0,3,0.27920371738274696
11103,703-004-5380,401.72516,5,2,3,0.5489674654247974
12127,703-004-5389,9181.317,3,2,1,1.4040452225731839
1242,703-004-5388,6312.391,"","","",0.27920371738274696
1258,207-008-2399,4367.425,3,1,2,0.7541940791711009
12598,703-004-5390,1381.0914,4,0,4,0.27920371738274696
12798,703-004-5390,7375.5376,8,2,6,0.8061600167338968
12909,703-004-5383,5244.5776,9,5,4,1.484373460471675
12950,703-004-5395,4273.3423,2,2,0,0.5434289467620382
13066,703-004-5386,6183.3794,4,3,1,0.7246268722394351
13466,703-004-5392,7607.5146,2,1,1,1.1299520550041215
13474,703-004-5394,3487.9338,2,1,1,0.8477127512081127
13556,703-004-5394,3636.868,7,4,3,0.9992213653701112
1360,703-004-5397,343.1499,1,0,1,0.27920371738274696
13733,703-004-5384,2272.7686,2,0,2,0.27920371738274696
1401,703-004-5388,1494.174,5,2,3,1.6008740818619172
14066,703-004-5398,5912.2676,4,4,0,2.5301658288802966
14212,703-004-5388,5219.3115,2,2,0,0.6347800870324278
14397,207-008-2398,830.85895,2,1,1,0.8518006520876427
14435,703-004-5384,3682.3374,2,1,1,1.2298746407272685
14484,703-004-5389,1501.0017,5,3,2,1.0875288327263268
14684,703-004-5385,1860.5829,6,3,3,3.156412809134838
14690,703-004-5394,1413.1123,9,6,3,2.0421850717367214
14772,703-004-5398,1762.7424,1,1,0,0.9860411493214525
15232,703-004-5380,4041.1372,4,2,2,0.46139851109563745
15288,703-004-5383,2803.356,4,3,1,1.5101012771557716
15536,703-004-5399,6740.179,5,1,4,0.37790440578861534
15927,703-004-5390,1022.4497,2,1,1,1.1317391979507254
15965,207-008-2399,345.59906,2,1,1,2.106520094395323
16086,703-004-5388,1968.0077,3,3,0,0.9391754752096046
16132,703-004-5397,2260.0723,2,1,1,0.8962459773197077
16241,703-004-5394,4325.0835,6,5,1,4.96313917272287
16746,703-004-5385,9763.532,5,2,3,0.6845840479260836
16846,703-004-5388,1879.1794,6,2,4,0.4872934845004436
17133,703-004-5385,4462.697,4,3,1,1.343861692711095
17169,703-004-5391,480.448,5,1,4,0.45233471475815834
172,703-004-5397,1658.8104,3,0,3,0.27920371738274696
17300,703-004-5398,1982.6948,4,1,3,0.4351843641450859
17431,703-004-5396,6092.6646,5,2,3,1.4343997391053351
17509,703-004-5394,6542.6016,5,3,2,1.1411644074218912
17595,703-004-5398,3410.6714,6,2,4,0.7258942263799076
17596,207-008-2398,8745.87,1,1,0,0.30886911235466386
17721,207-008-2398,3183.2874,5,3,2,1.0535503219038376
17872,703-004-5393,4656.4316,5,3,2,1.1106463149125771
18092,703-004-5386,5951.4517,3,1,2,0.3648707857516491
18117,703-004-5384,4738.8325,7,3,4,0.878430549013992
18237,703-004-5385,47.68789,3,1,2,0.44829646872267315
18285,703-004-5394,1755.2555,1,0,1,0.27920371738274696
18469,207-008-2399,1625.5844,7,5,2,2.6309317914874133
19034,703-004-5389,4496.2686,2,0,2,0.27920371738274696
19202,703-004-5381,3816.2231,"","","",0.27920371738274696
19346,703-004-5381,9728.692,4,2,2,1.1088717640472725
19489,703-004-5395,3799.2615,4,3,1,1.7713715193560282
19520,703-004-5392,8989.816,5,2,3,0.5672319708821597
19928,703-004-5393,1694.1959,7,5,2,2.367234996595945
20040,703-004-5398,3575.936,2,0,2,0.27920371738274696
20289,703-004-5395,9785.899,3,3,0,1.559855618715596
20703,207-008-2399,5934.3096,3,3,0,0.6302580684014168
21426,703-004-5384,7514.145,3,2,1,1.8177475947179111
21848,703-004-5387,9489.667,2,0,2,0.27920371738274696
22100,703-004-5391,5313.9766,4,3,1,1.1299757293861559
22398,703-004-5396,9254.628,8,4,4,0.7457258870990112
22450,207-008-2398,2628.7793,6,2,4,0.7523914860205616
22461,703-004-5381,2940.039,4,4,0,1.2105152109605704
22595,703-004-5396,1071.2505,7,2,5,1.725348735953221
22660,703-004-5393,5920.6416,5,2,3,0.5903280205378257
22869,703-004-5397,8855.693,3,1,2,0.6062395545473457
22960,703-004-5385,92.33892,5,4,1,2.3187042732093386
22995,703-004-5384,621.76587,3,1,2,0.6236470572789358
2313,703-004-5397,4335.602,4,0,4,0.27920371738274696
23195,703-004-5381,2615.5198,6,3,3,1.0364832873203003
23414,703-004-5381,9050.458,4,2,2,1.238050754057379
23472,703-004-5383,7947.984,6,3,3,1.5528829591883888
23574,703-004-5387,112.59079,4,1,3,0.5837426383677763
23714,703-004-5382,7202.116,5,4,1,2.270745703794435
23718,703-004-5395,75.60372,3,3,0,1.4323991209140907
2379,207-008-2398,5944.0864,4,1,3,0.44688509635494666
23812,703-004-5395,8489.789,5,3,2,1.6110144135703957
23943,703-004-5381,8374.005,4,2,2,0.554550614634008
24037,703-004-5381,4298.535,2,1,1,0.33853450732658075
24129,703-004-5381,6056.323,2,0,2,0.27920371738274696
24491,703-004-5388,7061.367,6,3,3,1.8530497571053341
24498,207-008-2399,2239.4001,"","","",0.27920371738274696
24623,703-004-5384,4774.2905,2,2,0,0.7875668372851478
24902,703-004-5382,1035.6444,5,2,3,0.5953805950615356
24974,703-004-5380,8639.989,4,4,0,1.3822644603504077
25306,703-004-5388,5569.71,3,1,2,0.4106216767891685
25445,703-004-5395,662.50323,1,0,1,0.27920371738274696
25603,703-004-5388,7905.5054,4,3,1,0.5752890803649539
2569,703-004-5387,8469.156,4,2,2,0.7682798789144726
25796,703-004-5389,7469.7017,4,1,3,0.33853450732658075
25841,703-004-5397,6103.1353,5,2,3,3.154196805727525
26051,703-004-5382,4921.9956,8,5,3,2.877972569738816
26135,703-004-5395,6099.5396,4,2,2,0.7902990437307823
26215,703-004-5391,355.3456,6,2,4,0.787745708968976
26515,703-004-5387,4372.493,9,5,4,3.1528530554969243
26607,703-004-5383,4481.0093,2,2,0,1.1246501804590021
26769,703-004-5398,5316.6396,6,3,3,2.1604607096885666
26859,703-004-5393,1727.8582,8,4,4,1.1389834732495392
26879,703-004-5399,9795.735,7,4,3,0.9255230312614001
27229,703-004-5388,4532.859,4,2,2,0.7412704636196906
27232,703-004-5396,4778.9917,3,3,0,0.9908426025128104
27396,703-004-5393,9133.035,4,2,2,0.6461016933427117
27417,703-004-5390,5615.087,3,2,1,0.5165268771580819
27431,703-004-5390,6460.072,6,2,4,0.6661878353607087
27504,703-004-5399,7383.484,7,2,5,0.967553773691596
27721,703-004-5398,9802.281,4,2,2,0.78376654116906
27795,703-004-5391,9860.09,4,3,1,0.7518142492034691
27922,703-004-5396,4887.1196,3,2,1,0.8662721064939155
28269,703-004-5395,8845.482,3,3,0,1.0491365674923778
28427,703-004-5384,9225.409,8,5,3,1.5713322922727198
28547,703-004-5388,1409.9532,1,1,0,1.0863117467956165
28607,703-004-5389,3097.037,6,4,2,2.4477870581300336
29334,703-004-5399,5041.6274,4,3,1,0.6537647292624775
29449,703-004-5382,5046.2373,4,3,1,1.92960927316872
29527,703-004-5397,2794.562,8,2,6,0.9824474610545032
29797,703-004-5399,2187.1655,7,2,5,0.6097424281039814
30476,703-004-5395,3757.3916,4,2,2,2.5587846895128115
30688,207-008-2399,2167.7368,4,3,1,0.7354877253116936
30730,703-004-5394,8318.314,9,4,5,0.9078843923257917
30838,703-004-5385,5989.6147,3,0,3,0.27920371738274696
3111,703-004-5380,5197.186,4,0,4,0.27920371738274696
31196,703-004-5390,1071.1372,4,3,1,1.3126764465480651
31350,703-004-5388,5362.243,4,2,2,1.0029733376056609
31741,703-004-5385,6186.745,5,2,3,1.1682866499205669
31936,703-004-5392,579.15686,7,3,4,0.8328368852340889
32105,703-004-5384,82.92198,"","","",0.27920371738274696
32236,703-004-5390,2935.4768,3,1,2,1.005571464210774
32416,703-004-5397,2676.847,2,1,1,0.5034427975288862
32743,703-004-5389,6213.0483,11,7,4,4.266919214777667
32753,207-008-2399,4386.0522,3,2,1,0.670404436245009
32754,703-004-5389,9401.864,6,2,4,1.1015059558650553
32770,703-004-5382,6457.863,2,1,1,1.099016472754877
33228,703-004-5392,5236.251,7,4,3,1.501844089050122
33245,703-004-5397,7383.961,6,5,1,1.4192372304302914
33607,703-004-5395,3278.4058,3,2,1,0.9897171766413522
33788,703-004-5393,8531.168,6,4,2,1.9406105119293955
33956,703-004-5397,315.92847,6,4,2,1.8754048416923557
33976,703-004-5391,5178.542,4,1,3,0.6912493576901139
34001,703-004-5387,8395.347,4,4,0,2.168973010294099
34245,703-004-5386,8880.936,3,2,1,1.1023406653293844
34724,703-004-5383,9572.545,1,0,1,0.27920371738274696
34731,703-004-5396,1600.4187,4,3,1,0.9305610411300401
34751,703-004-5382,5811.0005,6,5,1,4.384971542531729
35283,703-004-5390,4410.8423,6,1,5,0.45188586532481145
35426,703-004-5398,2959.4802,5,1,4,0.48428272709110554
35453,703-004-5385,7869.978,3,1,2,0.4118880439223944
35685,703-004-5389,968.63806,6,1,5,0.35906538916429065
35702,703-004-5397,2682.1692,1,1,0,0.5472448783861431
35752,703-004-5395,3277.9758,5,1,4,0.3131070259220805
35869,207-008-2399,3928.4795,2,0,2,0.27920371738274696
36049,703-004-5387,1212.9253,5,2,3,0.7287993348530601
36496,703-004-5390,8916.763,7,4,3,1.6467973182973406
36798,703-004-5384,1436.0172,5,2,3,1.2818422860286627
37028,703-004-5393,9418.8955,5,3,2,1.3826035010451365
37215,703-004-5384,7311.1943,7,5,2,4.0656491999341835
37809,703-004-5387,4891.603,1,1,0,0.5914636449486832
37827,703-004-5396,8619.953,5,1,4,0.5177358895500778
37916,703-004-5387,2421.651,2,0,2,0.27920371738274696
37921,703-004-5392,2493.26,2,1,1,0.579608381502661
3810,703-004-5398,7701.702,7,5,2,3.93112794122538
38141,703-004-5388,7071.4556,6,3,3,1.1372526168471087
38425,703-004-5388,1293.366,2,1,1,0.7770144576315179
3844,703-004-5385,9836.968,"","","",0.27920371738274696
38747,703-004-5380,3280.4204,2,0,2,0.27920371738274696
38802,703-004-5390,9849.402,2,2,0,1.034590828537991
38837,703-004-5399,7489.796,5,5,0,2.365702194553019
38931,703-004-5397,6592.455,1,0,1,0.27920371738274696
39738,703-004-5386,2679.8123,6,6,0,2.4782574122494965
39768,703-004-5390,1154.1622,4,1,3,0.3781048826279685
40443,703-004-5388,2166.9937,6,2,4,0.466580460786193
40541,703-004-5382,8546.573,4,1,3,0.5575239338605672
40604,703-004-5384,6734.979,5,1,4,0.6479253488345155
40720,703-004-5397,6484.032,4,3,1,1.2124168498691452
40772,703-004-5386,1766.1064,6,3,3,1.0391800546951475
40912,703-004-5399,6356.526,2,0,2,0.27920371738274696
4095,703-004-5386,2547.2366,5,3,2,0.8445036149673478
41077,703-004-5394,5474.364,8,6,2,4.533577747050032
41145,703-004-5383,8033.4097,3,0,3,0.27920371738274696
41177,703-004-5383,5910.031,3,2,1,0.9375659900757508
4119,703-004-5395,8170.007,1,1,0,0.33063068816101604
41288,703-004-5381,4303.251,5,2,3,0.6530641905760377
41608,703-004-5386,2386.6523,7,4,3,1.7488574285588585
41798,703-004-5394,7456.4375,3,3,0,2.177304312970588
42089,703-004-5385,4278.9497,5,2,3,1.6139276367057258
42125,207-008-2399,8962.279,3,1,2,0.4360703889202193
42228,703-004-5394,7495.9707,4,2,2,3.2039390197340207
42439,703-004-5381,6874.2734,6,3,3,0.980050081669688
42523,703-004-5384,1393.308,7,5,2,5.290925957094299
42872,703-004-5396,6208.571,2,1,1,0.7531794690027932
43216,703-004-5392,7646.765,7,3,4,1.2240075757822955
43228,703-004-5383,184.85547,6,3,3,0.9171223151678278
43827,703-004-5383,7802.0454,5,3,2,1.0886100205062466
44031,703-004-5393,3730.967,2,0,2,0.27920371738274696
44149,703-004-5382,6987.879,1,1,0,0.5733277548473692
44229,703-004-5395,7579.86,5,0,5,0.27920371738274696
45299,703-004-5393,7610.86,2,2,0,0.936498413640546
45311,703-004-5381,9030.269,5,1,4,1.502274374911187
46135,703-004-5390,3827.0127,2,1,1,1.0950068113968778
46226,703-004-5388,2772.7205,3,2,1,0.5165268771580819
4648,703-004-5381,2761.7336,4,2,2,0.7298115976442603
46500,703-004-5398,7903.477,6,5,1,1.8696042774671309
46583,703-004-5389,2845.9639,3,1,2,2.283230151211697
4662,703-004-5390,6457.783,3,3,0,0.6842085651448125
46846,703-004-5391,2012.0925,3,1,2,0.5207255887497018
4687,703-004-5394,2025.0743,4,1,3,0.5216583460212518
47148,703-004-5384,2040.3922,2,2,0,0.6591507337107534
47368,207-008-2399,4324.0146,7,3,4,5.008860708474966
47796,703-004-5380,9698.375,6,5,1,2.790754725164352
48065,703-004-5382,5086.136,"","","",0.27920371738274696
48150,207-008-2398,7952.0107,5,1,4,0.4546844171066259
48274,703-004-5392,2824.412,"","","",0.27920371738274696
48450,703-004-5399,1237.9241,6,1,5,0.4452285724593274
48641,703-004-5385,6598.325,5,3,2,1.874007489335268
48719,703-004-5395,552.11127,13,5,8,2.063627936191142
48867,703-004-5388,3351.2085,4,3,1,1.80791058738876
49133,207-008-2399,9519.36,3,2,1,0.7858026992831907
49318,703-004-5387,3476.4082,5,1,4,0.5733181087478976
4956,703-004-5392,5560.5425,6,1,5,0.7024641184814809
49573,703-004-5392,4330.6987,7,4,3,3.1568127110224906
5019,703-004-5395,5992.9917,4,2,2,1.3380356336231598
5262,703-004-5390,9068.076,2,2,0,0.7895196429290191
575,703-004-5394,1313.9933,4,3,1,1.4719800510845935
5800,703-004-5387,1466.6659,8,4,4,1.3461697124797454
5804,703-004-5396,5779.046,3,2,1,1.8717201488336341
5806,703-004-5385,7801.065,3,2,1,2.5581416281738156
6013,703-004-5399,4013.9812,8,6,2,2.9193852407624097
6424,703-004-5386,569.5987,4,0,4,0.27920371738274696
6479,703-004-5382,1615.9362,2,2,0,0.6679672268968664
6503,703-004-5382,9449.788,6,3,3,1.2575765399236676
6617,703-004-5396,8554.438,5,3,2,0.6496736351965159
6867,703-004-5397,178.36333,4,3,1,3.2644117762776084
6882,703-004-5398,5390.3716,3,1,2,0.520562073827919
6941,703-004-5380,7570.5757,3,0,3,0.27920371738274696
6963,703-004-5385,8260.88,6,1,5,0.6054701146623594
7026,703-004-5399,3895.8657,4,2,2,0.8580426012165042
7063,703-004-5385,6751.2246,2,0,2,0.27920371738274696
7092,703-004-5384,9712.282,"","","",0.27920371738274696
7116,703-004-5397,3229.1377,4,1,3,0.4200058038621007
7303,703-004-5380,582.62885,5,3,2,0.5486643883776585
7304,703-004-5391,51.01204,7,5,2,2.712014695739205
732,703-004-5390,7724.6953,3,2,1,0.6349606042395892
7840,703-004-5384,3885.4675,5,2,3,0.8500400833353924
8518,703-004-5387,9083.007,7,6,1,1.4020263852242987
8524,703-004-5394,2190.3176,6,2,4,1.635424048020381
8857,703-004-5394,3251.052,6,3,3,1.2479104974599193
8963,703-004-5390,7376.474,2,1,1,0.35831143730785864
911,703-004-5390,2316.9326,1,0,1,0.27920371738274696
9376,703-004-5383,6930.2607,4,1,3,0.61833395615244
9476,703-004-5381,5306.7227,2,1,1,0.4191550228080743
9643,703-004-5384,6067.885,8,6,2,2.704759334506635
9774,703-004-5380,7377.2114,3,2,1,1.0951650774836181
988,703-004-5384,8998.63,1,1,0,0.3187575773453028
9981,703-004-5397,290.15958,1,1,0,1.0536318949309713
1004,703-004-5390,9303.873,2,2,0,0.8958268138672039
10180,703-004-5396,2255.5654,2,1,1,0.6222530263759949
10215,703-004-5394,6380.671,4,2,2,0.5720604965455103
10716,703-004-5385,5595.039,3,2,1,5.194650565599602
10807,703-004-5399,3982.6167,6,2,4,0.5596735460672365
10874,703-004-5392,3810.1907,9,6,3,1.8334706942283896
11028,703-004-5385,1126.9879,5,2,3,0.5291415634684672
11083,703-004-5395,8862.408,2,2,0,0.5732895259855415
11161,703-004-5382,9911.554,3,0,3,0.27920371738274696
11214,703-004-5382,3127.6726,4,2,2,0.47697301719552604
11226,703-004-5392,7342.897,7,3,4,0.7340957081138197
11862,703-004-5397,3209.126,2,0,2,0.27920371738274696
12438,703-004-5392,1802.4379,5,3,2,1.2426364554980447
12729,703-004-5382,5583.446,3,1,2,0.5153827680246857
13252,703-004-5390,8924.841,4,2,2,0.5974538405465808
13369,703-004-5384,2816.6235,4,2,2,1.4325374981442476
13457,703-004-5395,2083.8857,4,2,2,0.7886972058825343
13506,703-004-5384,898.12695,5,1,4,0.3978652972704144
13657,703-004-5395,5589.4775,4,3,1,3.144728885986457
13841,703-004-5391,2824.2249,4,1,3,0.4832121575719994
13873,703-004-5389,9543.269,7,3,4,0.8793642323960535
13935,703-004-5384,3257.6472,3,2,1,2.7965135798541683
14235,703-004-5381,9378.731,1,1,0,0.3187575773453028
1431,703-004-5382,1552.729,2,1,1,0.4578713869692339
14354,703-004-5397,8885.647,3,1,2,0.4239642907688081
14401,703-004-5380,7103.2554,5,2,3,0.8833084771173135
14477,703-004-5388,2097.5483,1,1,0,0.5056117996865533
14485,703-004-5391,7833.9453,3,1,2,0.9790870325977157
1514,703-004-5385,506.61862,10,2,8,0.5294280278158688
15616,703-004-5380,8245.358,5,4,1,1.217595298944427
15839,703-004-5386,6123.211,3,2,1,0.8369946377223839
15990,703-004-5387,1745.2216,3,2,1,0.672648070286595
16145,703-004-5399,2472.4614,2,0,2,0.27920371738274696
16186,703-004-5396,3245.759,6,1,5,0.46406385399187905
16615,703-004-5381,8376.557,6,3,3,1.029666195780472
1664,703-004-5388,5417.6724,5,1,4,0.6501305910546629
16754,703-004-5383,3440.2937,5,1,4,1.7835949088774001
16796,703-004-5394,9604.771,3,2,1,0.5307662667446019
16842,703-004-5387,4537.904,4,2,2,0.9913170465631048
17124,703-004-5385,9679.969,3,1,2,1.6480481801697597
17246,703-004-5388,3689.2576,4,1,3,0.49886974340617357
17593,703-004-5385,3606.5042,2,0,2,0.27920371738274696
17758,207-008-2399,2013.8287,4,2,2,0.6660995904125603
18260,703-004-5383,3076.4668,4,3,1,0.5924460221631417
18359,703-004-5395,2063.2017,3,1,2,1.048835311411684
18513,703-004-5381,6576.2446,5,2,3,0.36622220930036975
18584,207-008-2398,1716.3264,6,2,4,0.7179301878549208
1877,703-004-5388,2507.5627,7,5,2,3.153760800480419
18900,703-004-5387,4938.0244,2,1,1,0.5656118280895122
1906,703-004-5389,9699.918,5,1,4,0.4866015649139345
19461,703-004-5381,680.32324,3,1,2,0.8105882414502847
19487,703-004-5392,9106.768,5,2,3,0.49821198479439016
19574,703-004-5383,7004.778,8,6,2,1.9136098648559285
1965,703-004-5391,9566.136,3,1,2,0.4828612335052675
19858,703-004-5385,4110.7427,2,1,1,0.7075928949808665
20212,703-004-5395,1375.77,7,4,3,3.3103658975596475
20228,207-008-2399,3860.886,3,1,2,1.184617113996505
20533,703-004-5390,9499.511,2,2,0,0.5898201796686978
2056,703-004-5387,5604.9062,5,2,3,0.5481503641838061
20595,703-004-5382,1857.5508,"","","",0.27920371738274696
20667,703-004-5388,4377.566,4,2,2,1.8958616623783207
20902,703-004-5397,8435.937,7,2,5,1.2187356904435738
20970,703-004-5396,1948.8668,1,1,0,0.4986527456368905
21255,703-004-5384,3769.685,4,1,3,0.6057914022559858
21405,207-008-2399,9276.027,4,3,1,1.7183588265409044
21741,703-004-5386,621.0971,4,2,2,2.5533376448427956
21810,703-004-5381,6132.1157,8,3,5,0.870584014865676
22080,703-004-5396,7143.325,7,3,4,0.5858373409279504
22374,703-004-5395,7406.4087,3,1,2,0.37175974969512765
22460,703-004-5396,143.35513,4,3,1,1.0816949041043857
22590,703-004-5385,9740.551,4,2,2,1.0435016145570557
22612,703-004-5396,2930.3284,4,1,3,0.4417995958697673
22747,703-004-5397,6521.557,4,2,2,2.0848533537401877
23125,207-008-2399,8117.959,4,1,3,0.33853450732658075
23140,703-004-5388,6307.7285,4,4,0,1.4682533876874848
23207,207-008-2399,9404.341,6,3,3,0.9629343095503299
23393,207-008-2398,8328.526,2,1,1,0.36023661478492536
2350,703-004-5397,9742.055,1,0,1,0.27920371738274696
23763,703-004-5387,150.40695,3,2,1,0.5202341068603478
24026,207-008-2398,1852.6787,3,2,1,0.49440967712901934
2403,703-004-5385,1123.3837,5,2,3,0.5015423184048785
24079,703-004-5384,1296.5381,4,3,1,1.6582999380172914
24127,703-004-5385,3269.7563,2,2,0,0.9744459047425622
24814,207-008-2399,4462.993,5,3,2,1.3885780706973567
25101,207-008-2398,9595.404,8,5,3,1.4611246767845023
2522,703-004-5393,271.5516,6,2,4,0.9928015406636826
25351,207-008-2398,1137.3062,3,1,2,0.36966739942268373
25433,703-004-5381,5027.195,4,3,1,3.49156383151844
2588,703-004-5382,2727.881,3,3,0,1.4633187647610006
26510,703-004-5382,1540.5881,3,2,1,0.9788247694012012
26564,703-004-5382,9081.576,3,2,1,0.7373254130630579
2703,703-004-5392,6272.753,4,0,4,0.27920371738274696
27173,703-004-5392,4380.712,4,2,2,0.7444241597230756
27281,703-004-5382,6691.6157,4,2,2,1.23972827115944
27561,703-004-5397,1151.5427,3,1,2,0.4154378411936542
27881,703-004-5387,935.5634,1,0,1,0.27920371738274696
28086,703-004-5396,6382.248,2,1,1,0.43192038758668366
28317,703-004-5380,9668.298,3,1,2,0.35831143730785864
28603,703-004-5397,8448.523,5,4,1,1.2419544906003204
28618,703-004-5388,2019.7821,4,1,3,0.37081873626101286
28766,703-004-5385,6565.5386,2,2,0,0.6468527186639874
28977,703-004-5398,9701.134,6,4,2,3.065629047117943
29059,703-004-5389,3256.5266,4,2,2,0.8380210933165587
29196,703-004-5399,8915.544,3,1,2,0.4524348905479412
29227,703-004-5394,9292.495,8,6,2,1.9903203014063784
29314,703-004-5392,8229.106,4,1,3,0.7200199984452678
30028,703-004-5390,5750.9487,3,2,1,0.5275608761824541
30100,703-004-5388,1868.931,"","","",0.27920371738274696
30522,703-004-5391,4719.711,8,4,4,1.9055608643068325
30754,703-004-5388,1989.0142,2,0,2,0.27920371738274696
30839,703-004-5380,4566.415,1,1,0,1.3738476270462785
30879,703-004-5384,8989.716,3,2,1,1.5202467652412188
31025,703-004-5380,5107.9834,5,2,3,0.9514234205781554
31169,703-004-5396,2985.6616,6,3,3,1.7881185624352764
3118,703-004-5383,8895.212,2,0,2,0.27920371738274696
31199,703-004-5397,2030.2338,"","","",0.27920371738274696
31499,703-004-5398,8698.122,2,1,1,0.6592808924133712
31616,703-004-5396,5903.5396,2,1,1,0.35050693770154023
31718,703-004-5383,6602.683,7,4,3,1.6626373793515954
31746,703-004-5394,8799.094,3,2,1,0.6348083872779297
31977,703-004-5391,9632.299,2,1,1,0.8007994120326988
31983,703-004-5397,6225.155,3,1,2,0.35290739119047443
32154,703-004-5397,3344.025,5,4,1,2.7972352925627106
32297,703-004-5386,7011.0493,5,2,3,1.6782886364280665
32319,703-004-5394,2482.254,2,1,1,0.6082988342713214
32374,703-004-5387,5341.88,6,3,3,0.9688547106400069
32474,703-004-5389,4600.9214,3,2,1,1.1374586459020701
32664,703-004-5385,174.26074,7,3,4,1.5417719660593623
32742,207-008-2399,6588.0234,3,1,2,1.3844691710187473
3300,703-004-5399,2760.2458,2,1,1,0.6695014305632665
33223,703-004-5385,2259.524,2,1,1,0.48121970228793826
33309,703-004-5384,4140.932,2,1,1,0.4675552831644071
33792,703-004-5399,6368.6157,3,0,3,0.27920371738274696
34218,703-004-5381,5804.9316,5,3,2,1.3797951460442122
34646,703-004-5396,3249.4749,3,0,3,0.27920371738274696
34739,703-004-5394,9295.426,8,3,5,1.3687099634689088
34902,703-004-5397,9071.287,9,2,7,2.1213401437995207
35212,703-004-5389,5736.3794,1,1,0,0.43425359727536994
35237,703-004-5386,5793.7036,4,1,3,0.646478645883514
35564,703-004-5382,8418.644,2,2,0,1.0469368195260444
36010,703-004-5381,8322.674,2,2,0,0.6299228494382341
36263,703-004-5391,7143.7603,3,1,2,0.78927455745281
36699,703-004-5388,9554.814,2,0,2,0.27920371738274696
36847,207-008-2399,7555.7207,4,2,2,0.7208232736592772
36963,703-004-5383,552.9016,"","","",0.27920371738274696
3702,703-004-5399,2618.9006,4,2,2,1.5328703941047384
37413,703-004-5393,2434.367,4,1,3,0.44796685322298513
3747,703-004-5399,7519.479,4,3,1,0.9440031976720794
37522,703-004-5397,6259.136,6,3,3,1.1276687255491002
37567,703-004-5390,5296.646,4,3,1,1.1820924976426241
37624,703-004-5388,4716.8867,3,3,0,0.9252859704146044
38050,703-004-5398,6506.102,2,0,2,0.27920371738274696
38363,703-004-5398,2780.493,1,0,1,0.27920371738274696
38419,703-004-5386,3182.5054,3,0,3,0.27920371738274696
38631,703-004-5397,3168.074,4,3,1,0.7635272585217757
38641,703-004-5396,6206.0093,3,2,1,0.9663978897360882
38947,703-004-5385,1852.3378,3,2,1,1.111090440314696
38980,703-004-5385,1182.8351,5,2,3,1.219749354453134
39078,703-004-5390,9890.336,3,1,2,0.5533947867886415
3911,703-004-5381,6136.9736,4,4,0,1.2948055007760917
39330,703-004-5381,8985.248,4,3,1,1.028259737940507
39398,703-004-5393,1649.1222,6,4,2,1.020016042943025
39723,703-004-5399,5296.9736,3,1,2,1.5391278680444476
40148,703-004-5397,2723.012,3,2,1,1.0148862098789175
40155,703-004-5391,3430.249,"","","",0.27920371738274696
4026,207-008-2399,3292.8003,2,0,2,0.27920371738274696
40283,703-004-5387,8547.833,1,1,0,0.5811715799063127
40286,703-004-5391,8618.876,5,1,4,0.3978652972704144
40350,207-008-2399,9383.901,1,1,0,0.3978652972704144
40565,703-004-5398,6892.995,6,3,3,0.856190632775517
40670,703-004-5389,5001.462,2,1,1,1.0800776657490856
410,703-004-5393,2230.017,6,3,3,0.9229095208599873
41057,703-004-5381,4760.9067,3,3,0,0.8573974208289492
41273,703-004-5399,7021.179,6,2,4,0.9115782071795338
41488,703-004-5390,4154.1104,4,3,1,1.6285176623905315
41491,703-004-5381,503.47806,2,1,1,0.587073281332714
41503,703-004-5386,1658.4772,7,4,3,1.7264531254480835
41520,703-004-5398,4140.8555,"","","",0.27920371738274696
41744,703-004-5389,5245.17,1,1,0,0.4427130175976016
41968,703-004-5394,222.00107,7,5,2,3.8063943041367967
42275,703-004-5384,8636.166,5,4,1,1.3337396944814879
42745,703-004-5393,1522.786,3,1,2,1.4832187604154785
43084,703-004-5387,6744.949,6,2,4,1.4853472886854715
4317,703-004-5391,8916.66,1,0,1,0.27920371738274696
43359,703-004-5391,3734.3062,5,3,2,3.158186912806919
43461,703-004-5392,8045.6226,5,1,4,0.4776641280027023
43649,703-004-5383,6128.4272,6,3,3,0.8741265013993795
43802,703-004-5392,2957.1484,3,1,2,0.7782818831513695
43859,703-004-5390,25.49112,4,2,2,1.0875632757837925
44309,703-004-5394,3002.7837,5,2,3,1.1579655100972819
44380,703-004-5399,2222.3752,3,1,2,0.6746553447552868
44421,703-004-5399,8574.5205,4,3,1,1.2675259070078744
44578,703-004-5396,6129.8774,3,1,2,0.3908792340943195
44634,703-004-5384,7080.4087,2,2,0,1.7775930189402713
44796,703-004-5383,894.16144,4,2,2,1.3267666555206026
44890,703-004-5382,8439.532,4,1,3,0.7275528614826968
44973,703-004-5393,4399.59,5,2,3,0.5625694242416825
45420,703-004-5399,5692.5024,2,2,0,0.612715991942342
45466,703-004-5393,5199.365,3,1,2,0.7066479391968524
45544,703-004-5383,3687.0002,6,3,3,1.1284086663716089
45584,703-004-5380,1870.0593,7,2,5,0.66638280477615
45838,703-004-5390,1286.3135,3,2,1,1.0082513928935934
45888,703-004-5381,7163.7886,5,3,2,1.4538987870534523
46065,703-004-5388,7026.8745,6,2,4,1.2847598282833625
46428,703-004-5390,5586.483,4,1,3,0.45523075479735875
46881,703-004-5391,8205.462,4,2,2,0.7891628299276447
46917,703-004-5383,7416.932,2,0,2,0.27920371738274696
47160,703-004-5396,1148.6292,7,1,6,0.4791648473387171
47237,703-004-5386,4948.0986,2,2,0,0.5956345970831934
47476,703-004-5387,3472.417,7,0,7,0.27920371738274696
47706,207-008-2398,5174.3516,5,2,3,1.0056480259613378
47838,703-004-5394,6431.739,4,1,3,0.634068528066024
48212,703-004-5396,8422.33,6,5,1,1.5194401533836517
48222,703-004-5382,6969.627,1,1,0,0.9560691505078781
48322,703-004-5382,578.66095,3,0,3,0.27920371738274696
48354,703-004-5385,1736.992,2,1,1,0.3187575773453028
48647,703-004-5382,4068.6328,5,2,3,0.5526856526774743
48797,703-004-5397,8747.961,4,2,2,1.3027969435356015
48875,703-004-5389,9083.522,5,3,2,1.5573224885082095
49002,703-004-5383,114.00163,3,2,1,0.40195589885798594
4904,703-004-5387,4515.403,3,1,2,0.3271627725873459
49093,703-004-5390,1522.9731,5,3,2,0.6033093315301126
49178,703-004-5394,7869.781,3,3,0,2.6352454404001686
49260,703-004-5385,3371.114,3,1,2,0.3976477510406204
49374,703-004-5384,7465.6763,5,2,3,1.3100350054552428
49547,703-004-5381,2664.1262,6,4,2,1.4198797741072415
49636,207-008-2398,3189.686,2,1,1,0.35069872013094033
5053,703-004-5384,6979.835,7,7,0,2.840596373005708
5116,703-004-5383,530.19464,2,0,2,0.27920371738274696
5192,703-004-5398,3938.2249,3,0,3,0.27920371738274696
5273,703-004-5382,9862.807,3,2,1,0.6431806758336751
5359,703-004-5396,7639.856,2,0,2,0.27920371738274696
5627,703-004-5397,6306.94,3,2,1,0.7986859355550386
5960,703-004-5380,3615.7703,4,2,2,0.6529797936432327
6037,703-004-5393,7251.462,8,4,4,1.0195935527729596
6120,703-004-5387,130.8298,8,6,2,2.500603124049552
6309,703-004-5382,1652.4088,3,2,1,0.8846385255582713
71,207-008-2398,5876.1606,2,1,1,0.3978652972704144
7159,703-004-5384,7013.9766,5,2,3,0.9034580159689136
7491,703-004-5385,9544.012,4,1,3,0.4570937336358871
7670,207-008-2399,213.70828,11,6,5,2.161237135097567
7818,703-004-5398,8718.67,5,2,3,0.8577401829030203
7962,703-004-5398,8993.24,4,3,1,1.4366484791173328
8142,703-004-5394,161.86298,5,4,1,1.764670376089952
8516,703-004-5390,5923.9917,2,2,0,0.7653630338379679
8842,703-004-5392,592.21027,2,2,0,0.5105937981636984
8918,703-004-5387,6789.5107,1,0,1,0.27920371738274696
8936,703-004-5398,5131.3496,2,2,0,1.5406933985868325
9133,703-004-5394,579.9383,2,1,1,0.4266110649982019
9290,703-004-5384,7383.4336,1,0,1,0.27920371738274696
9371,703-004-5398,2927.0273,2,0,2,0.27920371738274696
9548,207-008-2398,479.72858,8,4,4,1.9486562888699093
9549,703-004-5384,2227.906,2,1,1,0.4087426087601173
10077,703-004-5386,6399.795,3,2,1,1.1552469896594821
10685,703-004-5382,3373.0352,4,1,3,0.4681607468113684
10853,703-004-5390,2482.2795,4,3,1,1.2663188821257512
11091,703-004-5391,866.0495,5,5,0,1.092955547487519
11262,703-004-5384,37.338734,3,1,2,1.2582686667777376
11391,703-004-5380,4296.747,2,1,1,0.39555207732462144
11394,703-004-5386,8155.1426,5,0,5,0.27920371738274696
11464,703-004-5398,3363.7554,2,2,0,0.5040077198443927
11520,703-004-5395,6773.1216,2,1,1,2.173642584752211
11717,703-004-5388,3986.1775,4,4,0,1.8086683573186617
11818,703-004-5399,1181.5935,6,4,2,1.141200853408823
12168,703-004-5387,3927.568,5,4,1,0.9195144348128985
12297,703-004-5385,8755.667,4,1,3,0.6745445477084924
13029,703-004-5391,2875.278,2,1,1,0.9894702919552923
13260,703-004-5388,217.67259,7,4,3,1.2390843497461792
13463,703-004-5394,6220.5977,4,1,3,0.4598341967587269
139,207-008-2398,7904.7363,4,2,2,0.6171799039198129
13990,703-004-5389,8997.949,3,2,1,0.8000796070827495
14135,703-004-5389,356.86075,10,6,4,2.0611861240757077
14253,703-004-5398,4744.452,1,0,1,0.27920371738274696
14481,703-004-5381,9875.304,3,3,0,1.2299650837345912
146,703-004-5395,4511.873,4,0,4,0.27920371738274696
14619,703-004-5389,449.22827,3,0,3,0.27920371738274696
15043,703-004-5381,2122.2986,5,1,4,0.5169146537385478
1510,703-004-5397,4538.981,3,2,1,1.507656848863606
1530,703-004-5399,6790.291,3,2,1,0.4264281283958751
15663,703-004-5383,405.9738,5,2,3,1.310715129932224
15732,703-004-5393,5123.3755,2,1,1,1.1837831851841527
15739,703-004-5382,593.33386,5,0,5,0.27920371738274696
16109,703-004-5385,2028.203,5,1,4,0.3978652972704144
16434,703-004-5380,6529.3213,5,3,2,2.7875784208408336
16651,207-008-2398,3218.7742,4,1,3,0.7202436556752083
16933,207-008-2398,1389.2859,5,2,3,1.8200904151052526
17137,703-004-5381,9330.245,2,1,1,0.3807252912866403
17328,703-004-5383,1645.1454,2,1,1,0.5126132408904909
17465,703-004-5386,7215.9917,1,0,1,0.27920371738274696
17556,703-004-5396,8695.426,1,0,1,0.27920371738274696
17658,207-008-2398,4135.138,7,2,5,1.3830390319599224
17897,703-004-5381,8916.543,4,3,1,1.062141964369976
18008,703-004-5388,9812.153,3,2,1,0.700981975345913
18069,703-004-5383,6042.2,6,6,0,3.059326897132567
18086,703-004-5394,4647.3623,5,2,3,0.5631599767615532
18433,703-004-5384,5190.348,6,2,4,0.5206501335535744
18657,703-004-5385,8314.103,5,4,1,1.6704879489214202
18820,207-008-2399,7844.751,7,5,2,6.585136615529771
19109,703-004-5398,5086.137,5,3,2,1.2297592411408087
1911,703-004-5382,7897.446,4,4,0,0.9353946835711686
19186,207-008-2398,8456.944,4,3,1,1.5142475801715818
1926,703-004-5399,1606.9395,1,0,1,0.27920371738274696
19266,703-004-5383,2053.849,4,2,2,0.8598565098040427
19321,703-004-5397,1359.4586,4,4,0,3.116609296834979
1938,703-004-5381,8757.937,2,2,0,0.5643085729155963
19519,207-008-2399,1866.0331,2,2,0,0.5154339674555456
19579,703-004-5392,3494.2073,7,0,7,0.27920371738274696
19691,703-004-5385,8451.823,7,3,4,0.7753434050071386
19749,703-004-5388,1779.7726,2,2,0,1.4532430438067687
19814,703-004-5384,4732.5303,4,3,1,0.9133980167979416
1988,703-004-5384,3890.7517,6,3,3,1.148763357328462
20134,703-004-5382,4455.3765,3,2,1,0.9746710874232246
20273,703-004-5394,4936.327,3,2,1,0.7629435906842549
20537,703-004-5390,2504.5151,3,2,1,0.9120534932939318
20796,207-008-2399,3986.2693,7,5,2,1.8266016908485156
20894,703-004-5392,4934.9155,8,3,5,2.075538294499104
2100,703-004-5386,6982.8286,1,1,0,0.49789853289742514
21006,207-008-2399,500.6236,4,1,3,0.37193838513106503
2113,703-004-5388,4655.0957,3,2,1,0.5024952895247525
21144,703-004-5392,8701.384,3,1,2,0.7261451891144374
2126,703-004-5399,2549.426,4,2,2,0.43830290347556217
2156,703-004-5399,4983.879,2,1,1,0.4314860782385869
2188,703-004-5384,4264.307,1,1,0,0.35831143730785864
21920,703-004-5398,4122.706,2,1,1,0.33853450732658075
22086,207-008-2399,5548.407,"","","",0.27920371738274696
22186,703-004-5392,6457.116,3,2,1,0.4876824098694553
22291,703-004-5383,74.63574,6,3,3,0.6374097464818986
22309,703-004-5388,3089.9167,4,1,3,0.4577519890020569
22349,703-004-5385,8431.366,4,3,1,4.423544606751098
22785,703-004-5393,9854.184,4,4,0,1.1961229561876991
23100,703-004-5394,9341.945,3,2,1,2.470146764809536
23141,703-004-5390,2776.792,2,2,0,1.1761187663487205
23217,703-004-5380,7802.543,5,3,2,1.8171713575521184
23218,703-004-5380,2215.2024,2,1,1,0.39905191306929116
23232,703-004-5385,7955.459,4,2,2,1.0180115350470431
23547,703-004-5389,1172.4841,3,2,1,0.45719608721424815
23597,703-004-5390,3694.8203,3,1,2,0.6887191180289213
23757,703-004-5388,176.80228,4,4,0,1.075734025519584
2385,703-004-5393,1117.3224,3,2,1,0.6743916634680174
23942,703-004-5383,2971.4834,4,2,2,0.81461795045589
24098,703-004-5396,3042.565,4,3,1,2.630449379019333
24258,703-004-5382,644.8603,6,4,2,1.6495607646814499
24505,703-004-5391,2927.9185,6,4,2,2.3635553379866767
250,703-004-5388,8959.843,4,3,1,2.7407985392588325
25043,703-004-5386,1718.126,2,1,1,0.3978652972704144
25152,703-004-5399,8846.693,9,4,5,1.2371471412789978
25398,703-004-5384,2453.031,3,1,2,0.3978652972704144
25484,703-004-5397,9088.061,4,3,1,0.9041375589459385
25756,703-004-5380,3151.0532,1,0,1,0.27920371738274696
25981,703-004-5399,8920.295,1,1,0,0.5323484211431042
26063,703-004-5387,2677.4038,5,1,4,1.4626433091210773
26070,703-004-5390,9361.786,5,3,2,1.0948197335922447
2654,703-004-5382,66.90025,7,1,6,0.5923627261465921
26608,703-004-5398,3273.285,"","","",0.27920371738274696
26713,207-008-2398,6809.3296,4,1,3,0.35831143730785864
26941,703-004-5388,1368.7723,4,1,3,0.35831143730785864
27179,703-004-5383,4391.3003,1,1,0,0.35831143730785864
27515,703-004-5388,3747.6003,5,3,2,1.3258173940067213
27679,703-004-5397,2234.4958,4,1,3,0.7661253869566866
27760,703-004-5382,7737.006,7,4,3,3.119935051586287
28082,207-008-2398,795.1319,7,3,4,0.7772360736237742
28151,703-004-5396,5747.9937,6,5,1,1.9413829078591915
28216,703-004-5387,5171.165,4,3,1,0.7279252691260611
28566,703-004-5382,3735.8333,2,1,1,0.32666834933781397
28671,207-008-2398,4814.5845,6,3,3,0.7482855779395178
28868,703-004-5393,8528.925,7,4,3,3.2145393568966107
2889,703-004-5399,98.51337,5,1,4,0.6011413442112655
28965,703-004-5390,7297.71,4,2,2,1.0937538500041257
29124,703-004-5387,6552.0264,5,2,3,0.5826746075762955
2913,703-004-5386,1256.1571,2,1,1,0.4187427901947257
29465,703-004-5386,541.6781,3,1,2,0.8492721859238116
29557,703-004-5386,9001.05,5,3,2,1.9231567348886611
29584,703-004-5389,3787.5444,5,4,1,2.7332365193159047
29631,703-004-5397,492.17105,7,1,6,0.5985508592651896
29632,703-004-5389,5506.954,3,2,1,0.6009249258531854
30056,703-004-5399,7403.105,3,1,2,0.4824997430212705
30148,703-004-5395,6131.6245,8,5,3,2.2209553610979325
30525,703-004-5394,4196.6284,5,4,1,1.441534382857355
3087,703-004-5398,1246.9423,3,1,2,0.382920876276071
30885,703-004-5395,2442.8965,6,3,3,0.5639915091131489
310,207-008-2398,2408.8542,7,3,4,1.0165601512182314
31009,703-004-5380,6593.5034,2,1,1,1.295360908461852
3148,703-004-5396,6375.1084,1,0,1,0.27920371738274696
31539,703-004-5393,7676.086,6,2,4,0.9552568632690244
31619,703-004-5383,9958.517,6,2,4,1.740911714038957
31638,703-004-5392,4521.118,3,3,0,1.2900659640263947
31767,703-004-5398,8319.371,4,3,1,1.349745486330098
32171,703-004-5380,5381.088,4,2,2,0.6135973119687662
32381,703-004-5382,3916.126,5,2,3,0.8177636451779142
33243,703-004-5392,6933.937,1,1,0,0.7859717726354218
33338,207-008-2399,1897.785,4,1,3,0.33853450732658075
33818,703-004-5396,9760.19,5,4,1,1.4952069758976207
33911,703-004-5390,3954.5352,4,3,1,1.12540591408713
3395,703-004-5385,4844.4087,5,3,2,1.5862260700235864
34073,703-004-5396,651.0359,3,1,2,0.33853450732658075
34376,703-004-5395,172.6991,4,1,3,0.8088811847795159
34764,703-004-5390,7684.7065,4,1,3,0.5082223063927692
34831,703-004-5395,8887.59,5,3,2,0.8003558080917825
3544,703-004-5382,6475.5195,6,3,3,1.1497108602068065
35516,703-004-5394,1791.3711,4,2,2,0.6632553390474012
35724,703-004-5387,1161.0789,5,3,2,0.8117472469312299
35760,703-004-5394,2559.852,4,2,2,0.9378262405173382
35917,703-004-5392,2434.6965,3,1,2,0.4151697337513789
36264,207-008-2399,7376.536,9,8,1,1.611172050765966
36356,703-004-5381,8812.938,3,2,1,0.8607971834215361
3636,703-004-5392,3679.3542,4,2,2,0.5164279925081755
36683,703-004-5392,3007.683,2,1,1,0.44632568835780284
36794,703-004-5396,5206.349,2,1,1,0.3978652972704144
3727,703-004-5398,321.19333,4,3,1,0.8770945370621256
37325,703-004-5397,570.93384,3,1,2,0.3705334289347922
37355,703-004-5380,608.51276,4,1,3,1.186350483278567
37401,703-004-5383,8744.001,3,3,0,1.5870752777326036
37905,207-008-2399,3501.933,2,1,1,0.9824145651435503
38113,207-008-2399,1421.7496,4,2,2,0.5908717636941258
38370,703-004-5391,6697.3613,5,5,0,2.632945111493496
38741,703-004-5398,1413.8424,3,3,0,1.1321747635896824
38778,703-004-5391,1916.2161,2,1,1,0.9432901795384303
38822,703-004-5393,1026.4814,"","","",0.27920371738274696
39093,703-004-5380,595.24536,4,1,3,0.3299645043346936
39167,703-004-5380,2346.3489,3,1,2,0.47143795352820167
3927,703-004-5384,636.1932,3,1,2,0.6453697842748078
39446,703-004-5396,1671.0758,6,2,4,0.7876606829039996
39468,703-004-5385,4938.936,1,1,0,0.3978652972704144
39649,703-004-5396,2345.8594,7,5,2,3.6587801194721026
39696,703-004-5380,5422.336,3,2,1,1.136751302139506
40029,703-004-5388,1180.8998,3,0,3,0.27920371738274696
40056,703-004-5397,9330.455,6,2,4,0.7224105345816353
40308,703-004-5385,4006.7297,5,3,2,1.4190863663272937
40351,703-004-5391,7130.5107,5,2,3,0.4070995414172727
40560,703-004-5389,7700.354,4,3,1,1.1690689043697395
40576,703-004-5395,9536.636,4,3,1,1.5838181718086592
40577,703-004-5386,9703.1455,2,1,1,1.6525618055265063
40895,703-004-5395,4625.8164,3,2,1,0.4470250946524481
41389,703-004-5389,2257.2976,3,1,2,0.6608701602903749
41940,703-004-5396,7617.2734,4,2,2,0.6615693152416744
41982,703-004-5396,8124.4443,5,1,4,0.5740037894680705
42090,207-008-2399,216.32672,1,0,1,0.27920371738274696
42113,703-004-5383,1065.4307,7,4,3,0.9744400918360107
42157,703-004-5390,1854.5342,4,2,2,0.6273038826184737
42281,703-004-5385,3315.639,2,0,2,0.27920371738274696
42347,703-004-5398,4148.1377,2,1,1,0.33853450732658075
4235,207-008-2398,1669.8158,4,3,1,0.8489963540731669
42564,703-004-5397,4878.487,5,3,2,1.0424579434828207
42713,207-008-2398,6570.4287,8,6,2,1.9619956809693129
42809,703-004-5392,7004.9463,2,1,1,0.3861232944531969
42859,703-004-5387,3189.7212,3,0,3,0.27920371738274696
42900,703-004-5395,7362.547,2,0,2,0.27920371738274696
43408,703-004-5393,7327.1567,"","","",0.27920371738274696
43452,703-004-5391,1976.1473,5,4,1,2.0668770562711543
43553,703-004-5390,6876.186,7,4,3,1.5981510164206683
43604,703-004-5382,6903.227,"","","",0.27920371738274696
43702,703-004-5396,4018.0308,5,1,4,0.8733726706090724
43782,703-004-5382,5469.6055,3,0,3,0.27920371738274696
44142,703-004-5392,9279.809,7,2,5,0.8170392662352081
4469,207-008-2398,6389.16,7,2,5,1.4640155188882513
44876,703-004-5389,8350.639,5,2,3,1.037846973337231
45042,703-004-5390,3691.0312,6,4,2,1.0793593652165676
45119,703-004-5395,1899.4058,5,3,2,1.4240024698666311
45261,703-004-5392,6141.8647,"","","",0.27920371738274696
45267,703-004-5390,2790.7139,3,1,2,0.3824556741187016
45623,703-004-5396,8407.559,4,3,1,1.2566076906210557
45630,703-004-5386,1958.3154,2,1,1,0.32666834933781397
45815,703-004-5386,841.794,1,0,1,0.27920371738274696
46006,207-008-2399,9771.882,4,2,2,0.958882917603858
46037,703-004-5387,5003.3154,6,3,3,1.0891781264381095
46572,703-004-5394,8157.996,2,2,0,0.8715423682057375
46577,703-004-5388,5927.0366,2,2,0,0.8166575236058509
46932,703-004-5383,6290.736,4,1,3,0.37844435202879956
47124,207-008-2399,3830.1284,1,1,0,0.3473181506045906
47162,703-004-5391,2231.471,3,1,2,0.35917976813984914
47214,703-004-5380,6771.2544,6,2,4,0.8403667536798971
47263,207-008-2399,4139.075,1,1,0,0.3978652972704144
47317,703-004-5390,6033.398,6,2,4,0.7552990873993787
47424,207-008-2399,1479.0237,2,0,2,0.27920371738274696
47539,703-004-5397,4520.106,6,3,3,1.0888941252357933
47563,703-004-5399,5847.05,4,2,2,0.8809264654776443
47847,703-004-5394,6939.153,1,1,0,0.4568697678695571
47870,703-004-5381,9977.488,3,3,0,1.515183919014473
4791,207-008-2398,368.52896,7,1,6,0.5534558552053863
4814,703-004-5399,7603.4595,3,0,3,0.27920371738274696
48387,703-004-5386,2434.1733,5,4,1,2.2678458628070866
48421,703-004-5392,8387.857,3,1,2,0.62123568788773
48602,703-004-5389,3980.636,7,4,3,1.6447631789954422
48669,703-004-5384,8757.655,3,2,1,1.8290125424906836
4951,703-004-5388,9532.666,7,5,2,1.1708811754748318
49629,703-004-5390,5211.933,5,1,4,2.1694696023009667
49713,703-004-5387,3283.0793,5,2,3,1.9758808578692384
4985,703-004-5382,2463.8552,5,4,1,2.0530803680942515
49913,703-004-5397,3198.5134,5,3,2,0.8349995477553654
5219,703-004-5388,6726.7065,5,2,3,1.091061052426351
5621,703-004-5397,5468.221,4,1,3,0.4230808829965438
5654,703-004-5397,7740.4785,4,1,3,0.6655134004997699
5936,207-008-2398,676.89777,8,3,5,1.7537714766058428
6046,703-004-5384,2116.6545,5,2,3,0.5133385063572515
6219,703-004-5398,1741.6423,4,1,3,0.5518196079013644
6399,703-004-5381,1583.9255,2,1,1,0.4514910283913928
6648,703-004-5390,6053.347,7,6,1,2.2892559522729656
7035,703-004-5390,1064.3601,"","","",0.27920371738274696
7080,703-004-5384,6149.863,2,2,0,1.461850754354901
7233,207-008-2398,5090.9097,2,0,2,0.27920371738274696
7587,703-004-5399,5582.3975,3,1,2,0.538666178510046
7687,703-004-5385,4715.473,2,2,0,0.7272785545863764
7737,703-004-5382,493.6534,5,4,1,3.3583943242790832
7814,703-004-5385,4604.49,7,3,4,0.8609038871929855
8490,703-004-5386,1306.7609,4,1,3,1.8644109160639162
8683,703-004-5392,7884.1885,2,0,2,0.27920371738274696
9033,703-004-5390,7026.7837,6,3,3,0.8089387277755021
9076,703-004-5388,8709.567,5,4,1,1.0447607899853992
9119,703-004-5393,49.157143,1,1,0,0.6592586601530325
9171,703-004-5386,2915.4216,5,3,2,3.1106680705407554
9367,703-004-5392,8579.863,2,1,1,0.6376613799881111
9415,703-004-5380,3323.568,9,6,3,2.38548992139402
9425,207-008-2399,5842.2095,4,2,2,0.44298526196529936
9484,703-004-5388,5761.217,3,2,1,1.121161431972273
9602,703-004-5383,9256.472,6,3,3,1.0544115924208268
9661,703-004-5386,3184.5903,5,1,4,0.3959931727920479
9706,703-004-5393,263.5014,8,4,4,1.6971508984932944
9742,703-004-5383,1981.7251,2,1,1,0.8764231395203456
9915,703-004-5391,6661.727,5,3,2,0.6189831170132779
10009,703-004-5380,7719.2036,3,2,1,0.9885981028741894
10447,703-004-5399,7092.471,4,1,3,0.3978652972704144
10470,703-004-5397,7213.9795,5,3,2,0.8820834515116478
10534,703-004-5395,1937.3739,6,4,2,1.726821979399475
10709,703-004-5398,8328.764,1,0,1,0.27920371738274696
1109,703-004-5392,7593.03,2,1,1,0.4791576180399298
11143,703-004-5384,4093.0469,4,2,2,0.8896215036181231
11490,703-004-5381,8886.298,7,4,3,0.978140167870538
11754,703-004-5393,3445.0173,6,3,3,0.7318098242592237
11837,703-004-5394,4335.736,4,2,2,0.8426352679293669
12347,703-004-5396,8177.312,2,1,1,0.5383132081235301
12518,703-004-5382,2353.5376,2,1,1,0.3624893137664036
1252,207-008-2398,120.819214,4,1,3,0.36459361443235794
12968,703-004-5391,2566.9856,5,2,3,0.8641318477916161
12970,703-004-5385,7290.8604,11,3,8,0.9105492334424035
13060,703-004-5386,8415.042,3,2,1,0.7413643827675434
13204,703-004-5394,2496.7183,3,1,2,0.6070661059462822
1347,703-004-5398,739.8135,5,3,2,1.5287665740621765
13808,703-004-5391,973.01605,9,4,5,1.3715820117370385
13847,703-004-5394,9785.621,5,4,1,1.1895996188878772
13921,703-004-5394,3927.3274,7,4,3,1.037825106240407
14150,703-004-5385,1057.4078,6,1,5,0.6772287951145265
14269,207-008-2398,3221.0737,5,1,4,0.4590130926562781
14300,703-004-5394,773.40784,5,2,3,0.9271679200092375
14309,703-004-5387,5844.326,5,2,3,0.9385477766667005
14382,703-004-5380,817.6869,3,1,2,0.45969601476969413
14636,703-004-5398,5085.9424,5,5,0,2.112403373743164
14653,703-004-5399,6482.353,2,1,1,0.3694239440086507
14797,703-004-5387,4213.2007,7,3,4,1.5778459515019787
15250,703-004-5398,3390.971,4,2,2,0.5749477628944965
15586,703-004-5395,3911.4666,6,5,1,1.3682780480048533
15936,703-004-5395,8349.135,3,1,2,1.4032556442554471
16170,703-004-5384,2558.7542,5,1,4,0.5733337823776293
16244,703-004-5389,2699.3828,4,3,1,1.9473528631043704
16399,703-004-5389,9190.207,5,4,1,1.186784580291835
16421,207-008-2398,209.6486,4,2,2,0.8633614905497464
16424,703-004-5390,1067.1813,4,2,2,0.6034329873545387
16485,703-004-5398,2399.8838,6,3,3,0.68356923143876
16545,703-004-5387,6839.3755,7,4,3,1.5871502442405037
16552,703-004-5392,6082.952,4,3,1,2.4213408626166384
16734,703-004-5399,6747.5493,9,6,3,2.354173874547094
16820,703-004-5382,9368.544,3,2,1,0.9095306302135764
16903,703-004-5383,8979.274,4,1,3,0.42007759738412787
17379,703-004-5384,4022.6973,2,1,1,0.6382840654096746
17482,703-004-5396,3148.3948,3,1,2,0.9789239156611488
17655,703-004-5398,377.3391,4,2,2,0.7573739808465089
18361,703-004-5380,3460.444,5,2,3,1.1928202637678205
18370,703-004-5387,3341.2021,1,0,1,0.27920371738274696
18718,703-004-5384,7073.723,4,1,3,0.5165268771580819
18993,703-004-5393,2821.8137,2,1,1,0.33853450732658075
1918,703-004-5384,247.11072,5,2,3,0.8800727893722393
20022,703-004-5397,8760.143,3,2,1,0.7865270763680262
2019,703-004-5394,3484.4429,2,1,1,2.068570822695484
20385,207-008-2399,2900.5254,5,2,3,1.0670321658793755
20768,703-004-5391,9330.2295,1,1,0,1.8025947717534831
21178,703-004-5392,1204.9377,2,0,2,0.27920371738274696
21223,703-004-5398,1697.2828,3,1,2,0.41684046213303505
21406,703-004-5391,6076.1167,4,2,2,0.6453751420726008
21575,703-004-5391,6014.655,1,1,0,0.5340539107163927
21619,703-004-5380,1013.59784,5,4,1,1.4581739273343701
2185,207-008-2399,9011.057,3,3,0,0.5517884691479987
22181,207-008-2399,7909.3345,3,1,2,0.4314860782385869
22226,703-004-5383,3104.4143,3,1,2,0.34721788714710256
22278,703-004-5381,6200.186,7,1,6,0.33853450732658075
22330,703-004-5387,9945.532,4,0,4,0.27920371738274696
22489,703-004-5384,9984.825,2,2,0,0.5371375621288587
22587,703-004-5392,4272.802,3,1,2,0.8816660816029456
22705,207-008-2399,2255.77,3,1,2,0.49809582255110596
22732,703-004-5382,1807.5276,5,1,4,0.3565006121564479
23076,703-004-5382,2468.062,3,2,1,2.8426682945208372
23457,703-004-5390,6524.073,4,1,3,0.35534489781066697
23526,703-004-5383,5373.0513,5,3,2,1.8434452309975524
23668,703-004-5384,1777.1072,7,4,3,2.255289796157806
23723,703-004-5387,2189.25,5,3,2,3.5317090947385585
24165,703-004-5387,7759.956,4,2,2,0.8703925028179256
24212,703-004-5382,8804.5205,7,4,3,0.8697102037020528
24345,703-004-5399,2245.949,6,3,3,1.6404916427649994
24593,703-004-5382,766.22784,2,0,2,0.27920371738274696
24767,703-004-5381,1915.9514,"","","",0.27920371738274696
25143,703-004-5396,6277.9985,7,5,2,1.8462884191191915
25230,703-004-5391,2242.5645,2,0,2,0.27920371738274696
2564,703-004-5393,1971.5321,5,2,3,0.8513479332305699
25701,207-008-2398,9353.128,4,1,3,0.47632199290070076
26078,207-008-2398,8552.541,3,2,1,2.5565068153181008
26091,703-004-5384,6186.8745,2,2,0,1.1391902589874987
26161,703-004-5395,2799.9639,4,2,2,1.0499783028918352
26199,703-004-5396,8030.3604,2,2,0,0.8041000554144566
26234,703-004-5390,3390.1626,4,3,1,1.3132169611512796
26824,703-004-5392,605.2905,3,1,2,0.4331772706675277
27369,703-004-5395,6913.076,2,2,0,0.6337955179979745
27384,703-004-5395,6627.272,4,1,3,0.43227753826269694
2758,703-004-5388,7620.6113,2,0,2,0.27920371738274696
27669,207-008-2398,8919.406,4,2,2,0.4483163254176433
27731,703-004-5394,5304.795,5,3,2,1.5480575951044213
28110,207-008-2399,291.28015,3,2,1,0.47697301719552604
28246,703-004-5395,4707.215,5,3,2,2.527497084152136
28508,703-004-5394,1149.8124,3,2,1,0.9031807501834418
28518,703-004-5397,7062.7524,2,1,1,1.1342489855280393
28570,703-004-5390,787.41907,3,2,1,1.1599531651503037
28576,703-004-5398,387.76218,5,4,1,0.8381328025101032
28902,703-004-5382,9190.7295,8,4,4,2.909465972488895
28962,703-004-5396,283.68652,2,0,2,0.27920371738274696
29021,703-004-5383,4566.0527,7,5,2,1.346509129430483
29027,703-004-5386,97.230675,3,3,0,0.6116606816250765
29214,703-004-5399,8297.278,7,3,4,1.721726158790083
29232,703-004-5393,163.56766,5,4,1,1.309368423671674
2926,703-004-5391,2290.7822,2,0,2,0.27920371738274696
29328,703-004-5380,4252.054,3,0,3,0.27920371738274696
29461,703-004-5389,7414.375,2,2,0,2.8637977736964944
29522,703-004-5389,5199.707,3,3,0,1.2927483828024648
29538,703-004-5381,4662.0776,2,2,0,1.685650718475316
29747,703-004-5382,2214.945,8,5,3,1.855659582368526
30554,703-004-5395,9713.522,2,1,1,0.5997365866652077
30745,703-004-5387,1639.4169,4,2,2,0.8012371862714083
3098,207-008-2399,126.104355,8,2,6,1.0836085670590756
31325,703-004-5396,4972.0747,4,1,3,0.45710435574209346
31341,703-004-5391,6373.07,4,1,3,0.6360654674581626
31494,703-004-5390,9271.122,5,2,3,0.6620230346445385
31656,207-008-2398,2694.5884,6,4,2,0.9485300581001902
31764,703-004-5385,270.82443,3,2,1,0.5342953071092429
32063,703-004-5382,6072.66,4,4,0,0.9546506935999001
32134,703-004-5396,2672.1484,6,4,2,1.1977288069705372
32423,703-004-5382,2653.4932,1,0,1,0.27920371738274696
32458,703-004-5396,1426.1687,6,3,3,1.2649486339613971
32565,703-004-5392,1040.6232,1,1,0,0.5649836642013657
3261,703-004-5395,2227.7153,4,2,2,0.7550750158614409
32627,703-004-5394,976.0183,4,2,2,0.800698876393578
32768,703-004-5384,1767.1729,4,1,3,0.33853450732658075
33021,703-004-5394,406.9209,7,3,4,1.2598052752414013
33130,703-004-5385,9904.515,2,1,1,1.8573841930680999
33461,703-004-5381,5013.1304,5,3,2,1.8113266355621678
33493,703-004-5392,7942.8906,5,1,4,0.4508661786261988
33732,703-004-5382,317.79825,5,2,3,0.6092857832714949
33849,703-004-5388,6726.8447,4,2,2,0.9809936843168067
33916,703-004-5390,61.922073,2,1,1,0.4552115629239451
33938,703-004-5397,9498.494,4,2,2,0.5755049527600765
34202,703-004-5389,6523.09,2,1,1,0.3326390986750188
34403,703-004-5389,7509.485,4,2,2,0.577730011055276
34424,703-004-5380,3618.9531,3,2,1,1.888303723564471
34750,703-004-5391,851.48694,2,1,1,0.33853450732658075
35051,703-004-5396,2208.06,8,4,4,2.2892714225639175
3507,703-004-5392,2625.079,5,1,4,0.5803610809221839
352,207-008-2399,7603.3843,7,2,5,0.6175809365483172
35209,703-004-5385,5052.157,3,1,2,0.5656961587863778
35521,703-004-5382,1008.55054,2,2,0,1.3791562484408184
35777,703-004-5382,4443.641,3,1,2,0.6731112135267898
35961,703-004-5385,1206.3408,1,0,1,0.27920371738274696
35994,703-004-5385,8938.213,3,1,2,0.8682841037686477
36134,703-004-5387,532.1354,2,0,2,0.27920371738274696
36236,703-004-5399,7723.4697,1,0,1,0.27920371738274696
36298,703-004-5380,9617.005,9,5,4,1.6256705121295287
36431,703-004-5381,1194.2393,5,3,2,1.5488222048216174
36565,703-004-5398,9741.25,4,1,3,0.4682780501350527
36644,703-004-5395,8587.925,6,3,3,0.9897822534062192
36692,703-004-5382,9695.928,4,1,3,1.4551548282916555
36707,703-004-5399,4372.521,3,2,1,0.5383392549533236
36783,207-008-2399,3452.3452,2,1,1,0.3670132864996209
36904,703-004-5388,5873.0024,4,4,0,2.349367049192428
37055,703-004-5390,4953.405,6,5,1,1.5978096203332703
37254,703-004-5381,3527.2288,6,3,3,1.5484321734289024
37414,703-004-5388,3103.754,9,6,3,3.954377598478603
37556,703-004-5387,2282.2434,5,2,3,0.889754739529798
37725,207-008-2398,6466.3853,3,2,1,0.9305686620690116
37891,703-004-5384,9399.438,6,1,5,0.5099384300519691
379,703-004-5388,7449.7354,4,2,2,2.258599495941739
38176,703-004-5385,4809.116,7,2,5,0.5951731508225412
38195,703-004-5398,7504.367,5,3,2,1.757839367069607
38381,207-008-2399,3992.2983,6,3,3,0.5226798902688705
38390,703-004-5385,7478.276,5,3,2,1.527511874616282
38539,703-004-5392,4588.925,6,4,2,1.1247409343869712
38788,703-004-5389,7534.4634,5,1,4,0.4314821115010364
38864,703-004-5399,5955.6885,3,1,2,0.5201608880421418
39134,703-004-5394,7167.4346,5,3,2,1.1331193406589086
39326,207-008-2399,9322.493,8,4,4,1.8502825033278818
3935,703-004-5394,343.89377,2,2,0,2.2356146330013345
39622,703-004-5388,7238.267,5,3,2,2.3723555182100666
39735,703-004-5391,4185.1626,5,2,3,0.6764002393906219
39816,703-004-5385,3947.4893,3,3,0,4.051861043232584
39858,703-004-5397,1025.8854,3,1,2,0.3792997042504898
40182,703-004-5394,7776.587,10,2,8,0.7079757997643442
40237,703-004-5385,7191.878,3,2,1,0.4542013685348287
40246,703-004-5398,1172.8156,3,2,1,0.7153965033089122
40271,703-004-5385,6366.5127,4,4,0,2.4652299102496458
40407,703-004-5393,1944.9341,7,5,2,2.6459380783893534
40549,703-004-5383,7395.0527,5,3,2,1.6243916788611668
40850,703-004-5386,5975.831,9,3,6,0.8658488978470654
40876,703-004-5395,3768.3816,5,2,3,0.6620154941431298
41124,703-004-5397,7502.2085,1,0,1,0.27920371738274696
41187,207-008-2399,5550.654,4,3,1,1.548182837403031
41252,703-004-5388,4966.7017,5,3,2,0.6839191799957705
41258,703-004-5391,2360.198,5,2,3,3.7904818364321016
41399,703-004-5384,9950.613,5,4,1,1.0702636230692613
41495,703-004-5382,7649.0977,6,3,3,2.628343142876047
41600,703-004-5389,8881.338,2,2,0,1.0389796207005961
41636,703-004-5381,8800.729,2,1,1,0.8490467986112915
41720,703-004-5380,4596.816,5,4,1,5.566889234946462
42017,703-004-5387,3242.5374,2,1,1,0.6750884345246617
42161,703-004-5383,8373.552,3,1,2,0.3637500930527101
42730,703-004-5393,2305.246,4,3,1,0.6866086434354469
4289,703-004-5385,2982.9443,3,0,3,0.27920371738274696
43326,703-004-5398,9410.741,3,2,1,0.640375425119511
43598,207-008-2398,7862.1836,1,1,0,0.35446748195146627
43895,703-004-5384,348.64606,2,2,0,0.4453299292254814
44213,703-004-5392,857.3097,4,2,2,0.494700154390346
44431,703-004-5399,60.414673,6,3,3,3.1666348142565197
4449,703-004-5394,9687.338,2,0,2,0.27920371738274696
44683,703-004-5397,9730.605,3,3,0,1.2316271725869345
44803,703-004-5390,2028.1362,3,3,0,1.3912604293962256
44951,703-004-5392,7528.072,3,3,0,0.7055253924829017
45416,703-004-5395,8728.447,1,0,1,0.27920371738274696
45481,703-004-5380,6140.6196,6,4,2,2.6578984099915566
45564,703-004-5388,701.49243,4,2,2,0.7441377798388744
45668,207-008-2398,1075.5277,2,0,2,0.27920371738274696
45796,703-004-5384,8699.362,4,1,3,0.5567442415357037
46102,703-004-5387,4898.312,4,2,2,0.5003427561234028
46468,703-004-5392,110.93199,5,2,3,1.9601517689961474
46946,703-004-5388,4505.7026,3,3,0,1.1358604585577796
47013,703-004-5384,3259.694,6,2,4,0.7744348366121103
47096,703-004-5391,9017.763,8,5,3,2.593060836353175
47153,703-004-5399,2133.4636,7,3,4,1.5328681694344328
47192,703-004-5391,8511.729,4,3,1,0.7240547889993413
47204,703-004-5380,8720.476,5,2,3,1.2013724194480848
47207,703-004-5380,6011.4126,4,2,2,1.0158938180075858
47924,703-004-5397,3433.1519,4,1,3,0.9067422513030051
47994,703-004-5396,5412.2017,3,3,0,1.2177591754267063
48362,703-004-5383,8845.022,2,1,1,0.49759878879794595
48403,703-004-5389,5748.9673,6,2,4,0.9127060903932747
48475,703-004-5385,7934.9854,"","","",0.27920371738274696
48787,703-004-5380,7671.7266,3,1,2,0.3978652972704144
49334,703-004-5388,5834.6763,3,2,1,1.2328290151954269
49357,703-004-5394,2914.8943,3,2,1,0.6183557006103538
49549,703-004-5389,9363.197,4,2,2,0.6165921394104771
49725,703-004-5396,7515.429,3,1,2,1.2465150603883224
4974,207-008-2398,9868.431,3,0,3,0.27920371738274696
49811,703-004-5390,9136.521,3,3,0,1.2935481687049124
49889,703-004-5380,2500.779,10,6,4,1.40221043010932
4995,207-008-2399,9167.238,4,1,3,1.4576153022555707
5022,703-004-5385,6980.0054,5,4,1,2.695560541643425
5553,703-004-5393,3729.0173,1,1,0,1.03910574134495
559,703-004-5387,7943.6694,1,1,0,0.40156447188095895
5599,703-004-5394,8424.624,4,1,3,0.5404581441242333
5857,703-004-5395,1871.097,4,0,4,0.27920371738274696
6329,703-004-5394,6433.8027,2,2,0,0.7622812682392287
6458,703-004-5396,6241.92,1,1,0,0.3978652972704144
6512,703-004-5387,7313.4517,4,1,3,0.40543572748668766
6517,703-004-5387,6762.1655,4,1,3,0.5705645084359628
6717,703-004-5387,5029.4775,"","","",0.27920371738274696
7161,703-004-5380,2202.248,4,2,2,0.9863195160165334
7207,703-004-5385,61.247944,11,7,4,1.8541200354502558
7215,703-004-5388,6587.2163,4,1,3,1.9818883554831213
7267,703-004-5387,4444.3555,4,0,4,0.27920371738274696
7530,703-004-5380,7724.9883,5,4,1,2.101180401624522
7643,703-004-5384,8827.695,1,0,1,0.27920371738274696
7664,703-004-5399,4663.3877,2,2,0,1.10890963115993
782,703-004-5395,9292.247,4,3,1,0.8053994185924458
7824,703-004-5391,1242.6573,5,4,1,0.7349638819130287
8431,703-004-5383,7908.8516,5,5,0,1.2509733115814372
8462,703-004-5393,7667.033,5,4,1,1.9790484617001174
8553,703-004-5387,8886.82,1,1,0,0.9224038153336517
8718,703-004-5399,1826.0217,5,2,3,1.5803367758370943
9154,703-004-5398,5489.105,5,2,3,0.5087479513654459
9368,703-004-5398,7837.456,7,2,5,0.4272834806175653
9683,703-004-5391,5973.0605,5,2,3,1.0428073792437649
9718,207-008-2398,6320.601,4,1,3,0.9804443440401082
9995,703-004-5380,1214.3881,4,2,2,0.9873707546691067
10154,703-004-5399,2761.1287,1,0,1,0.27920371738274696
10688,703-004-5388,214.89621,2,0,2,0.27920371738274696
1069,703-004-5385,550.80536,4,2,2,0.43445261773577853
10955,703-004-5391,8450.389,6,2,4,0.7253058917192136
1105,703-004-5394,8924.1,5,3,2,3.3016022644592247
11222,703-004-5390,8670.11,5,3,2,0.8416206350542356
1148,703-004-5383,1300.5161,2,0,2,0.27920371738274696
11493,703-004-5394,879.97797,2,0,2,0.27920371738274696
11526,703-004-5389,9412.016,6,3,3,0.86303811188748
11703,703-004-5386,4694.6978,3,2,1,0.9067685557036546
11743,703-004-5398,1994.1628,3,1,2,0.7629487731318993
11771,703-004-5388,319.60248,2,2,0,0.6798936589819838
11774,703-004-5387,654.245,3,2,1,0.8449451989330509
11778,207-008-2399,5467.257,4,3,1,1.3819205738020297
11939,703-004-5383,7590.534,3,2,1,2.2706576979840456
12129,703-004-5398,9869.014,3,2,1,0.763627608279369
12477,703-004-5384,4826.8013,1,1,0,1.0397342595748813
12513,703-004-5397,4013.0718,6,1,5,1.680907243203222
12873,703-004-5398,7762.692,6,2,4,0.78201803637582
12896,703-004-5395,5464.427,1,1,0,0.45850054771347565
12997,703-004-5381,5570.0254,4,3,1,1.2267862060684158
13023,703-004-5395,5332.824,4,2,2,0.8914086245014323
13168,703-004-5380,3606.3748,7,4,3,1.4117690817178152
13262,703-004-5388,5440.525,2,0,2,0.27920371738274696
13893,703-004-5391,5153.2524,5,2,3,2.0276080672743033
14019,703-004-5398,5693.4355,1,0,1,0.27920371738274696
14188,703-004-5394,6956.816,6,2,4,1.7874648046077923
14764,703-004-5383,3797.5537,4,3,1,1.4109577221613367
15346,703-004-5391,825.9082,4,3,1,1.9065061348846404
15432,703-004-5396,6059.7964,1,1,0,0.5006089099067916
15434,703-004-5394,7939.963,3,1,2,0.5415586143285012
15727,703-004-5380,2939.7207,4,2,2,1.2418306719393875
16157,703-004-5399,3167.754,1,1,0,0.5975917934716591
16355,703-004-5383,4452.9683,3,0,3,0.27920371738274696
16578,703-004-5395,1826.1779,6,3,3,0.9259112298928509
16634,703-004-5386,7099.8384,3,3,0,1.669830194082728
16891,703-004-5399,3330.6294,1,0,1,0.27920371738274696
17346,207-008-2399,5956.4453,3,1,2,0.3816811762357354
17500,703-004-5380,4888.0933,3,1,2,0.39405506899598897
17533,703-004-5392,8345.194,4,3,1,1.621676662897652
17615,703-004-5392,9643.285,"","","",0.27920371738274696
18019,703-004-5382,1904.9597,4,3,1,1.3770865050952952
18082,207-008-2398,7140.151,6,4,2,1.2334040310905159
18180,207-008-2399,869.93634,8,4,4,1.9214617426631428
18515,207-008-2398,7842.5728,9,5,4,1.5571444664248528
18798,703-004-5390,2364.2534,"","","",0.27920371738274696
18959,703-004-5391,69.68498,3,2,1,0.8423175521410884
19224,703-004-5388,905.7772,8,4,4,1.7648964744895244
19275,207-008-2398,4157.917,"","","",0.27920371738274696
19307,703-004-5398,1075.6749,9,5,4,2.047333544166471
19469,207-008-2398,8864.419,5,1,4,0.35831143730785864
19793,703-004-5396,8585.286,3,1,2,0.32666834933781397
19855,703-004-5398,1974.259,5,2,3,1.2193060941843135
19946,703-004-5393,8188.6953,4,3,1,1.2876175523001872
20213,703-004-5388,5311.9688,2,0,2,0.27920371738274696
20257,703-004-5396,475.5366,2,1,1,0.5502582293178019
20337,703-004-5398,9776.483,4,0,4,0.27920371738274696
20493,703-004-5393,1660.583,4,1,3,1.638176980442383
20631,703-004-5392,3116.0247,7,5,2,2.382114027054487
20762,207-008-2399,4054.4033,5,4,1,2.1001830058762767
20766,703-004-5384,898.0912,7,5,2,2.909259436845233
21176,703-004-5396,9689.9375,4,4,0,1.0703444819541315
22013,703-004-5381,3047.7947,8,4,4,1.3671369798679196
22064,703-004-5381,130.09846,3,2,1,0.6391795940270409
22156,703-004-5389,9922.534,4,3,1,2.769226100280481
22296,207-008-2399,7441.6904,5,2,3,0.9114874497446194
22476,703-004-5392,4331.2617,2,2,0,1.698798617464261
22714,703-004-5387,2414.4436,3,3,0,0.9421854538042336
22863,703-004-5389,8012.191,6,4,2,0.9798945553031506
22880,703-004-5381,5031.122,3,1,2,1.7328590445790912
22918,703-004-5384,8639.747,3,2,1,0.8581958078384967
22977,703-004-5398,3466.1968,3,2,1,1.1092421511747201
22979,703-004-5384,8749.915,6,4,2,1.1657296002434174
22988,703-004-5396,8157.651,2,1,1,0.5383716564217886
23320,703-004-5396,213.57834,7,3,4,1.6760118847367658
23373,703-004-5380,2804.5427,6,3,3,1.9485593807217692
23517,703-004-5390,2161.9666,4,2,2,0.7383781974996902
23754,703-004-5397,2509.3591,2,2,0,0.5176590937957282
23807,703-004-5384,5129.599,4,2,2,0.7544336967375539
23922,703-004-5383,4362.1714,4,0,4,0.27920371738274696
24019,703-004-5388,8590.742,4,1,3,2.121713876911406
2422,703-004-5390,2011.3104,5,3,2,1.0569691154146221
24336,703-004-5383,5292.7153,3,3,0,2.174363039728712
24552,703-004-5385,8784.524,10,2,8,0.6123245839583977
24584,703-004-5381,3736.4739,8,5,3,1.5015755037502432
25111,703-004-5399,3485.2551,3,1,2,0.42450933213034947
25140,703-004-5391,43.75696,3,2,1,1.0561549320064771
25251,703-004-5397,7872.333,5,2,3,0.8290323402641107
25357,703-004-5396,2577.9802,7,4,3,0.8667558819858172
2579,703-004-5387,2152.4841,6,2,4,0.8236128319470687
25829,703-004-5392,7376.3047,4,3,1,0.9876357392245397
25914,703-004-5399,101.30107,5,1,4,0.3637500930527101
26485,703-004-5384,9402.743,6,2,4,1.7097686665311167
26781,703-004-5393,884.7332,3,1,2,0.3978652972704144
26792,703-004-5388,4301.3687,4,2,2,0.49637166734616217
26901,703-004-5383,2081.8608,7,4,3,1.8880663758835132
26980,703-004-5386,3216.6152,5,4,1,1.1991552965698793
27280,703-004-5389,6474.1665,6,5,1,2.4794358193261545
27421,703-004-5383,2104.6853,7,4,3,1.490878597949094
27580,703-004-5396,7362.9053,1,1,0,0.4570655337251608
27582,703-004-5383,7534.7837,3,0,3,0.27920371738274696
27584,703-004-5385,5758.0435,7,3,4,0.9589913942600228
28013,703-004-5388,1629.1398,1,0,1,0.27920371738274696
28315,703-004-5391,2507.9119,4,3,1,1.4188809317074356
2851,703-004-5382,5316.248,3,1,2,0.4007649969245601
28614,703-004-5392,5462.833,2,1,1,1.2511742200885536
28663,703-004-5392,5780.113,4,2,2,1.1214744186670438
28727,703-004-5391,8344.245,2,1,1,0.35831143730785864
28874,703-004-5395,107.932686,4,1,3,0.40664429177530864
28918,703-004-5385,4616.546,7,3,4,1.6114902114643679
29187,703-004-5387,5639.2593,2,1,1,0.41049979195030195
29418,703-004-5394,9258.33,2,1,1,0.3978652972704144
29671,703-004-5389,3898.974,2,1,1,0.7173981649322514
29691,703-004-5390,9967.479,6,2,4,0.45719608721424815
29767,703-004-5397,5028.892,7,2,5,0.5105937981636984
29770,703-004-5382,654.20685,"","","",0.27920371738274696
29793,703-004-5385,6839.6484,5,2,3,1.1477796958459374
29889,207-008-2399,639.351,3,0,3,0.27920371738274696
30004,703-004-5391,6825.1567,8,6,2,2.8813667552194238
30073,703-004-5382,1941.1647,2,2,0,1.907378935121028
3008,703-004-5390,2723.4202,"","","",0.27920371738274696
30308,703-004-5388,9511.904,4,2,2,0.9142464876943663
30559,703-004-5382,2143.8027,4,3,1,0.8544437804228282
31035,703-004-5390,1040.3829,3,3,0,1.8060688653173693
31106,703-004-5387,646.9506,7,4,3,0.7747651057638528
31315,703-004-5381,8075.4624,5,2,3,1.4599289544407918
3177,703-004-5381,9104.989,4,3,1,0.7337804184527879
32001,703-004-5393,7042.392,7,3,4,0.7457181645315674
32054,703-004-5392,5366.239,2,1,1,0.5929183593560774
32353,703-004-5388,7270.694,6,3,3,1.7676711322869307
32863,207-008-2399,3183.1038,4,1,3,0.855336634033398
33299,703-004-5382,3094.2786,7,3,4,1.047259810805984
33300,703-004-5395,3432.9092,4,2,2,0.9301299779583899
33466,207-008-2398,7718.505,6,3,3,1.4134763069998293
33661,703-004-5397,5330.9565,6,4,2,1.1781559489433604
33717,703-004-5385,3312.0007,3,2,1,0.8106706600893743
33842,703-004-5386,1580.3658,3,0,3,0.27920371738274696
33903,703-004-5380,6023.935,10,1,9,0.33853450732658075
34071,703-004-5399,1934.6285,4,1,3,1.1568826678896529
34307,703-004-5394,9421.947,6,5,1,1.7673328217562472
34308,703-004-5380,9374.254,4,0,4,0.27920371738274696
34391,703-004-5391,9310.598,2,1,1,0.3919322182760311
34431,703-004-5384,1659.8213,1,1,0,1.0539398024069788
34497,703-004-5383,7684.7734,2,2,0,0.5631199753306878
34596,703-004-5397,2451.2058,6,3,3,1.599101994204432
34672,703-004-5386,642.4284,5,2,3,0.6351884570457493
34708,703-004-5381,2211.953,5,4,1,1.9760785615381704
35067,703-004-5383,4836.9824,7,4,3,2.4679992525024033
35103,703-004-5395,9821.226,4,2,2,0.7302858162797145
35435,703-004-5395,965.6876,2,2,0,0.9078372334464478
35530,703-004-5397,3144.0693,4,0,4,0.27920371738274696
35812,207-008-2398,3677.9404,5,2,3,0.7287761858721532
35815,703-004-5399,4790.149,3,1,2,0.3317114664830398
35964,703-004-5399,3373.0542,4,2,2,0.864064818103408
36090,703-004-5384,3739.041,1,1,0,0.50815335597802
36259,703-004-5381,2932.3142,4,1,3,0.3661643545787207
36297,703-004-5387,2706.9712,3,1,2,2.0429218074879616
36305,703-004-5384,5840.0356,7,2,5,0.6906948004333257
36764,703-004-5380,1024.363,4,1,3,0.5328011802317931
36818,703-004-5395,84.651115,8,4,4,0.7796632918820572
37075,703-004-5389,4315.2466,5,4,1,1.8038735198961213
37093,703-004-5381,7302.8867,4,1,3,1.064024484834286
37153,207-008-2398,7691.046,4,1,3,0.4957496908268324
37162,703-004-5382,2192.6707,1,0,1,0.27920371738274696
37288,703-004-5396,4039.8674,3,2,1,0.5102676103162405
37345,703-004-5389,5672.0977,5,3,2,0.7021645378660575
37354,703-004-5383,7994.38,4,2,2,1.076373781188432
37356,207-008-2398,7238.7515,6,4,2,1.1989403776961334
37528,703-004-5399,5535.3423,9,3,6,0.7374459353280772
37562,703-004-5388,1821.4065,7,4,3,2.5463150200553684
37585,703-004-5390,9230.626,3,2,1,1.1282073352589355
37595,703-004-5393,8943.086,5,4,1,1.090288066740352
37596,703-004-5387,8242.311,1,0,1,0.27920371738274696
37623,703-004-5390,518.0025,4,1,3,0.5342587992581095
37681,703-004-5380,1592.9847,1,1,0,0.3978652972704144
38241,703-004-5395,820.2541,2,0,2,0.27920371738274696
38264,703-004-5386,9710.6455,1,1,0,0.9351042068378368
38580,703-004-5390,7060.59,2,2,0,0.7853523617478425
38659,703-004-5392,1201.719,5,3,2,0.8228649745501657
38939,703-004-5381,9423.768,7,3,4,1.1566763611646114
38946,703-004-5386,2279.588,"","","",0.27920371738274696
38965,703-004-5380,1073.7085,2,2,0,0.7973128138638618
39009,703-004-5385,9116.088,5,1,4,0.3950907834649872
39105,703-004-5388,7090.1113,6,3,3,1.1119070507109778
39668,703-004-5383,3060.4285,5,2,3,1.450089036195724
3994,703-004-5398,3889.091,3,0,3,0.27920371738274696
40151,703-004-5397,5372.682,10,2,8,0.8716921961761669
4022,703-004-5391,2115.4475,1,0,1,0.27920371738274696
40493,703-004-5388,5493.915,3,2,1,0.8827011157284683
40749,703-004-5394,7791.7417,5,3,2,1.854119939594821
41017,703-004-5399,1053.2212,3,1,2,0.33853450732658075
41505,703-004-5390,6241.203,4,1,3,1.287642284265519
41920,703-004-5389,7347.4316,7,4,3,0.7165368591260424
41939,703-004-5392,4091.273,4,2,2,0.6599263678220486
4202,703-004-5395,3543.9575,2,0,2,0.27920371738274696
42054,703-004-5381,5426.0933,4,2,2,1.0926517828687872
42147,703-004-5394,9860.159,5,3,2,2.805165491719542
42380,703-004-5391,1979.3302,2,0,2,0.27920371738274696
42466,703-004-5396,1612.4368,2,1,1,0.40498545558547094
42784,703-004-5389,5664.254,7,3,4,1.6239679070845296
42840,703-004-5380,19.456148,4,3,1,1.8373740859800671
4285,703-004-5396,2097.4583,4,3,1,1.3185654192412615
42850,703-004-5389,4118.9565,3,1,2,0.6351239305791985
42957,703-004-5389,36.470295,2,0,2,0.27920371738274696
42983,703-004-5384,8690.133,1,0,1,0.27920371738274696
43142,703-004-5392,5168.091,3,2,1,0.5643870477127745
43295,703-004-5384,4196.3496,3,3,0,1.2024286407150009
43306,703-004-5393,1101.9749,6,6,0,2.1343006267680664
436,703-004-5399,690.0352,6,4,2,3.021168335521678
43815,703-004-5393,7558.909,6,3,3,1.5368003346950467
43886,703-004-5387,5151.319,3,2,1,1.4451055950943335
43894,703-004-5392,4551.0103,3,2,1,1.2405802523140868
44101,703-004-5385,3000.9307,1,0,1,0.27920371738274696
44169,207-008-2398,7085.026,2,0,2,0.27920371738274696
44870,703-004-5381,2872.2607,3,1,2,0.3978652972704144
44872,703-004-5394,9359.127,7,6,1,1.537922687834181
44923,703-004-5383,3867.5332,4,4,0,2.6919596816617166
45301,703-004-5391,7015.1665,4,2,2,1.5567433607274848
45395,703-004-5388,180.65096,7,2,5,0.6637059785431761
45403,703-004-5395,722.1222,2,2,0,0.6263844950948193
45549,703-004-5388,4885.3906,3,3,0,1.2102750159194477
45602,207-008-2399,8744.991,5,4,1,0.9573300752716667
4605,703-004-5394,9093.132,3,2,1,1.6322918104912543
46412,207-008-2398,6158.4746,6,3,3,1.0933064066290306
46948,703-004-5380,4057.9922,2,1,1,0.5256723734140115
46959,207-008-2399,3343.5469,2,0,2,0.27920371738274696
47031,703-004-5389,4234.618,3,2,1,1.0311052644048246
47139,703-004-5393,2423.3616,4,1,3,0.5165268771580819
47147,703-004-5383,7429.89,4,0,4,0.27920371738274696
4735,703-004-5380,9401.21,2,1,1,0.4117173369614541
47547,703-004-5390,9339.31,5,1,4,0.6998669164174102
47594,703-004-5384,9667.357,4,1,3,0.7822416771829277
47802,703-004-5380,8782.878,5,3,2,1.782358090145824
47988,703-004-5394,6107.23,3,1,2,1.274599634545043
48032,703-004-5387,5898.327,4,2,2,0.5828242309235294
48109,703-004-5399,5903.074,2,1,1,1.697649364836424
48636,703-004-5386,2290.2764,6,4,2,2.337589793058424
48801,703-004-5386,5844.632,3,1,2,0.5323484211431042
48869,207-008-2398,989.08545,7,4,3,1.7808502127627313
49026,703-004-5399,684.47235,4,2,2,3.16692369736224
49216,703-004-5389,7926.2676,5,4,1,0.7979491208334653
49346,703-004-5388,4582.082,2,1,1,0.7150970098767694
49370,703-004-5395,5507.024,2,0,2,0.27920371738274696
49449,703-004-5380,6612.3374,4,2,2,1.9978722264944635
49451,703-004-5382,7649.063,8,5,3,2.2929827434668617
49488,207-008-2399,1738.8755,6,3,3,0.7943061870412053
49647,703-004-5387,6695.171,4,4,0,1.8332784874754748
4999,703-004-5380,8684.499,6,4,2,2.25681638315335
5055,703-004-5382,636.58594,4,4,0,1.8690028144340673
5140,703-004-5389,6066.943,1,0,1,0.27920371738274696
5172,703-004-5393,643.2736,"","","",0.27920371738274696
5184,207-008-2398,5424.912,3,0,3,0.27920371738274696
5247,703-004-5398,5561.929,3,3,0,1.8874776213002973
5295,703-004-5394,5856.278,2,2,0,1.0086451244211692
5542,703-004-5380,3928.5803,4,1,3,0.34439664482504373
5726,703-004-5396,8893.941,4,0,4,0.27920371738274696
6061,703-004-5390,7267.9917,3,1,2,0.4289428307875475
6108,703-004-5383,4760.9478,3,2,1,0.7165709779507442
6169,703-004-5380,6152.0483,4,2,2,1.5863859358219914
6211,703-004-5393,4596.994,3,2,1,1.2595795505939613
709,703-004-5387,888.3786,4,3,1,0.5238464425499652
7395,703-004-5385,9456.214,2,1,1,0.3978652972704144
7475,207-008-2398,6563.26,6,5,1,1.5506728256579343
7697,703-004-5386,5564.4966,7,2,5,1.2487837873313936
7701,703-004-5399,5828.942,3,0,3,0.27920371738274696
7726,703-004-5391,4981.4067,4,2,2,1.6689572491432518
7804,703-004-5383,3649.621,4,4,0,1.664599797468518
7855,703-004-5385,3995.099,5,3,2,1.0152615539276073
8010,703-004-5399,9381.005,1,0,1,0.27920371738274696
8097,703-004-5396,5056.0464,4,2,2,0.8333049810795532
8272,703-004-5389,9444.09,4,3,1,0.6410083961820389
8351,703-004-5386,916.78796,2,0,2,0.27920371738274696
8504,703-004-5396,669.46747,2,2,0,1.8171586528453636
8528,703-004-5392,610.24725,5,2,3,0.8423223418865587
8768,703-004-5386,8926.158,4,0,4,0.27920371738274696
901,703-004-5380,1532.966,4,2,2,0.8189556658042666
9197,703-004-5384,929.33356,4,2,2,1.270963650417157
9495,703-004-5396,5994.1626,4,1,3,0.60900260100836
9597,207-008-2399,2926.4753,6,6,0,4.6276413117402555
962,703-004-5398,46.494007,4,3,1,0.9797909992868967
9676,703-004-5389,4371.9023,3,2,1,0.7397478807287666
983,703-004-5394,7972.5156,2,2,0,1.146395686052313
10048,703-004-5385,8500.21,2,1,1,0.5771646794255966
10060,703-004-5385,4404.418,4,3,1,1.7340007563238338
10692,703-004-5386,7098.281,4,3,1,0.9731269001069345
10929,703-004-5390,279.06656,2,0,2,0.27920371738274696
10998,703-004-5389,3285.7515,5,0,5,0.27920371738274696
11098,703-004-5385,1960.712,5,1,4,0.5659595643908251
11115,703-004-5385,6059.2656,2,1,1,0.37512182779194486
12422,703-004-5387,9691.007,7,3,4,1.3010870740769631
12428,703-004-5383,168.78545,7,2,5,1.24829545994535
12897,703-004-5392,2798.5876,4,2,2,1.0056325441971319
13487,703-004-5386,2018.2246,2,1,1,0.4884148279720749
13513,703-004-5392,158.0274,4,2,2,0.9563235416618165
13588,703-004-5395,1658.1887,4,2,2,1.1743015665144059
1359,207-008-2399,5560.3496,2,1,1,0.666633615690538
13707,703-004-5397,6806.705,5,2,3,0.47591824759652457
14048,703-004-5380,7357.169,7,4,3,1.6388850974296036
14163,703-004-5383,9844.815,2,2,0,1.479185977494889
14746,703-004-5399,2102.7136,7,3,4,1.32238118338517
14840,703-004-5393,6191.287,6,4,2,3.6431759461941384
14862,207-008-2399,9910.899,3,2,1,1.023129746450299
15244,207-008-2399,1818.6945,7,3,4,0.8449360940295166
15622,703-004-5385,5772.959,3,2,1,1.3552506617658584
15747,703-004-5392,9424.618,1,0,1,0.27920371738274696
15859,703-004-5397,5407.107,6,2,4,1.7001438923845773
1661,207-008-2398,9553.302,2,2,0,0.6874322723454703
16704,703-004-5399,7063.982,4,3,1,2.5250311323994503
16724,207-008-2398,2103.5515,1,1,0,0.35831143730785864
16785,703-004-5398,6557.9106,3,2,1,1.1692441881875162
16886,207-008-2398,6143.397,2,1,1,0.6492149367480959
17115,703-004-5399,5106.915,2,0,2,0.27920371738274696
17130,703-004-5380,8607.1455,5,3,2,1.450747915192238
17291,703-004-5393,3800.139,5,1,4,0.5601538156355379
17828,703-004-5388,4528.968,5,2,3,0.6017128347123784
18255,703-004-5398,2089.7007,3,2,1,0.8273902121786718
18266,703-004-5381,2563.8557,7,6,1,1.790915137464467
18518,703-004-5384,9000.74,3,2,1,0.43445261773577853
18540,703-004-5385,5643.6,1,1,0,0.44375766329196986
18633,703-004-5399,1490.7802,6,2,4,0.8679475710619049
18822,703-004-5385,9158.203,10,2,8,0.9732660137195651
18994,703-004-5399,9351.331,"","","",0.27920371738274696
19055,703-004-5396,5137.919,5,3,2,1.0343263556607578
19153,703-004-5384,1241.2948,3,3,0,1.30932000137251
19251,703-004-5380,9939.24,3,0,3,0.27920371738274696
19472,703-004-5399,3268.8643,5,3,2,1.861627856733943
19853,703-004-5393,7345.6543,1,1,0,2.6037310073956084
20403,703-004-5394,4553.968,4,2,2,0.5748552308705417
2047,703-004-5384,9959.729,1,1,0,0.6758758315488539
20519,703-004-5384,7756.239,3,2,1,0.6906455416422691
20620,703-004-5394,5169.1855,2,2,0,2.902033641924121
20829,703-004-5393,1279.716,6,3,3,1.5077237630567508
20990,703-004-5382,1133.1433,4,2,2,1.079197304668632
21218,703-004-5381,71.46597,4,1,3,1.9998379445202055
21279,703-004-5389,6169.9937,3,2,1,1.749324521151003
21422,703-004-5393,3240.7964,3,1,2,0.5695984131064842
21754,207-008-2398,2870.5955,1,0,1,0.27920371738274696
21849,703-004-5387,9328.209,3,3,0,0.8393058608484844
21895,703-004-5388,7463.244,2,0,2,0.27920371738274696
22205,703-004-5397,2389.2998,5,3,2,1.0167444371577723
2229,703-004-5394,9972.576,2,0,2,0.27920371738274696
22334,703-004-5390,8991.4375,8,2,6,1.07923534778191
22549,703-004-5384,2020.0098,4,2,2,0.6626294437116313
22727,703-004-5389,7489.345,7,2,5,0.8360329065375954
23020,703-004-5382,168.10954,2,0,2,0.27920371738274696
23095,703-004-5389,8164.686,3,2,1,0.5531856623922973
23569,207-008-2398,180.98415,3,3,0,1.0982185809158613
23737,703-004-5399,5155.0835,6,3,3,0.9992344546002325
23755,703-004-5392,2060.9385,2,0,2,0.27920371738274696
2409,703-004-5387,510.23544,7,2,5,0.7133950145575247
24146,207-008-2399,424.97278,6,0,6,0.27920371738274696
24230,703-004-5391,3242.5476,"","","",0.27920371738274696
24893,703-004-5384,9901.107,4,1,3,0.3880353596319388
2490,703-004-5383,4854.647,2,2,0,0.9900304873649922
24947,703-004-5398,664.5316,3,1,2,0.4457749101500602
25000,207-008-2398,1346.8528,5,2,3,0.6077179810657624
25166,703-004-5397,5222.244,4,3,1,0.6808099683974257
255,703-004-5389,8431.875,1,0,1,0.27920371738274696
25735,703-004-5393,1861.4578,6,2,4,0.9186549595733973
2595,703-004-5385,1718.573,7,5,2,1.599170885976735
25950,703-004-5382,1979.599,4,1,3,0.3401166617250829
25955,703-004-5389,345.06677,4,4,0,0.9473832973158542
26237,703-004-5385,7855.786,6,4,2,0.8683390804518046
26393,703-004-5382,1784.02,3,2,1,1.3760006856123366
26651,703-004-5396,2967.4143,5,4,1,1.326951721167955
26990,703-004-5396,5273.031,4,2,2,1.2318903392107627
27231,703-004-5380,5905.086,3,2,1,1.1789274097366866
27759,703-004-5386,4398.738,6,6,0,2.185071494180213
27859,207-008-2399,1402.7458,2,0,2,0.27920371738274696
27880,703-004-5387,1478.7615,1,1,0,0.4975325002831804
27931,703-004-5392,8013.9365,5,2,3,0.6027961193630618
28042,703-004-5387,2054.3289,4,2,2,0.5970996363971619
28909,703-004-5382,7478.359,3,2,1,0.9418359056564188
28997,703-004-5383,8639.478,4,1,3,0.33457949803375336
29113,703-004-5381,5073.975,3,1,2,0.7262888750805593
29155,703-004-5382,6039.782,2,1,1,0.43472032732443144
29270,703-004-5393,3494.6155,4,2,2,0.5611270198793887
29543,703-004-5397,2279.6726,3,2,1,0.45086746962023927
29562,703-004-5384,5174.871,3,3,0,1.281986088718105
29667,703-004-5380,7823.6514,4,0,4,0.27920371738274696
29860,703-004-5382,6168.3247,5,3,2,0.9695915299472205
30034,703-004-5393,1333.2725,5,2,3,0.4963321430501744
30248,207-008-2399,9745.728,2,1,1,0.3271627725873459
30694,703-004-5391,8869.076,2,1,1,0.3401166617250829
30847,703-004-5398,2162.863,4,2,2,0.9933141459135634
30900,703-004-5393,3572.157,2,0,2,0.27920371738274696
30904,703-004-5381,2884.2937,6,4,2,3.1053757620624713
30996,703-004-5385,8142.3696,6,4,2,3.0613298388490224
31587,703-004-5386,5622.7964,3,1,2,0.4470623219109421
31636,703-004-5399,4206.0347,7,5,2,2.803475646794629
31742,703-004-5390,2192.1335,4,2,2,0.81127951072962
31806,703-004-5386,9597.971,1,0,1,0.27920371738274696
31928,703-004-5388,3478.2332,5,2,3,1.0571669363242266
32257,703-004-5385,5975.2827,3,2,1,2.068120248654205
32322,703-004-5397,9200.8,"","","",0.27920371738274696
32385,703-004-5393,1598.8076,1,0,1,0.27920371738274696
32487,703-004-5387,2403.7397,1,1,0,0.3665762163470347
32495,703-004-5388,5415.255,2,1,1,0.7322777505598069
32560,703-004-5389,3054.2446,4,4,0,1.309340227449258
32605,703-004-5388,1349.1296,3,0,3,0.27920371738274696
32711,703-004-5399,9301.073,2,0,2,0.27920371738274696
32922,703-004-5384,7986.734,1,1,0,0.35534489781066697
33060,703-004-5380,6160.526,4,2,2,0.5371115477281853
33435,703-004-5399,5572.7954,2,0,2,0.27920371738274696
33597,703-004-5398,5457.1597,3,3,0,1.312603908814178
34673,703-004-5385,393.1719,4,3,1,1.415929803800086
3483,703-004-5393,6590.2246,3,2,1,0.6216336562989986
35253,703-004-5392,7325.6626,7,5,2,1.4843597172462781
35280,207-008-2398,629.79224,6,3,3,2.011808303846312
35399,703-004-5396,3681.1155,7,2,5,0.47697301719552604
35587,703-004-5394,6305.7266,3,0,3,0.27920371738274696
35597,703-004-5382,6093.24,4,2,2,2.168346465083598
35615,703-004-5395,8723.64,2,1,1,0.33243191178950066
35781,703-004-5383,2828.8662,1,0,1,0.27920371738274696
35839,703-004-5384,7047.2207,4,1,3,0.4874276198517604
35846,703-004-5399,1546.6887,7,4,3,1.123478987202649
35909,207-008-2398,9437.039,1,1,0,0.658182223318951
36036,207-008-2399,8897.729,2,0,2,0.27920371738274696
36378,703-004-5388,252.57349,10,8,2,2.7636232184017517
36492,703-004-5381,7696.668,8,5,3,1.942124094897754
37970,703-004-5397,1462.2421,4,3,1,1.4811139701260607
38043,703-004-5397,8116.339,"","","",0.27920371738274696
38080,703-004-5383,3632.767,"","","",0.27920371738274696
38131,703-004-5397,4179.636,3,0,3,0.27920371738274696
38190,703-004-5392,5922.274,4,1,3,0.3187575773453028
38422,703-004-5383,3863.5332,3,1,2,0.3993078641332142
38445,703-004-5388,7696.823,6,3,3,1.2162674455143228
38574,703-004-5398,1590.6018,5,3,2,1.1866741081095897
38715,703-004-5387,3187.996,8,5,3,1.4735113710956813
38813,703-004-5398,4450.724,1,1,0,0.9062058375098302
38920,703-004-5395,8750.094,2,1,1,0.4907725490212672
39006,703-004-5386,4454.3667,2,1,1,0.3968590661435781
40055,703-004-5399,2309.3296,3,1,2,0.32436104083999817
40254,703-004-5398,8638.634,3,3,0,1.3709184607503393
40322,703-004-5383,5147.4814,1,1,0,0.5397551199921017
40734,703-004-5388,5654.4434,2,1,1,1.2550243406749615
41004,703-004-5399,8731.124,5,4,1,1.1258778934234355
4123,703-004-5380,3504.7817,4,3,1,1.825155686161957
41246,703-004-5386,9860.167,3,0,3,0.27920371738274696
41326,207-008-2399,3693.4292,6,1,5,0.36807237761375045
41368,703-004-5390,7320.59,3,2,1,0.5662688775364096
41391,703-004-5395,981.79755,11,6,5,1.9597719756513337
41712,703-004-5386,1209.9141,3,1,2,1.3381633814601483
4176,703-004-5383,7262.4727,6,2,4,1.4222319262698904
41838,703-004-5389,3228.8843,5,2,3,1.8239456719030824
41859,703-004-5398,7634.1445,2,2,0,0.7523721028717737
41900,703-004-5389,7407.694,4,1,3,2.309579848987648
4210,703-004-5397,3623.6602,6,4,2,3.781135908457384
42525,703-004-5384,7085.6255,5,1,4,0.41527508465165136
42822,703-004-5389,7079.143,6,5,1,1.1582215481054907
43017,703-004-5382,6016.9526,4,1,3,0.3468408179187174
43140,703-004-5392,3465.9272,6,4,2,0.964855810965685
43264,703-004-5399,731.1648,4,2,2,0.9526827409461387
43471,703-004-5399,4743.7837,1,1,0,0.4895394850111459
43549,703-004-5381,7186.8735,1,0,1,0.27920371738274696
43837,703-004-5385,5753.36,4,1,3,0.5598691754414225
44011,703-004-5383,3252.1045,3,1,2,0.5132520097049671
44130,703-004-5382,7582.7964,5,2,3,2.200380256648029
44153,703-004-5380,374.92395,7,7,0,2.954502940638561
44216,703-004-5389,7083.0425,4,1,3,0.35831143730785864
4425,703-004-5384,5290.046,4,1,3,0.43451054181943566
4467,703-004-5394,8641.1,11,4,7,4.719214655351011
44908,703-004-5392,826.2408,1,0,1,0.27920371738274696
44944,207-008-2399,2600.5066,3,0,3,0.27920371738274696
45104,703-004-5383,2447.8823,3,2,1,1.1008187005505858
45105,703-004-5382,4173.329,4,2,2,1.577520742191743
45204,703-004-5387,7369.0605,3,2,1,0.7671213868521654
45341,703-004-5390,6714.0396,3,2,1,1.513445633261914
45560,703-004-5393,2843.2285,3,1,2,0.4112983811785064
45608,207-008-2398,742.55646,3,0,3,0.27920371738274696
45716,703-004-5381,8703.839,7,3,4,0.5803502913410158
45735,703-004-5389,3285.3252,"","","",0.27920371738274696
4577,703-004-5395,3363.362,8,6,2,2.1997178309821224
45790,703-004-5390,7157.117,6,2,4,0.5076272586665069
45870,703-004-5394,8567.908,4,3,1,4.115101773647426
45874,703-004-5380,9634.122,5,5,0,1.4174461577443997
45885,703-004-5393,775.4403,5,1,4,0.46630023322519093
46689,703-004-5386,6188.334,2,2,0,1.0703774527213488
46745,703-004-5391,3520.8237,6,3,3,1.3072757124384125
46768,703-004-5397,5587.998,6,2,4,0.8455510582511938
46796,703-004-5385,6399.9756,1,0,1,0.27920371738274696
46843,703-004-5394,5481.189,6,4,2,3.0424025225126843
46909,703-004-5385,4056.03,4,2,2,0.5710290214468773
46936,703-004-5386,998.21985,4,1,3,0.8853471665877161
46938,207-008-2398,7945.4507,5,2,3,2.75167568932033
47301,207-008-2398,5260.755,6,4,2,2.4957993365390876
48229,703-004-5391,7946.26,7,1,6,0.4980785208096962
4848,703-004-5386,6117.421,3,3,0,0.9860195105970639
48766,703-004-5386,3207.9226,6,2,4,0.7335936915775639
48817,703-004-5384,5358.2847,2,0,2,0.27920371738274696
48873,207-008-2398,1250.0972,5,4,1,1.89615722697035
49040,703-004-5389,7053.723,3,1,2,0.35831143730785864
49575,703-004-5398,903.613,5,2,3,0.41764222725169237
49682,703-004-5384,6921.147,2,1,1,0.3655113260183773
49748,703-004-5381,1260.1709,1,0,1,0.27920371738274696
49756,703-004-5385,9812.624,2,1,1,2.391925096074864
49775,703-004-5392,4675.5596,2,2,0,0.6574387235816535
5547,703-004-5389,9000.105,4,2,2,0.7730432610253233
5711,703-004-5399,7453.171,3,1,2,0.690731760135698
6778,703-004-5382,4271.169,1,1,0,0.3565006121564479
6808,703-004-5395,5350.429,7,3,4,1.1424240103870733
6827,703-004-5382,1453.4956,1,0,1,0.27920371738274696
6951,703-004-5382,6761.4077,2,2,0,0.7152608473154244
698,703-004-5392,1557.6387,8,3,5,1.2715185209092712
7091,703-004-5391,9847.6,3,1,2,0.6450116758533817
7610,703-004-5389,4667.562,6,1,5,0.4720501073859889
8104,703-004-5391,7717.5156,5,1,4,0.9345434340452177
8275,703-004-5392,7638.76,7,1,6,0.5374549911269816
8612,703-004-5389,4694.4414,2,2,0,1.625484298313397
8809,703-004-5380,5844.9424,5,1,4,0.35831143730785864
8884,703-004-5380,3127.5981,7,0,7,0.27920371738274696
9263,703-004-5393,5912.694,6,4,2,0.9550001719391397
9329,703-004-5396,2159.2642,4,1,3,0.32666834933781397
9423,703-004-5397,6029.493,2,1,1,1.3639157587917674
9625,703-004-5393,4723.6494,4,4,0,1.5873914444712058
9807,703-004-5386,8056.333,1,0,1,0.27920371738274696
10377,703-004-5391,5552.63,4,2,2,0.7996446448663522
1067,703-004-5394,3891.9556,4,2,2,0.5330076521424801
10799,703-004-5390,9386.873,1,1,0,1.0465737152190104
1086,703-004-5391,2639.9941,2,2,0,0.4900337841590369
10894,703-004-5381,573.0611,2,2,0,0.7649769299779766
1119,703-004-5395,29.553772,9,5,4,1.6032723274364615
11278,703-004-5384,9451.898,5,3,2,1.1347206785571307
11797,703-004-5395,3172.847,5,2,3,1.11971648346281
11985,703-004-5383,3666.212,2,1,1,0.3565006121564479
11991,703-004-5382,3216.2476,4,2,2,0.4637554356580387
12253,207-008-2399,1497.9822,2,1,1,1.0512307274626957
1240,703-004-5386,6207.7974,4,4,0,2.3680821983853075
12547,703-004-5383,4050.1077,5,4,1,4.331946789471655
12645,703-004-5382,4237.8325,3,1,2,1.654519368936853
12708,703-004-5381,1743.8352,8,2,6,3.3969736656051928
1343,703-004-5395,8007.8755,4,1,3,0.42268358756872765
13494,703-004-5399,8307.175,4,0,4,0.27920371738274696
13568,703-004-5380,4713.0044,5,3,2,0.7413391403256578
13751,703-004-5381,8642.766,4,1,3,0.35534489781066697
13854,703-004-5398,8568.049,4,1,3,0.5165268771580819
1420,703-004-5391,7378.132,3,0,3,0.27920371738274696
14355,703-004-5386,3320.4763,2,1,1,0.47625313694420757
14531,703-004-5391,9730.853,6,2,4,1.148670881237288
14820,207-008-2398,5588.1333,3,1,2,0.3807252912866403
15030,703-004-5396,8582.396,1,0,1,0.27920371738274696
1552,703-004-5388,1844.7101,2,2,0,0.43445261773577853
15958,703-004-5388,9246.763,3,1,2,0.529270018385706
16067,703-004-5387,3073.15,1,0,1,0.27920371738274696
16071,207-008-2399,8854.05,2,1,1,1.5873639989204535
16174,703-004-5393,3716.0015,3,1,2,0.46697970446925413
16575,703-004-5389,7695.135,3,0,3,0.27920371738274696
16692,703-004-5382,9451.09,5,0,5,0.27920371738274696
16714,703-004-5388,8637.971,6,3,3,1.0397563002908103
1677,207-008-2399,5122.0376,7,2,5,1.4571389555140848
16958,703-004-5386,9425.814,3,2,1,0.9875598273063889
16981,703-004-5399,4727.5396,3,1,2,0.8046019610975946
1709,703-004-5383,8171.087,3,2,1,2.030057328858709
17266,703-004-5399,7712.5044,5,4,1,1.133569137106687
17651,703-004-5391,6302.8867,1,1,0,0.5209490718009996
17695,703-004-5384,4553.6865,7,5,2,1.7847946284525746
18169,703-004-5388,3432.6262,1,1,0,0.41832194317452814
18270,703-004-5390,8343.475,2,2,0,0.5043601867438829
18365,703-004-5396,7324.363,3,1,2,0.49369263158437243
18615,207-008-2398,5005.7227,12,7,5,1.8145669845479222
18752,703-004-5399,3827.867,3,1,2,0.6696310257067258
1912,703-004-5399,4120.059,"","","",0.27920371738274696
19457,703-004-5386,3981.8943,6,2,4,0.4520378262516952
1998,703-004-5392,5618.9507,3,1,2,1.45954725766672
20216,703-004-5392,3185.885,5,3,2,0.7489972751228091
20356,703-004-5395,8934.289,4,3,1,1.2921832590242668
20567,703-004-5397,1878.3528,7,3,4,2.452638634693688
20628,207-008-2399,6746.252,4,2,2,0.7209307451004691
21090,703-004-5387,7268.713,"","","",0.27920371738274696
21385,703-004-5382,2023.7476,7,3,4,2.684115824692279
21412,703-004-5396,1615.7585,4,2,2,1.0762246146150707
21710,703-004-5394,6130.785,5,2,3,0.8873225900655106
21804,703-004-5398,4381.211,7,1,6,0.8379006258694409
21910,207-008-2399,36.6205,4,1,3,0.5043580703376953
21930,703-004-5385,4170.043,2,1,1,0.4111557796692314
21963,703-004-5389,9435.595,7,5,2,1.465127036443174
2214,703-004-5384,388.86667,4,1,3,0.6384563659165814
22200,703-004-5390,9401.974,4,1,3,0.5137476187476713
22219,207-008-2398,7650.282,1,1,0,1.2459026203400096
225,703-004-5390,6381.259,2,2,0,0.6353996888728486
22518,703-004-5381,9270.188,1,1,0,0.32666834933781397
22663,703-004-5387,4234.3555,3,1,2,0.480446340523488
22833,703-004-5394,9913.16,4,4,0,1.4761745094153433
22903,703-004-5399,3154.18,6,4,2,1.1197749588395043
22939,703-004-5380,5159.1177,4,2,2,1.6021824325521168
23018,703-004-5399,6015.533,2,0,2,0.27920371738274696
2320,703-004-5386,1869.6898,6,4,2,2.4004125550468927
235,703-004-5385,6877.858,2,2,0,0.8963915595239577
23617,207-008-2398,1534.574,"","","",0.27920371738274696
23840,703-004-5398,9522.129,5,3,2,1.8072111675925004
23989,703-004-5380,6300.4106,4,2,2,1.1855948883064664
24525,207-008-2399,3412.63,3,2,1,0.8308743118654486
24656,703-004-5391,2677.3857,1,1,0,0.4439291292749075
24957,703-004-5398,4001.6526,7,3,4,0.8374575125158993
25201,703-004-5397,2062.5396,3,1,2,1.2429611133563898
25268,703-004-5392,5332.047,5,1,4,0.4120775189618227
25985,703-004-5391,27.371645,6,4,2,1.107489037656484
26137,703-004-5395,6326.8647,2,1,1,0.7625774824633396
27015,703-004-5397,2857.4907,1,0,1,0.27920371738274696
27042,703-004-5384,3997.0356,3,2,1,1.1170293995579736
27057,703-004-5396,7595.7163,2,1,1,0.5255170755100846
27837,207-008-2399,374.5395,1,0,1,0.27920371738274696
2786,703-004-5389,8649.451,2,1,1,0.5534653600625974
28134,703-004-5397,5505.7017,4,3,1,2.452061543619184
28402,703-004-5397,1190.4258,3,2,1,0.5607085402384107
28423,703-004-5395,7042.313,4,2,2,0.6337051436709153
28478,703-004-5381,7810.013,3,0,3,0.27920371738274696
28563,703-004-5396,9156.913,4,2,2,0.6149929771827739
28745,703-004-5393,4850.4185,5,3,2,0.7463661176935693
28827,703-004-5380,3810.6262,4,4,0,1.5454218884951014
28964,703-004-5396,5627.8374,4,2,2,0.9214916089832543
29067,703-004-5386,7252.1924,2,1,1,0.3485399858196089
29231,703-004-5397,3378.377,2,0,2,0.27920371738274696
29957,703-004-5390,5108.202,4,2,2,0.6801983202425005
2999,703-004-5397,3348.133,5,1,4,0.9653061631889809
30196,703-004-5380,5719.5254,4,2,2,0.49207073303413823
30276,703-004-5397,8528.705,1,0,1,0.27920371738274696
30329,207-008-2398,2270.9287,3,3,0,1.9423179336332208
30512,703-004-5381,2757.756,7,2,5,0.5703022038643623
30588,703-004-5390,7122.8857,6,3,3,1.3841742873114036
30654,703-004-5396,400.5003,3,3,0,2.935362929733384
30702,703-004-5382,2104.547,3,1,2,0.35831143730785864
30794,703-004-5395,5032.3423,4,2,2,0.6402570047900733
30828,703-004-5392,6732.3604,1,1,0,0.4642865523393341
30935,703-004-5381,6894.137,2,1,1,0.33853450732658075
30980,703-004-5398,5591.0366,5,2,3,0.5481891295211162
30999,703-004-5399,9007.178,1,0,1,0.27920371738274696
312,703-004-5393,1277.1785,2,1,1,0.4073666338149928
31297,703-004-5381,7521.694,3,2,1,1.0558758993351285
31949,703-004-5391,5132.2744,4,3,1,1.233390161503578
32042,703-004-5398,5282.271,2,1,1,0.3892985904335242
32071,703-004-5387,3473.63,1,0,1,0.27920371738274696
32098,703-004-5389,3501.2268,7,5,2,2.294690111359191
32365,703-004-5386,8681.528,9,3,6,1.8523780288330807
3242,703-004-5387,8196.914,4,2,2,0.7923772880769442
32869,703-004-5380,692.3926,9,5,4,4.668053325172516
32957,703-004-5380,1557.4658,2,1,1,0.8212243033382323
33084,703-004-5383,2162.9614,1,0,1,0.27920371738274696
33261,703-004-5391,6213.874,4,2,2,0.5726419874618538
33361,703-004-5381,8429.568,3,1,2,0.5207002020678085
34438,703-004-5398,5640.274,6,2,4,1.5313361783189565
34445,703-004-5382,1602.2396,4,1,3,0.5165268771580819
34838,703-004-5389,7233.37,1,0,1,0.27920371738274696
34915,703-004-5388,5338.1562,6,2,4,0.7937700439937531
3510,703-004-5381,751.4626,4,1,3,0.6148073629532346
36141,703-004-5390,7593.1694,4,1,3,0.7599420254467683
37205,703-004-5399,6424.623,5,4,1,2.515814633815571
37427,703-004-5388,9659.331,6,5,1,1.7198375275820428
37667,703-004-5388,5900.1274,4,1,3,1.0471182590920112
37837,703-004-5397,4911.402,8,4,4,1.5968597981851669
37932,703-004-5382,2718.0935,"","","",0.27920371738274696
38201,703-004-5391,547.0407,3,3,0,1.1410105464776827
38279,703-004-5391,3841.129,9,6,3,5.241400355496358
38524,703-004-5389,4706.348,4,1,3,0.8898707935612529
38551,703-004-5386,7822.16,6,6,0,2.4024847306634904
38883,703-004-5393,5380.351,6,5,1,2.8744390629884027
39216,703-004-5388,5331.1016,4,1,3,0.44844381420099266
39394,207-008-2398,2884.837,3,2,1,0.6747921362538429
39443,703-004-5389,9209.161,4,3,1,1.1124238629471166
39483,703-004-5394,2197.1416,5,1,4,0.4759839779724293
39593,703-004-5393,2204.2173,5,3,2,1.7962903363202893
39632,703-004-5394,351.52316,7,4,3,1.4210015177740587
39753,703-004-5398,6344.815,3,3,0,1.3596267721277835
39965,703-004-5398,4903.2666,5,3,2,1.4790366790053504
40209,703-004-5393,6212.575,6,6,0,1.834458584013853
4028,703-004-5398,5329.6973,1,1,0,0.35318614495832257
4043,703-004-5381,3490.1863,4,1,3,0.35831143730785864
40783,703-004-5392,2818.1165,1,1,0,0.44208837340378443
41236,703-004-5396,8114.7627,4,3,1,1.2245198186842545
41683,703-004-5388,4763.1675,10,6,4,1.950570743270615
4181,703-004-5397,6203.4316,5,3,2,0.8168306330981603
41972,703-004-5389,7507.0244,2,2,0,1.5045600688910554
42047,703-004-5397,2494.4402,4,2,2,0.7150240468684694
42447,703-004-5387,3266.0537,3,1,2,0.42771068790922206
42508,703-004-5389,7875.341,5,4,1,0.949384593594584
42526,207-008-2398,8685.59,2,1,1,0.3978652972704144
42567,207-008-2398,9422.966,2,1,1,0.3393097629818468
4287,703-004-5390,7223.8267,5,3,2,0.7890861654795499
42990,703-004-5390,5330.8994,5,1,4,0.393925541258173
43298,703-004-5388,253.59035,3,3,0,1.183822298923683
43580,703-004-5388,6066.9736,4,2,2,0.4045894534640489
43717,703-004-5384,2450.425,6,2,4,2.4321556074021493
43758,703-004-5386,3206.6543,10,4,6,3.420287582269113
44226,207-008-2399,7083.9546,4,1,3,0.481587045592051
44262,703-004-5384,8461.388,6,1,5,0.3978652972704144
44276,703-004-5382,4284.7256,7,3,4,2.5621290039753966
45113,703-004-5383,7298.012,3,1,2,0.9403138094002672
45492,703-004-5392,2138.6367,4,4,0,1.762523976875508
45559,703-004-5383,5560.591,4,1,3,0.4279684769507722
45581,703-004-5393,1431.7518,4,2,2,1.7190599626829068
45873,703-004-5389,3799.6912,2,1,1,0.6041016980244509
46094,703-004-5387,2626.9382,4,3,1,1.956769887506019
46454,703-004-5386,460.7594,4,2,2,0.9614245731574068
46491,703-004-5381,655.1456,2,0,2,0.27920371738274696
47058,207-008-2398,322.5219,9,9,0,2.4103988660663864
47083,703-004-5396,6622.677,1,0,1,0.27920371738274696
47515,703-004-5385,3932.388,7,7,0,2.705768698119025
47572,703-004-5396,5062.469,1,1,0,0.6783316906272209
47673,703-004-5382,3718.0715,2,1,1,0.41337322149236944
47740,703-004-5390,3851.5288,4,0,4,0.27920371738274696
47954,703-004-5387,9909.308,3,1,2,0.3767361387852352
48178,703-004-5399,9521.368,5,1,4,0.3187575773453028
48195,703-004-5381,1181.8522,2,0,2,0.27920371738274696
48242,703-004-5391,7148.8125,5,3,2,1.1539930989126546
48406,703-004-5389,3432.0337,6,4,2,0.8794880777139792
48439,703-004-5383,1691.0696,2,1,1,1.3535632988912754
4846,703-004-5395,737.0049,5,2,3,0.8636272110691603
48683,703-004-5393,5011.581,4,2,2,1.7363773080195641
48720,703-004-5392,7019.9116,1,1,0,0.4606591100578449
48833,703-004-5399,3068.0735,3,1,2,0.4987276401749318
48949,703-004-5395,7646.29,4,1,3,0.5349795247858543
49182,703-004-5393,3230.53,2,1,1,0.8074534769341898
49204,703-004-5396,6204.1606,3,2,1,1.027925798183764
49665,703-004-5399,4519.7295,5,4,1,1.0251232284695797
49733,703-004-5394,2132.83,3,2,1,1.0762041509430045
49823,703-004-5389,7400.2803,2,2,0,1.1227269447743027
49877,703-004-5386,4845.3545,5,2,3,1.1877149331083379
49920,703-004-5380,8108.83,4,0,4,0.27920371738274696
49969,703-004-5398,5788.3667,4,2,2,0.733680181249602
5054,703-004-5387,4155.0273,2,2,0,0.6330876766288811
5459,703-004-5390,3541.3123,6,3,3,3.965911686911458
6250,207-008-2398,1017.5258,3,1,2,0.33853450732658075
6392,703-004-5395,2184.3047,3,3,0,1.250242347556276
65,703-004-5387,7155.97,4,1,3,0.6415402301251165
6645,703-004-5382,4748.098,3,1,2,0.5425657193591416
7231,703-004-5383,1298.5087,4,2,2,1.3396892324537895
752,703-004-5390,5021.31,3,2,1,0.9449110534190934
7653,703-004-5385,7856.5205,2,0,2,0.27920371738274696
7937,703-004-5395,3337.131,2,0,2,0.27920371738274696
7951,703-004-5387,4326.5874,6,0,6,0.27920371738274696
7952,703-004-5385,831.30597,4,3,1,1.0772425500023084
8045,207-008-2399,4241.876,7,2,5,0.989192454964855
8169,703-004-5381,1417.076,3,1,2,0.5196336078692569
8441,703-004-5395,9039.343,5,1,4,0.4827291283977542
8793,703-004-5394,6232.7017,5,0,5,0.27920371738274696
9310,703-004-5383,6420.6777,5,2,3,0.9227992360264514
9749,207-008-2399,4446.341,1,0,1,0.27920371738274696
1027,703-004-5397,4532.1763,2,1,1,0.41869466570893527
10836,207-008-2399,429.1451,5,4,1,1.26667577158348
10844,703-004-5395,1261.1168,3,0,3,0.27920371738274696
10866,703-004-5396,7355.7324,2,1,1,0.35114230018964543
11053,703-004-5399,7785.2476,2,0,2,0.27920371738274696
11819,703-004-5381,9859.888,3,0,3,0.27920371738274696
11958,703-004-5394,7463.863,5,1,4,0.5859682668078328
12141,703-004-5385,5415.295,6,3,3,1.1912554519683918
12221,703-004-5392,3098.4683,4,1,3,0.5000317309654807
12302,703-004-5392,5179.801,5,4,1,2.5265335817297006
12333,703-004-5382,7564.414,3,3,0,2.156554224656079
12412,703-004-5391,704.4351,4,2,2,0.6292215924626481
1247,703-004-5390,4388.7363,4,1,3,0.3978652972704144
12552,703-004-5390,5169.691,5,2,3,0.9612589751016091
12806,703-004-5384,9191.0,7,2,5,0.5833298187189433
13037,703-004-5397,1396.9434,2,1,1,0.6637686502436667
13143,703-004-5399,3331.2554,3,3,0,1.1982984452642138
13961,703-004-5396,7992.987,1,1,0,0.3978652972704144
14004,703-004-5387,379.18686,2,2,0,0.6046220554123769
14080,703-004-5398,8398.556,1,0,1,0.27920371738274696
14373,703-004-5386,5433.422,7,5,2,2.212818108354087
14717,207-008-2399,6627.4,2,1,1,0.3835966852097502
14769,703-004-5385,9443.554,5,3,2,1.8322256360449745
14859,703-004-5384,3055.628,4,1,3,0.4134121616723635
1527,703-004-5398,5291.8394,1,1,0,0.3978652972704144
15588,703-004-5384,629.41016,5,4,1,1.3548993884156582
15619,703-004-5390,4275.858,6,4,2,2.868589279968079
1571,703-004-5383,8336.292,5,1,4,0.7251780871337449
15772,703-004-5382,779.4946,3,0,3,0.27920371738274696
15776,703-004-5388,3520.2957,2,0,2,0.27920371738274696
16405,703-004-5392,9728.324,7,5,2,2.0581465709657394
16440,703-004-5397,6106.616,1,0,1,0.27920371738274696
16484,703-004-5388,1298.4944,5,3,2,0.7574170878021129
16537,703-004-5389,536.3828,6,2,4,1.061797068975586
16572,207-008-2399,7115.9907,2,1,1,0.3978652972704144
17046,703-004-5398,1729.5122,7,2,5,1.7972223092964743
17110,703-004-5392,4144.5024,3,1,2,0.36998301227997626
17165,703-004-5383,5816.0586,8,2,6,0.5753830326352305
17201,703-004-5398,4071.9373,8,4,4,1.9013328418156943
17285,703-004-5387,7168.352,4,1,3,0.35831143730785864
17530,703-004-5383,6480.1104,6,4,2,3.9626811037511596
17558,703-004-5380,3013.2341,3,2,1,0.5956345970831934
1762,703-004-5383,2775.7043,6,5,1,0.9554972970682327
17911,703-004-5386,476.99036,2,2,0,0.9232230093928604
18015,207-008-2399,7337.525,"","","",0.27920371738274696
18102,703-004-5390,7217.858,5,2,3,0.5851314009510455
18112,703-004-5385,9995.951,5,2,3,0.8979408306784935
18292,703-004-5390,3911.0815,1,0,1,0.27920371738274696
18377,703-004-5383,2506.8748,3,3,0,1.334727137911703
18440,703-004-5399,5927.6865,5,3,2,1.2580765091784993
18661,703-004-5380,7944.165,7,3,4,1.2857983616831865
18708,703-004-5390,6138.0366,8,6,2,3.287375141129855
18892,703-004-5393,7326.414,5,2,3,0.4914871691436801
18928,703-004-5388,781.939,5,3,2,0.9238374607629003
19104,207-008-2398,2191.4978,10,5,5,2.662110343951827
19226,703-004-5388,5953.5986,6,5,1,2.1887511928416816
19335,703-004-5391,6444.6167,3,2,1,0.5669580486103406
1951,703-004-5386,5856.9663,2,2,0,0.6189923874492066
19578,207-008-2398,7840.2783,5,5,0,1.4144639864871955
19589,703-004-5384,3461.7817,5,1,4,0.8701053937474575
1966,703-004-5380,5640.5537,4,0,4,0.27920371738274696
19918,703-004-5397,1476.2866,4,2,2,2.20510667684413
19977,703-004-5396,7324.1084,3,3,0,1.5784043283784746
20006,703-004-5380,2949.2014,3,1,2,0.5234498304681868
20877,703-004-5399,1004.2167,7,2,5,1.3304292624959646
21007,207-008-2398,7055.5117,1,1,0,0.35831143730785864
21191,703-004-5399,8432.475,10,5,5,1.8249205741375303
21558,703-004-5391,7437.004,"","","",0.27920371738274696
21644,207-008-2399,2180.841,3,2,1,0.8632269917334313
21798,207-008-2398,4590.2324,4,1,3,1.2346764832447221
22095,703-004-5389,2975.4072,2,2,0,1.4192135127437007
22263,703-004-5385,3878.5745,4,1,3,0.6460770779104579
22414,703-004-5398,5214.3623,2,0,2,0.27920371738274696
23152,703-004-5393,182.42776,6,3,3,0.8905236925831302
23418,703-004-5396,2913.8882,7,1,6,0.3976167924264308
23589,703-004-5390,1014.67194,3,3,0,0.9668113151268143
23626,703-004-5381,1952.2994,7,2,5,0.6953989381986858
24395,703-004-5397,7105.3667,1,0,1,0.27920371738274696
24640,703-004-5387,8326.812,4,1,3,0.5709329925319285
2468,703-004-5391,327.18658,4,3,1,3.548308995684412
24786,703-004-5394,1850.642,2,1,1,0.44829646872267315
25187,703-004-5399,269.7128,8,5,3,1.9191299214462252
25337,703-004-5386,5174.453,3,3,0,2.829121198881277
25509,703-004-5390,3853.4595,4,2,2,0.44092199144863864
25978,703-004-5386,8175.308,3,1,2,0.5155457631787007
26212,703-004-5396,853.3883,4,2,2,1.1780030074020384
26519,703-004-5383,7760.226,3,2,1,0.5692937396284894
27008,703-004-5393,395.77484,3,1,2,0.5521899359845268
27244,703-004-5389,8878.184,1,0,1,0.27920371738274696
27256,703-004-5391,4158.717,7,3,4,2.210565060668528
27478,703-004-5392,5923.4136,6,6,0,1.9152239032325875
27587,703-004-5391,3556.112,3,1,2,0.8269228345631295
27633,703-004-5380,8540.1455,8,5,3,1.4624455015210582
27707,703-004-5393,9022.034,5,2,3,0.5021886029216555
27988,207-008-2398,9707.3545,6,2,4,0.8330208088224481
28254,703-004-5393,5019.726,1,1,0,0.4457749101500602
28327,703-004-5399,3277.5164,5,1,4,0.35534489781066697
28381,703-004-5381,6989.28,2,2,0,0.549621921404252
28612,703-004-5387,6380.9185,"","","",0.27920371738274696
28629,703-004-5394,5058.7236,3,2,1,0.6507167060702914
28687,703-004-5391,3785.5513,6,3,3,1.0651639888350628
28829,703-004-5383,9296.033,7,3,4,1.279257669486353
29144,703-004-5383,9764.347,7,5,2,2.0169929391083827
29264,703-004-5381,3278.135,3,1,2,0.5186191173943681
29636,703-004-5388,1434.756,2,0,2,0.27920371738274696
29744,207-008-2399,2398.7366,2,1,1,0.5184947533967535
29900,703-004-5394,1320.6637,6,4,2,1.0202359238756078
2994,703-004-5387,5970.1025,2,1,1,0.9543064370043847
29968,207-008-2399,346.47525,6,3,3,1.9330062992971049
30197,703-004-5393,3138.1167,2,1,1,0.4410119661795691
30551,703-004-5387,9117.2,5,3,2,1.0149217672284034
3056,703-004-5394,3287.6826,1,1,0,0.432972294977076
30798,703-004-5399,6134.43,3,2,1,2.223606423708721
31026,703-004-5384,2183.004,3,3,0,1.327216880919958
31168,703-004-5389,998.5727,7,3,4,1.592766173324608
31215,703-004-5393,5588.532,6,3,3,0.7455772703542611
31388,703-004-5381,3847.577,2,1,1,1.1118346670416015
31395,703-004-5391,398.24487,5,2,3,1.7205832727334154
31780,703-004-5388,3397.2292,7,3,4,0.6776505334014264
32260,703-004-5386,7697.3315,6,2,4,1.3931360216962227
32625,703-004-5397,6963.5874,3,1,2,0.5578687513189465
32634,703-004-5396,6720.4707,5,2,3,0.6295211132531857
32814,703-004-5397,3006.8196,8,2,6,0.5444537677093648
32875,703-004-5385,3336.529,4,4,0,2.3725146188746398
33468,703-004-5398,6849.2554,3,1,2,0.6745363723092781
33752,703-004-5397,2444.2334,2,1,1,1.4473386310290148
34272,703-004-5382,4573.4077,3,1,2,1.2968149704021092
34776,703-004-5389,9444.389,9,5,4,1.3142350732654953
34779,703-004-5380,5107.3066,6,4,2,2.672419800466507
34854,703-004-5380,7991.6084,3,2,1,0.8799851961127879
34880,703-004-5394,109.71129,3,1,2,0.37175974969512765
34949,703-004-5393,5599.454,5,4,1,1.5162135972294517
35942,703-004-5383,710.6107,5,1,4,0.3978652972704144
36483,703-004-5388,204.54109,7,3,4,1.2163317810930476
3658,703-004-5392,2861.9307,4,2,2,0.48539930205338233
36693,703-004-5396,4256.553,2,0,2,0.27920371738274696
36701,703-004-5393,5575.461,3,2,1,0.5409499468469887
37186,703-004-5394,5906.1157,4,2,2,1.1913424304327784
37272,703-004-5386,5630.423,5,1,4,0.6934346966000844
37715,703-004-5389,8878.005,4,2,2,0.7262120502692668
37716,207-008-2398,9141.828,5,3,2,1.0441190910286755
37727,703-004-5387,9528.728,3,0,3,0.27920371738274696
38516,703-004-5399,5441.648,3,1,2,0.4600637420615335
38565,703-004-5399,4570.6104,8,2,6,0.5793027246441201
39257,703-004-5387,7920.499,3,2,1,0.6803787420529693
39354,703-004-5385,9629.85,3,3,0,2.056203717029903
39383,703-004-5392,1829.7004,6,1,5,0.47113268031855676
39459,703-004-5395,1884.042,3,1,2,0.42665626841926046
39566,703-004-5390,1388.9081,3,1,2,0.45149747114004773
39785,703-004-5397,922.97437,6,3,3,3.1281371760730905
39804,703-004-5399,2560.3884,2,0,2,0.27920371738274696
40180,703-004-5396,3685.906,8,4,4,2.222920593178506
40748,703-004-5382,3419.0203,5,1,4,0.6563023829104747
40878,703-004-5397,224.55632,3,2,1,0.7707390009834687
40881,703-004-5398,6264.4434,3,1,2,0.5590534883996907
40899,703-004-5398,3959.7463,2,1,1,0.4273833741051576
41043,703-004-5399,3564.9294,4,2,2,1.3450145844466947
41281,207-008-2398,3811.2664,4,2,2,1.0661007555779787
41401,703-004-5389,8276.243,2,1,1,0.3468408179187174
41558,703-004-5392,1352.1296,3,2,1,0.7493541860209446
41789,703-004-5381,6263.2393,4,3,1,1.4144839266729363
42029,703-004-5397,9166.377,5,2,3,1.2010950823867923
42154,207-008-2399,6911.829,3,1,2,1.289511305750707
42419,703-004-5387,2480.3215,3,3,0,1.186325887613715
43079,703-004-5389,1309.8372,3,2,1,0.47883747353553185
4311,703-004-5392,1861.552,2,0,2,0.27920371738274696
4331,703-004-5388,5096.7085,3,0,3,0.27920371738274696
43558,703-004-5380,7341.159,8,3,5,0.5595611843637301
43631,703-004-5392,1122.3245,4,2,2,1.6957024078722622
43873,703-004-5397,117.3836,1,1,0,0.6132446521508502
43959,703-004-5397,1513.0615,4,1,3,0.5922537059869883
43967,703-004-5386,8672.204,7,4,3,1.189057131504598
44071,703-004-5383,8839.13,2,0,2,0.27920371738274696
44180,703-004-5389,6211.967,4,3,1,0.9776553805200233
44319,703-004-5396,7931.7915,3,3,0,1.587120469126518
44524,207-008-2399,4435.0977,4,2,2,0.9503082441050489
44689,703-004-5382,3983.0012,2,1,1,0.39907663423176776
4493,703-004-5398,9899.026,9,6,3,2.504193657621313
45139,703-004-5395,3690.6003,4,1,3,0.37175974969512765
45512,703-004-5385,7038.441,6,3,3,2.4240363476165654
45546,703-004-5390,3732.6133,3,1,2,0.37368223209705764
45666,703-004-5390,8290.149,2,0,2,0.27920371738274696
45779,703-004-5395,469.10464,7,1,6,0.32666834933781397
45894,703-004-5383,510.39398,3,1,2,0.4058419216328706
45905,703-004-5398,4096.004,5,3,2,1.5823217917129833
45977,703-004-5380,8189.806,5,2,3,0.7227425038859148
46032,703-004-5397,2299.205,7,3,4,1.2821509906784798
46355,703-004-5385,2956.282,6,3,3,0.8810771078848435
46383,703-004-5383,2858.8557,5,2,3,0.9209377091426001
46585,703-004-5394,7141.0073,1,1,0,0.3670132864996209
46677,703-004-5389,1024.9037,1,0,1,0.27920371738274696
46735,703-004-5381,885.0568,3,2,1,1.4223380430734134
46827,703-004-5396,9898.103,5,2,3,1.0945072802910314
46830,703-004-5389,4805.806,5,4,1,2.4921063999392543
4689,703-004-5394,5593.474,4,1,3,0.4424638144409291
47075,207-008-2398,7708.5586,4,2,2,0.6537951703372024
47102,703-004-5392,403.87152,4,1,3,0.463463819784236
47411,207-008-2399,8119.4067,5,3,2,1.1254062130130047
47448,703-004-5380,8679.94,2,0,2,0.27920371738274696
4754,703-004-5390,9083.201,2,2,0,0.6529576155886678
47677,703-004-5382,2900.8413,2,0,2,0.27920371738274696
47902,703-004-5389,6446.9897,4,1,3,0.9820398970367817
47969,703-004-5393,1990.8392,3,2,1,0.8430784159065738
48149,703-004-5396,6624.47,9,4,5,1.2566367322476513
48201,703-004-5381,1692.7594,4,2,2,0.7123604457834657
48248,703-004-5391,8198.292,6,6,0,1.8789732445849194
48308,703-004-5392,609.9188,3,1,2,0.6271799987402235
48368,703-004-5384,5984.834,1,1,0,0.44693955158229104
48462,703-004-5399,3978.5312,6,3,3,1.1585758539825113
48528,703-004-5387,6266.221,2,1,1,0.7510690676178988
48703,703-004-5397,3164.01,5,2,3,1.216491486320424
48726,703-004-5398,5830.232,5,3,2,2.0261198652886705
48899,703-004-5399,7342.408,2,1,1,0.5906049689852284
48915,703-004-5382,6809.952,7,1,6,1.0128271019641044
49312,703-004-5392,6896.5586,2,0,2,0.27920371738274696
49678,207-008-2398,2871.0806,3,0,3,0.27920371738274696
49832,703-004-5394,9300.796,3,0,3,0.27920371738274696
49838,703-004-5386,6135.633,4,0,4,0.27920371738274696
49972,703-004-5383,5346.1636,6,2,4,1.4816057713868234
5579,703-004-5382,1069.271,4,3,1,0.5647742429200642
5766,703-004-5387,7160.517,6,2,4,0.7523199656142174
5819,703-004-5396,1160.9166,5,1,4,0.36867381687163897
5978,703-004-5396,5446.8984,5,1,4,1.570004489682758
6122,207-008-2398,5064.4624,4,1,3,0.329176958730082
6507,703-004-5380,5436.314,3,0,3,0.27920371738274696
6688,207-008-2398,6055.0635,4,3,1,0.8251061348679418
6795,703-004-5393,4029.0344,3,3,0,0.7155107976727695
7288,703-004-5380,6590.984,1,1,0,0.4901125697597904
7576,703-004-5391,7345.14,"","","",0.27920371738274696
7725,703-004-5381,8264.302,4,3,1,1.5532300763022628
7901,703-004-5396,1989.6204,1,1,0,0.673189585001659
8072,703-004-5392,2509.6917,4,3,1,0.8974404190969384
8265,703-004-5391,7720.6504,7,4,3,1.4797297102069424
8495,703-004-5380,6601.773,8,4,4,2.56078049386781
8556,703-004-5391,7467.567,3,1,2,0.45623928652701035
8573,703-004-5385,2384.8176,2,2,0,0.5486853528786859
8626,207-008-2399,8697.645,7,5,2,1.4382040340840556
8650,703-004-5392,8200.689,8,3,5,1.1652343803414995
8739,703-004-5394,9517.842,6,4,2,1.8035461164639455
93,703-004-5387,5992.9473,1,1,0,0.9761065716869773
95,703-004-5393,8456.218,5,3,2,0.5951451011701436
9832,703-004-5382,8503.348,1,1,0,0.7732212844274655
9905,703-004-5391,819.82495,3,1,2,0.44950854341811725
9941,703-004-5393,8126.043,1,0,1,0.27920371738274696
10285,703-004-5395,4130.308,7,3,4,2.3651021342697853
10423,703-004-5384,6267.2715,7,1,6,0.5255163782648272
10646,703-004-5398,8391.67,3,1,2,0.5599167018648945
10670,703-004-5383,1938.3281,2,0,2,0.27920371738274696
10834,703-004-5389,4330.052,6,1,5,0.6739573578561746
10838,703-004-5394,3479.795,4,4,0,6.811020721743639
11224,703-004-5392,2220.977,2,2,0,0.8483919004653274
1133,703-004-5398,7947.5234,7,4,3,3.0498287427499093
11344,207-008-2398,1534.8339,6,4,2,1.6501119510602278
11663,703-004-5389,8987.528,3,0,3,0.27920371738274696
12115,703-004-5385,9760.033,6,2,4,3.284670532812594
12136,703-004-5399,3699.2085,7,2,5,1.0747010591855328
12257,703-004-5393,740.7808,2,0,2,0.27920371738274696
12354,703-004-5381,7499.597,5,3,2,1.4368837085012676
12444,703-004-5399,6939.0117,5,3,2,0.8240693520135212
1286,703-004-5384,5440.6514,3,2,1,0.867680356361518
13129,703-004-5388,1913.8473,1,1,0,0.6532434425431752
13291,703-004-5391,4186.409,7,2,5,0.7752706159835787
13366,703-004-5396,2554.1704,4,1,3,0.488781392593699
13399,703-004-5386,1434.6194,3,2,1,1.3589743022884933
1371,703-004-5393,2996.6133,2,2,0,1.0849402101218237
13978,703-004-5398,6331.798,2,0,2,0.27920371738274696
1416,703-004-5389,8850.949,2,1,1,1.471772253618664
14222,703-004-5395,2979.3853,6,2,4,1.3356191437938227
14290,703-004-5380,7557.8647,1,0,1,0.27920371738274696
14338,703-004-5399,8976.516,5,3,2,1.607665409287586
14374,703-004-5381,2847.811,4,1,3,0.5278693122982958
14433,207-008-2399,6593.303,3,1,2,0.4349648529357958
14583,703-004-5385,9170.598,2,1,1,0.55573008358035
14628,703-004-5395,80.509186,1,1,0,0.4375186492683901
14641,703-004-5387,4071.48,2,0,2,0.27920371738274696
14668,703-004-5380,3438.3552,4,1,3,0.3978652972704144
14705,703-004-5387,9652.472,6,2,4,1.47420567178916
1486,207-008-2399,8371.531,4,1,3,0.3634419025605018
14907,207-008-2398,7236.8066,4,2,2,1.2910713716688655
15077,703-004-5385,6816.974,4,2,2,0.6034256795579586
15125,703-004-5395,68.580505,2,2,0,0.8364494125399693
15134,703-004-5383,163.72264,3,3,0,1.0686629687907738
15658,703-004-5392,3697.9895,3,1,2,0.35534489781066697
15679,703-004-5394,455.6787,4,1,3,0.7671675399293079
15684,207-008-2399,9792.348,4,2,2,0.4997576886114567
15894,703-004-5397,7428.7275,1,1,0,0.36505405133015895
16196,703-004-5392,5047.698,2,1,1,1.2885193445474061
16234,207-008-2398,8893.893,3,2,1,0.6119089001569047
16264,703-004-5389,9307.061,6,4,2,2.784563745266659
17097,703-004-5392,5096.1597,4,2,2,0.5981578431213983
17228,703-004-5399,6669.0044,2,1,1,0.35831143730785864
17250,703-004-5399,6586.677,5,3,2,1.135909548212845
17536,703-004-5381,7957.739,2,1,1,0.33853450732658075
1783,703-004-5397,9791.176,2,1,1,0.6795668369308733
17923,207-008-2399,8905.307,3,2,1,0.8652157975026228
1841,703-004-5399,7969.642,4,2,2,1.6500259879920367
18506,703-004-5389,5594.27,6,3,3,0.8321210330944506
18543,703-004-5397,4663.1396,4,3,1,1.1171504195682707
188,703-004-5385,5738.78,3,2,1,0.778761006438463
18867,207-008-2399,2206.3328,"","","",0.27920371738274696
18961,703-004-5395,8546.751,4,3,1,0.7859521641587973
19243,703-004-5399,7306.645,5,3,2,4.102799830346472
1962,207-008-2399,5784.8735,2,1,1,0.658366820742103
19658,703-004-5399,8100.3994,5,2,3,0.8743122727815309
20030,703-004-5391,3564.4333,3,2,1,0.9449958084437744
20066,703-004-5388,2788.6206,1,1,0,0.418192217365425
20278,703-004-5391,2772.9363,4,0,4,0.27920371738274696
20632,703-004-5382,7641.592,3,3,0,1.3726162859735005
20828,703-004-5386,1035.8125,1,1,0,0.7137480368089433
20935,703-004-5380,104.00951,4,3,1,1.1534823555116565
21280,703-004-5387,5968.3804,1,0,1,0.27920371738274696
21357,703-004-5383,3419.5732,2,1,1,0.4032545106903127
21601,703-004-5395,9900.76,1,1,0,0.4691540017214045
21968,703-004-5387,9162.12,3,1,2,0.5467451468497737
22024,703-004-5398,9630.895,4,1,3,0.39905191306929116
22281,703-004-5399,3206.504,7,5,2,3.0003811562006275
22417,703-004-5393,9504.602,2,1,1,0.5398418562705668
22781,703-004-5391,2459.3972,6,4,2,1.8746241505433208
23047,703-004-5398,2635.525,6,4,2,1.8899866874509539
23219,703-004-5386,4134.6816,6,2,4,1.2756448021844642
23621,703-004-5386,4164.3022,2,1,1,0.3554141170656014
23711,703-004-5381,2344.4128,5,2,3,1.7325550260984863
23739,703-004-5392,7146.4995,7,4,3,2.6582587564253934
2375,703-004-5380,1300.8469,7,3,4,1.4628132998380887
24059,703-004-5394,4964.606,4,3,1,1.2672076540471018
24074,703-004-5399,4463.4224,5,3,2,0.979733755369502
24145,703-004-5383,6592.936,4,2,2,0.6085829580883115
24151,703-004-5380,6968.8735,2,0,2,0.27920371738274696
24225,703-004-5384,4343.2324,6,2,4,1.1327091521022088
24259,703-004-5392,5569.287,3,1,2,1.4914166347962705
24497,703-004-5381,4844.978,6,3,3,0.8896550883733813
24509,207-008-2399,3970.1438,3,2,1,0.6445040934576038
24557,703-004-5382,8053.0615,2,2,0,1.3264030730436875
24688,703-004-5383,3994.6758,3,2,1,1.7346627428125725
24704,703-004-5385,3246.6804,6,2,4,0.9922767347725907
24934,703-004-5382,1630.0977,5,1,4,0.4180377658513179
25174,703-004-5386,4596.3447,4,3,1,2.3695536968791644
25295,703-004-5392,4079.852,4,1,3,0.5864541617579749
25296,703-004-5396,4048.825,1,1,0,0.3710673050462447
25457,703-004-5383,9910.327,4,1,3,0.415854828148524
25848,703-004-5395,2375.738,2,1,1,1.1559833932350243
25875,703-004-5380,4700.444,2,1,1,0.6589127307276549
2596,703-004-5390,8907.818,2,1,1,1.054776493660994
2604,703-004-5398,682.52203,10,7,3,4.636630696651793
26346,703-004-5389,2960.5574,1,1,0,0.5894327589962818
26578,703-004-5388,510.8607,4,3,1,1.1778648896987916
26832,207-008-2399,5272.435,5,1,4,0.871131605748229
26839,207-008-2399,9574.519,4,1,3,0.4733019245677514
27022,703-004-5385,2875.1868,5,1,4,1.0928226293446914
2709,703-004-5384,6742.6826,7,1,6,0.6264077027364537
27145,703-004-5392,2604.2778,4,2,2,0.9132379747328556
27558,703-004-5394,6074.303,4,4,0,2.480605985365242
276,703-004-5385,8116.506,1,0,1,0.27920371738274696
27640,207-008-2398,4643.6616,2,1,1,1.2991369533580528
27725,703-004-5384,765.42737,3,2,1,4.2511084073855825
27736,703-004-5392,1575.1416,5,2,3,0.6070260080866964
27826,703-004-5397,201.92862,5,1,4,0.8108405390970702
2793,207-008-2398,2488.6238,2,1,1,0.37741320487394237
27983,703-004-5388,6951.5728,3,2,1,0.5636841323592054
28127,703-004-5395,1971.848,2,0,2,0.27920371738274696
28171,703-004-5394,6687.6416,4,1,3,1.3309466275327506
2821,703-004-5384,2936.253,4,2,2,1.1996766659052969
2840,703-004-5390,8574.911,3,2,1,1.6325113069111319
28517,703-004-5395,5120.0815,8,4,4,1.7533791301419324
28724,703-004-5383,1921.8069,4,2,2,0.9171733957268657
28832,207-008-2399,907.76263,4,4,0,1.2230318310368047
28921,703-004-5399,1029.1892,4,3,1,1.0107238178021851
29216,703-004-5387,320.8792,"","","",0.27920371738274696
29448,703-004-5385,4789.652,2,1,1,0.35831143730785864
2954,703-004-5395,4329.505,4,2,2,1.113878087123346
298,207-008-2398,2493.3242,5,3,2,1.941722174771575
29915,703-004-5391,5355.7456,2,0,2,0.27920371738274696
30193,703-004-5397,7259.6235,8,2,6,1.1877289839545944
30435,703-004-5390,495.3891,2,1,1,0.46667962220797904
3054,703-004-5387,3869.2166,3,0,3,0.27920371738274696
30613,703-004-5392,9073.7,6,5,1,2.2798085555490606
30859,703-004-5391,2756.9468,6,3,3,0.8092035226534574
30967,703-004-5392,3730.0115,2,1,1,0.43684544085479465
31305,703-004-5398,4557.073,8,4,4,1.8110243180981924
31729,703-004-5395,1003.10565,4,3,1,0.9042602873038268
31846,703-004-5392,2337.954,2,0,2,0.27920371738274696
31870,703-004-5386,5698.925,4,1,3,0.4563180150670437
31934,703-004-5383,339.98965,5,4,1,1.8347475913864046
32021,703-004-5380,7731.477,7,5,2,2.0999211314279767
32274,703-004-5391,7556.0874,3,1,2,0.3637500930527101
3272,703-004-5397,8120.9487,1,0,1,0.27920371738274696
32990,703-004-5394,4360.9717,3,2,1,0.519078993593967
33000,703-004-5397,6718.324,4,2,2,2.0072195140768416
33015,703-004-5385,3759.532,3,2,1,0.5669580486103406
33067,703-004-5380,6218.515,5,2,3,0.9476585222968091
3314,703-004-5383,8853.98,4,2,2,0.7131087107811626
33254,703-004-5383,2206.1873,4,1,3,0.5260887554378619
33329,703-004-5394,3528.0496,6,2,4,2.6253722883350874
3360,703-004-5387,6651.99,8,3,5,0.577719247723217
33857,703-004-5393,2648.8406,5,2,3,0.9944480174045027
34010,703-004-5388,9413.396,5,3,2,3.0808681577510217
34353,703-004-5395,4037.0364,2,0,2,0.27920371738274696
34518,703-004-5380,5532.866,7,5,2,1.2617563237123801
34621,703-004-5385,3243.5388,5,3,2,0.710392228745952
34753,703-004-5398,9383.143,7,3,4,1.3441303824384234
35292,703-004-5382,3999.65,2,1,1,0.42421679105046867
35335,703-004-5395,6786.642,2,1,1,0.8247987375602482
35459,703-004-5382,2273.6208,1,0,1,0.27920371738274696
35556,703-004-5391,6911.6963,3,2,1,1.2180555091929337
35617,703-004-5386,1838.6049,"","","",0.27920371738274696
35888,703-004-5385,6344.8843,2,1,1,0.3518419090877331
35916,703-004-5383,7174.4097,5,2,3,0.490421329582795
35983,207-008-2398,9365.471,3,1,2,0.3366886605283281
36007,703-004-5397,4771.7456,5,4,1,1.8517089729999487
36309,207-008-2399,819.3785,5,3,2,1.9403639055046273
36316,703-004-5380,8128.2183,4,1,3,0.5585400572297138
36500,703-004-5388,9940.042,7,3,4,1.4346596655215047
36753,703-004-5389,4635.0566,4,2,2,1.7861158973832014
36804,703-004-5399,4171.9834,6,3,3,2.395841060376437
36932,703-004-5392,7568.378,5,2,3,0.6964089669572645
36935,703-004-5386,2621.1052,3,2,1,0.6561640075860656
37034,703-004-5398,9581.45,1,0,1,0.27920371738274696
37141,703-004-5391,4659.4834,1,1,0,1.68498193798345
37659,703-004-5398,1164.9221,7,3,4,1.26334315541762
3773,703-004-5394,1804.2177,4,2,2,0.5699912576254669
37968,703-004-5381,1256.836,6,2,4,1.017769130537178
3797,703-004-5394,1083.3049,2,2,0,0.8489354250785301
38134,703-004-5389,8144.6455,3,2,1,0.4747978271385826
38305,703-004-5398,7942.8823,5,3,2,1.1121021322572429
38583,703-004-5394,9718.737,2,2,0,0.8736335121802751
38662,703-004-5393,3976.193,4,2,2,0.5886323278116974
38829,703-004-5388,3323.906,6,2,4,1.3045629055250743
39181,207-008-2398,402.23538,5,1,4,0.9759898707350001
39188,207-008-2399,8891.55,2,1,1,0.8781974491494574
39332,703-004-5381,6091.719,6,4,2,1.2846971451108418
39773,703-004-5396,7163.7075,4,2,2,1.341337573037799
39775,703-004-5389,9627.384,2,0,2,0.27920371738274696
39882,703-004-5394,2609.7078,6,3,3,1.0338073750578887
40064,207-008-2398,5863.4316,3,2,1,0.8550359690921946
40239,703-004-5389,1058.5851,4,3,1,0.9636892346632701
40293,703-004-5390,2711.519,5,4,1,1.6355538533881184
40387,703-004-5396,6710.211,7,5,2,1.6345091447757587
40472,703-004-5382,1345.4586,1,0,1,0.27920371738274696
40477,703-004-5388,6022.7417,5,0,5,0.27920371738274696
40519,703-004-5392,6973.6104,4,1,3,0.6701472181859038
40587,703-004-5387,6050.7417,6,4,2,1.3365707519440904
40613,703-004-5389,4213.505,2,2,0,0.5171596798497088
4073,207-008-2398,8161.4746,3,0,3,0.27920371738274696
40882,703-004-5397,8205.14,2,1,1,0.5614937129079313
40942,703-004-5392,1339.8057,3,1,2,0.6945222310236941
41305,703-004-5384,6597.5576,4,2,2,0.7072939076993648
41450,703-004-5397,9607.664,1,1,0,0.35534489781066697
41694,703-004-5381,24.297237,4,3,1,1.0442753627616346
41822,703-004-5380,8146.6523,5,2,3,1.1528852257194215
42038,703-004-5385,1880.5021,4,1,3,0.3978652972704144
42199,703-004-5383,7900.39,3,1,2,0.7961405255930988
42218,703-004-5389,6153.286,6,4,2,2.644512540037779
42219,703-004-5384,6466.885,6,1,5,0.33853450732658075
42289,207-008-2399,1303.773,2,1,1,0.5165268771580819
42626,703-004-5397,7898.023,5,1,4,0.6569161603152742
42651,703-004-5397,7629.002,5,2,3,0.7055955258343213
42699,703-004-5398,2952.062,1,0,1,0.27920371738274696
42950,703-004-5395,5619.7705,4,2,2,0.916746545818527
4300,703-004-5390,9138.383,2,1,1,0.3807252912866403
43047,703-004-5392,8384.384,2,1,1,0.449108970929404
43077,703-004-5396,255.05542,1,1,0,0.5278430423864637
43394,207-008-2399,2319.9963,8,3,5,0.951863244299743
4373,703-004-5393,3482.3762,5,3,2,0.5725673405790922
43766,703-004-5384,1641.922,4,3,1,1.0648278450181867
44385,703-004-5386,9169.8955,6,1,5,0.6018031234581742
44438,703-004-5382,9742.643,2,1,1,0.692027353811942
44487,703-004-5388,1676.184,3,2,1,0.6902523810658658
44675,703-004-5382,4305.9277,7,4,3,0.8525331108525254
44761,703-004-5399,8674.778,6,2,4,1.1091022703786078
44976,703-004-5393,2024.6858,3,1,2,0.35598567034206036
45437,703-004-5397,9747.34,5,3,2,1.6332846191692532
45575,703-004-5390,7420.117,4,3,1,1.1239858699858618
46059,703-004-5387,7491.4277,2,1,1,0.4700585720210765
46263,703-004-5384,9522.293,5,2,3,1.9023995022134568
46304,703-004-5384,1073.5381,3,1,2,0.6745477163447805
46440,703-004-5390,2301.6292,3,1,2,0.35831143730785864
46559,207-008-2399,7434.007,1,0,1,0.27920371738274696
46815,207-008-2398,4137.1196,2,2,0,1.097057379094874
47014,703-004-5385,7647.2275,2,0,2,0.27920371738274696
47095,703-004-5390,7859.319,2,1,1,0.3622851340020347
47824,703-004-5382,166.48471,5,1,4,0.8166259188981344
47927,703-004-5385,1564.5385,7,0,7,0.27920371738274696
47989,703-004-5392,1041.1477,4,3,1,0.6658506642246391
48260,703-004-5389,7339.3594,3,1,2,1.8851445416195367
48974,703-004-5383,1067.304,9,5,4,3.7505180094601673
49107,703-004-5390,6120.0366,4,3,1,1.2810966294966755
49279,703-004-5394,7067.8594,5,1,4,0.4622313541703099
49329,703-004-5386,3472.9958,8,3,5,1.4586547282517879
49390,703-004-5384,4724.4556,1,1,0,0.4923309407354442
49442,703-004-5391,6798.356,7,3,4,1.0689005031209635
49450,703-004-5386,9374.183,8,6,2,2.0800142225180047
49515,703-004-5383,9979.728,3,3,0,1.4052656232358403
49614,703-004-5395,2639.0154,3,2,1,1.2990660641576648
49861,703-004-5380,6812.206,3,0,3,0.27920371738274696
5135,703-004-5396,9416.545,5,2,3,0.9105062114645226
5190,703-004-5381,9932.771,4,3,1,0.7470830340438679
528,703-004-5392,289.2977,6,6,0,2.431007542416205
5510,703-004-5396,463.3075,4,1,3,0.3773696593076815
5513,703-004-5399,3196.0898,6,3,3,1.4436580225295677
5937,207-008-2398,3064.0913,4,2,2,0.8981896128626641
6159,703-004-5391,6122.6953,4,0,4,0.27920371738274696
6422,703-004-5395,3590.0544,3,2,1,0.9049949647222061
6502,703-004-5391,4292.367,1,0,1,0.27920371738274696
6600,703-004-5381,9751.909,4,1,3,0.5115693122775978
6625,703-004-5393,480.991,1,1,0,0.4949983830964352
7300,703-004-5392,6541.4023,2,2,0,0.9427558398417705
7386,703-004-5382,945.0162,2,0,2,0.27920371738274696
749,703-004-5390,5104.403,3,1,2,0.921141345421121
7560,703-004-5392,2305.6494,1,0,1,0.27920371738274696
7775,703-004-5391,3578.8704,4,1,3,0.8066786645206799
7939,207-008-2398,5585.6587,7,3,4,1.6231558462944966
8019,703-004-5396,5204.279,3,1,2,0.4876906584452787
8418,703-004-5390,6186.013,5,1,4,3.8571071471389677
8854,703-004-5384,6612.6255,2,0,2,0.27920371738274696
8914,703-004-5385,8723.491,4,3,1,1.5533649428927025
8979,207-008-2399,5442.084,3,2,1,1.6203695551115376
9469,703-004-5395,1449.6803,"","","",0.27920371738274696
959,703-004-5395,5210.581,4,2,2,1.0195204795460366
98,703-004-5399,6922.8105,4,3,1,1.5099780658729516
980,703-004-5388,8991.973,4,3,1,0.9622833041695423
9926,703-004-5397,192.73341,6,3,3,1.60226246507449
1003,703-004-5387,4878.934,6,2,4,0.884864906845227
10241,703-004-5387,5073.209,3,2,1,1.0405703524373178
11512,703-004-5388,7447.6465,3,1,2,0.5606466549687799
12094,703-004-5388,463.45413,6,4,2,1.1048093660599954
1229,703-004-5388,4278.1597,3,1,2,0.6402275521540126
12517,207-008-2398,3687.532,4,2,2,0.8297376995935299
12632,703-004-5391,4413.5737,4,3,1,1.6066047223457367
12690,703-004-5393,8032.143,5,5,0,2.6437484984177484
13032,703-004-5392,5629.5186,2,0,2,0.27920371738274696
13154,703-004-5385,1025.0503,5,3,2,1.5922410890878613
13250,703-004-5398,1107.8251,4,3,1,0.518059589231631
13410,703-004-5383,4997.4155,4,4,0,2.2881476226562882
13448,703-004-5397,8417.646,6,0,6,0.27920371738274696
13651,703-004-5386,6288.4,3,1,2,0.5453388649892741
13917,703-004-5389,3417.2864,5,3,2,0.9521770503487264
14013,703-004-5392,2766.8435,2,0,2,0.27920371738274696
14084,703-004-5380,1473.1335,4,3,1,1.0416299875990693
14124,703-004-5390,8453.794,2,2,0,3.6137654171824205
14211,703-004-5398,5664.6465,4,1,3,0.3401166617250829
14430,703-004-5391,60.073734,5,3,2,1.337811025812373
14666,703-004-5393,132.64299,10,5,5,1.1689828091320547
14688,703-004-5397,7019.1895,3,2,1,1.5021572717968006
15216,703-004-5393,929.3145,7,4,3,0.7646663930996417
15452,703-004-5399,1068.5521,3,2,1,1.1950891462054065
15763,703-004-5398,4803.2417,3,2,1,1.374938945217286
15940,703-004-5382,5825.9536,5,1,4,1.1066302536185408
16302,703-004-5399,8712.74,4,2,2,1.3731870974945852
16330,703-004-5387,5129.4517,4,2,2,2.459109406955756
16436,703-004-5389,2052.2546,5,0,5,0.27920371738274696
16676,703-004-5392,5752.3564,3,0,3,0.27920371738274696
16815,703-004-5384,4966.611,3,1,2,1.3875640018275646
16851,703-004-5399,7309.905,7,1,6,0.5171702863803234
17117,703-004-5383,398.4916,3,1,2,0.9771866857999723
17329,207-008-2399,2741.277,5,2,3,1.29565540692902
17817,703-004-5387,6364.989,8,5,3,1.8572209724452493
17952,703-004-5384,9690.433,5,1,4,0.4660775419199834
1823,207-008-2399,2642.4783,6,5,1,2.567889720397359
18687,703-004-5381,313.29633,3,2,1,3.184692537267785
18790,703-004-5390,4414.2876,5,4,1,0.882024488242276
19264,703-004-5380,8552.568,4,2,2,0.9104565317251591
19308,703-004-5380,6305.315,4,1,3,0.5797339453782461
19511,703-004-5397,6744.007,2,0,2,0.27920371738274696
19762,703-004-5396,5930.7046,4,1,3,0.4266110649982019
2015,703-004-5398,5942.666,2,1,1,0.4059736283681288
20245,703-004-5384,8037.3286,2,2,0,1.23482182326802
20475,703-004-5385,7990.342,2,2,0,0.5417424628842112
2068,703-004-5383,8024.767,3,1,2,0.838634540229436
20717,703-004-5399,4789.725,2,1,1,1.219427406701114
21078,703-004-5391,4127.9956,3,2,1,0.8215538743374303
21404,703-004-5385,5644.977,4,4,0,2.4023935422868665
21462,703-004-5384,4677.7153,4,1,3,0.4868681371088888
21750,703-004-5390,4551.3774,4,1,3,0.4103573010060467
21932,703-004-5387,8750.064,5,4,1,1.8232689289934525
22235,207-008-2398,4199.977,4,1,3,1.20774361841402
22362,703-004-5399,9688.147,2,1,1,0.45472129642865555
22373,703-004-5391,3471.006,2,1,1,1.6719280452133332
2262,703-004-5390,2617.3562,2,1,1,0.48369799622232396
22644,703-004-5385,6424.5713,6,1,5,0.42153674923200507
22738,703-004-5393,6373.7305,8,6,2,4.982508870735012
22870,703-004-5380,1391.0383,6,2,4,1.4116961548810718
2298,703-004-5399,3075.0454,2,1,1,0.5165268771580819
23397,703-004-5383,4321.017,4,1,3,0.6823853315486506
23464,703-004-5385,2527.4365,3,2,1,0.7896339196182914
23497,703-004-5386,3546.5698,4,2,2,1.28058411493891
23554,703-004-5380,7176.366,4,0,4,0.27920371738274696
23706,207-008-2398,3155.8257,3,1,2,0.5786017793499253
23825,703-004-5389,8833.46,5,3,2,1.59642340163656
23837,703-004-5394,9620.09,5,3,2,1.063576651080886
24095,703-004-5380,4792.446,2,1,1,0.32666834933781397
24494,703-004-5395,196.14816,8,4,4,1.3410683279365216
24764,703-004-5387,7796.917,3,2,1,0.7071399366165977
25045,703-004-5396,9758.435,6,2,4,1.0065018665990393
25094,703-004-5393,6213.2495,6,2,4,1.0364946410409226
25360,703-004-5395,7556.7744,3,0,3,0.27920371738274696
25384,207-008-2399,7321.22,1,1,0,0.529189056578595
25613,703-004-5386,7703.166,1,1,0,1.072450690163015
25659,703-004-5393,3237.586,6,3,3,2.082843963791273
25964,703-004-5385,8796.186,4,2,2,0.9053199863603081
2607,703-004-5394,6723.6763,3,2,1,0.7331662089167369
26124,703-004-5383,1359.4723,2,2,0,0.5657792323382252
26221,703-004-5381,1865.2571,2,1,1,0.6221774846342005
26241,703-004-5385,476.67383,4,0,4,0.27920371738274696
2662,703-004-5385,9906.945,4,0,4,0.27920371738274696
26632,703-004-5395,3044.802,6,4,2,2.044445098929937
2689,703-004-5380,7255.9854,4,3,1,1.3451276267117114
26971,703-004-5399,5562.4824,6,5,1,2.499223707650409
27203,703-004-5387,8773.949,10,5,5,0.8427178340776067
275,703-004-5388,1526.2955,3,2,1,1.0650654404150734
2764,703-004-5383,1133.4365,4,2,2,0.9840722865363796
28006,703-004-5383,3781.6746,4,4,0,1.3033089654694747
28239,703-004-5386,5085.489,3,2,1,1.8404113663788046
28511,703-004-5393,2664.7168,6,4,2,2.042273093213495
28578,703-004-5386,6903.359,7,3,4,1.3538269339836881
28678,703-004-5383,5959.902,2,2,0,1.1490548703916263
28680,703-004-5398,5391.1196,7,2,5,1.1777232317892183
29007,703-004-5398,2126.2126,3,1,2,0.6419705670473427
29023,703-004-5395,7035.0854,4,2,2,0.6180484510619751
29044,703-004-5382,7850.345,8,3,5,2.0993633263988527
29149,703-004-5381,3948.3518,4,2,2,0.3859991392816477
2923,703-004-5382,9918.62,3,2,1,1.893219511905815
29586,703-004-5392,768.8302,5,2,3,0.42604742249373545
2960,703-004-5393,7802.316,5,3,2,1.3782670407849256
3005,703-004-5397,5773.7876,4,2,2,0.675905331531538
30099,703-004-5382,6533.935,4,3,1,1.3461653581590307
30175,703-004-5386,4989.2944,4,1,3,0.38228357543464303
30213,703-004-5392,373.4875,6,1,5,0.6998597663646654
30255,703-004-5392,1423.3082,8,5,3,1.6521932301494378
30305,703-004-5385,5925.139,2,1,1,0.8070513037815108
30331,703-004-5384,2831.729,4,3,1,1.2098519744839629
30428,703-004-5380,2671.6821,6,5,1,1.113228469142019
30490,703-004-5399,5143.265,2,1,1,0.45798374407602976
30524,703-004-5380,4527.053,4,4,0,1.0501122958334252
30595,207-008-2398,4477.6357,8,4,4,1.0374442727011621
3067,207-008-2399,9642.445,5,1,4,0.7125339573811798
31015,703-004-5389,7103.774,2,1,1,1.4313606491175557
3129,207-008-2398,6272.0757,5,5,0,1.3941275193191838
3130,703-004-5397,8139.8833,6,4,2,1.964505276887231
31526,703-004-5387,8422.174,2,2,0,1.0310714808131607
31685,207-008-2399,9635.331,3,2,1,0.5340945874708761
31758,703-004-5393,3770.0696,5,3,2,0.8641263500143773
31804,703-004-5382,3667.1704,1,1,0,0.9997027870862416
31820,703-004-5391,3797.465,4,1,3,0.5011865206675661
31984,703-004-5388,4214.2314,3,0,3,0.27920371738274696
32188,703-004-5398,4792.614,8,3,5,1.2269443721128677
32741,703-004-5388,4986.4097,4,1,3,0.665074694402457
32821,703-004-5383,9751.962,6,3,3,1.5138955225665844
32903,703-004-5391,8990.558,10,6,4,1.176558687472329
3303,703-004-5392,9404.59,3,0,3,0.27920371738274696
33178,703-004-5395,5167.7314,3,2,1,2.2547844498814493
33269,703-004-5399,1809.3324,1,1,0,0.35831143730785864
33292,703-004-5392,8133.031,6,4,2,1.506349016304758
33334,703-004-5394,9884.343,7,3,4,1.3225826869414272
3384,703-004-5381,8120.6167,3,2,1,0.6468075248286705
3388,207-008-2399,5189.8804,2,2,0,0.5797301215321151
34063,703-004-5392,3705.6047,2,1,1,0.44428049958026683
34094,703-004-5399,5965.2026,5,2,3,0.6302606641234767
34302,207-008-2399,2785.1475,"","","",0.27920371738274696
34380,703-004-5398,2573.7852,3,1,2,0.6841517419816552
3461,703-004-5398,6606.844,6,2,4,0.599273927134511
34610,703-004-5381,5752.52,3,2,1,2.2539506947867567
3462,703-004-5390,4709.48,5,1,4,0.3978652972704144
34642,703-004-5383,1279.7755,2,1,1,0.4759845431227463
35285,703-004-5396,5752.86,4,2,2,1.565407702237326
35454,703-004-5388,2417.307,4,2,2,0.7516640449344071
35495,703-004-5381,2156.6362,2,1,1,0.41961893861354455
3561,703-004-5386,1814.4869,5,5,0,1.9709668108855019
35717,703-004-5397,6844.099,9,4,5,1.341888678959598
35772,703-004-5387,4198.7695,3,3,0,1.2282866078266164
35866,703-004-5385,7353.8306,"","","",0.27920371738274696
36200,207-008-2399,9258.619,3,0,3,0.27920371738274696
36475,703-004-5393,9409.099,2,1,1,0.5308581826215876
36560,703-004-5395,5673.267,5,4,1,1.2251291495403216
36722,703-004-5392,4462.1206,7,2,5,0.6966839984392188
36872,703-004-5398,2382.6016,7,3,4,1.3070158980549844
36961,703-004-5398,9335.426,4,2,2,1.3434582502140864
3708,703-004-5387,6325.8926,6,3,3,3.1443837076661856
37456,703-004-5387,9357.21,3,0,3,0.27920371738274696
37505,703-004-5393,7283.5693,2,0,2,0.27920371738274696
37532,703-004-5388,1989.4844,4,3,1,1.2721060312578152
37564,207-008-2398,4735.311,6,1,5,0.3299645043346936
37574,703-004-5394,1223.4724,2,1,1,0.5110167782580598
37601,703-004-5388,2300.757,1,1,0,0.5112160324205517
37678,703-004-5392,2577.051,6,4,2,1.944170054624194
37773,703-004-5397,4132.8003,5,2,3,0.8295597233395096
37845,703-004-5388,1653.4895,9,3,6,1.6875761822791233
38005,703-004-5397,3107.9954,2,2,0,0.7204690732376552
38028,703-004-5388,1046.8364,4,2,2,0.9080205020882404
38371,703-004-5386,5491.568,3,2,1,0.5311386292544057
38401,703-004-5389,8811.425,4,1,3,0.3978652972704144
38454,703-004-5382,9290.922,5,4,1,1.0696008785295652
38510,703-004-5381,3219.5693,4,2,2,0.5770672313131222
38534,703-004-5399,3847.0208,4,3,1,1.28580441949521
38549,703-004-5380,416.14233,7,5,2,4.807109661771634
38767,703-004-5392,3612.4832,10,7,3,3.4683107614953816
38780,703-004-5386,5339.521,2,1,1,0.3807252912866403
38863,703-004-5399,1773.8975,4,3,1,1.2739316880911398
38957,703-004-5381,9658.573,1,1,0,0.49879249079183857
38976,703-004-5399,473.90936,5,3,2,1.4246685356796394
39029,703-004-5392,5623.5635,4,3,1,0.6648114299862392
39318,703-004-5396,9276.426,6,3,3,1.4041957133958511
39486,703-004-5391,1165.061,11,8,3,5.0256354685295985
395,703-004-5398,2808.5876,"","","",0.27920371738274696
39568,703-004-5396,4459.649,4,4,0,1.2267389434650773
39683,703-004-5387,570.88196,3,1,2,0.5037368110790809
39705,703-004-5381,1906.6208,2,2,0,1.7018601832942335
39767,703-004-5380,3401.1047,6,2,4,0.8126718252041901
40297,703-004-5381,9998.932,2,1,1,0.5633005726864132
40301,703-004-5390,5338.9385,4,2,2,0.6078894536446393
40415,207-008-2399,3995.7344,3,2,1,1.8733490020510577
40425,703-004-5393,7580.038,5,1,4,0.6678203915148578
40676,703-004-5385,9132.823,5,2,3,0.4382761575321589
40733,207-008-2398,8647.104,3,0,3,0.27920371738274696
40924,703-004-5388,6127.1196,7,5,2,2.7974132725514744
41041,703-004-5386,937.51135,4,4,0,1.5528769816016768
41291,703-004-5394,4017.3877,5,3,2,0.6747423170083051
41341,703-004-5387,1768.6814,2,2,0,0.5864981142089788
41603,207-008-2398,7637.8,4,2,2,0.7403229225765451
41739,703-004-5388,8747.222,4,1,3,1.2582686667777376
42318,703-004-5393,2445.9744,6,2,4,0.9304400939164598
42422,703-004-5395,7760.02,2,1,1,0.5711919761355576
42541,703-004-5388,3465.9136,3,3,0,0.8252489493516088
42545,703-004-5395,3364.9802,1,1,0,0.35831143730785864
42599,703-004-5392,9843.846,2,1,1,0.4879128571731377
42763,703-004-5384,5682.2783,3,1,2,0.5835235188139057
42988,703-004-5387,4672.088,6,1,5,0.7171932270357176
43165,703-004-5393,4761.8716,5,4,1,2.320680070422012
4332,703-004-5396,2884.6233,6,3,3,1.0577106356076522
43364,703-004-5382,997.4581,6,3,3,0.9157797333436584
43413,703-004-5387,3214.4053,4,2,2,1.1505401855445583
43938,703-004-5390,5816.6416,2,0,2,0.27920371738274696
44201,703-004-5384,1911.5663,4,3,1,2.948224626767325
4432,703-004-5387,2531.2578,4,2,2,2.2576522231403104
44356,703-004-5397,7399.5063,7,4,3,1.0629083419038956
44368,703-004-5399,2378.2605,1,0,1,0.27920371738274696
44459,703-004-5389,6939.7334,6,5,1,1.3632564538004508
44585,703-004-5394,473.71625,2,0,2,0.27920371738274696
44604,703-004-5386,3958.9292,3,3,0,1.2941640662250202
44707,703-004-5398,6254.831,8,4,4,1.1193775965142183
44815,703-004-5391,245.3506,5,4,1,2.0265926401248704
4503,703-004-5393,7731.335,4,2,2,1.0944305744354506
45188,703-004-5380,3346.1648,4,4,0,1.7440786400606796
45220,703-004-5386,8678.285,3,1,2,0.3978652972704144
45496,703-004-5389,3113.5237,"","","",0.27920371738274696
45741,703-004-5382,7275.261,6,4,2,1.6459354122671643
45834,703-004-5386,6123.1436,2,2,0,1.6771662914514407
4591,207-008-2399,3369.6604,4,2,2,0.9387898061803849
45921,703-004-5383,2360.2878,5,4,1,1.9299855528014558
46311,703-004-5393,6291.1255,5,2,3,0.607642137488341
46574,207-008-2399,6853.37,2,0,2,0.27920371738274696
46799,703-004-5389,93.32597,3,1,2,0.4880863425898346
46930,703-004-5395,106.121895,5,3,2,1.9979989902019017
47065,703-004-5395,8384.325,1,1,0,0.46779164331076767
47161,703-004-5392,7363.229,4,3,1,1.0038849275358175
47178,703-004-5399,2815.9678,2,2,0,0.5590946272422271
47430,703-004-5394,9852.12,3,3,0,0.7649160693552762
47674,703-004-5389,532.6444,6,2,4,0.7849863240864204
47769,703-004-5399,8720.711,2,1,1,2.1514364025722936
47869,703-004-5384,2678.4229,3,2,1,0.8084479182878361
48038,703-004-5394,9205.869,6,3,3,0.7603620522106241
48104,703-004-5393,8897.649,6,2,4,1.332967724391559
48192,703-004-5397,777.2273,2,2,0,0.45263746090483026
48240,703-004-5383,116.12356,2,0,2,0.27920371738274696
48579,207-008-2399,3521.9585,1,1,0,0.3978652972704144
49252,703-004-5386,8573.243,7,2,5,1.2334029645669025
49286,703-004-5392,9116.2295,3,1,2,0.8783384899021792
49311,703-004-5392,4994.536,6,3,3,1.4621128785026591
49409,703-004-5386,1730.051,4,3,1,0.9550755438396693
49432,703-004-5386,6279.912,4,4,0,1.1000462449146275
5080,703-004-5395,6146.319,7,4,3,1.2648561747540097
5223,703-004-5384,2404.9683,3,2,1,0.608942360659713
5232,703-004-5394,2176.0732,3,1,2,0.5204120160500231
5414,703-004-5387,8211.912,4,1,3,0.6733376042258765
5565,207-008-2399,2743.4563,4,3,1,1.8544532854330227
5587,703-004-5394,2690.314,4,2,2,0.3940681267140091
5748,703-004-5398,621.3653,5,5,0,1.8521717554571728
5850,703-004-5380,3364.871,6,0,6,0.27920371738274696
6326,703-004-5390,8952.579,2,2,0,0.5501327169367225
6849,703-004-5392,7606.157,3,0,3,0.27920371738274696
7408,703-004-5395,6500.7896,7,6,1,1.4168638510705747
7412,703-004-5394,5080.5103,3,1,2,0.42460472969839963
7671,703-004-5394,1930.0544,4,3,1,1.9488269046503617
7800,703-004-5392,6647.047,7,5,2,2.1540964342913513
7833,703-004-5384,3736.8489,2,1,1,1.0013733312992634
8065,703-004-5387,9124.118,2,2,0,0.6739679043283826
8564,703-004-5388,1851.2368,4,2,2,1.8998344522674413
8782,703-004-5392,3774.3342,5,3,2,1.5083122975517118
8879,703-004-5398,2199.5217,2,1,1,0.4567857159171366
8966,703-004-5399,1051.8801,4,2,2,1.1128208150444123
909,703-004-5388,8884.953,3,0,3,0.27920371738274696
9101,703-004-5394,7908.6016,5,3,2,2.057378693471452
9285,703-004-5396,6377.416,4,2,2,1.1608845112456696
9617,703-004-5398,1350.7568,5,2,3,0.7761163567766314
9740,703-004-5388,5221.6567,2,1,1,1.1267802741607962
9761,703-004-5399,4404.9946,7,6,1,1.8396799952725444
9785,207-008-2398,159.45792,4,2,2,0.47697301719552604
9841,703-004-5390,164.30199,5,2,3,0.4954500260499095
9899,703-004-5394,2851.5674,7,3,4,0.7504563795667233
11061,703-004-5383,2665.7153,3,0,3,0.27920371738274696
11197,703-004-5387,205.943,2,0,2,0.27920371738274696
11263,703-004-5380,8708.861,3,1,2,0.802885910052557
11934,703-004-5389,4092.9878,2,1,1,0.35114230018964543
12183,703-004-5386,3036.1772,4,3,1,0.7530877831844248
12194,703-004-5391,4127.2056,2,1,1,0.4014581062170133
12263,207-008-2398,9729.225,2,0,2,0.27920371738274696
12545,703-004-5390,362.60843,6,3,3,0.555264314053811
12834,703-004-5380,9877.998,8,5,3,2.286642524400422
12883,703-004-5390,6010.8145,2,2,0,0.43741915723297026
13522,703-004-5389,1647.1904,3,1,2,0.828010839782602
13604,703-004-5381,5201.812,1,1,0,1.2255489509003312
13665,703-004-5399,708.3046,1,0,1,0.27920371738274696
13752,703-004-5385,6143.3633,9,4,5,1.0910601502584267
14184,703-004-5391,9318.876,5,3,2,0.748631602262101
14322,207-008-2399,6872.195,3,1,2,0.33853450732658075
14329,703-004-5395,7766.079,5,2,3,0.9106388434651699
14489,207-008-2399,1110.6455,4,3,1,1.0824933678888033
14700,703-004-5395,5133.3276,"","","",0.27920371738274696
14853,207-008-2398,5997.292,6,2,4,0.8811350214462422
1488,703-004-5395,3219.9775,3,2,1,0.5572709280987812
14976,703-004-5399,4802.2886,4,3,1,0.8392542519762539
1519,703-004-5392,589.67413,2,0,2,0.27920371738274696
15206,703-004-5399,6430.1606,3,1,2,0.7604445907218681
15236,703-004-5386,7852.88,2,1,1,0.33853450732658075
15393,703-004-5396,9146.944,3,1,2,0.4337975069301488
15394,703-004-5398,1134.1279,2,2,0,0.5504890697406374
15533,703-004-5388,8985.581,4,2,2,2.1722353290310803
15670,703-004-5389,1788.8427,4,1,3,2.3664313553837037
16291,703-004-5380,6262.5205,"","","",0.27920371738274696
16380,703-004-5385,1392.7596,3,1,2,0.667592332494324
16695,703-004-5397,9149.284,5,1,4,0.9085373581295364
16976,703-004-5383,328.89963,3,2,1,0.606352238332946
17564,703-004-5385,2582.366,4,3,1,2.040355616626705
17657,703-004-5391,2884.7312,3,1,2,0.35114230018964543
17919,703-004-5385,6883.3784,5,2,3,0.7824554613195221
18162,703-004-5392,5303.6416,8,2,6,0.855452465417008
18175,207-008-2399,6191.5547,6,2,4,1.1912162289789614
18273,703-004-5396,8811.393,4,2,2,1.0679166141315453
18468,703-004-5389,1479.9363,4,1,3,0.47100804972823196
18507,703-004-5386,8959.827,4,2,2,1.4495026286646182
18748,703-004-5394,983.3765,6,4,2,1.734550447031554
18869,703-004-5398,9118.385,5,1,4,0.4446047751261679
19204,703-004-5393,2476.8125,6,3,3,1.4808586635510113
19382,703-004-5380,1800.1187,4,1,3,0.7499593737196206
19488,703-004-5397,1924.5154,1,0,1,0.27920371738274696
1954,703-004-5389,2926.6428,1,0,1,0.27920371738274696
19792,703-004-5382,9631.216,3,2,1,0.724002790127425
19820,207-008-2398,105.811356,2,1,1,0.35831143730785864
19851,703-004-5398,9282.517,7,5,2,2.0539861862537254
19981,207-008-2399,1356.2053,4,2,2,0.5124775507444151
20090,703-004-5398,1625.0544,4,2,2,0.6447652091922971
20217,703-004-5399,2640.3857,3,1,2,0.4414714501861341
20434,703-004-5396,624.4522,3,1,2,0.4314860782385869
20649,703-004-5387,8141.341,6,4,2,2.1351953285347873
20897,703-004-5389,6200.4805,5,2,3,0.9252240770297011
21061,703-004-5384,3568.2393,3,1,2,1.3560986887588369
21152,703-004-5391,6107.456,5,1,4,0.4514904429146495
2131,703-004-5393,4379.3477,5,2,3,0.6702899093902671
21395,703-004-5398,2697.6824,6,1,5,0.6388554586994643
21841,703-004-5386,411.4944,4,2,2,0.5105937981636984
22102,703-004-5383,5655.455,5,2,3,0.871340552282366
22396,207-008-2399,6230.2383,5,1,4,0.6895750101884113
22654,703-004-5385,6922.1626,3,2,1,0.719757904571227
22768,703-004-5383,9815.206,4,3,1,2.487977077197638
23142,703-004-5389,1573.236,10,4,6,2.255837227035186
2319,703-004-5387,4835.425,3,1,2,1.2866106789671612
23452,703-004-5386,2892.7778,3,2,1,0.570727746396648
23985,703-004-5385,9884.864,7,5,2,2.1192293099097794
24017,703-004-5393,3409.2253,2,0,2,0.27920371738274696
24257,703-004-5380,1002.19904,4,2,2,1.202266976476995
24384,703-004-5383,4153.853,4,4,0,1.623458882908657
24416,703-004-5388,1015.39136,1,1,0,0.33853450732658075
24496,207-008-2399,8312.45,4,3,1,1.7590587546867698
24614,703-004-5392,8734.14,1,1,0,1.080533721698367
24634,703-004-5391,4407.228,6,3,3,1.8040463580480797
24876,703-004-5381,212.42738,4,1,3,0.6496784792044842
25081,703-004-5396,4218.634,3,1,2,0.35831143730785864
25434,703-004-5386,2548.2744,3,1,2,0.57656833002081
2547,703-004-5392,9317.655,2,2,0,1.2046344688253008
25628,207-008-2399,6990.7256,3,1,2,0.7913968623063719
25805,703-004-5384,1211.558,5,4,1,1.4173641695364951
26094,703-004-5392,7954.646,5,1,4,0.6072071912675507
26257,703-004-5395,7200.382,3,1,2,0.3978652972704144
26486,703-004-5387,615.3488,2,1,1,1.0058790347818891
2676,703-004-5387,9140.146,4,3,1,1.0049085594625708
27286,703-004-5392,8049.0415,4,0,4,0.27920371738274696
27457,703-004-5388,1021.20337,6,5,1,1.3013204073480735
27556,703-004-5399,3744.226,5,1,4,1.6970966458869907
28066,207-008-2398,666.76733,2,2,0,0.7433856042121216
28375,703-004-5396,312.7575,1,0,1,0.27920371738274696
28424,207-008-2398,4792.5757,2,2,0,1.439379614988872
28834,703-004-5399,7659.0693,3,1,2,0.5165268771580819
29293,703-004-5380,5548.402,5,3,2,0.8310334935970275
29346,703-004-5392,8895.87,4,1,3,0.6584724031517248
30221,703-004-5386,2614.546,3,3,0,1.3633143331647273
30297,703-004-5384,7024.094,1,0,1,0.27920371738274696
30392,703-004-5398,7299.576,4,3,1,0.8338364480785967
31145,703-004-5381,3321.1196,5,4,1,2.2569626225961166
31666,703-004-5395,5013.842,6,2,4,2.0479457871785605
31703,703-004-5385,3685.3855,4,2,2,0.649038157275394
31733,703-004-5385,3257.2722,4,1,3,0.9481565225556626
31893,703-004-5398,6545.737,7,6,1,3.2892163476717045
32028,703-004-5394,6820.7407,2,1,1,0.42011278225422183
32294,703-004-5387,3076.235,6,3,3,1.2005719458750124
32525,703-004-5391,7267.6396,3,1,2,0.6451662707985288
32697,207-008-2399,7145.1016,5,2,3,0.8124023108846063
33030,703-004-5393,3835.7222,2,0,2,0.27920371738274696
33478,703-004-5398,6413.938,2,0,2,0.27920371738274696
3352,703-004-5396,5956.6284,9,3,6,1.5164705945540342
33724,703-004-5392,5079.5073,1,1,0,0.7207515784334751
33970,703-004-5382,3504.606,6,3,3,1.4004154047383448
33999,703-004-5391,7777.7915,4,2,2,0.4478620865322868
34104,703-004-5387,3355.6914,4,3,1,0.701204935587658
34117,703-004-5398,1981.1404,3,2,1,1.103392439467402
34660,703-004-5398,6130.668,2,2,0,1.4013057114568457
34700,207-008-2399,7234.5186,5,2,3,1.471817988426044
35081,703-004-5392,9042.41,6,3,3,1.032231611597244
35090,703-004-5398,3031.5132,4,4,0,1.2834284727575749
35097,703-004-5389,9349.697,2,2,0,0.4598330112117519
35664,703-004-5387,6431.0366,6,3,3,0.6366481848901787
3572,703-004-5398,458.20773,2,0,2,0.27920371738274696
35768,703-004-5392,5028.9517,3,1,2,0.5972156228534007
36033,703-004-5393,3924.049,2,2,0,0.4596682034619079
3607,703-004-5380,9117.119,5,1,4,0.42436923667441445
36155,703-004-5398,2224.6318,5,4,1,1.0373789779987719
36307,703-004-5391,9470.223,5,2,3,0.5292743408369304
36590,703-004-5380,5867.4976,7,3,4,0.8817351429546793
36639,703-004-5395,1018.21124,4,1,3,1.1027886142953298
3670,703-004-5386,8820.888,3,2,1,0.9525981846420467
36800,703-004-5387,8893.711,4,1,3,0.3978652972704144
37033,207-008-2398,5034.5083,2,0,2,0.27920371738274696
37238,703-004-5394,1087.2365,5,3,2,2.3980475677759694
37569,703-004-5383,9726.397,4,2,2,0.5445738564537961
37652,703-004-5385,8343.402,4,3,1,0.894841164199373
37683,703-004-5384,4264.9688,3,3,0,1.273517642560755
37922,207-008-2399,9739.64,3,2,1,1.147466198819986
38090,703-004-5399,8068.3984,4,4,0,2.8924313093276526
38114,703-004-5399,8649.092,4,2,2,1.348033004760233
38240,703-004-5394,2021.9487,4,3,1,1.1966609843654807
38455,703-004-5396,2971.8381,4,1,3,0.37175974969512765
38493,703-004-5380,6066.954,3,2,1,0.7805756252630415
38628,703-004-5389,859.4334,4,2,2,1.2094820904671264
38808,703-004-5386,5702.3184,6,1,5,0.3978652972704144
39003,703-004-5384,7058.025,3,0,3,0.27920371738274696
39092,207-008-2399,2392.06,3,1,2,0.4152817892036748
39284,703-004-5391,1266.287,4,2,2,1.0274464270998298
39453,703-004-5386,318.58206,4,2,2,2.0147251661096135
3947,703-004-5386,4474.6055,4,3,1,1.3648766711239773
39559,703-004-5393,8179.4917,3,3,0,1.2434772230909719
39626,703-004-5391,1534.0519,7,3,4,0.9268412009313696
39674,703-004-5392,9225.919,2,2,0,0.5703698505786836
39756,703-004-5385,5067.9487,1,0,1,0.27920371738274696
40225,703-004-5392,6256.0674,6,3,3,2.050731481154784
40553,703-004-5388,6192.0635,7,3,4,0.8926068143481534
40672,703-004-5393,5072.91,2,1,1,0.4691540017214045
40950,703-004-5394,135.19406,3,3,0,0.7304103422477929
40952,703-004-5395,859.50854,6,3,3,1.151177503660924
41028,703-004-5386,9340.477,4,1,3,1.2207999746048024
41100,703-004-5387,8828.721,4,2,2,0.4351548496705591
41323,703-004-5389,2835.3662,1,0,1,0.27920371738274696
41342,703-004-5394,649.1822,3,1,2,0.9006906315492483
41569,703-004-5387,9151.035,6,3,3,1.733270966669293
41697,703-004-5381,4930.614,2,1,1,0.5428290549255067
41751,703-004-5395,8563.626,8,2,6,0.4860423826059786
41820,703-004-5398,6358.6216,3,2,1,1.023256724424518
41974,703-004-5395,95.98851,6,2,4,1.829990556892744
41977,703-004-5383,1434.8817,6,5,1,2.167139787459024
42458,703-004-5396,3440.6836,1,0,1,0.27920371738274696
42512,207-008-2399,2901.5505,4,2,2,0.7684844789522601
42517,703-004-5397,5311.6987,4,0,4,0.27920371738274696
42648,703-004-5387,1171.4495,1,1,0,0.33853450732658075
42658,703-004-5388,3572.9385,3,2,1,0.556934925029716
4267,703-004-5397,9185.433,3,2,1,0.774691460170937
42786,703-004-5399,5944.765,4,1,3,0.4021739603523429
42906,703-004-5391,5118.6055,4,2,2,1.6087434409491712
43020,703-004-5381,4155.1978,6,5,1,2.4855545631671974
43442,703-004-5393,2444.4778,6,1,5,0.5421501568824405
43645,703-004-5398,162.10913,2,1,1,0.37512182779194486
43920,703-004-5386,7034.7314,3,2,1,0.9866200628452824
4414,703-004-5397,9788.603,3,2,1,1.0249186825207994
44324,703-004-5388,9186.718,4,3,1,1.0218576069612313
44891,703-004-5394,6193.4,6,5,1,1.7336566990896825
45221,703-004-5389,5947.355,8,2,6,0.8962763968914274
45250,703-004-5388,4496.212,6,3,3,0.6337603221810716
4539,703-004-5398,6424.825,5,3,2,0.9554457132053917
45408,207-008-2398,5429.8125,2,1,1,0.6022613169071561
45531,703-004-5385,4442.9473,3,0,3,0.27920371738274696
45746,703-004-5398,9335.36,7,1,6,0.6409541381122656
45763,703-004-5381,1199.4099,5,2,3,0.9932899168512098
4608,703-004-5380,8057.577,7,2,5,0.7271216989360262
46312,703-004-5380,8713.117,2,1,1,0.4271927197880031
46316,703-004-5382,9795.56,2,1,1,0.3978652972704144
46368,703-004-5380,3048.8152,3,0,3,0.27920371738274696
4642,703-004-5397,8555.215,5,2,3,0.8030193185617126
46568,703-004-5382,9844.793,3,1,2,0.6234232776721358
46579,703-004-5393,8608.915,5,4,1,3.8568636970952133
47254,207-008-2398,257.79068,1,0,1,0.27920371738274696
47391,703-004-5390,6717.8647,4,2,2,1.0670662514301625
47406,703-004-5392,6247.8433,8,2,6,2.0550939123326146
47463,207-008-2399,3948.2378,2,1,1,1.2513884013349972
47901,703-004-5394,2668.5662,3,2,1,0.7846947135252734
48232,703-004-5386,3532.7388,5,2,3,0.4684657887888556
4825,703-004-5393,2776.134,7,2,5,0.5442145791318709
48349,703-004-5380,7837.441,6,2,4,0.48745479008560333
48465,703-004-5394,4890.069,5,2,3,0.5426737840375818
48632,703-004-5394,3603.0935,4,1,3,0.45785586229348174
48717,703-004-5381,7854.4424,3,0,3,0.27920371738274696
48953,703-004-5386,5683.4214,4,1,3,0.4225328611223202
49074,703-004-5383,3112.4324,4,3,1,0.8850950634564346
4929,703-004-5388,9074.968,3,2,1,0.5805006666178802
49375,703-004-5381,5916.132,3,2,1,0.5455076402561801
5129,703-004-5395,6284.333,4,3,1,1.8410922672781365
5173,703-004-5383,8745.237,3,1,2,0.6614740782098187
5308,703-004-5383,7529.519,1,0,1,0.27920371738274696
5443,703-004-5387,7428.2925,7,5,2,1.1434738322063007
5662,703-004-5384,1490.8844,8,3,5,1.3426879754445566
5712,703-004-5387,6186.33,4,3,1,1.4940265242374258
5870,703-004-5380,9675.231,3,3,0,1.3166324242166252
6057,703-004-5387,7013.0444,3,2,1,0.5531045031882094
6067,703-004-5399,6833.315,3,1,2,0.7396167452005958
6203,703-004-5383,3155.4658,4,2,2,2.5788722131607145
6514,703-004-5394,15.566349,5,2,3,1.2755435885866335
6652,703-004-5399,4474.7495,7,3,4,1.136010916448808
6714,703-004-5390,5643.2397,6,3,3,1.7027408172527085
6896,703-004-5395,6396.163,6,5,1,2.244988549543338
6929,703-004-5384,7782.252,5,2,3,0.5801448229701356
697,207-008-2398,7945.076,5,2,3,1.1576602946817014
7018,703-004-5393,3756.6924,1,0,1,0.27920371738274696
7202,703-004-5383,3578.6934,5,1,4,0.43404458121512324
7212,703-004-5391,9865.257,3,1,2,0.5079948757154971
7401,703-004-5388,6184.3037,1,1,0,0.657155118656467
7729,703-004-5394,5391.359,4,1,3,0.4564293063101202
7975,703-004-5380,677.58856,2,1,1,0.45617324946692395
8160,207-008-2399,3920.0962,4,4,0,1.3242477937150108
8255,703-004-5387,5145.9507,"","","",0.27920371738274696
8455,703-004-5390,1787.0306,4,2,2,0.5495967568430482
8724,703-004-5392,1483.2395,"","","",0.27920371738274696
8741,703-004-5380,3720.1797,2,2,0,0.4212350361982912
8846,703-004-5380,817.90924,4,2,2,1.8802229753455872
8927,703-004-5381,6071.5557,3,3,0,1.2353557933244845
9008,703-004-5381,8865.419,4,1,3,0.3874144629789273
9131,703-004-5393,4346.912,1,0,1,0.27920371738274696
9300,703-004-5399,9003.841,6,2,4,0.8393418161092975
10597,703-004-5390,6640.8843,1,1,0,0.43916463654075477
1074,703-004-5395,6659.227,6,3,3,1.3112713926162258
10770,703-004-5395,6149.4536,4,3,1,1.744727790013683
10960,703-004-5395,3753.9429,2,1,1,0.3978652972704144
11050,703-004-5390,6944.752,4,1,3,0.8043077836276314
11063,703-004-5389,500.3774,2,1,1,0.3978652972704144
1143,703-004-5399,9614.218,3,2,1,0.6150262197013437
11518,703-004-5397,3306.7847,3,2,1,0.8935233077861959
11554,703-004-5388,8554.038,5,4,1,1.6175964497075983
11555,703-004-5380,293.56064,6,3,3,1.5838968875509138
11675,207-008-2398,2031.5302,6,3,3,1.121662174483131
11681,703-004-5382,3360.4675,4,0,4,0.27920371738274696
11787,703-004-5389,4199.4453,2,1,1,0.513721058697963
11861,703-004-5384,3771.0522,6,3,3,0.6903217741543851
11884,703-004-5393,9332.692,3,2,1,0.6360802729820926
12016,703-004-5391,4714.9473,6,1,5,0.6367549547080165
12384,703-004-5385,246.43182,3,1,2,0.7534157047017801
12523,703-004-5388,6658.0264,3,1,2,1.0069102033823571
12738,703-004-5386,3755.6858,4,1,3,0.33853450732658075
12924,703-004-5390,4315.784,3,2,1,1.8697082746781661
13471,703-004-5386,8898.511,3,0,3,0.27920371738274696
13473,703-004-5389,5298.254,1,1,0,0.6328105327117025
1357,703-004-5399,8641.744,3,0,3,0.27920371738274696
13599,703-004-5384,7179.0664,5,2,3,1.045313620070004
13955,703-004-5392,9238.588,6,1,5,0.32666834933781397
13995,207-008-2398,3960.6829,4,2,2,0.8051443144192786
14028,703-004-5384,4771.9834,7,5,2,1.6789614558553128
14126,703-004-5387,593.4501,5,4,1,1.2887175084577247
14291,703-004-5391,4682.098,4,3,1,1.340606100316213
14503,703-004-5382,3532.6438,4,2,2,1.058195576861933
14601,703-004-5383,2554.8613,3,3,0,2.3493290452709794
14642,703-004-5380,1428.8545,9,4,5,1.4882668436897593
1475,703-004-5383,9597.055,4,3,1,1.5223200051150974
14926,703-004-5383,7882.478,4,2,2,1.0005990352602954
15072,703-004-5397,5586.211,3,1,2,0.493672404270495
15475,703-004-5398,2331.9714,6,3,3,1.7367455264526186
1565,207-008-2398,2062.9014,6,4,2,1.3217191672569482
15880,207-008-2398,1827.8611,3,3,0,1.1440005990637858
15945,703-004-5397,7001.3105,3,2,1,0.924426473703349
15980,703-004-5381,9007.508,7,5,2,1.873164942297364
16,703-004-5394,1064.8656,4,2,2,0.7977422318578014
16044,703-004-5392,6235.453,5,2,3,0.5692289869231401
1613,703-004-5383,7352.2275,6,4,2,2.0657615655986676
16516,703-004-5393,8073.8545,5,3,2,2.601978817469083
16594,703-004-5385,5132.512,2,1,1,0.4045400111390957
16925,703-004-5386,3249.6494,1,1,0,0.49610335779475473
1696,703-004-5390,5368.4844,5,2,3,1.4140323733083326
16994,207-008-2399,3241.2297,3,2,1,0.7384336726632724
1711,703-004-5386,8780.705,4,3,1,1.954011244066912
17164,703-004-5383,5942.924,4,2,2,0.8324514389589589
17237,703-004-5395,9607.632,6,3,3,2.524594289665535
17363,703-004-5391,9633.906,7,5,2,3.9294174642216704
18068,703-004-5393,5617.8057,7,4,3,1.8573558275642554
18874,703-004-5393,39.958954,3,2,1,0.8899104650821673
18945,703-004-5380,8899.462,1,1,0,0.35831143730785864
1919,703-004-5399,9925.843,8,5,3,1.6154011841351978
19274,703-004-5383,5638.417,1,0,1,0.27920371738274696
19363,703-004-5384,5274.823,2,1,1,0.8023022632416531
19479,703-004-5391,3373.545,6,3,3,1.160790338225399
19930,703-004-5391,636.82556,3,1,2,0.534211550980157
2005,703-004-5388,131.60168,3,0,3,0.27920371738274696
20205,703-004-5383,1022.53973,4,2,2,1.0622514515091168
20964,703-004-5392,1228.7473,4,1,3,0.5165268771580819
21349,703-004-5395,8122.135,8,3,5,1.8627862572937077
21513,703-004-5396,2632.7114,2,2,0,0.48817994418491684
21548,703-004-5388,9245.919,2,2,0,0.8780316711135836
21590,703-004-5392,5910.54,7,5,2,2.484928797217517
2167,703-004-5391,4601.75,8,5,3,1.9527438747988897
21892,703-004-5387,4660.8096,2,0,2,0.27920371738274696
21980,703-004-5396,9324.6875,5,3,2,2.8178405804510422
22145,703-004-5394,9867.331,4,3,1,1.1756329340942244
22198,703-004-5386,4378.883,5,3,2,1.0914704378851172
22265,703-004-5392,6478.8716,4,4,0,1.7656262792443211
22372,703-004-5395,728.0845,2,1,1,0.5411908004894169
22638,703-004-5388,8311.975,2,1,1,0.42555299924420353
23106,703-004-5398,4153.783,3,2,1,0.9463304500655842
23108,703-004-5380,7031.757,3,1,2,0.35831143730785864
23787,703-004-5394,6983.553,2,2,0,2.305546694711245
23884,207-008-2398,932.3442,4,0,4,0.27920371738274696
24233,703-004-5381,6819.0396,3,2,1,1.336411522743799
24313,703-004-5390,5181.612,3,3,0,0.905102437635529
24447,703-004-5380,5219.018,3,2,1,0.5479473245980806
24459,207-008-2399,4540.5454,7,5,2,1.225842848750162
24503,703-004-5395,1208.3489,4,0,4,0.27920371738274696
24719,703-004-5389,8166.565,8,3,5,0.6934067946781363
24763,703-004-5399,3146.1804,4,0,4,0.27920371738274696
24788,207-008-2398,4754.292,4,1,3,0.4344158834388463
24940,703-004-5392,4478.7954,5,2,3,1.249535865146506
251,703-004-5394,9524.197,4,3,1,0.8981554534250864
25456,703-004-5396,9173.69,4,2,2,0.6594332855707058
25465,703-004-5383,5682.87,3,2,1,0.6752129223143323
25934,703-004-5388,7405.366,2,1,1,0.7911214808683369
26019,703-004-5394,6889.6987,3,3,0,1.0996044386942498
26325,703-004-5385,1064.3822,6,1,5,0.37512182779194486
26368,703-004-5399,6718.9336,5,1,4,1.9644270458336366
26484,703-004-5390,2766.3828,5,4,1,2.991512702462688
26573,703-004-5382,1782.5204,7,3,4,2.7525532848069347
26676,703-004-5396,8725.025,5,3,2,0.836577951672959
26814,703-004-5397,3087.4448,2,2,0,1.629923374883269
27802,703-004-5386,9081.932,3,2,1,1.0698985352390933
27894,703-004-5390,9989.5625,3,2,1,0.7981990206549746
27943,703-004-5396,1501.0052,5,2,3,0.7465715254849923
28081,703-004-5387,9865.84,1,0,1,0.27920371738274696
28222,703-004-5395,6636.7495,5,3,2,0.8052757460333375
28268,703-004-5386,9188.302,8,2,6,0.8530849191457438
28380,703-004-5390,291.3201,3,3,0,1.0140172175343072
28434,703-004-5384,7026.681,7,6,1,3.3996076775555877
2862,703-004-5397,8727.103,6,4,2,1.959596114919433
28650,703-004-5398,5056.3955,2,2,0,0.41764222725169237
28926,703-004-5380,7668.5166,2,1,1,0.5087519831675901
28971,703-004-5399,9146.234,4,0,4,0.27920371738274696
29138,703-004-5382,4677.0737,5,1,4,0.35831143730785864
29377,703-004-5384,6140.5117,5,4,1,4.2092981526543785
29482,703-004-5381,4272.166,5,2,3,1.32003794846893
2977,703-004-5388,2841.8577,3,1,2,0.5024505839042261
30105,703-004-5387,5601.1973,2,0,2,0.27920371738274696
30106,703-004-5380,8617.455,7,3,4,0.832225904035488
31018,703-004-5387,6670.1865,3,1,2,0.44914706329079523
31143,207-008-2399,211.66682,3,2,1,1.3833736644935515
31370,703-004-5395,8913.762,6,4,2,2.286881377736895
31543,703-004-5388,9615.139,4,1,3,0.5562267636120339
31588,703-004-5390,2770.844,5,4,1,2.350781663705305
32004,207-008-2398,4146.7466,3,1,2,0.7396210026682523
32309,703-004-5381,8810.451,9,3,6,0.8841347250368585
32354,703-004-5389,5285.9478,2,0,2,0.27920371738274696
32417,703-004-5392,1780.228,"","","",0.27920371738274696
32475,703-004-5381,5271.0176,8,2,6,0.9276341979354514
3251,207-008-2399,3884.1016,4,3,1,0.9045571399421491
32865,703-004-5386,2843.5498,3,1,2,1.038367498215127
33010,703-004-5398,9318.239,4,2,2,0.5432237500386138
3315,703-004-5395,1267.2257,4,1,3,0.8208116224337889
33482,703-004-5390,3744.3394,4,3,1,1.3287725970181192
3354,703-004-5398,9367.665,4,2,2,0.7220624994416227
33649,703-004-5396,7246.904,8,7,1,4.161688812061052
34138,703-004-5385,1319.5425,2,1,1,0.4729669001383076
34564,703-004-5388,9126.349,2,0,2,0.27920371738274696
34592,703-004-5388,7950.5557,6,4,2,2.261533371062781
34676,207-008-2399,6297.351,4,1,3,0.7033787460614012
34804,703-004-5380,5239.571,3,3,0,0.7941086518130445
34881,703-004-5394,4819.6953,4,1,3,0.5619902275787334
34925,703-004-5383,5212.8267,2,1,1,0.8308721162277203
34929,703-004-5396,3830.8699,4,2,2,1.0064125364303567
34954,703-004-5391,4934.307,8,3,5,1.3122644182534973
35,703-004-5396,1959.6875,4,2,2,1.3460822522163087
35303,703-004-5387,6278.0483,3,1,2,1.192621199867653
35364,703-004-5381,9938.851,3,1,2,0.47681736137623665
35380,207-008-2399,1827.1011,4,4,0,3.2306817084018253
35401,703-004-5383,9861.611,7,2,5,0.7248428913380317
35605,703-004-5391,4850.9736,4,2,2,1.1073576704314725
35725,703-004-5393,7972.2856,4,0,4,0.27920371738274696
35747,703-004-5399,829.646,8,7,1,1.9930083372408909
3605,703-004-5388,9602.781,2,1,1,0.882021147059449
3649,703-004-5385,5721.497,2,1,1,1.0038538545919695
36792,703-004-5392,8809.286,8,2,6,0.6633419811943778
37007,207-008-2399,6050.6006,6,5,1,1.209319628909384
37056,703-004-5380,7076.7085,6,1,5,0.6686898767086698
37135,703-004-5384,8772.355,3,2,1,0.8830654812360629
37449,703-004-5382,3258.005,2,1,1,0.8663120928825141
37762,703-004-5389,6761.0835,6,2,4,0.9887557137763655
38159,703-004-5387,7418.0137,8,5,3,1.332992216211982
38657,703-004-5386,8652.947,5,1,4,0.35831143730785864
38763,703-004-5383,9774.335,4,1,3,0.5799951069478398
38855,703-004-5388,9567.044,4,2,2,0.7098668334358305
38878,703-004-5396,9312.207,4,3,1,1.503759396535421
38921,703-004-5382,1226.9133,5,2,3,0.42635890914094055
38952,703-004-5397,3866.0645,3,3,0,1.5942859765930144
39028,703-004-5385,3566.0393,8,8,0,5.409018431578369
39116,703-004-5386,4006.7583,5,1,4,0.4143460722548127
39190,703-004-5396,3849.1218,2,2,0,2.3562651537116786
3929,703-004-5383,6421.741,2,1,1,0.6114737687532793
39501,703-004-5390,3461.2722,7,5,2,1.3370667302719703
39736,703-004-5388,7474.8896,6,4,2,0.7185391805723824
39932,703-004-5386,3534.987,2,0,2,0.27920371738274696
40074,207-008-2398,4322.7275,2,1,1,0.46258530063414643
40109,207-008-2399,8261.527,1,1,0,0.3792997042504898
40510,703-004-5397,458.4223,3,1,2,2.5237946172903345
40641,703-004-5390,2770.195,2,1,1,0.3740141244043647
4086,207-008-2398,4835.916,4,3,1,1.9461109402843326
40994,703-004-5397,6303.1934,4,3,1,1.186992066929214
41850,703-004-5382,7684.7383,5,5,0,1.5223328026846612
41973,703-004-5381,8795.197,4,3,1,2.7160718235017933
4198,703-004-5385,2598.0698,6,4,2,1.4097288765163114
42065,703-004-5394,3791.337,2,2,0,2.7715223629462367
42401,703-004-5399,9826.952,7,4,3,1.854840988818134
42421,703-004-5396,1591.4309,3,2,1,0.7030708711514986
42557,703-004-5398,7341.49,4,2,2,0.4700416152564627
42948,703-004-5382,2302.3188,3,3,0,1.7515499341014018
43129,703-004-5396,4460.5205,3,1,2,0.8580976784323199
43151,703-004-5381,8371.137,3,2,1,1.0137346248544767
43182,703-004-5386,6630.211,3,2,1,1.05190547799456
43381,703-004-5393,399.8685,7,6,1,2.0893906975868357
43439,703-004-5394,852.4221,2,1,1,0.7247672577738135
43543,703-004-5381,8738.872,3,1,2,0.35831143730785864
4365,703-004-5387,5331.7666,4,4,0,2.1151052083526407
43858,703-004-5381,8639.471,1,0,1,0.27920371738274696
44212,703-004-5399,7943.467,5,1,4,0.47337795893597145
44308,703-004-5393,9598.714,5,2,3,3.0436861655264833
44702,703-004-5387,4504.5103,4,1,3,0.35831143730785864
44767,703-004-5395,1217.2335,2,1,1,0.5777364754501371
44791,703-004-5389,3042.7593,4,2,2,0.6244751786476299
44811,703-004-5380,7060.548,5,3,2,4.467118700628073
44894,207-008-2398,9933.718,3,0,3,0.27920371738274696
45014,703-004-5391,8270.9795,7,5,2,2.5044877639841836
45148,703-004-5386,3093.0334,3,1,2,0.42041529696934515
45224,703-004-5395,6220.1797,7,3,4,1.3763833390818083
45356,703-004-5397,2788.1086,2,1,1,0.46620935168327526
4540,703-004-5380,9980.058,2,0,2,0.27920371738274696
45440,703-004-5396,6421.32,1,0,1,0.27920371738274696
45495,703-004-5386,6835.117,3,1,2,0.5165268771580819
45501,703-004-5389,1071.9932,4,2,2,0.6348588415460613
45792,703-004-5393,4178.952,2,2,0,1.05739376619547
45951,703-004-5389,4283.957,4,4,0,2.6078991563084375
46199,703-004-5384,3340.8813,3,1,2,0.4717199083532593
4633,703-004-5399,1796.3188,5,1,4,0.33816665642892896
4653,703-004-5383,3959.31,6,5,1,2.9145056992659195
46557,703-004-5383,1753.453,2,2,0,0.6039903500002833
47205,703-004-5381,8383.63,3,0,3,0.27920371738274696
47363,703-004-5397,8765.93,2,0,2,0.27920371738274696
47378,207-008-2398,505.67508,4,3,1,2.1763414014098643
47885,703-004-5391,7294.3735,1,1,0,0.6489849654113504
47888,703-004-5390,8514.262,3,2,1,0.503185734565202
47892,703-004-5396,5672.377,3,2,1,0.49303447947105966
47911,207-008-2398,3482.455,8,3,5,1.6351145241386997
48001,207-008-2399,9872.378,5,3,2,1.1473596826884926
48219,703-004-5384,2187.0845,3,2,1,0.48224686519053356
48261,703-004-5396,6241.2407,4,2,2,0.8019513656589771
48640,703-004-5392,4573.7764,3,0,3,0.27920371738274696
4874,703-004-5381,1939.8004,4,2,2,0.6837161354651267
488,703-004-5395,6584.3345,2,2,0,1.650960704092905
48927,703-004-5399,9914.56,3,1,2,1.1464407272011303
49235,703-004-5387,653.224,4,1,3,1.0713921287669925
49245,703-004-5399,8816.985,6,2,4,0.9065527194273292
49247,703-004-5389,7539.3057,9,2,7,1.1599804189890202
4930,703-004-5384,2569.112,3,2,1,0.9232773202917933
49552,703-004-5385,6200.3076,1,0,1,0.27920371738274696
49883,703-004-5395,6591.323,4,4,0,1.850665433485643
4989,703-004-5387,3424.6218,2,2,0,1.1906916199164037
5195,703-004-5385,8233.968,1,0,1,0.27920371738274696
52,703-004-5380,9991.962,2,1,1,0.3422921240230235
5285,703-004-5391,1792.2562,1,1,0,0.45417036186964266
5469,703-004-5398,8973.3545,3,1,2,0.5464855505686076
5525,703-004-5385,6939.6587,2,1,1,0.4568149900804321
5845,703-004-5386,7919.449,7,5,2,1.1034194170671836
5934,703-004-5386,7718.115,4,3,1,0.683954697331599
6118,703-004-5389,1965.5496,2,0,2,0.27920371738274696
6173,703-004-5386,9628.557,3,2,1,0.5065549280169607
634,703-004-5386,7382.8257,5,4,1,1.121881752230729
644,207-008-2399,88.597534,3,1,2,0.7083224866982576
6886,703-004-5384,6310.6616,4,3,1,1.4478719155467903
7185,703-004-5395,3857.9702,3,1,2,0.32666834933781397
7222,703-004-5392,2159.8804,5,2,3,0.7496421661811108
7313,703-004-5399,3631.0261,4,3,1,0.6690982882540655
7323,207-008-2399,5647.0986,4,2,2,1.4066453081851833
742,703-004-5384,9653.07,3,1,2,0.7846640649304327
7590,703-004-5392,9094.91,6,3,3,0.6735208608012012
7629,703-004-5397,8732.169,4,3,1,1.2233480771117926
7715,703-004-5392,7588.6304,7,1,6,0.35831143730785864
8071,703-004-5384,6042.5938,9,7,2,2.7537411951047943
8546,207-008-2399,7508.936,7,5,2,2.3229743091419905
9591,703-004-5392,5881.947,3,2,1,0.6674562564360732
9598,703-004-5381,681.19226,3,1,2,0.44955250753606574
973,703-004-5381,7506.602,2,2,0,0.7655642123398793
9815,703-004-5399,14.441609,7,3,4,1.7632257513268286
0,703-004-5397,5611.028,4,3,1,1.509171081857738
10000,703-004-5395,9803.058,2,1,1,0.853648029434261
10291,703-004-5399,2732.8123,3,0,3,0.27920371738274696
10424,703-004-5387,5403.852,4,2,2,1.5804631945661927
10457,207-008-2398,8759.677,4,2,2,0.6193739024909171
10475,703-004-5397,3006.3909,5,4,1,1.0701292899260986
10837,703-004-5397,7788.124,2,1,1,1.0703996737769064
10841,703-004-5398,3108.504,6,2,4,1.3860905659010276
10932,703-004-5382,4098.373,5,1,4,0.8237444985398911
11154,703-004-5380,7813.8335,3,1,2,0.5045406319759193
11314,703-004-5398,5660.355,5,2,3,0.9736981998751868
11343,703-004-5383,4744.8047,4,2,2,0.6808868385434991
11448,703-004-5385,5954.0317,4,3,1,2.410954269541478
11486,703-004-5396,95.59214,4,1,3,0.43778997467011915
11579,703-004-5387,8370.532,4,2,2,0.8799049011111059
11796,703-004-5385,9953.729,5,4,1,1.251565701753658
11802,703-004-5388,5136.217,3,3,0,2.4907225683418415
11843,703-004-5398,5367.953,2,0,2,0.27920371738274696
11870,703-004-5380,4505.452,3,1,2,0.5089744836421741
11984,703-004-5394,4010.7822,4,3,1,1.3330817408208007
12430,703-004-5381,7434.9707,2,1,1,0.3805394705486912
12612,703-004-5388,4683.7915,3,1,2,0.40447480700475974
12656,703-004-5386,9844.965,4,2,2,0.6117120672232144
12666,703-004-5391,9492.27,2,2,0,0.9664069834981553
1303,703-004-5395,7715.8594,5,1,4,0.35831143730785864
13063,703-004-5382,7136.4355,1,1,0,0.5242224631842495
13094,703-004-5392,4618.7026,3,1,2,0.3978652972704144
13658,703-004-5394,2962.8188,4,2,2,0.8546450649548116
13702,703-004-5392,1754.97,6,1,5,0.5323001371675478
14139,703-004-5380,9471.826,4,0,4,0.27920371738274696
1428,703-004-5391,4488.487,3,2,1,1.7576906088694895
14383,703-004-5385,5200.099,3,2,1,3.6276022536014594
1457,703-004-5390,4735.8823,3,1,2,0.7344987557816222
14590,703-004-5387,2158.4404,6,3,3,0.6367706114442515
1476,703-004-5396,5495.4927,9,4,5,1.5121993241474543
14781,703-004-5390,3021.8982,6,1,5,0.4893007002904981
14849,703-004-5386,8548.718,5,3,2,0.7731653122134056
14936,703-004-5399,3879.4976,4,1,3,0.3883950655014524
15101,703-004-5399,2978.2837,3,1,2,1.504645764047381
15808,703-004-5385,4357.664,3,1,2,0.5039453843958521
15907,703-004-5386,983.6906,3,2,1,1.3766781966117672
15964,703-004-5382,4756.838,2,2,0,1.145219378952299
16211,703-004-5395,2362.4216,"","","",0.27920371738274696
16526,703-004-5392,3980.6301,5,4,1,1.4578208336115264
16921,207-008-2399,8569.029,5,3,2,0.8971621412166049
16988,703-004-5391,2446.7212,4,3,1,0.8056784409848273
17023,703-004-5399,2971.6409,2,1,1,0.8336816119713542
17064,703-004-5391,383.87955,6,2,4,0.8635236398533567
17092,703-004-5385,9861.302,2,0,2,0.27920371738274696
17255,703-004-5398,3714.263,7,3,4,1.6438179108307447
17538,207-008-2398,3244.9067,6,4,2,1.2232410261242082
17854,703-004-5395,9010.827,4,2,2,1.1149002056386612
17916,703-004-5393,4335.484,4,2,2,0.7865195598600097
17928,703-004-5394,2669.798,4,3,1,1.7772547619016434
17958,207-008-2398,8945.152,1,0,1,0.27920371738274696
187,703-004-5397,2029.0703,5,3,2,0.7796699015005817
18766,703-004-5391,4868.581,4,1,3,0.4190501798586095
18848,703-004-5382,1332.0482,6,4,2,1.5557935051178258
19050,703-004-5398,97.507835,2,1,1,0.39907663423176776
19233,703-004-5397,1302.5332,5,1,4,0.3978652972704144
19400,703-004-5390,6339.062,3,1,2,0.4768644834254133
19426,703-004-5397,1823.067,2,1,1,0.4258686060851547
19722,703-004-5399,3323.0425,3,3,0,0.7299914598290267
19879,703-004-5387,8020.6265,3,1,2,0.39753897792572335
2000,703-004-5397,632.0357,5,2,3,0.7255786264053916
20039,703-004-5385,559.6161,1,1,0,0.7107017529619792
20100,703-004-5383,5561.5854,3,1,2,0.6145046290290695
20145,703-004-5398,2771.501,4,2,2,0.8403833520707036
2035,703-004-5396,7847.6206,3,2,1,2.657697197340072
20728,207-008-2398,1959.6737,8,4,4,1.5473540826128367
20895,703-004-5385,9133.128,3,2,1,1.740212986045328
21024,703-004-5389,6076.202,1,1,0,0.6854090127401546
21211,703-004-5382,1828.5316,4,2,2,1.0372147789706374
21799,703-004-5394,1539.4259,3,0,3,0.27920371738274696
22063,703-004-5396,1549.0353,5,4,1,4.254706289665493
22065,703-004-5390,9592.505,1,1,0,0.48801060983729216
22147,703-004-5396,3930.2356,4,2,2,0.5231841109886995
22316,207-008-2399,7834.1865,5,2,3,0.45719608721424815
22575,703-004-5384,2491.07,5,1,4,0.49055112379113175
2303,703-004-5387,5396.723,2,2,0,0.897826729749126
23092,703-004-5388,8020.518,2,0,2,0.27920371738274696
23376,703-004-5384,1384.5015,5,3,2,1.6992098835889717
23379,703-004-5394,1984.1522,3,0,3,0.27920371738274696
23427,703-004-5390,1951.1521,5,2,3,0.7757325984927004
23488,703-004-5382,252.77435,6,3,3,2.051812142394595
2390,703-004-5387,1761.4413,3,1,2,0.41513418539082786
24430,703-004-5382,9128.413,7,2,5,0.616638214314996
24673,703-004-5380,82.23235,2,1,1,0.45602516749212313
24726,703-004-5391,2904.61,"","","",0.27920371738274696
25116,703-004-5394,8460.903,1,1,0,0.4073582236614278
25403,703-004-5396,4556.7056,3,1,2,0.8563703033540592
25644,703-004-5392,2393.8406,8,2,6,0.5612575135744368
25856,703-004-5383,9259.903,2,0,2,0.27920371738274696
26032,703-004-5399,3701.6672,5,4,1,1.5030533217172573
26127,703-004-5382,1821.6366,3,2,1,1.143303009890775
26328,703-004-5387,3010.5627,8,4,4,2.8558746853126515
26416,703-004-5390,3579.2207,3,2,1,0.9981927297286705
26528,703-004-5395,7968.0933,1,0,1,0.27920371738274696
26542,703-004-5388,7265.966,4,2,2,0.9845850994040454
26577,703-004-5389,5513.8613,4,0,4,0.27920371738274696
26678,703-004-5397,881.33453,4,3,1,0.7993533444973575
26935,703-004-5383,8319.487,1,1,0,0.4235479838743847
26967,703-004-5395,5677.6343,8,5,3,1.6742189575015172
27027,703-004-5392,8780.199,5,3,2,0.8433433771295307
27472,703-004-5391,7699.154,5,3,2,1.5898109407040155
2765,703-004-5396,8523.147,3,2,1,1.3712738681138459
27789,703-004-5398,9383.886,2,0,2,0.27920371738274696
28048,703-004-5381,8702.826,2,1,1,0.543691315490671
28493,703-004-5384,6104.452,6,1,5,0.5543447193874605
28560,703-004-5398,3575.1975,3,2,1,1.4983508743332459
28583,703-004-5384,5438.6016,7,3,4,1.3573580709622657
28594,703-004-5391,2095.086,7,6,1,1.8816967638508197
28715,703-004-5395,4322.3145,2,0,2,0.27920371738274696
28866,703-004-5385,1905.3453,4,2,2,0.4370895417332823
28883,703-004-5382,3100.351,2,1,1,0.6783316906272209
29215,703-004-5381,5130.5537,2,1,1,0.35906538916429065
29223,703-004-5388,961.4444,7,4,3,0.9002365274326312
29710,703-004-5382,2749.1921,3,1,2,0.39028828433128343
29752,703-004-5381,33.853054,1,1,0,0.3393097629818468
30040,703-004-5398,5213.045,4,3,1,0.9392154755880466
30090,703-004-5393,9286.649,3,2,1,1.2202849877851367
30242,703-004-5393,9589.861,3,3,0,0.817899742221875
30693,703-004-5385,7632.5215,2,2,0,0.8068343193661045
30877,703-004-5390,5894.961,7,5,2,1.1664866289374745
30940,703-004-5396,9412.807,2,0,2,0.27920371738274696
3106,703-004-5399,8004.7285,6,4,2,1.436914600468567
31471,703-004-5397,7421.629,7,1,6,0.6108756078395373
3181,703-004-5389,9746.565,2,2,0,0.6823047005806431
32320,703-004-5397,3798.1194,5,1,4,0.4146519554385231
32509,703-004-5398,2500.4636,3,1,2,0.6010594593866965
32516,207-008-2399,86.15375,4,0,4,0.27920371738274696
3279,703-004-5392,9798.908,5,2,3,0.9317863404938665
32817,207-008-2399,7371.917,3,3,0,1.2587254964138004
33197,703-004-5398,2805.99,6,4,2,1.0031480968402724
33401,703-004-5396,3167.3503,5,1,4,0.5347173989890692
33914,703-004-5399,8540.722,4,2,2,0.8609432132693879
33940,703-004-5382,5978.435,6,5,1,2.0486647206198447
34340,703-004-5381,6950.5693,4,1,3,0.46023141508423776
34686,207-008-2398,5465.5786,5,3,2,0.947295444842011
34772,703-004-5384,6325.39,4,2,2,0.7738781315161362
34822,703-004-5381,8814.117,2,0,2,0.27920371738274696
34891,703-004-5382,9856.369,2,1,1,0.4323363515511755
35340,703-004-5388,6751.9556,3,3,0,1.4060204176009754
3548,703-004-5388,6550.4272,1,1,0,1.5157834261303096
35963,703-004-5384,4173.3325,3,1,2,0.7034080739855781
36044,207-008-2398,1627.3796,6,3,3,0.5978104860577136
36149,703-004-5399,3808.8452,2,2,0,2.004904057343185
36402,703-004-5389,1314.72,4,2,2,1.7575481828272734
36420,703-004-5397,2548.5234,6,4,2,2.350660740441833
3666,703-004-5385,6842.0903,7,3,4,1.512367784528229
3691,703-004-5388,3373.9631,8,5,3,2.41113333734875
37199,703-004-5398,1078.4865,3,2,1,0.6077795660759037
37229,703-004-5396,8061.293,8,6,2,2.0599986127439305
37338,703-004-5383,2330.256,3,2,1,0.5358843680812252
37834,703-004-5382,5780.519,2,1,1,0.6123956680122152
37858,703-004-5399,6769.531,2,0,2,0.27920371738274696
38325,703-004-5396,7141.0693,2,1,1,0.4239033200327499
38375,703-004-5397,9812.208,5,1,4,1.2047774918711553
38414,703-004-5387,1982.3516,6,3,3,2.353141749248176
38709,703-004-5391,7526.2812,4,2,2,0.8264266614680951
38776,703-004-5394,5464.886,6,3,3,1.1014021726913177
38924,703-004-5393,3451.3796,5,1,4,0.4359244601778353
38933,207-008-2398,171.4027,3,2,1,0.64503165910054
39159,703-004-5397,8104.2485,5,4,1,3.116935632861525
39495,703-004-5396,6447.933,5,3,2,0.9353425012063761
39695,703-004-5391,4729.4053,2,2,0,0.7800117323510941
39726,703-004-5398,5380.1113,3,1,2,0.6406174281645348
39875,703-004-5394,5656.3794,2,1,1,0.49494530231601236
40811,703-004-5387,5401.2783,2,1,1,0.5466103610162483
40908,703-004-5381,9117.087,4,2,2,0.8286921538907708
41099,703-004-5382,6577.1514,2,0,2,0.27920371738274696
41430,703-004-5399,681.39435,4,1,3,1.124153155727075
41923,703-004-5384,5628.6006,3,2,1,0.5501476581262543
42172,703-004-5382,882.98083,"","","",0.27920371738274696
42195,703-004-5388,8448.933,5,0,5,0.27920371738274696
42217,703-004-5381,5954.6865,2,0,2,0.27920371738274696
42930,703-004-5388,3643.9216,3,1,2,0.49203965057332855
42931,703-004-5387,2596.5427,3,2,1,0.5356303782050567
42962,703-004-5383,1520.2665,5,1,4,0.45670166396471623
43083,703-004-5380,5563.574,3,2,1,0.46315553544860655
43121,703-004-5382,1015.2662,7,3,4,1.3146365372746396
43330,703-004-5384,3205.006,3,2,1,0.6454006854429822
43426,703-004-5388,2312.453,8,5,3,2.2640465154118203
43568,703-004-5398,2774.5564,3,2,1,0.5788821433397479
43584,703-004-5398,7711.6104,5,3,2,1.4433918693378167
43614,703-004-5385,2477.5542,2,0,2,0.27920371738274696
4363,703-004-5394,5548.4146,5,4,1,3.1734367518707582
4392,703-004-5398,2043.5178,3,0,3,0.27920371738274696
441,703-004-5389,9967.728,4,2,2,0.46181070420987963
44105,703-004-5399,9948.901,1,0,1,0.27920371738274696
4418,703-004-5384,875.7418,3,1,2,1.2548300797020835
4430,703-004-5388,3713.8892,4,2,2,0.6750987137673427
44764,703-004-5396,9853.949,5,1,4,0.4008021713726342
44996,703-004-5380,8603.529,7,2,5,2.097739159184479
45078,703-004-5382,5050.063,3,3,0,1.7871082859958405
4511,703-004-5382,6345.503,5,3,2,0.9977722394074774
45332,703-004-5383,723.6588,7,4,3,0.9843444508725441
45352,703-004-5385,3920.213,2,0,2,0.27920371738274696
45434,703-004-5395,1028.406,6,3,3,2.0924376562938996
45441,703-004-5392,1594.9667,2,2,0,1.4761097311967992
45532,703-004-5390,163.67435,"","","",0.27920371738274696
4562,703-004-5396,7795.9634,8,4,4,2.1165059648823465
45847,703-004-5382,8317.643,5,1,4,0.8912001709397773
46142,703-004-5382,3827.2393,7,5,2,0.9603357064606317
46508,703-004-5388,916.43097,6,3,3,1.2140394106275774
46602,703-004-5380,5899.7534,4,2,2,1.1797795005134915
46743,703-004-5389,8563.98,3,1,2,0.4862959979021611
46868,207-008-2399,293.58804,4,3,1,1.9222932831360775
46913,703-004-5386,3484.3164,2,1,1,0.6288520695786547
46996,703-004-5381,6397.392,2,1,1,0.3679173747273365
47066,703-004-5395,3624.0757,4,3,1,0.6917779447505115
47087,703-004-5384,4133.418,"","","",0.27920371738274696
47110,703-004-5393,2507.6968,3,0,3,0.27920371738274696
47320,703-004-5396,5792.3154,4,0,4,0.27920371738274696
47528,703-004-5394,2921.7935,5,1,4,0.6675925451038169
47642,703-004-5397,5094.416,6,2,4,0.7285656940408958
48317,703-004-5398,9370.129,4,2,2,2.5193928175512936
4852,703-004-5399,2444.4478,4,2,2,0.521325951956812
48549,703-004-5392,4365.148,4,3,1,0.9086196004711651
48627,703-004-5397,7235.4346,2,1,1,1.177924817046816
48772,703-004-5389,7709.2188,3,2,1,0.626830549092601
48825,703-004-5386,1257.4344,6,2,4,0.5528111232055777
48829,703-004-5385,4949.852,3,1,2,0.5489094630351762
48838,703-004-5381,4710.6035,4,3,1,1.261596304608366
49000,703-004-5386,1176.2006,3,2,1,0.5377938044089742
49562,703-004-5395,1400.3813,1,0,1,0.27920371738274696
49624,703-004-5389,9045.454,4,2,2,0.41922438165019454
49855,703-004-5380,8277.445,6,2,4,1.006382863045094
49935,703-004-5391,1060.357,3,1,2,0.9714419803983568
49938,703-004-5390,7306.392,6,4,2,0.775130727760188
5130,703-004-5397,1458.7349,7,2,5,0.8977531313769765
5136,703-004-5383,2261.3318,3,2,1,0.7465922417102518
5240,703-004-5398,3085.8499,3,2,1,0.7635465266034936
5600,703-004-5383,3320.4978,2,1,1,0.6215390360723061
6945,703-004-5391,7061.522,4,2,2,0.9224782017270194
7370,703-004-5381,6162.71,2,0,2,0.27920371738274696
7460,703-004-5392,6013.4663,5,3,2,0.7717920509684058
7589,703-004-5394,8342.806,8,2,6,0.997598318905866
7612,703-004-5383,2367.4739,4,4,0,1.957316689506348
7676,703-004-5399,228.8419,1,1,0,2.0881587172970693
7716,207-008-2399,8914.235,5,2,3,2.340865392738016
7766,703-004-5384,4451.564,2,2,0,0.6856196284980081
7772,703-004-5394,6015.935,6,5,1,1.5358191618661958
7778,703-004-5399,7337.5513,5,3,2,1.3420377320802466
7915,703-004-5388,8810.089,7,4,3,2.4698143907283847
8029,207-008-2399,1773.9022,5,4,1,1.3936516747815944
8057,703-004-5387,2011.658,3,1,2,0.6880164534730148
8290,207-008-2399,6135.9395,4,3,1,0.9595724615938113
8677,703-004-5388,7873.384,4,2,2,0.5023893107967021
8835,207-008-2399,9322.252,5,2,3,0.5916094412522424
8956,703-004-5381,8904.351,3,1,2,0.4839507967776707
9007,703-004-5386,8231.069,6,2,4,0.6577206607094391
964,703-004-5380,340.97733,8,2,6,0.9105546854398976
9843,703-004-5394,1464.4509,10,6,4,1.6929045614570184
9878,703-004-5399,1671.3768,7,4,3,1.76217637074232
10323,703-004-5399,186.20312,5,3,2,1.0978991701679366
10364,703-004-5381,6102.394,3,2,1,0.6826896083626981
10411,703-004-5384,3310.982,1,1,0,0.7167110277386982
10689,207-008-2398,2101.5322,4,2,2,1.1867532517857207
10889,703-004-5382,8812.982,1,0,1,0.27920371738274696
11356,703-004-5384,8956.96,6,5,1,2.2711676647031234
11382,703-004-5397,5654.109,4,2,2,2.6951830120043017
11542,703-004-5383,3687.69,5,3,2,1.064063769006711
11580,703-004-5389,2335.223,2,0,2,0.27920371738274696
11910,703-004-5380,6320.088,5,4,1,2.688458508711452
1214,703-004-5396,5447.5337,4,1,3,0.5531511643794205
12361,703-004-5398,2593.6008,4,4,0,1.1887750887244881
12385,703-004-5395,7749.4014,6,4,2,0.9637545796671234
12574,703-004-5395,6170.6562,10,2,8,1.163598683776378
12744,703-004-5390,3313.685,2,1,1,0.44616409887303654
1284,703-004-5384,1934.3591,4,1,3,0.868358346596324
12953,703-004-5388,9828.219,4,2,2,0.80035252957815
13191,703-004-5395,2657.2441,2,1,1,0.5676410790944892
1327,703-004-5386,745.69824,6,2,4,0.7603761497526063
13298,703-004-5396,9891.382,3,2,1,0.8099144378767402
13353,703-004-5397,7918.746,1,0,1,0.27920371738274696
13475,703-004-5383,2031.4712,3,1,2,2.2423329512870653
13490,703-004-5396,96.117256,7,5,2,1.1300768205740916
13541,703-004-5395,6180.163,5,3,2,1.2931222849692452
13758,703-004-5384,1555.2056,3,2,1,0.8242847512746155
13876,703-004-5390,2016.9026,"","","",0.27920371738274696
14103,703-004-5382,1187.38,3,1,2,0.3486207416170325
14299,703-004-5392,5811.8423,7,2,5,0.5627972268864884
14996,207-008-2399,7814.394,4,2,2,1.799617136916754
15045,703-004-5397,1473.9484,2,1,1,0.42106241664001426
15112,703-004-5383,7938.087,1,1,0,0.44829646872267315
15144,207-008-2398,2123.4507,3,0,3,0.27920371738274696
15199,703-004-5387,66.54501,5,2,3,0.8742261450855728
15326,703-004-5391,7699.0503,3,2,1,0.9812936774437888
15584,703-004-5399,8806.372,3,3,0,1.069345893377654
16090,703-004-5385,4138.562,5,1,4,0.35114230018964543
16202,703-004-5387,7993.498,4,3,1,4.670150915799267
16305,703-004-5396,754.8159,9,3,6,2.076009587478959
16317,703-004-5395,6971.1016,5,3,2,0.8294462665416866
16339,703-004-5388,7108.476,3,2,1,1.0197126330475539
1658,703-004-5380,8920.3545,2,1,1,0.35831143730785864
16613,703-004-5387,3633.181,3,2,1,1.5095250513996807
16672,703-004-5399,6482.303,10,3,7,1.3117448089951886
16694,703-004-5395,1392.6792,6,3,3,1.8727314691268708
16825,703-004-5381,1064.505,"","","",0.27920371738274696
16841,703-004-5398,577.8724,10,3,7,0.7607380251389888
17352,207-008-2399,463.86124,4,3,1,1.654709428334127
18004,703-004-5385,217.33463,3,2,1,0.5080722395910855
181,703-004-5383,950.45746,4,3,1,1.3649106290575534
18254,703-004-5394,563.7884,5,2,3,0.5130164720864051
18392,703-004-5390,7506.0146,5,4,1,1.404077819776292
18495,703-004-5383,8289.296,2,0,2,0.27920371738274696
18980,703-004-5384,2733.0947,8,0,8,0.27920371738274696
19532,703-004-5391,6480.507,5,5,0,1.7669689167202465
19663,703-004-5385,7598.198,7,4,3,0.7472514733095896
20395,207-008-2399,8491.167,5,0,5,0.27920371738274696
20616,207-008-2399,6676.2905,4,2,2,0.882651424434937
20963,703-004-5391,5217.233,6,4,2,1.6136118222263205
21370,703-004-5397,3676.6304,2,2,0,1.568837539327516
21594,703-004-5386,3129.1418,1,1,0,0.6313978787993377
21706,703-004-5392,9230.499,3,2,1,2.5321966066189923
21912,703-004-5398,9118.501,6,4,2,2.243986246177142
22546,703-004-5385,8571.819,7,1,6,0.33853450732658075
22577,703-004-5399,4281.63,11,5,6,1.583754362186226
23025,703-004-5382,9972.818,3,2,1,0.4542295477170565
23635,703-004-5384,8658.271,2,1,1,0.32666834933781397
23845,703-004-5390,1140.157,4,2,2,0.41764222725169237
2387,703-004-5399,2604.9387,5,4,1,0.9825298847068384
2397,703-004-5393,8909.429,4,2,2,1.5564058741296762
24063,703-004-5399,2156.7607,5,4,1,2.2891563987443093
24100,703-004-5396,6845.0063,4,2,2,0.5669580486103406
24123,703-004-5384,5695.588,7,4,3,1.1591406515590048
24136,703-004-5384,8274.516,9,8,1,2.4782332323507834
24200,703-004-5392,8506.483,6,4,2,1.6150746271919294
24408,703-004-5399,6601.7607,4,2,2,0.5488841320441171
24435,703-004-5385,55.043697,6,4,2,3.759330873190496
24727,703-004-5398,4629.0835,4,2,2,0.5313791043623969
24757,703-004-5388,5940.16,4,2,2,0.5762353740871109
24769,703-004-5380,834.20514,4,3,1,1.3837459270245953
24869,703-004-5386,5183.544,4,3,1,1.3590896220288189
24889,703-004-5384,5547.5425,4,3,1,0.7196643874834786
24959,703-004-5386,5291.2544,1,0,1,0.27920371738274696
25053,703-004-5398,8416.466,2,0,2,0.27920371738274696
25065,703-004-5396,856.9461,4,2,2,0.7787595343272403
25346,703-004-5388,1097.3871,4,4,0,3.4409146691201435
25734,703-004-5395,7693.184,3,1,2,0.5641653161443255
25790,703-004-5398,8275.037,6,2,4,1.9062904243376577
25791,703-004-5383,3112.9062,1,1,0,1.0911225695910234
25972,703-004-5396,1390.6598,5,1,4,0.39968230271244437
25997,703-004-5395,2539.9214,5,3,2,1.4494679591935173
26037,703-004-5391,1180.0616,3,0,3,0.27920371738274696
26092,703-004-5397,68.44103,3,1,2,1.1383943998145658
26114,703-004-5399,9813.806,1,0,1,0.27920371738274696
26167,703-004-5382,2371.1282,"","","",0.27920371738274696
26583,703-004-5398,3531.1526,4,2,2,2.0201623702190585
27497,703-004-5389,8473.56,4,1,3,0.6874890251219749
27659,703-004-5382,4962.814,4,3,1,0.9869679938973589
28548,703-004-5392,5500.7954,6,4,2,1.18604178499587
28574,703-004-5389,3593.9116,5,3,2,3.1547523693276864
28595,703-004-5396,9110.599,5,3,2,1.3018702176362145
28634,703-004-5394,3592.2354,6,5,1,2.5838752418409934
28651,703-004-5383,213.95386,2,1,1,0.6344230639626315
28944,207-008-2399,3866.1099,1,1,0,0.6330772933535352
28986,703-004-5384,4684.889,4,1,3,0.6634672043634363
29118,703-004-5382,2650.9707,4,2,2,0.4992698576719184
2921,703-004-5399,9013.042,7,4,3,4.547551566048156
2928,703-004-5382,2379.9832,3,1,2,0.5239432259010611
29349,703-004-5395,6844.6006,1,1,0,0.5967400890416755
29376,703-004-5399,2034.9502,6,4,2,1.3141695463061736
2966,703-004-5392,7178.229,3,3,0,1.073233130790743
29874,703-004-5393,7393.75,5,2,3,0.5857208620789943
30050,703-004-5395,1864.3254,4,3,1,0.7960021996741842
306,703-004-5398,6497.0854,2,1,1,0.39209683221196123
3076,703-004-5392,4746.2803,2,1,1,0.5457320153197843
30886,703-004-5383,6570.8984,3,2,1,0.5655126720315791
31149,703-004-5381,1073.56,6,4,2,1.077387475904702
31333,703-004-5394,6596.631,2,1,1,0.5293613532392896
31665,703-004-5394,3834.6772,3,1,2,3.220810500675324
31967,703-004-5388,4121.25,4,1,3,0.6568577290031317
32189,703-004-5395,9947.488,7,4,3,2.2388276061351804
32194,703-004-5398,9146.244,2,2,0,0.4138615374702714
32265,703-004-5383,182.00218,1,1,0,0.7643171662319816
32580,703-004-5382,5866.5996,3,2,1,1.0884670756355563
32829,703-004-5391,1827.9808,3,2,1,1.8654692435778728
32909,703-004-5397,9850.859,5,2,3,0.6730463406137754
33049,703-004-5382,4518.1255,"","","",0.27920371738274696
33052,703-004-5382,4789.593,5,2,3,1.5805064758708636
33175,703-004-5391,6596.2324,2,0,2,0.27920371738274696
33229,703-004-5388,7898.283,9,5,4,1.1513214304161634
33233,703-004-5395,9616.19,3,3,0,1.5189245694366895
33638,703-004-5389,2514.5984,6,4,2,1.470441715215111
33784,703-004-5394,9839.116,4,1,3,0.4952287459741555
33794,703-004-5396,1193.4536,3,2,1,1.110531914065708
34000,703-004-5397,1199.6943,6,4,2,1.3847886455493128
34268,703-004-5396,1400.1733,8,4,4,1.9466694715581387
34311,703-004-5398,780.8584,3,0,3,0.27920371738274696
34512,703-004-5387,9100.132,4,3,1,1.026522913880011
3474,703-004-5398,5175.8076,5,4,1,0.8188367534400994
3484,703-004-5399,1740.9999,5,2,3,0.8177852479517459
35783,703-004-5394,8076.551,3,2,1,1.6744745376711445
36218,703-004-5387,6324.1567,5,2,3,0.7954847758899535
36424,703-004-5396,6009.319,4,2,2,1.2661890168906607
36455,703-004-5396,4201.5024,3,3,0,0.9922904810298478
36525,703-004-5385,294.39688,2,0,2,0.27920371738274696
36596,703-004-5396,9163.925,1,1,0,0.4866238781901213
36712,703-004-5381,6990.599,6,4,2,1.8745906062020865
36767,703-004-5383,8678.372,3,3,0,1.5173028607369505
3683,703-004-5393,8043.2646,3,1,2,0.3508391569347761
3687,703-004-5390,8739.842,1,1,0,0.5360782144401367
37012,703-004-5383,7198.902,8,3,5,1.1478695133827619
37193,703-004-5398,6061.623,6,4,2,2.2662760604167893
37649,703-004-5393,4701.422,4,3,1,0.6532449515865003
37766,703-004-5388,1624.1217,9,5,4,2.542948282601167
37914,207-008-2398,8766.751,4,2,2,0.7579712753952021
37980,703-004-5397,2956.9858,3,1,2,0.47243075630821957
38035,703-004-5382,4018.2876,5,2,3,0.725303805103588
3804,703-004-5391,8943.072,6,1,5,0.35534489781066697
38059,703-004-5383,4119.2656,10,5,5,1.567320507582297
38281,207-008-2398,6197.66,4,2,2,1.0220776200217963
38402,703-004-5385,2445.6626,4,2,2,0.9490363918396404
38421,703-004-5380,3602.3801,6,5,1,1.8804504479381146
38485,703-004-5388,8093.6523,3,0,3,0.27920371738274696
38806,703-004-5390,7250.3984,8,5,3,2.6763343729313522
38886,703-004-5381,4843.8843,7,1,6,0.3807252912866403
39106,703-004-5394,8485.084,1,1,0,0.9646810307532995
39588,703-004-5392,2484.8938,3,1,2,0.6199296229814454
40217,703-004-5394,4766.5156,1,0,1,0.27920371738274696
40476,703-004-5390,727.0366,3,2,1,0.7044538581501784
40764,703-004-5391,9483.949,5,5,0,0.9701298078208388
41013,703-004-5381,2864.609,9,5,4,1.509596231309882
41027,703-004-5399,6213.6626,6,4,2,1.402071923327588
41213,703-004-5387,4073.0215,5,3,2,1.1174527764410416
41317,207-008-2398,7870.2075,4,2,2,0.7718073095009541
41335,703-004-5393,7456.024,7,4,3,0.8637669701430887
41654,703-004-5386,5913.9,4,1,3,0.43974464019969967
41765,703-004-5387,6616.4307,4,2,2,0.6741581421044418
42074,703-004-5388,9958.97,1,0,1,0.27920371738274696
42278,703-004-5380,865.5328,2,2,0,1.0707880891815258
42309,207-008-2399,2261.3604,2,2,0,0.4777199671197564
42402,703-004-5386,6726.038,4,2,2,1.2750816235945963
42503,703-004-5399,9475.752,5,1,4,0.5367614642461369
42587,703-004-5398,4250.8154,1,0,1,0.27920371738274696
42628,703-004-5384,1752.199,2,1,1,0.7408314814906762
42884,703-004-5382,1847.5121,7,1,6,0.609053617954734
42919,703-004-5392,6079.7876,4,1,3,0.7023855475201815
42956,703-004-5385,7639.098,3,1,2,1.2460947426522897
43215,703-004-5384,9027.895,2,2,0,0.8877355583033347
43500,703-004-5397,4943.529,3,1,2,0.649064640440615
43608,703-004-5394,3344.9685,2,1,1,0.33853450732658075
43750,703-004-5381,6041.2363,3,1,2,0.6216470645062541
43857,703-004-5390,7941.659,2,1,1,0.3187575773453028
43885,703-004-5393,6684.5713,5,3,2,0.9354169110931653
44194,703-004-5387,1760.7665,3,1,2,0.8037187388527566
44206,703-004-5394,2474.398,3,1,2,0.5010690539107101
44260,207-008-2398,6904.26,6,2,4,1.6135524623634236
44676,703-004-5395,7367.14,6,2,4,1.1869640869497793
44715,703-004-5387,4052.512,6,4,2,1.1202151671075193
44798,703-004-5381,1673.1584,2,1,1,1.403121546898803
44855,703-004-5383,6809.767,2,2,0,1.476590015202045
44977,703-004-5396,8757.723,5,4,1,0.8120185110317379
45091,703-004-5398,6615.6562,6,4,2,2.9682690098815563
45187,703-004-5386,8337.897,4,1,3,0.9787860962030112
45431,703-004-5399,7791.9463,6,2,4,0.6052091266030902
45536,207-008-2399,3921.029,4,2,2,1.3285834962930494
46014,207-008-2399,5580.28,9,6,3,3.4334386546568765
4632,703-004-5396,3260.6172,4,3,1,2.3484603349939785
46381,703-004-5381,1786.0175,5,1,4,0.35534489781066697
46696,703-004-5394,3135.8057,3,2,1,0.5758576671019155
46816,703-004-5393,4821.015,2,2,0,1.0116109884871187
46876,703-004-5390,8668.532,3,2,1,0.6596462499252445
4692,703-004-5387,2198.0447,1,1,0,0.5165268771580819
46943,703-004-5386,5989.263,4,4,0,1.0579123072544399
47309,703-004-5397,9401.607,3,2,1,0.5982429288306989
47697,703-004-5388,4253.0522,3,2,1,1.2183330395362628
47704,703-004-5386,134.54318,4,2,2,1.523249600548405
47855,703-004-5394,9947.838,7,4,3,1.5161244324094283
47970,703-004-5382,2145.5396,3,0,3,0.27920371738274696
48085,703-004-5383,2745.067,4,2,2,1.006766065497238
48217,703-004-5381,1941.4752,3,2,1,0.7347181057216516
48269,703-004-5399,7420.911,5,1,4,0.32666834933781397
48604,703-004-5390,865.556,3,0,3,0.27920371738274696
48733,703-004-5385,3332.733,6,4,2,0.7149070679933531
4876,703-004-5383,1651.3884,8,5,3,1.648869004956232
49066,703-004-5394,1466.9812,2,2,0,1.7730912593767725
49199,703-004-5385,5165.6353,2,1,1,0.6754261275735461
49593,703-004-5395,2752.5686,6,2,4,0.8548138289416952
5354,703-004-5383,9680.504,3,0,3,0.27920371738274696
5528,703-004-5394,453.07635,7,5,2,1.1325697288632335
5650,703-004-5386,1045.2932,3,1,2,0.992794819430585
607,703-004-5385,2637.4746,6,3,3,2.582522334607561
6183,703-004-5390,6648.646,1,0,1,0.27920371738274696
6266,703-004-5384,3189.3242,10,6,4,3.2335588266074153
6271,703-004-5393,8985.905,"","","",0.27920371738274696
63,703-004-5385,4036.5786,8,4,4,1.9542531950316469
6494,703-004-5387,9029.476,2,1,1,0.33853450732658075
6615,703-004-5382,4931.395,2,1,1,0.35534489781066697
6764,703-004-5385,7448.9062,7,3,4,1.0154600034502879
6784,703-004-5384,1243.6372,1,1,0,0.48923740617546474
7135,703-004-5384,9610.379,4,2,2,2.6567102627244314
7266,703-004-5394,8661.423,3,1,2,0.5390583622881704
7421,207-008-2399,3670.7002,6,4,2,0.7776387005202778
7477,703-004-5382,5376.0063,6,3,3,2.0379715705030748
7680,703-004-5396,5596.062,5,0,5,0.27920371738274696
8242,703-004-5398,918.5153,4,3,1,1.1963715442786813
8731,207-008-2398,1115.771,3,1,2,2.133542985880369
9097,703-004-5380,4817.8647,"","","",0.27920371738274696
9100,703-004-5382,1909.16,7,6,1,1.8927544200974737
9177,207-008-2399,5297.389,1,0,1,0.27920371738274696
9224,703-004-5383,229.93504,3,1,2,0.5441017543752696
9328,703-004-5397,6651.3486,5,1,4,0.6771922616242441
9338,207-008-2399,8109.9473,3,1,2,0.7084958644831234
934,703-004-5380,9103.266,4,1,3,0.45670166396471623
9348,703-004-5397,7373.8765,7,2,5,1.026583508724721
9502,207-008-2398,9873.959,6,2,4,0.679125305346377
9518,703-004-5389,966.54236,5,4,1,1.8688714497505852
9728,703-004-5382,6501.831,3,1,2,0.8830289821725389
10047,703-004-5382,4689.08,5,2,3,1.5750367311519082
10442,703-004-5394,3439.4277,3,2,1,0.5016289158031851
10483,703-004-5397,2140.3467,3,2,1,1.441146754821575
10669,703-004-5380,5110.5767,4,2,2,1.1339092564751552
107,703-004-5384,628.5238,3,1,2,0.32666834933781397
110,703-004-5395,2201.6208,2,0,2,0.27920371738274696
11077,703-004-5394,8123.6064,5,2,3,0.7661461351447104
11221,703-004-5381,6431.8906,4,1,3,0.770001625070085
11414,703-004-5391,9966.012,5,1,4,0.4199396739325996
11514,703-004-5389,7829.695,3,3,0,1.355430831451454
11809,703-004-5394,1094.9678,4,1,3,0.3978652972704144
1185,703-004-5394,5517.907,4,0,4,0.27920371738274696
12395,207-008-2399,4599.427,6,2,4,0.9701083326292536
12433,703-004-5388,8718.01,5,4,1,1.68581123133019
12516,703-004-5384,4118.645,4,3,1,1.970971854494464
1269,703-004-5398,4636.427,4,2,2,0.7792908942661061
12833,703-004-5380,6696.2085,5,2,3,0.582682835882132
13017,703-004-5391,9507.129,6,3,3,0.8289415555311096
13235,703-004-5387,6505.181,2,1,1,0.6797738166426216
13240,703-004-5384,3350.07,5,3,2,1.163249359371049
1375,703-004-5383,4354.1465,"","","",0.27920371738274696
13934,703-004-5389,156.65948,4,1,3,0.3978652972704144
14185,703-004-5392,8926.79,5,4,1,1.4736700186868223
14237,703-004-5395,6070.7734,1,0,1,0.27920371738274696
14520,703-004-5383,7212.5874,8,5,3,1.6021441669069778
14808,703-004-5397,5593.691,4,3,1,0.9523449830423242
14933,703-004-5389,3033.5593,5,2,3,0.6789092825564679
15154,703-004-5397,4367.4688,1,1,0,0.6180032105237264
15576,703-004-5388,573.7245,3,2,1,0.6292553780513659
15826,703-004-5387,8441.1875,2,0,2,0.27920371738274696
15991,703-004-5388,1300.0673,2,1,1,0.8458959970606887
16074,703-004-5384,2840.7283,2,1,1,0.7853250209986206
16155,703-004-5399,3097.0693,5,2,3,0.5466532085462493
16192,703-004-5380,6214.1484,2,2,0,1.1763425181358733
17696,703-004-5396,7369.656,3,2,1,0.8283909962286685
17706,703-004-5390,3645.348,3,1,2,0.7306874648563869
17801,207-008-2398,2158.847,5,2,3,0.6910511626253091
17860,703-004-5399,9778.09,4,2,2,1.877790616087407
18214,703-004-5387,5844.092,1,0,1,0.27920371738274696
19893,703-004-5396,1535.3578,1,1,0,0.35831143730785864
20226,703-004-5392,5275.213,9,6,3,2.1295106420102385
20251,703-004-5395,4825.772,2,0,2,0.27920371738274696
20279,703-004-5385,493.4424,3,1,2,0.686220136553665
20325,703-004-5390,9828.266,2,1,1,0.43866276904533463
20414,703-004-5396,1258.853,4,1,3,0.6173892200625992
20552,703-004-5381,4514.433,3,1,2,0.5165268771580819
20564,703-004-5387,6018.5366,2,2,0,0.8451636772284118
20784,703-004-5383,8824.658,2,0,2,0.27920371738274696
20926,207-008-2398,3520.9478,5,4,1,1.6645861394596309
20966,703-004-5398,3440.1936,5,1,4,0.35831143730785864
21027,703-004-5383,3125.04,3,2,1,1.9972228247223391
21687,703-004-5394,9422.649,1,1,0,0.5570898287358543
21974,703-004-5383,1660.6396,3,2,1,1.009677666654453
22006,703-004-5385,5255.6807,"","","",0.27920371738274696
22243,703-004-5390,592.37244,2,1,1,0.5165268771580819
22269,703-004-5384,1405.356,5,2,3,0.6811610502147379
22290,703-004-5383,4085.5747,4,3,1,0.9046712956772718
22391,207-008-2399,7632.2285,2,1,1,0.7504567265510641
22765,703-004-5386,1686.7179,3,1,2,0.5295175453962836
23011,703-004-5398,5006.2,6,5,1,2.129681939207252
23228,207-008-2398,6027.9014,4,1,3,0.5013775705669992
23484,703-004-5397,9448.51,5,2,3,1.380150877810892
23955,207-008-2398,3336.24,3,1,2,0.7940147444876662
2396,703-004-5394,8848.806,3,1,2,0.5269762034611302
24318,703-004-5398,2603.8867,3,2,1,0.933924283593436
24766,703-004-5382,409.81412,3,1,2,0.4654796630294423
25086,703-004-5382,9731.353,4,2,2,0.6909497066832422
25182,703-004-5398,1018.0783,6,2,4,1.5483355856835803
25624,703-004-5384,5850.9834,5,3,2,0.790933702267599
25704,703-004-5387,1896.5583,5,1,4,0.42460472969839963
25785,703-004-5398,7678.402,3,2,1,0.712207764319363
25861,703-004-5396,691.7757,4,2,2,0.6749108654495446
25897,703-004-5394,2262.8875,4,2,2,1.0673680862715609
26349,703-004-5382,4329.0566,3,1,2,0.4217064550327408
26388,703-004-5393,6242.3076,5,2,3,1.0740611852695943
26588,703-004-5385,5584.328,7,3,4,1.7949065703181593
26738,207-008-2399,3598.988,1,1,0,1.5057531515235403
27328,703-004-5380,2716.301,7,4,3,0.9865877137263313
27493,703-004-5394,6216.3926,3,2,1,0.7103282387418193
27571,703-004-5392,1689.5968,4,2,2,0.7626480327837379
27762,703-004-5385,3807.95,2,1,1,0.4736322217019922
27804,703-004-5396,3308.015,1,1,0,0.8606523807578109
2795,703-004-5390,9064.969,4,2,2,1.0430913191280722
27992,703-004-5384,1067.3368,5,2,3,0.9284442055631225
2811,703-004-5398,7785.5605,2,0,2,0.27920371738274696
28159,703-004-5395,1331.026,6,2,4,1.3394475252886133
28659,703-004-5386,7422.0835,5,3,2,1.7081609635189368
28803,703-004-5394,4562.0923,6,4,2,0.8707426108254244
29140,703-004-5390,1852.8837,5,4,1,1.1146468435477095
29359,703-004-5398,3707.4536,"","","",0.27920371738274696
29368,703-004-5397,1859.1381,4,1,3,0.9054882086620206
29816,703-004-5389,274.06097,6,2,4,2.0313243333398496
3003,703-004-5381,9809.7705,2,1,1,0.5550067166365203
30185,703-004-5398,1478.2405,5,3,2,1.084967384918549
30235,703-004-5387,3437.636,2,1,1,0.5401063358267223
30408,703-004-5399,5473.2324,5,1,4,0.413761017451408
30507,703-004-5382,9016.06,3,2,1,0.9557038012053921
30670,703-004-5380,1251.6332,5,2,3,0.8424544689667394
31176,703-004-5392,4465.73,2,2,0,1.7992844708609554
31180,207-008-2398,8144.586,5,3,2,1.1486334388381105
3153,703-004-5383,4010.0085,2,0,2,0.27920371738274696
31544,703-004-5396,3973.053,2,0,2,0.27920371738274696
31565,703-004-5381,4940.158,6,3,3,0.8492473678939382
31743,703-004-5396,2571.1155,4,1,3,0.6675857320788698
3248,703-004-5387,8831.008,"","","",0.27920371738274696
32858,703-004-5392,3905.2356,3,2,1,0.6294092933805306
33059,703-004-5386,3778.165,2,1,1,1.1802939580053757
33168,703-004-5398,7651.01,3,1,2,0.40218450853031656
33217,207-008-2398,7229.6006,5,0,5,0.27920371738274696
33497,703-004-5397,846.287,2,0,2,0.27920371738274696
33595,703-004-5386,1148.6399,4,2,2,0.9224960504246732
33688,207-008-2398,4104.4297,4,3,1,2.7481049296950384
33780,703-004-5386,1140.3811,11,7,4,3.018399946865626
33891,703-004-5393,2676.7886,2,2,0,0.9674319810121472
34072,703-004-5385,3805.568,5,2,3,0.560705227769924
34078,703-004-5385,3235.2996,4,2,2,0.7259471508221637
34181,703-004-5399,5713.3276,4,4,0,1.4458260857062994
34238,703-004-5389,9917.1455,5,4,1,3.8608551097673334
34416,703-004-5397,6369.546,3,1,2,0.4484220866438104
3446,703-004-5398,3839.3914,6,3,3,1.2076180018925933
34558,703-004-5398,2682.7966,4,3,1,0.7938108841233076
34842,703-004-5386,1134.5178,3,0,3,0.27920371738274696
35203,703-004-5396,6756.108,3,2,1,0.9558294549396946
35551,703-004-5382,6817.013,4,2,2,0.45339562050284593
35601,703-004-5388,1722.7715,1,0,1,0.27920371738274696
35703,703-004-5398,18.534065,2,1,1,0.5175485128414011
35712,703-004-5388,7183.955,7,1,6,0.5846394609279578
35739,703-004-5399,1095.9113,5,0,5,0.27920371738274696
35785,703-004-5393,5086.087,2,2,0,0.5910890977078639
36280,207-008-2399,2097.3062,8,4,4,0.7676983491219692
36396,703-004-5389,2997.3293,3,1,2,0.34031172623652106
36454,703-004-5380,6350.7188,3,1,2,0.7123154065756367
36514,703-004-5389,7402.3564,4,4,0,2.6971213347972904
36604,703-004-5380,5390.2246,4,2,2,0.9527066269702927
372,703-004-5388,7481.5645,2,1,1,0.5204198696566936
37293,703-004-5383,4642.3774,4,3,1,1.2026806096029214
37529,703-004-5391,5154.7896,5,3,2,0.7807506431467371
37602,703-004-5395,3347.9482,7,5,2,1.8129239111912876
3771,703-004-5386,6025.524,"","","",0.27920371738274696
37724,703-004-5380,634.4533,4,2,2,0.7246404383946621
37746,703-004-5399,3420.2969,2,0,2,0.27920371738274696
38119,703-004-5391,2755.18,3,1,2,0.7215676948018978
38340,207-008-2399,1508.5411,2,1,1,0.33853450732658075
38344,207-008-2399,3173.8037,3,1,2,0.3686450608778714
38383,703-004-5387,3366.1306,2,2,0,0.7699134628157215
38651,703-004-5392,9327.629,5,2,3,1.2999858502130575
38803,703-004-5387,6562.67,8,3,5,1.6875318469143386
38887,703-004-5398,120.364426,2,0,2,0.27920371738274696
39100,703-004-5382,6941.1523,3,0,3,0.27920371738274696
39152,703-004-5387,7084.879,2,1,1,0.7006942145450231
39662,703-004-5384,8668.21,4,4,0,0.9842501398822244
39741,703-004-5382,911.7514,2,1,1,0.41226908258740397
39988,703-004-5381,3199.4868,4,3,1,1.3859457280320038
4018,703-004-5382,1295.3711,4,3,1,0.7884022231052273
40195,703-004-5385,2961.1157,4,1,3,0.4492227217669812
40757,703-004-5383,4730.7485,7,3,4,0.9961194890099089
41338,703-004-5386,9971.587,4,3,1,0.7929504710544186
41774,703-004-5381,8485.184,8,4,4,1.7240623559073145
41871,703-004-5395,8289.396,3,1,2,0.5905468775734436
41959,703-004-5391,6281.777,4,2,2,1.4145178271379757
41997,703-004-5380,9593.871,5,2,3,0.5758576671019155
42166,703-004-5388,3387.5168,4,2,2,0.6093190680789691
42241,703-004-5396,5032.5547,7,3,4,1.6213848570418095
42358,703-004-5382,9895.758,3,3,0,0.8573948529031539
42365,703-004-5391,9390.295,5,5,0,1.371435434092326
42366,703-004-5389,8843.426,4,1,3,0.45793863784516714
42638,703-004-5381,1982.2222,4,3,1,2.3234108910334106
42644,703-004-5386,1967.6393,5,2,3,1.1726854686136663
4323,703-004-5387,4757.5156,5,4,1,2.092788311041289
43263,703-004-5390,6141.454,5,2,3,0.8106979446217772
43334,703-004-5388,1006.4346,6,5,1,1.0819627597780492
43677,207-008-2399,3135.668,6,3,3,1.4209494691036368
43709,703-004-5390,2826.828,6,5,1,1.5658968487815446
4389,703-004-5393,8364.032,5,1,4,0.3978652972704144
43932,703-004-5388,8976.725,3,1,2,0.4186761486703386
43948,703-004-5384,323.9608,7,5,2,2.199649764540508
44137,703-004-5383,5891.468,3,2,1,1.140492139604662
44327,703-004-5391,3802.5183,2,2,0,1.6292332125805717
44352,207-008-2398,5709.5557,1,1,0,1.2872114106678705
44402,207-008-2398,5786.659,4,1,3,0.3978652972704144
44417,703-004-5386,465.07,3,0,3,0.27920371738274696
44470,703-004-5381,8947.862,3,2,1,1.3446597260809228
44482,703-004-5395,7618.9385,7,3,4,1.4437963903893534
44550,703-004-5388,358.88135,3,0,3,0.27920371738274696
44608,703-004-5398,6434.7334,6,4,2,1.241064354429488
4466,703-004-5395,5368.167,2,0,2,0.27920371738274696
44667,703-004-5383,1764.8125,4,2,2,0.7440361178594994
44673,703-004-5387,7523.0645,5,3,2,2.164486042501025
44682,703-004-5387,4787.7705,3,1,2,0.9747615661706417
44745,703-004-5383,3176.3125,3,2,1,0.4843459541171027
44789,703-004-5392,6634.719,3,1,2,0.32666834933781397
45345,703-004-5395,2265.5469,2,0,2,0.27920371738274696
45375,703-004-5389,769.0799,2,1,1,0.3670132864996209
45537,703-004-5383,6072.366,4,3,1,2.942683338505119
45555,703-004-5385,6102.0054,4,4,0,1.764614392582965
45718,703-004-5396,4169.3037,4,1,3,0.4457749101500602
45785,207-008-2398,7535.744,2,1,1,0.5374341196342888
45884,207-008-2398,3002.3677,4,1,3,0.3978652972704144
45944,703-004-5390,5628.4814,4,1,3,0.7263985385432915
46130,703-004-5392,1444.8113,2,1,1,0.4684689373035765
46177,703-004-5388,3777.8855,4,2,2,0.6408345775254167
46519,207-008-2398,2079.8696,6,4,2,2.7205039306502
46880,703-004-5395,7616.6157,6,2,4,1.3022376170684544
46993,703-004-5399,3452.1633,1,1,0,0.7945586481329603
47007,703-004-5397,7066.533,3,1,2,0.5557187427433097
4702,703-004-5390,1037.0142,4,2,2,0.7615179112648655
48263,703-004-5392,3712.0247,5,4,1,5.185320784105251
48504,703-004-5390,1861.105,3,2,1,0.6274406354714065
48586,703-004-5387,1273.1528,"","","",0.27920371738274696
48728,207-008-2398,5700.6772,4,2,2,0.8451398837623082
48778,703-004-5388,7229.484,4,2,2,0.7269089556453291
49098,703-004-5384,5784.9883,1,0,1,0.27920371738274696
49186,703-004-5391,8206.88,3,3,0,1.4266759508324263
49812,703-004-5389,2230.109,7,2,5,2.017718712506211
49999,703-004-5392,2954.827,3,1,2,0.4148770671288338
5282,703-004-5399,8743.263,9,5,4,2.319692075833615
5503,703-004-5391,2950.8381,3,2,1,0.47697301719552604
554,207-008-2399,6076.037,2,2,0,0.98644852650934
565,207-008-2398,4575.368,6,5,1,2.5129889430746446
5701,703-004-5384,7380.8306,2,1,1,0.6174346418548649
5880,703-004-5388,2009.2678,2,0,2,0.27920371738274696
6315,703-004-5385,9740.991,3,1,2,0.538579013259999
6559,703-004-5390,6093.381,1,1,0,0.3783626723474551
6655,703-004-5389,9903.604,2,2,0,0.8456739595310243
6745,703-004-5391,1632.1177,5,4,1,1.2526433596242807
6956,703-004-5389,7485.514,3,3,0,0.9389392737399173
7087,703-004-5389,168.61378,5,4,1,1.899349683249016
726,703-004-5395,6051.438,2,1,1,0.5375911616753285
7295,703-004-5382,1033.3645,8,7,1,3.5284640195540664
7325,703-004-5387,2239.1003,5,3,2,1.2894712639800763
7326,703-004-5389,6179.4717,5,2,3,0.9671914864329304
7333,703-004-5395,5680.8677,3,2,1,1.8603329081457345
7399,207-008-2398,8417.158,5,3,2,1.1355899337412807
7505,703-004-5394,5263.3066,1,0,1,0.27920371738274696
7529,703-004-5385,4713.0317,4,2,2,0.6560942782122109
7867,703-004-5383,6237.888,4,2,2,1.177551885187382
8575,703-004-5380,9761.65,2,1,1,0.520068528091601
8812,703-004-5395,8749.54,6,2,4,1.2034280676843803
892,703-004-5384,8850.517,3,3,0,1.7803358013530497
9001,703-004-5389,6591.029,1,1,0,1.16532767513092
9080,703-004-5385,9112.859,1,1,0,0.44946605174353327
9866,703-004-5383,7255.3013,4,2,2,1.452885368347486
1020,703-004-5385,5321.6655,2,1,1,0.39748898624160406
10206,703-004-5395,97.59068,5,2,3,0.696544399578719
1029,703-004-5389,1500.5952,4,4,0,2.808856290921496
10735,703-004-5394,2591.7673,"","","",0.27920371738274696
10740,703-004-5395,7170.3726,5,2,3,1.053351821353536
11052,703-004-5381,4738.8027,3,1,2,0.3187575773453028
11719,207-008-2399,4317.948,4,1,3,0.564744715351299
11721,703-004-5390,5766.2144,2,0,2,0.27920371738274696
1176,703-004-5385,4761.9277,4,2,2,2.5807365310868544
1198,703-004-5399,9961.178,2,1,1,1.657458550414229
12181,703-004-5393,3477.5042,3,1,2,0.40840582796650965
12287,703-004-5380,3473.3308,3,1,2,0.6078164954614913
1233,703-004-5399,9020.061,1,1,0,1.2274853077252887
12348,703-004-5382,6138.6704,5,2,3,0.4568664717145602
1287,703-004-5394,660.4409,5,1,4,1.0243125672745406
12892,703-004-5388,2916.348,6,4,2,1.374145796396122
13102,703-004-5382,7317.825,5,1,4,0.7239834688623368
13305,207-008-2398,8719.139,6,5,1,1.7919115710649656
13318,703-004-5395,326.8385,5,4,1,1.1430662592934022
13594,703-004-5388,1838.19,4,3,1,2.3456623946939357
13705,703-004-5380,9352.041,5,2,3,0.7260607039292835
13849,703-004-5396,4471.2573,3,1,2,1.3726505275049101
14029,703-004-5386,5156.2363,5,3,2,0.9228626223972041
14142,703-004-5389,3033.5747,4,1,3,0.35692705220916915
14192,703-004-5393,8078.9624,1,0,1,0.27920371738274696
14509,703-004-5381,691.43414,8,3,5,1.0388804733329058
1458,703-004-5396,7716.565,6,2,4,3.739210867499268
14794,703-004-5392,1532.3347,4,1,3,0.44570151772086475
1491,703-004-5384,6703.761,7,4,3,1.1923252877285244
15075,703-004-5385,6159.5107,4,3,1,0.9316487993793088
1542,703-004-5389,7535.91,4,1,3,0.3902511792276225
15521,703-004-5392,9461.865,8,3,5,1.2503122694001025
15598,703-004-5388,4947.609,7,5,2,4.297598528272835
15633,703-004-5395,8484.389,4,2,2,0.7459960552880628
15685,703-004-5389,2236.0056,3,3,0,0.9894217635809339
1614,703-004-5392,4795.1255,1,1,0,0.44829646872267315
16557,703-004-5383,9726.46,3,1,2,0.35831143730785864
16666,703-004-5394,8351.783,5,2,3,0.8632972640080084
16794,703-004-5381,881.4722,6,0,6,0.27920371738274696
16860,703-004-5389,4642.8555,4,2,2,0.6450769220363883
17120,703-004-5392,1248.048,5,4,1,0.986227151328184
17360,703-004-5390,6331.418,2,0,2,0.27920371738274696
17520,703-004-5389,1357.1703,8,3,5,1.1335626044044858
17665,703-004-5398,2984.708,5,1,4,0.7986640015719914
1797,207-008-2398,8610.203,6,5,1,1.1578795773228343
17994,703-004-5389,6784.262,5,3,2,0.9796148838978203
18263,703-004-5389,9187.72,6,3,3,0.9608718828776838
18389,703-004-5399,4306.9136,3,1,2,0.6300487198794394
18804,703-004-5383,8019.128,3,3,0,0.7527217265686894
19072,703-004-5389,5046.5884,2,0,2,0.27920371738274696
19098,703-004-5380,7267.539,6,2,4,0.5847145771423927
19277,703-004-5396,9210.457,4,2,2,0.7413446726884473
19292,703-004-5387,4046.2231,3,3,0,2.340121331965212
19832,703-004-5387,7158.654,4,2,2,1.3315867688243375
19849,703-004-5387,9031.011,3,2,1,1.6480498138553275
19913,703-004-5398,1372.3207,2,1,1,0.6123461029173735
20206,703-004-5381,1679.9695,3,2,1,1.1531574672910383
20208,703-004-5398,6855.436,3,2,1,0.7792543657662181
20379,703-004-5382,4753.825,4,0,4,0.27920371738274696
20558,703-004-5397,8641.625,5,2,3,0.7218668180197283
20767,703-004-5391,8926.042,4,2,2,1.0744685306104094
20809,703-004-5384,5889.97,4,2,2,0.4168053734344544
210,703-004-5394,3765.3477,7,5,2,3.2020072071008165
21015,703-004-5386,8477.844,3,2,1,0.8446969072554215
21032,703-004-5382,6689.2983,4,2,2,0.9855897306387665
21044,703-004-5390,4452.6055,5,2,3,0.8037269654117731
21125,703-004-5399,7560.9355,7,3,4,1.024855531401304
21348,207-008-2398,1396.8652,3,2,1,0.7885723178896615
21560,703-004-5397,2229.9893,3,1,2,0.7632929570666495
21811,703-004-5391,6623.919,4,1,3,0.40717602332300845
22401,703-004-5391,3651.7756,3,3,0,1.3084069009725616
22516,703-004-5385,4646.4434,3,1,2,0.8734614540831167
22694,703-004-5390,2375.918,3,2,1,0.5600675687196066
22782,207-008-2398,5888.0425,5,5,0,2.4044512713669333
22905,703-004-5383,5971.5347,2,0,2,0.27920371738274696
22990,207-008-2398,3658.473,5,1,4,0.33853450732658075
22996,703-004-5397,6751.724,5,2,3,1.2990773538550202
23253,703-004-5382,1638.5216,8,3,5,2.2978145980799534
23533,703-004-5399,8191.695,7,2,5,1.7729283254162802
23550,703-004-5394,7875.477,5,5,0,2.815041711624096
23742,703-004-5383,4174.646,4,3,1,0.9078737849580137
23803,703-004-5391,8386.762,5,3,2,0.9352167149701717
23868,703-004-5388,1431.7018,7,3,4,1.1365596225358745
23924,703-004-5383,7123.8525,9,5,4,4.190394441483435
24086,703-004-5389,2774.965,3,1,2,0.9152640668826755
24162,703-004-5398,3243.7969,5,3,2,0.9343484459410872
24188,703-004-5392,6394.757,5,0,5,0.27920371738274696
24391,703-004-5394,8999.613,5,2,3,0.5637805384550616
24406,703-004-5388,6525.653,5,2,3,1.1986369935980221
24586,703-004-5384,6322.348,3,1,2,0.7637103296994575
24707,703-004-5399,414.0121,4,3,1,0.9182831193033524
25546,207-008-2398,3251.5364,4,1,3,0.4914594315041256
25956,703-004-5393,5873.013,3,3,0,2.159967179630214
2602,207-008-2398,5985.3286,7,5,2,2.5912577128821845
26138,703-004-5397,4623.964,"","","",0.27920371738274696
26517,703-004-5382,5312.075,8,3,5,0.506920939738604
27448,703-004-5394,3891.4763,6,4,2,1.2882332623080683
27828,703-004-5399,1032.8811,3,0,3,0.27920371738274696
2790,703-004-5396,6760.408,5,2,3,1.537562644929608
28003,703-004-5399,2004.8052,2,1,1,0.49067083200583855
28028,703-004-5381,3345.7236,7,3,4,0.8031270178687947
28412,703-004-5396,2438.8809,2,0,2,0.27920371738274696
28837,703-004-5388,1431.641,9,3,6,2.7544259434644953
28876,703-004-5389,7239.8765,4,2,2,1.1551106853434658
29197,703-004-5380,16.2071,4,4,0,0.8488459407054998
29285,703-004-5393,7316.003,3,1,2,0.6112427110385568
29679,703-004-5396,6030.0635,5,2,3,0.9683522514336229
30001,703-004-5387,4645.833,4,4,0,1.2289518381148923
30275,703-004-5395,1733.8132,6,6,0,5.33245925583286
30950,703-004-5384,9437.433,2,1,1,0.49547437296280944
30960,703-004-5388,4211.042,5,3,2,1.082810900035066
31127,703-004-5397,1490.1525,3,0,3,0.27920371738274696
31265,703-004-5396,2711.1084,4,2,2,3.5072134576971776
315,703-004-5391,569.52295,3,1,2,0.5113408583259939
31507,703-004-5391,6557.441,5,4,1,2.4401470177978655
31680,703-004-5394,6578.75,5,2,3,0.7062597098312944
31712,703-004-5398,5329.7056,3,1,2,0.5612082748726195
31768,703-004-5398,7787.5425,9,4,5,1.575455208304336
31790,703-004-5380,2379.597,8,5,3,1.398105472018884
32340,703-004-5386,1700.97,4,2,2,0.8434950135656024
32587,703-004-5392,212.88275,"","","",0.27920371738274696
32595,703-004-5391,339.34058,4,3,1,1.3298743901943662
32708,703-004-5388,4651.906,4,2,2,0.8614886770510006
32786,703-004-5382,400.25592,3,1,2,1.1843793063280443
32855,703-004-5395,7596.7764,7,5,2,1.7410167831453327
3297,703-004-5385,1740.1433,"","","",0.27920371738274696
33320,703-004-5385,9280.472,4,1,3,0.4203978128290838
33322,703-004-5399,4868.0854,3,2,1,0.649616842717737
33488,703-004-5393,9959.416,4,2,2,0.5742946770964031
3363,703-004-5399,3581.3867,3,1,2,0.750132468520186
33684,703-004-5385,3205.4973,8,5,3,1.955726078538823
33819,703-004-5388,7666.9897,4,2,2,1.0496199588634185
3401,207-008-2399,3687.5737,4,2,2,1.493907617463972
3418,703-004-5395,6905.534,3,2,1,0.8967759468705687
34314,703-004-5381,4037.873,4,2,2,0.924251997190512
34449,703-004-5391,6995.863,8,4,4,1.767990918373313
35134,703-004-5393,6708.7593,8,5,3,1.6572158598361582
3515,703-004-5394,1841.2578,3,2,1,0.7492904657262331
35158,703-004-5396,5424.54,3,2,1,1.679186610190955
35189,703-004-5390,6985.5327,2,1,1,1.366180627459645
35458,703-004-5398,4987.3438,5,5,0,1.9731972406528206
35977,703-004-5392,9591.511,3,1,2,0.3919322182760311
36394,703-004-5385,323.40527,5,2,3,0.49351971527986194
36403,703-004-5386,4259.216,3,0,3,0.27920371738274696
36422,703-004-5384,3025.5933,3,1,2,0.3978652972704144
3684,703-004-5393,5678.7134,3,1,2,0.7647740820329415
36882,703-004-5380,9793.521,7,3,4,0.6082355575773555
37011,207-008-2399,478.1878,8,4,4,2.1284115199469653
37101,703-004-5384,7451.626,6,4,2,1.4985366543990497
37418,703-004-5380,1298.5099,4,2,2,0.6287263888781418
37479,703-004-5385,90.39104,6,5,1,5.053864184993135
38168,703-004-5387,3428.5396,4,2,2,0.42933204094812605
38202,703-004-5399,7463.0366,4,2,2,0.6232833043836238
38228,703-004-5397,4379.1357,5,1,4,0.4477086887498441
38975,703-004-5399,8826.446,9,5,4,1.0857628317840344
39053,703-004-5382,8254.79,4,2,2,0.8985455205248853
39086,703-004-5392,6154.114,3,2,1,0.5146242341757383
3916,703-004-5387,2794.144,3,3,0,1.0704698170921851
39485,207-008-2399,753.1887,3,3,0,1.0233489129742694
39532,703-004-5386,2273.5823,3,1,2,0.43297561920701255
39610,703-004-5389,8916.374,2,0,2,0.27920371738274696
39656,703-004-5395,5929.4434,1,0,1,0.27920371738274696
39673,703-004-5393,8569.929,4,3,1,0.8789813658705237
39885,703-004-5391,6732.955,2,2,0,1.2407127710689663
3998,703-004-5394,1957.3373,1,0,1,0.27920371738274696
39993,207-008-2398,2014.743,3,1,2,0.35237835831347525
4012,703-004-5393,5329.6816,4,1,3,0.537762355725479
40282,703-004-5391,1955.5271,9,4,5,1.8738884828905844
40497,703-004-5389,1383.9238,4,2,2,1.7608739347128122
40579,703-004-5392,5301.8496,8,4,4,1.3090306225583772
40664,703-004-5395,5960.79,4,2,2,1.1054298364033774
40679,703-004-5396,5571.8022,4,0,4,0.27920371738274696
40708,703-004-5386,4847.45,2,1,1,0.4152817892036748
4074,703-004-5395,7815.763,5,2,3,2.555481663062828
4082,703-004-5381,8397.982,6,3,3,1.8577057600683415
40889,703-004-5388,3513.4697,3,1,2,0.3797614955655527
411,703-004-5394,8197.802,4,0,4,0.27920371738274696
41479,703-004-5396,6690.754,7,4,3,0.9145253115751565
41629,703-004-5393,7257.746,6,2,4,0.9706901623732229
41773,703-004-5386,1513.4252,3,3,0,1.231489653867563
41799,703-004-5383,3355.7778,5,1,4,0.610456576818603
4183,703-004-5392,7864.261,3,1,2,0.44884068829047097
42429,703-004-5393,8452.709,3,2,1,0.9820055156141108
42481,703-004-5383,7881.8433,8,4,4,1.6991341844591599
42493,703-004-5391,9181.341,5,2,3,1.1418678531288822
42662,703-004-5396,329.41818,2,2,0,1.0480021447947265
42732,703-004-5389,7931.463,5,3,2,1.5799359218257274
42967,703-004-5387,5049.6704,8,5,3,1.464884178620122
43630,703-004-5391,2169.398,2,1,1,1.7661295603610996
43734,207-008-2399,8474.125,1,1,0,2.086302223929656
44053,703-004-5394,8241.7705,2,1,1,0.32666834933781397
44064,703-004-5388,3733.474,2,2,0,0.7634261776367663
44232,703-004-5399,989.2827,6,1,5,0.5165268771580819
44692,207-008-2398,7175.315,3,1,2,0.3637500930527101
44927,207-008-2399,1754.5563,6,2,4,0.7141506108125192
4497,703-004-5396,2293.879,7,4,3,1.4926483492466514
45056,703-004-5383,9458.449,4,2,2,1.376846459251618
45228,703-004-5388,2311.6833,3,0,3,0.27920371738274696
45229,207-008-2398,1111.694,5,2,3,0.6907262293738804
45358,703-004-5383,1125.8739,4,2,2,0.8222566009898259
45364,703-004-5399,2214.7202,5,4,1,1.6531668673919142
45378,703-004-5389,9995.013,6,5,1,1.6366157062465614
45505,703-004-5388,8117.7207,2,1,1,0.32666834933781397
45651,703-004-5393,1701.1517,4,4,0,0.7451932760549369
45806,703-004-5398,6820.4067,3,2,1,0.7693136444341107
46198,703-004-5395,1932.6925,2,1,1,0.7972280751245618
46287,207-008-2399,9715.2,9,7,2,2.3438797960442255
46731,703-004-5398,5451.4004,3,1,2,0.6305643636045019
4691,703-004-5383,9590.436,4,2,2,2.2293785088361493
47008,703-004-5395,4343.2266,2,1,1,0.7699044591848874
4729,703-004-5394,9242.457,3,0,3,0.27920371738274696
47394,703-004-5392,6292.4863,3,0,3,0.27920371738274696
47647,703-004-5386,5138.558,2,0,2,0.27920371738274696
47655,703-004-5381,4174.4404,2,2,0,1.0965177896789564
47672,703-004-5398,2771.219,3,3,0,1.609779101215664
48051,703-004-5394,585.5024,5,4,1,1.3115470117221644
4812,703-004-5380,9599.386,4,3,1,0.6728524499801887
48249,703-004-5384,4963.695,2,2,0,0.8310628837257832
48886,703-004-5398,5684.628,3,1,2,0.4810198776666186
48992,703-004-5392,6137.082,6,1,5,0.8092925186944369
5006,703-004-5398,1781.8737,10,5,5,2.0358402178317263
5038,703-004-5380,715.46436,1,0,1,0.27920371738274696
5089,703-004-5396,157.50706,5,4,1,0.8743158922528297
510,703-004-5386,9234.992,4,2,2,2.5523921729392134
5266,703-004-5383,2971.9084,3,2,1,2.6788722280311377
5875,703-004-5382,763.4974,8,6,2,1.2392495314772485
5903,703-004-5385,3241.4246,4,3,1,0.9565637438621375
6241,703-004-5389,1010.85126,2,0,2,0.27920371738274696
6447,703-004-5397,7093.048,4,3,1,2.393667062753606
6528,703-004-5387,8569.227,3,0,3,0.27920371738274696
6581,703-004-5384,105.39114,2,1,1,0.47130387781251787
6735,703-004-5385,9300.928,6,3,3,0.9470521045760208
6755,703-004-5398,345.13474,5,3,2,1.4781078393218494
6803,703-004-5390,3459.2183,2,0,2,0.27920371738274696
7190,703-004-5385,6387.683,2,1,1,0.6604331601810823
7485,703-004-5384,0.05185604,2,1,1,0.4802172332875546
7561,703-004-5389,9980.93,6,3,3,1.173872537550684
7688,703-004-5380,7946.1265,"","","",0.27920371738274696
784,703-004-5383,1069.7668,10,4,6,1.8187548734947923
7938,703-004-5391,2246.5027,4,1,3,0.7738462445175213
8347,703-004-5383,691.7941,2,0,2,0.27920371738274696
8445,703-004-5392,8939.314,2,0,2,0.27920371738274696
8536,703-004-5382,6869.7256,5,2,3,0.9323838319424456
8639,703-004-5390,3142.5352,2,1,1,0.47494606329679057
871,207-008-2398,3352.3542,7,4,3,2.593487159751804
8779,703-004-5397,3738.2173,7,3,4,0.7865783093411984
9005,703-004-5396,503.2462,5,0,5,0.27920371738274696
9088,703-004-5392,3298.465,3,1,2,0.460682329201231
9091,703-004-5381,8416.284,4,0,4,0.27920371738274696
9360,703-004-5399,9630.698,"","","",0.27920371738274696
9449,703-004-5390,3915.2605,4,3,1,1.3030046451425172
10082,703-004-5385,3057.328,3,2,1,0.5702762024294299
10119,703-004-5385,3624.6138,3,0,3,0.27920371738274696
10160,207-008-2399,6481.787,2,1,1,0.47683700959996733
10435,703-004-5394,562.25775,4,1,3,1.1666171826599505
10529,703-004-5398,8472.943,7,5,2,2.9269412721661645
10624,703-004-5381,681.69354,5,2,3,3.641687751886402
10843,703-004-5390,409.25024,6,4,2,2.6380430796569243
10857,703-004-5394,8144.6978,5,2,3,1.2925934103740875
10882,703-004-5398,1058.1523,3,2,1,0.8948257887357826
1094,703-004-5390,1662.2239,3,2,1,0.6554201675026506
10943,703-004-5397,9875.876,4,0,4,0.27920371738274696
11152,703-004-5380,7055.8755,7,3,4,1.2160038539173201
11449,703-004-5383,6530.259,2,1,1,1.7518006488275792
1166,703-004-5396,7097.5493,4,2,2,1.7613324971666777
11914,703-004-5390,8573.232,1,0,1,0.27920371738274696
11950,703-004-5393,1786.9681,3,1,2,0.3965146510547745
12074,703-004-5382,1288.5522,4,3,1,1.2134755574154064
12387,703-004-5382,2239.3472,2,0,2,0.27920371738274696
12453,703-004-5393,1737.2638,1,1,0,0.5228786956791461
12476,703-004-5394,2832.2417,2,1,1,1.434587608178211
12488,703-004-5386,6512.7124,6,2,4,1.0819425393714106
12496,703-004-5396,1816.6548,1,0,1,0.27920371738274696
12743,703-004-5382,5020.436,2,0,2,0.27920371738274696
12972,703-004-5389,7538.435,5,1,4,0.7059081310052376
13108,703-004-5398,8928.983,4,3,1,1.4396996349078486
1330,703-004-5389,1106.6383,2,1,1,0.5145386915253491
13418,703-004-5389,6995.323,5,3,2,2.2586341166975017
13436,703-004-5399,4614.8096,1,0,1,0.27920371738274696
13540,207-008-2398,6824.875,5,2,3,1.4074879577566037
13784,703-004-5396,6026.7427,5,2,3,1.8294592790024764
13825,703-004-5382,7509.0264,5,4,1,3.0496014913856584
13998,207-008-2399,1506.117,4,2,2,1.4135163654327574
14086,703-004-5388,2726.4656,3,1,2,0.4003374135180742
14240,207-008-2398,4812.7783,3,1,2,0.5051297823691624
14275,703-004-5387,8368.062,6,2,4,0.7891466698720289
14440,703-004-5392,4466.159,5,2,3,0.746354582722283
14873,703-004-5382,3061.0693,2,0,2,0.27920371738274696
14884,703-004-5393,7566.746,4,3,1,1.088450355743903
15015,703-004-5385,422.0563,3,0,3,0.27920371738274696
15146,703-004-5394,2156.6301,5,1,4,0.7155986066634804
15299,703-004-5384,5731.723,3,2,1,0.7590844772375512
15357,703-004-5384,9295.422,5,4,1,1.8086338408442888
1545,703-004-5382,1977.5992,5,1,4,0.4125228230587813
15538,207-008-2399,2773.9036,2,1,1,0.7809829496690512
15667,703-004-5383,865.4934,"","","",0.27920371738274696
15719,703-004-5381,7284.2485,3,1,2,0.5165268771580819
15737,703-004-5385,6027.716,1,1,0,0.3903157877709006
15756,703-004-5387,9294.448,5,3,2,1.0839374674879294
15995,703-004-5381,1040.5355,8,5,3,1.41380322610776
16467,703-004-5384,5691.018,3,2,1,0.5952727602504365
16554,703-004-5391,8493.514,5,1,4,0.9695619598536964
16560,703-004-5386,3516.4333,1,0,1,0.27920371738274696
16995,703-004-5385,9147.693,2,1,1,0.5165268771580819
17043,703-004-5396,1117.2909,2,2,0,0.6741040372198792
17185,703-004-5391,3632.588,4,2,2,1.2281468843790118
17278,703-004-5397,3287.8716,5,0,5,0.27920371738274696
17805,703-004-5382,2679.907,7,5,2,2.12092571998824
1810,703-004-5386,3061.1592,2,0,2,0.27920371738274696
18167,703-004-5395,999.0543,4,1,3,0.4788193718960567
18220,703-004-5392,9486.18,6,3,3,1.0257060010571428
18437,703-004-5387,8702.787,6,1,5,0.35831143730785864
18511,207-008-2399,3210.2673,5,3,2,0.6174781523845119
18582,703-004-5391,4035.306,5,4,1,0.9014576707807875
18749,703-004-5385,6561.1865,2,0,2,0.27920371738274696
18829,703-004-5392,512.93494,8,6,2,1.9210993748359704
19193,703-004-5393,175.0517,7,2,5,1.2833747622624243
19219,703-004-5383,6012.2793,1,0,1,0.27920371738274696
19375,703-004-5387,6025.4775,2,1,1,0.9830358162158924
19435,703-004-5380,6125.6973,5,4,1,1.4033359003444457
19726,703-004-5394,6275.962,3,0,3,0.27920371738274696
19818,703-004-5382,2239.0085,4,0,4,0.27920371738274696
20097,703-004-5391,6160.2197,6,6,0,4.242551902716705
20242,703-004-5382,4321.7397,2,1,1,0.5751615191665747
20609,703-004-5393,9388.896,1,1,0,0.3772515134718986
20622,207-008-2399,5709.187,5,4,1,1.1574666162746714
2065,703-004-5385,7471.954,6,4,2,1.7754713598693754
20655,703-004-5380,9192.055,6,1,5,0.5422371667601911
21327,703-004-5381,2607.485,9,3,6,2.2273794660260906
21480,703-004-5398,6122.2734,1,1,0,0.41813953045942787
21510,703-004-5383,7060.9907,2,1,1,0.3978652972704144
2154,703-004-5380,8807.065,5,2,3,0.8728287651226868
2192,703-004-5381,6231.6226,2,1,1,0.4406663906199691
22033,703-004-5398,8130.9004,5,2,3,1.3694855124650407
22253,703-004-5387,4613.489,7,4,3,1.4425125974139419
22523,703-004-5392,4564.2134,6,4,2,2.175866763852072
22568,207-008-2399,2857.222,2,2,0,0.7048661407949983
22711,703-004-5383,6005.528,5,3,2,0.6560127296763706
22816,703-004-5389,2484.6804,7,3,4,1.002417666700368
23235,703-004-5382,8865.849,9,6,3,2.7159504219734996
23310,207-008-2398,7744.741,5,2,3,1.113928544919647
24280,703-004-5398,7551.72,5,2,3,0.4762790539511038
2430,703-004-5392,2304.3018,3,2,1,0.7300871135001425
24523,703-004-5399,6159.2056,6,4,2,1.2982989269845477
24735,703-004-5381,7269.967,7,4,3,1.3471015308394274
24930,703-004-5387,5891.883,5,3,2,1.5658146258155294
25046,703-004-5384,6605.003,3,3,0,2.8079075495515244
25263,703-004-5395,2414.0166,4,1,3,0.43771981120411796
25617,207-008-2398,8751.694,2,1,1,0.32666834933781397
25694,703-004-5398,4453.295,3,2,1,0.7178065820425379
25857,703-004-5396,8645.207,6,4,2,1.2982893253383747
26031,703-004-5397,5768.888,6,5,1,1.515116256541333
26088,703-004-5388,5979.832,7,4,3,1.4177234810258532
26479,703-004-5382,6595.496,4,1,3,1.0515287590316083
26500,703-004-5384,3132.3784,6,3,3,1.1719048248484867
26522,703-004-5380,9358.991,6,3,3,0.75217788131129
26532,703-004-5387,5361.913,4,2,2,0.5329934586484553
2659,703-004-5397,8160.0737,2,2,0,0.9843269653243482
26944,207-008-2399,5504.772,6,6,0,1.9437451533403163
27024,703-004-5380,188.68149,3,2,1,3.2082632422393758
27226,703-004-5397,8548.147,5,2,3,0.80408418174608
2727,703-004-5392,4258.126,3,2,1,1.1465821299190948
27284,703-004-5393,4797.437,3,2,1,1.0322212740764272
27644,703-004-5387,5233.0903,6,4,2,1.637443618855595
27670,703-004-5389,1302.0104,3,3,0,1.6609563508071925
27810,703-004-5393,742.1732,5,0,5,0.27920371738274696
27993,703-004-5387,6704.864,6,3,3,1.3969478638187351
28021,703-004-5392,5072.685,4,1,3,0.5273593423989552
28080,703-004-5398,4080.8105,6,4,2,1.6439013906682647
28133,703-004-5385,3446.5212,1,1,0,1.6872127396595686
28768,703-004-5399,5118.6704,4,3,1,0.9064584142757944
28789,703-004-5390,3036.0896,2,2,0,1.001793613976087
28979,703-004-5384,5959.955,5,4,1,1.1471598309366648
29656,703-004-5398,702.79956,5,2,3,0.8623029796247633
29730,703-004-5382,433.27927,4,1,3,0.37691823226524435
29772,703-004-5389,1262.8705,1,1,0,0.4138637057222303
29862,703-004-5391,1208.0371,9,4,5,1.6199844876213523
30157,703-004-5399,8917.647,6,1,5,0.3356517871695026
30477,703-004-5399,4842.441,6,3,3,1.169287159003479
30679,703-004-5399,99.676254,8,2,6,0.5934048650115704
30682,703-004-5387,9639.78,6,5,1,1.580625713131098
30716,703-004-5389,2557.7224,"","","",0.27920371738274696
30855,703-004-5388,8884.149,3,2,1,1.572154548443093
31042,703-004-5390,4883.0186,2,1,1,0.4756507529209138
31316,703-004-5399,9271.252,5,2,3,0.4348528398617603
31353,703-004-5399,3822.328,4,2,2,0.8716160163151104
31458,703-004-5382,3653.1274,7,4,3,1.5986996936059024
31479,703-004-5390,4644.2427,3,1,2,0.5565308821959177
32723,703-004-5380,2763.133,7,4,3,0.7154800366057956
32807,207-008-2398,123.742226,1,0,1,0.27920371738274696
32825,703-004-5386,3535.7075,9,3,6,0.8023012129646316
3284,207-008-2399,8785.234,3,2,1,0.4826224730396112
32842,703-004-5390,3389.4783,3,0,3,0.27920371738274696
33085,703-004-5392,3787.8774,1,0,1,0.27920371738274696
33215,703-004-5399,7395.516,6,5,1,3.0541008658184303
33446,703-004-5390,4205.3013,3,3,0,0.5656613898614381
33616,703-004-5395,3984.7446,2,1,1,0.41467568775450064
33628,703-004-5390,2079.9136,3,1,2,0.40787407191843955
33846,703-004-5393,2483.3584,1,1,0,0.5098181172033138
33950,703-004-5382,8813.894,12,2,10,1.6278947847286351
34017,703-004-5394,8566.377,4,1,3,0.7695930517706451
34258,703-004-5385,1318.6354,3,2,1,0.5181864911990108
34269,703-004-5385,2594.0984,2,0,2,0.27920371738274696
34336,207-008-2398,7323.1895,6,6,0,2.4453353314255466
3434,703-004-5389,60.95469,3,0,3,0.27920371738274696
34543,703-004-5380,8535.371,5,4,1,2.401242013971921
34866,703-004-5399,1258.2129,4,1,3,0.9228772143598252
34917,703-004-5385,263.67426,9,4,5,0.836420163983731
35117,703-004-5389,3227.1396,2,0,2,0.27920371738274696
3528,703-004-5382,5138.414,4,2,2,0.7383544116286477
35354,703-004-5394,2639.848,8,5,3,1.3649279374114671
35689,703-004-5384,5521.918,3,0,3,0.27920371738274696
35710,703-004-5382,7121.6533,9,4,5,1.2990726337939595
35892,703-004-5391,269.38498,"","","",0.27920371738274696
36138,703-004-5380,8541.0625,6,2,4,0.7439918575791035
36239,703-004-5397,5103.577,5,2,3,0.6661747882966431
3635,703-004-5398,1716.4135,3,1,2,0.40332079504295193
36464,703-004-5381,5379.5566,4,4,0,1.736641413855135
36557,703-004-5396,9007.027,3,1,2,0.7182515629671166
36779,703-004-5398,3089.6973,6,2,4,0.775155158314014
36951,703-004-5388,2995.078,1,0,1,0.27920371738274696
37051,703-004-5397,231.26721,5,2,3,0.8517935953482566
37358,703-004-5385,681.96954,5,1,4,0.32666834933781397
37395,703-004-5393,2065.5203,1,1,0,1.1070040782572441
37404,703-004-5399,4762.9614,11,6,5,4.274222782833103
37476,703-004-5391,7890.8193,4,1,3,0.571728475202609
37689,207-008-2398,3118.516,4,1,3,0.44829646872267315
3776,207-008-2399,9480.974,3,1,2,0.47399190845290345
37776,207-008-2398,3637.1624,4,2,2,0.4471891354187228
37826,703-004-5390,734.7447,2,1,1,0.5374341196342888
37966,703-004-5390,4722.8013,7,3,4,0.6043720787044689
38309,703-004-5395,4844.917,8,2,6,1.443582606260524
38394,703-004-5380,197.70384,4,2,2,2.61880865105562
38471,207-008-2399,4669.0703,3,3,0,2.819760522705329
38619,703-004-5388,875.65424,7,6,1,3.100768051307182
38753,703-004-5382,4908.224,2,0,2,0.27920371738274696
38800,703-004-5388,8087.561,3,2,1,0.4967766375343791
3890,703-004-5383,9400.993,4,2,2,0.5105937981636984
39434,207-008-2399,8876.392,4,1,3,0.36951836429724944
3957,703-004-5397,4767.6265,4,0,4,0.27920371738274696
39613,703-004-5391,9209.412,2,1,1,0.528356793922658
39829,703-004-5390,6518.3716,6,2,4,0.8519617515338685
4001,703-004-5399,4346.025,2,0,2,0.27920371738274696
40124,703-004-5395,156.02768,6,2,4,0.7178330513055067
40321,703-004-5388,1070.5132,4,1,3,0.8375106801271923
40355,703-004-5386,972.30853,4,4,0,1.7089105707495638
40846,703-004-5387,2348.615,2,1,1,0.9017537854914018
41185,703-004-5390,455.7961,7,2,5,2.197588747055119
41425,703-004-5392,6442.756,4,1,3,0.41990687136818466
41521,703-004-5387,9697.302,1,0,1,0.27920371738274696
41631,703-004-5399,9598.533,2,1,1,0.3978652972704144
417,207-008-2398,6337.853,6,5,1,1.5546297727016931
41780,703-004-5391,2983.4204,2,1,1,0.413813210047748
41797,703-004-5388,5379.3477,10,6,4,1.7764967723678484
42073,703-004-5382,9934.509,2,0,2,0.27920371738274696
42868,703-004-5393,423.0541,4,3,1,1.3203495192042607
4292,703-004-5387,1314.9894,4,1,3,0.3919322182760311
42987,703-004-5382,2937.8003,4,1,3,0.5766618312067538
43635,703-004-5383,4457.298,3,1,2,0.34031172623652106
43641,703-004-5393,5327.052,6,3,3,0.7664316665661938
4410,703-004-5386,4655.9165,3,1,2,0.47116061096108364
44221,703-004-5396,8545.276,2,1,1,0.8717086311409133
44571,703-004-5380,5199.9756,6,4,2,2.3963879547775084
44610,703-004-5390,4177.387,3,1,2,0.5485597297274709
4492,703-004-5391,822.2437,4,0,4,0.27920371738274696
44920,703-004-5389,6694.175,3,1,2,0.36951836429724944
45209,703-004-5390,3127.91,5,3,2,1.098004102400923
45959,703-004-5383,953.86206,3,1,2,0.5262935986639112
46011,703-004-5395,7112.7217,4,4,0,2.2392048635666333
46174,207-008-2399,2641.741,5,3,2,2.2905593655967977
46189,703-004-5381,5801.3853,5,2,3,1.0014082054244136
46634,703-004-5391,646.6365,5,3,2,0.7952423943616403
46727,703-004-5384,6312.072,5,1,4,0.45459314247576343
46852,703-004-5394,9563.967,3,1,2,1.1634438299942667
46884,703-004-5383,8804.806,3,1,2,0.39752628104032844
46961,703-004-5383,8224.778,1,0,1,0.27920371738274696
47006,703-004-5393,2254.8955,3,1,2,0.5252797188383539
47088,703-004-5398,2545.4963,2,2,0,0.7527600715008561
47367,703-004-5398,9247.043,6,2,4,0.5403319471047646
47451,703-004-5398,4960.938,2,0,2,0.27920371738274696
47521,703-004-5391,5568.9956,3,2,1,0.47697301719552604
47947,703-004-5384,1494.8964,2,1,1,0.4568697678695571
47962,703-004-5391,3387.4023,6,4,2,1.3072807171464735
48139,703-004-5385,6737.9565,5,4,1,1.4224886232993637
48660,703-004-5393,1760.0018,2,1,1,0.8642153352383248
48784,703-004-5380,8681.253,6,2,4,0.797487350052242
48859,703-004-5389,8484.238,3,2,1,1.576968484635154
49259,703-004-5381,2739.3943,3,1,2,0.3822662437476815
49653,207-008-2399,408.16724,3,0,3,0.27920371738274696
49747,703-004-5395,1233.9067,8,5,3,3.3196763788636154
49840,703-004-5390,6254.9043,2,1,1,0.5157927872059241
5163,703-004-5382,2610.5117,3,3,0,2.495539215569189
5522,703-004-5396,3859.6296,3,1,2,0.37175974969512765
557,703-004-5399,110.8408,3,1,2,0.7207132789637578
6000,703-004-5398,1491.3868,8,3,5,2.767302347520392
6395,703-004-5388,4748.3213,7,3,4,0.7769570433809102
6439,703-004-5395,9001.615,5,1,4,0.37512182779194486
6492,703-004-5398,3867.7305,5,3,2,0.8121698546273564
6594,703-004-5386,7139.61,9,2,7,1.8235740410765506
6842,703-004-5393,6970.8657,6,2,4,0.5339885172654536
6920,703-004-5395,1122.1552,7,5,2,1.1795253926245484
696,703-004-5380,3178.175,3,2,1,1.2995958846691684
7024,703-004-5388,1267.804,7,2,5,0.8226241282403215
7189,703-004-5399,5122.397,5,2,3,1.024599789224595
7242,703-004-5394,5852.7637,2,2,0,0.5436050234570566
83,703-004-5398,2814.0723,5,2,3,1.4239176627953614
844,703-004-5395,5382.158,3,1,2,0.8117439452574873
8447,703-004-5391,4258.5723,4,1,3,0.5867842414867391
8475,703-004-5388,7780.452,2,2,0,0.5285384220691709
8522,703-004-5386,8935.101,2,1,1,1.4817816845431826
8656,703-004-5392,3254.7568,4,1,3,0.5792575151025638
8917,703-004-5382,8997.632,5,4,1,3.522730970177182
9494,703-004-5386,2450.1782,3,2,1,1.6796045904922012
9512,703-004-5389,8765.155,10,5,5,1.6565834968895454
9582,703-004-5385,1016.14056,4,3,1,1.3677570932582919
9968,703-004-5385,7661.876,2,1,1,1.8141046619751544
10063,703-004-5391,72.00957,3,0,3,0.27920371738274696
10416,703-004-5399,3869.8477,5,2,3,0.7350036077061528
1049,703-004-5388,1572.5499,8,6,2,1.5155399561897294
10679,703-004-5399,6574.62,"","","",0.27920371738274696
10745,703-004-5399,6502.475,6,5,1,1.23284964511377
10984,703-004-5380,7673.2666,7,3,4,1.8475652172215555
11042,703-004-5397,1833.3423,4,0,4,0.27920371738274696
11857,703-004-5383,9551.336,10,5,5,1.517455849917147
12,703-004-5381,4053.2397,6,3,3,0.9316315079457189
12059,703-004-5381,9790.46,4,2,2,0.5956345970831934
12418,703-004-5388,9539.591,5,3,2,1.2266774495658872
12549,703-004-5381,4917.133,2,0,2,0.27920371738274696
12694,703-004-5391,7027.686,6,5,1,2.430384297417041
12920,207-008-2399,5079.2534,3,2,1,0.6961964304522439
12983,703-004-5386,2506.5845,4,2,2,0.604909688252368
13020,703-004-5383,3662.402,8,5,3,2.578345981893114
13128,703-004-5389,5541.245,1,1,0,0.5020561283857213
13130,703-004-5398,8936.27,2,0,2,0.27920371738274696
13274,703-004-5381,9999.621,3,2,1,0.3943054498737844
13408,703-004-5385,3746.9358,1,0,1,0.27920371738274696
13675,703-004-5398,9092.868,7,5,2,1.3448664274071505
13688,703-004-5387,6254.0474,7,4,3,1.7058881234029577
14558,703-004-5389,2665.9863,4,2,2,0.6705431927947322
14663,703-004-5391,6687.333,7,3,4,1.4666791037955853
14804,703-004-5391,8843.287,4,0,4,0.27920371738274696
15002,703-004-5394,8167.8657,3,2,1,0.7225709718312123
1525,703-004-5383,1454.9321,2,0,2,0.27920371738274696
15429,207-008-2399,6180.701,4,4,0,1.499490845714154
15532,703-004-5387,8819.29,4,1,3,1.2428291031905823
15672,703-004-5389,9935.115,2,0,2,0.27920371738274696
15769,703-004-5385,9089.241,3,1,2,0.9003946550559798
15886,703-004-5399,3526.2776,3,1,2,0.38130427662286237
16187,703-004-5388,6645.84,6,5,1,1.2247632633546979
16423,703-004-5381,4850.526,7,5,2,2.045073650367265
16591,703-004-5384,2719.6897,4,1,3,0.4422027021721919
16633,703-004-5391,7966.3037,4,3,1,0.8128099788115309
17036,703-004-5399,5093.5464,4,2,2,0.8081359265554569
17060,703-004-5381,211.80272,6,3,3,1.03568834395039
17144,703-004-5396,7096.0083,1,0,1,0.27920371738274696
17242,703-004-5394,3872.3118,1,1,0,0.5705588109351308
17495,703-004-5390,7942.3237,4,1,3,0.5734652230199557
17543,703-004-5381,1460.1671,4,3,1,1.4092886851705044
18251,703-004-5396,2701.8499,5,2,3,0.8419264155569346
18309,703-004-5386,5328.3394,1,0,1,0.27920371738274696
18541,703-004-5390,5626.421,5,2,3,0.9537256680129377
18986,703-004-5393,4147.6094,3,2,1,1.8497427693261128
19097,703-004-5389,1490.2067,3,0,3,0.27920371738274696
19281,703-004-5388,9004.747,4,1,3,0.4504751035697982
19707,703-004-5380,7481.1436,9,3,6,1.7421131671497687
2042,703-004-5389,7916.9614,1,0,1,0.27920371738274696
20724,703-004-5380,932.3114,4,3,1,0.45520106324242643
20904,207-008-2398,6752.279,3,2,1,0.8352756288209008
20915,703-004-5386,9912.052,3,1,2,0.4554203136236768
21273,703-004-5391,1688.2909,4,4,0,2.3921715620771993
21493,703-004-5398,7245.383,5,2,3,1.2094390762456937
21519,703-004-5384,6652.4536,3,2,1,0.5345453759039075
22056,703-004-5394,9362.044,4,3,1,1.1957657380951283
22075,703-004-5381,9358.862,4,2,2,0.4561760724304935
22305,703-004-5381,8069.154,6,3,3,2.103810590487126
22678,703-004-5381,5535.303,5,3,2,1.3729896487879025
23280,703-004-5382,244.9125,9,3,6,2.1843427207051995
2338,703-004-5384,4366.0386,1,0,1,0.27920371738274696
23817,703-004-5382,4424.269,6,5,1,4.598271616043795
23981,703-004-5398,1875.5173,4,2,2,0.6137065954490737
24102,207-008-2399,118.97683,7,6,1,3.8114221678889058
24133,703-004-5394,4077.6646,4,1,3,0.609676217369901
24142,703-004-5396,1633.3818,2,2,0,0.5343071939969565
24184,703-004-5391,6141.2246,2,1,1,0.3807252912866403
24249,703-004-5391,9737.219,4,1,3,0.673199253369642
24535,703-004-5387,8131.526,4,2,2,2.7994963765203558
24590,703-004-5389,6029.3745,4,2,2,1.5428294122150428
24866,207-008-2399,5283.631,7,5,2,2.789858411106799
24965,703-004-5399,2789.5337,2,1,1,0.9505024307387996
25008,703-004-5393,9411.617,3,3,0,0.9840656838538067
25141,703-004-5398,1968.8064,3,1,2,0.7811708756257898
25343,703-004-5388,1217.106,3,0,3,0.27920371738274696
25389,703-004-5394,4770.3286,3,1,2,0.8438734015181903
25726,703-004-5385,6804.6304,3,2,1,0.4733189409679227
2585,703-004-5381,4290.9307,4,1,3,0.7867729096924951
26314,703-004-5382,2182.256,5,1,4,0.8983683140693692
26659,703-004-5386,3838.5486,5,2,3,0.9304314209673112
26683,703-004-5395,6845.7847,4,3,1,1.1116868188693674
26787,207-008-2399,8988.623,2,0,2,0.27920371738274696
26842,703-004-5385,3651.942,4,1,3,0.46631685710514514
26904,703-004-5389,1646.9407,6,3,3,1.6514447652388287
26905,703-004-5385,9077.653,6,3,3,1.2440155695097943
27053,703-004-5387,8219.082,4,2,2,0.7138676768212667
27094,703-004-5387,1264.5996,10,3,7,1.869592002516893
2722,703-004-5399,6385.594,5,3,2,1.4122697050531237
27259,703-004-5380,685.7896,5,2,3,1.1318300702250879
27387,703-004-5392,1792.8511,3,2,1,1.3159974421696388
27812,703-004-5392,6736.1655,2,0,2,0.27920371738274696
28407,703-004-5394,2626.642,3,2,1,0.5026226227574716
28497,703-004-5397,3408.83,1,0,1,0.27920371738274696
28537,703-004-5391,202.55089,5,2,3,1.3519649817489727
28632,703-004-5391,4248.0093,2,0,2,0.27920371738274696
28646,703-004-5381,7455.419,1,0,1,0.27920371738274696
29046,703-004-5398,641.3716,2,2,0,0.7180265832124303
29179,703-004-5384,9692.355,"","","",0.27920371738274696
29263,703-004-5380,4425.5386,6,2,4,2.109669475816412
29462,703-004-5381,7033.0923,5,2,3,0.5542177397985041
30156,207-008-2399,1799.3492,2,0,2,0.27920371738274696
30171,703-004-5398,4547.5737,4,1,3,0.3467175417218341
30465,703-004-5394,4597.079,6,3,3,2.283458785138422
30572,703-004-5399,8846.317,2,1,1,0.5971855947385603
30871,703-004-5388,7361.956,1,1,0,0.5568718143198889
30956,703-004-5382,4348.6543,3,1,2,0.4207924319097514
31075,703-004-5398,2419.5654,2,1,1,0.42050988209897766
31496,703-004-5388,373.30032,7,5,2,3.2413669486756964
31563,703-004-5396,3744.6482,4,1,3,0.5392795137894474
31960,703-004-5394,5954.3755,1,0,1,0.27920371738274696
32000,703-004-5395,1089.8685,8,6,2,4.593811382172255
32355,703-004-5389,3841.0425,6,3,3,1.4028413237715027
32704,703-004-5399,5484.3765,3,2,1,0.4698038800773128
32850,703-004-5382,9685.908,4,2,2,1.0853887104372484
32896,703-004-5390,8308.483,9,2,7,2.186498671455217
32955,703-004-5391,6088.865,2,0,2,0.27920371738274696
33063,703-004-5389,320.58536,2,0,2,0.27920371738274696
33170,703-004-5393,6602.6807,3,2,1,0.4620514105834089
33625,703-004-5393,3079.3105,4,3,1,2.1319413324034593
33646,703-004-5399,5003.5356,3,0,3,0.27920371738274696
33796,703-004-5397,5302.0596,2,1,1,0.766702611496044
3385,703-004-5393,8423.263,3,2,1,1.0177465136257353
339,703-004-5384,7172.66,"","","",0.27920371738274696
33946,703-004-5388,6617.502,7,4,3,2.0586251111798837
34242,703-004-5386,7337.2314,6,1,5,0.3905112393181939
34290,703-004-5380,1477.9127,2,2,0,2.2788478119397086
34309,703-004-5395,6840.4233,5,2,3,0.9925697740417132
34381,703-004-5380,8320.934,7,5,2,2.9487790018262108
34718,703-004-5394,4527.695,5,4,1,2.1370986553318967
35139,703-004-5382,4849.7544,2,1,1,0.3690557427011291
35647,703-004-5398,7085.8955,3,1,2,0.4714647506110769
3588,703-004-5382,4268.561,6,1,5,0.45174218675253625
36237,703-004-5398,3352.506,8,4,4,1.0445122328811383
36879,703-004-5380,6335.434,6,4,2,2.3150710279239846
36995,703-004-5399,3890.3015,3,1,2,0.6312577922119704
37178,703-004-5394,381.87564,6,3,3,1.6953190929131527
37259,207-008-2399,1162.5266,4,2,2,1.6278685828331294
37513,703-004-5390,8539.814,3,3,0,1.334614641980631
37576,703-004-5395,8278.518,4,3,1,1.2599064696972364
37723,703-004-5396,8381.072,3,2,1,1.1552400305186656
37855,703-004-5386,3869.9453,3,2,1,0.704103528202807
38460,703-004-5390,201.30695,7,5,2,1.6371928003178646
38754,703-004-5399,3797.3118,4,1,3,0.5369114388287168
39319,703-004-5382,820.5271,7,3,4,1.6340798826688183
39547,703-004-5390,9890.719,6,3,3,1.158462951265385
39575,703-004-5381,3192.9546,6,2,4,1.4005882938020955
39729,703-004-5392,563.9237,2,1,1,0.42245815936656106
39762,703-004-5383,2287.587,4,2,2,1.3846741598019994
40162,703-004-5397,5820.231,4,2,2,0.9286069937243402
40418,703-004-5388,5108.5146,2,1,1,0.36010784178115807
40550,703-004-5388,3080.697,5,2,3,0.8236325167101761
40584,703-004-5382,8993.446,5,1,4,0.5418346842795378
40982,703-004-5397,892.0252,4,3,1,1.6983817740237048
4103,703-004-5385,6843.4507,5,2,3,1.128565979260901
41400,703-004-5389,7922.5444,3,1,2,0.679804162841728
41711,703-004-5385,2804.9165,3,2,1,0.9242011053280946
41775,703-004-5393,2822.5386,3,0,3,0.27920371738274696
41924,703-004-5394,4835.515,5,2,3,0.9084577993642189
42084,703-004-5384,308.56012,5,4,1,1.1767884605957242
42288,703-004-5388,7596.8306,5,2,3,0.5218007251530894
42334,703-004-5380,129.46666,3,1,2,0.3978652972704144
4234,703-004-5396,6661.7173,4,1,3,0.9181454389545906
43918,703-004-5389,1355.6653,3,2,1,0.8458909638490255
4396,703-004-5398,3785.215,6,2,4,0.6605963723286733
44043,703-004-5384,9900.789,3,1,2,0.4342290077249578
4413,703-004-5397,2764.3513,4,4,0,1.4088249177011838
44361,703-004-5380,1235.4661,4,1,3,0.5165268771580819
45183,703-004-5399,3923.2861,4,1,3,0.3978652972704144
45230,703-004-5393,2694.3462,2,0,2,0.27920371738274696
45253,207-008-2398,5719.203,3,3,0,0.6727579066780547
45605,703-004-5387,8113.982,2,1,1,0.6705572640709431
45743,703-004-5381,2896.0503,5,4,1,1.6826475114479011
45828,703-004-5382,9509.022,5,2,3,0.8215469517001223
45880,703-004-5397,4734.26,2,1,1,0.47819350615482453
46342,703-004-5394,8343.274,5,2,3,0.8755630931174861
46394,207-008-2399,8761.618,3,2,1,0.9977514725449939
4657,703-004-5399,961.5004,6,4,2,2.192515080163385
46907,703-004-5391,9205.376,2,2,0,0.5960990653198294
473,703-004-5397,4439.931,4,2,2,1.0179212310664365
47358,703-004-5385,4754.788,7,6,1,1.8138090905711761
47523,703-004-5394,1964.7235,2,1,1,0.7199988166069798
47645,703-004-5387,5132.3115,3,0,3,0.27920371738274696
47997,703-004-5381,185.80974,4,1,3,0.3665762163470347
48546,703-004-5392,9011.148,10,5,5,1.6843856821925205
48629,703-004-5380,9615.865,5,0,5,0.27920371738274696
4881,703-004-5383,1658.7883,6,1,5,0.35501625658847297
48853,703-004-5384,252.30765,2,1,1,0.44013867046506466
48896,703-004-5380,43.72001,1,1,0,0.43208815300476083
49063,703-004-5396,9043.696,1,1,0,0.45776824478578987
49196,207-008-2398,786.02136,9,7,2,1.5739918452646597
49273,703-004-5398,6442.7446,3,0,3,0.27920371738274696
49413,703-004-5389,2281.714,3,1,2,0.6060581089769566
49462,703-004-5399,1134.9016,5,2,3,1.7203505007789994
49497,703-004-5392,6102.7812,2,1,1,0.7734370458961782
49561,207-008-2398,7289.1235,4,3,1,0.7300343743996199
49591,703-004-5396,904.6257,4,3,1,1.5422019867542538
5039,703-004-5390,5658.1313,6,4,2,2.9497552957504016
5311,703-004-5380,3608.6309,5,1,4,1.259678170696105
5485,703-004-5381,5668.8887,4,3,1,0.5543876121705739
5500,207-008-2398,7019.292,2,1,1,0.7282818357922782
5666,703-004-5390,8747.003,5,2,3,0.6871865659746075
5706,703-004-5385,5960.114,2,2,0,0.9641661610423026
5746,207-008-2399,2228.0627,3,1,2,0.46122973720630955
5801,703-004-5380,625.99896,3,1,2,0.4895869903492098
5867,703-004-5382,1634.3468,5,5,0,1.5408908393905552
5928,703-004-5389,1248.5963,4,3,1,0.9789940854034341
5945,703-004-5381,9307.4795,4,2,2,0.821089436995785
6097,703-004-5397,6956.3115,2,1,1,0.48892327196003543
618,703-004-5389,1351.5884,2,1,1,1.0790205216525142
630,703-004-5391,9388.784,2,0,2,0.27920371738274696
6477,703-004-5396,3548.0159,2,1,1,0.6034084527122909
6529,703-004-5394,1299.5094,4,0,4,0.27920371738274696
6626,703-004-5387,1596.6606,2,0,2,0.27920371738274696
6759,703-004-5398,4276.01,5,1,4,0.8211719293913574
6895,703-004-5387,8053.5503,7,3,4,1.4679138796841702
7164,703-004-5390,3055.9373,7,2,5,1.6867991000475189
7196,703-004-5393,9187.465,4,1,3,1.9219681724811704
720,207-008-2398,4483.6045,5,4,1,1.3382362900023452
7221,703-004-5392,9140.748,1,0,1,0.27920371738274696
7344,703-004-5392,7848.527,2,1,1,0.35831143730785864
7777,703-004-5392,3666.9128,3,1,2,0.504237768479246
7854,703-004-5399,7362.38,1,1,0,0.42037326557525817
7907,703-004-5396,8550.4,2,1,1,0.7222965190226067
7936,207-008-2399,9108.121,6,6,0,3.4199288673652477
8025,703-004-5385,666.76917,2,1,1,0.3227129633415584
8137,703-004-5387,8942.557,7,3,4,1.7821745173456336
8221,703-004-5391,574.87366,2,0,2,0.27920371738274696
8283,703-004-5395,615.9103,3,0,3,0.27920371738274696
8373,207-008-2398,6244.143,"","","",0.27920371738274696
8510,703-004-5398,5656.21,5,1,4,0.3918926644160685
9429,703-004-5386,1494.1621,3,2,1,0.6653510530857075
9770,703-004-5381,4176.082,2,1,1,0.36010784178115807
10089,703-004-5390,4871.22,4,2,2,0.7193589935517948
10354,703-004-5390,1874.6597,5,2,3,0.5547447658495366
10549,703-004-5386,612.0753,2,1,1,0.7339809163281656
1058,703-004-5385,5579.9727,4,1,3,0.6980109806407785
10677,703-004-5380,9950.362,5,3,2,1.0678032656002743
11299,703-004-5380,8726.526,3,3,0,0.8767443108622319
1193,703-004-5387,4586.004,1,0,1,0.27920371738274696
12470,703-004-5397,3505.2336,6,4,2,3.2100252205951203
12682,703-004-5381,9827.244,3,2,1,0.772615997928744
12898,703-004-5397,5450.7397,7,4,3,1.4021744085134453
13092,207-008-2398,7259.838,5,1,4,0.6426275006912083
13368,703-004-5390,6285.422,1,0,1,0.27920371738274696
13476,703-004-5389,823.84766,3,2,1,0.6831844941641537
13815,703-004-5399,1588.8793,8,5,3,2.2387158729451073
14033,703-004-5387,7974.431,3,1,2,1.0972578406545637
14108,703-004-5397,5691.3086,3,1,2,0.42426744326918797
1494,703-004-5397,1154.3679,3,3,0,0.803841630244939
15001,703-004-5385,6260.097,1,0,1,0.27920371738274696
15151,703-004-5383,1279.1759,1,0,1,0.27920371738274696
15178,703-004-5394,88.94145,3,3,0,0.6539016331910552
15192,703-004-5397,6661.0195,2,0,2,0.27920371738274696
15239,703-004-5380,9206.683,3,2,1,0.4626347429590996
15241,703-004-5393,6173.6987,5,3,2,1.3059664286392236
15768,703-004-5383,8970.77,3,3,0,1.264373891719724
1579,703-004-5388,84.257126,5,4,1,2.825296754559976
16127,703-004-5391,9696.945,5,4,1,1.4021991780751581
16182,703-004-5380,3826.5073,6,3,3,1.2600212671343696
16653,703-004-5386,4255.183,6,1,5,0.8975207677606771
16663,703-004-5387,2826.5918,6,1,5,0.35831143730785864
16678,703-004-5399,5302.2515,5,5,0,2.5984473891550337
16888,703-004-5381,1287.5497,4,3,1,1.1812411723852518
16954,703-004-5398,7139.002,5,2,3,1.1102747746168888
17055,703-004-5397,3058.2637,6,2,4,0.5373104357079328
17082,703-004-5393,3564.8965,7,3,4,1.093017316483868
17178,703-004-5390,4119.1436,10,5,5,2.0566991245876993
17331,703-004-5385,4190.3994,2,0,2,0.27920371738274696
17414,703-004-5388,9584.97,9,5,4,1.5725962841047878
17611,703-004-5392,6881.5566,2,2,0,1.2475890267265153
17770,703-004-5389,3541.5078,3,0,3,0.27920371738274696
18115,703-004-5393,3410.731,6,4,2,1.3370557803855332
1833,703-004-5387,5647.904,"","","",0.27920371738274696
18899,703-004-5385,7774.9824,2,0,2,0.27920371738274696
19514,703-004-5392,9816.515,2,0,2,0.27920371738274696
19664,703-004-5390,578.78436,1,1,0,1.032883431891057
2028,703-004-5394,2024.427,2,1,1,0.43915581889695127
20606,703-004-5388,7369.609,8,4,4,0.9991788116373039
20611,703-004-5388,7450.9346,3,1,2,1.1248336253080193
20637,703-004-5386,3236.9304,2,2,0,1.244412645537535
20852,703-004-5397,7373.3906,2,0,2,0.27920371738274696
2097,703-004-5399,3373.5269,2,0,2,0.27920371738274696
20997,703-004-5387,2685.566,4,1,3,0.4515079959254209
21063,703-004-5388,1613.3804,3,2,1,1.935457010755185
21439,703-004-5386,7231.141,3,1,2,1.201550015057149
22298,703-004-5386,9693.754,4,2,2,1.0187090849189635
22300,703-004-5393,5940.1743,3,2,1,0.9907809479214355
22496,207-008-2398,7501.8105,3,1,2,1.9479414276502116
22744,703-004-5391,4143.8735,3,2,1,0.774343469286149
22762,703-004-5382,2591.3088,7,3,4,1.151061807810733
22912,703-004-5391,2317.2456,8,5,3,2.624847084128492
22917,703-004-5398,7350.1836,5,2,3,1.1880713241801582
23273,703-004-5391,473.77347,6,2,4,1.0190398750309901
23466,703-004-5392,598.0831,3,1,2,0.5081258348049519
23555,703-004-5391,283.39923,6,3,3,0.6296075172768659
23608,703-004-5396,7759.945,2,2,0,0.4907618223939727
23730,703-004-5398,9426.645,4,4,0,1.1558261777908845
23796,703-004-5395,3384.0955,3,1,2,1.8217784948437779
24031,703-004-5393,4775.615,6,2,4,0.6526525434064477
24401,703-004-5392,8535.398,4,2,2,0.6293081037558541
24448,703-004-5392,4181.5845,3,3,0,2.2080359239204683
24561,207-008-2398,7632.709,9,4,5,1.5709717851390048
24569,703-004-5397,7649.5234,5,3,2,0.9062280398100339
25091,703-004-5389,4934.1504,7,1,6,0.9632648835647832
25180,703-004-5387,5212.734,6,4,2,1.888436926405052
25197,703-004-5383,8792.5625,2,1,1,0.3978652972704144
25609,703-004-5396,4211.1523,3,2,1,0.684276771163983
2573,703-004-5394,6308.0273,7,3,4,1.6411641906540348
25888,703-004-5382,2511.2468,4,2,2,0.7188603624720095
26140,703-004-5394,9796.187,5,1,4,0.3280920136168829
26244,703-004-5398,9442.708,2,1,1,0.7514311496467275
26347,703-004-5398,3722.3398,4,2,2,1.3018626484879319
26367,703-004-5380,6985.2407,9,2,7,0.6876853466626355
26849,703-004-5399,9526.061,6,2,4,0.6611514852277177
26875,703-004-5385,3991.435,6,1,5,0.49594427901635596
26887,703-004-5387,5585.32,5,4,1,4.588487557165563
2691,703-004-5387,2603.892,2,1,1,1.2405945809440808
26916,703-004-5394,646.09406,"","","",0.27920371738274696
27080,703-004-5386,3375.3174,7,4,3,1.2498315527307227
27139,703-004-5398,1311.8702,2,0,2,0.27920371738274696
27835,703-004-5395,6986.3438,8,4,4,1.7280214160669403
284,207-008-2398,3221.8403,3,1,2,0.3807252912866403
28414,703-004-5381,1239.0769,6,6,0,3.053284445697176
28435,703-004-5387,8949.365,2,0,2,0.27920371738274696
28982,703-004-5395,8954.057,7,4,3,0.8664057917976565
29013,703-004-5396,440.53555,2,2,0,0.5353557489842475
29033,703-004-5385,8222.609,3,1,2,0.5165268771580819
29602,703-004-5383,5355.6387,5,4,1,1.3982583941165696
29624,703-004-5394,1749.5721,6,2,4,1.4212817769764365
29739,703-004-5385,1298.4264,1,1,0,0.621457753627982
30436,703-004-5388,724.8765,5,3,2,1.6281106469192395
3044,703-004-5392,7007.7046,7,6,1,1.9022149270216493
30672,703-004-5380,1655.8445,5,1,4,1.3049483015186032
31241,703-004-5387,8312.554,4,2,2,1.30013248561341
31538,207-008-2398,1211.834,4,1,3,1.0762027147352833
31653,703-004-5380,9424.856,4,2,2,0.7371449803343211
31796,207-008-2399,906.21826,2,2,0,1.5575522857102555
31887,703-004-5385,9152.583,2,1,1,0.5239799348408168
3195,703-004-5384,4462.852,3,2,1,0.6761182716343351
31985,703-004-5391,2188.012,8,4,4,1.0268265180263634
32057,207-008-2399,5273.641,1,1,0,0.35831143730785864
32070,703-004-5390,3094.1343,2,1,1,0.33853450732658075
32512,703-004-5396,3262.0073,7,3,4,1.1325052787295025
32575,703-004-5390,7232.8677,3,3,0,2.203948234181531
32604,703-004-5397,3124.2197,7,4,3,0.9029530981464383
3264,207-008-2398,2602.185,5,3,2,1.1173989505483317
32673,703-004-5393,9396.946,3,0,3,0.27920371738274696
3283,703-004-5392,5662.401,6,0,6,0.27920371738274696
32880,703-004-5395,5579.602,3,2,1,0.5999058603060022
32889,703-004-5398,8538.785,3,2,1,0.5406333118136206
32942,703-004-5393,1298.9396,2,1,1,0.6801890563202109
33025,703-004-5393,2553.9463,2,1,1,0.8596210610185608
33057,703-004-5396,5545.3354,4,2,2,0.8811809898578286
33103,703-004-5395,9779.303,1,0,1,0.27920371738274696
33632,207-008-2398,2546.919,2,2,0,0.6328618387419752
33698,207-008-2399,7610.063,3,1,2,1.1190122698256926
33790,703-004-5390,6373.48,"","","",0.27920371738274696
34013,703-004-5385,152.38345,1,0,1,0.27920371738274696
34046,703-004-5392,0.121593475,6,1,5,0.49189803293876305
34131,703-004-5384,6789.6523,2,1,1,0.37635788591577474
34151,703-004-5382,7390.841,5,5,0,2.316427785615729
34205,703-004-5389,2306.5447,1,0,1,0.27920371738274696
35060,703-004-5383,6046.4062,3,2,1,1.958257443226093
35392,703-004-5398,8631.04,1,0,1,0.27920371738274696
35501,703-004-5393,5777.191,3,2,1,0.7330728506021672
35667,207-008-2398,9249.82,4,2,2,0.6537861838166444
35944,703-004-5388,7910.1616,2,1,1,0.33853450732658075
36000,703-004-5381,8960.715,6,4,2,1.2711855408029242
36112,703-004-5390,2135.4473,6,5,1,1.1104483029392191
36332,703-004-5395,5705.712,4,1,3,0.8605504910612156
36369,703-004-5383,895.1652,2,0,2,0.27920371738274696
36666,703-004-5386,5034.377,4,2,2,0.6671020860963526
36833,703-004-5386,1018.10455,3,2,1,0.6361362475323776
37241,703-004-5386,8605.505,2,1,1,0.5281000367899807
3729,703-004-5397,6817.2485,4,3,1,0.9680814850321597
37337,703-004-5395,6109.865,5,3,2,0.7012481023124375
3741,703-004-5394,5933.482,1,1,0,1.3260510020161345
3744,703-004-5394,1267.9648,3,2,1,0.5131410496831783
37545,703-004-5399,2369.994,2,0,2,0.27920371738274696
38197,703-004-5390,872.4105,2,2,0,0.7755428120126463
38278,703-004-5384,4311.377,3,1,2,0.3978652972704144
38288,703-004-5383,1864.6914,8,5,3,3.3627819574470803
38368,703-004-5399,5993.584,3,2,1,0.47697301719552604
38492,703-004-5393,7904.9336,5,2,3,0.4066444000949161
38731,703-004-5381,4482.899,3,0,3,0.27920371738274696
38799,703-004-5394,6044.416,6,2,4,0.6389856428503171
39544,703-004-5391,4719.737,2,1,1,0.3518419090877331
39546,703-004-5381,1987.1265,4,1,3,1.0392383216070564
3960,703-004-5383,6189.1787,6,2,4,2.2982650179835646
39887,703-004-5398,2781.3684,3,2,1,1.3825174780852432
40007,703-004-5388,8755.219,4,2,2,0.9164425523847302
40174,703-004-5387,2151.2222,5,3,2,0.8697053727375513
40395,703-004-5389,269.0673,3,1,2,0.4149868551553604
40399,703-004-5390,1593.8729,2,0,2,0.27920371738274696
40529,703-004-5397,351.00104,4,4,0,1.133278814333672
40706,703-004-5394,8560.428,4,2,2,1.2246817924149114
408,703-004-5389,3707.8792,4,3,1,1.5806120322134443
41010,703-004-5396,897.20905,7,4,3,3.10900496915404
41160,703-004-5398,7249.3027,4,1,3,0.8005213360761191
41570,703-004-5385,7033.5234,1,1,0,0.3978652972704144
4175,207-008-2399,5017.693,3,0,3,0.27920371738274696
41763,703-004-5393,6903.8643,6,2,4,0.8695625490587061
41811,703-004-5392,6856.6167,4,3,1,1.3323501563741338
4197,207-008-2399,146.74902,4,3,1,1.842331229523045
42137,703-004-5392,8634.088,5,3,2,1.4061894008375302
42171,703-004-5387,6458.1353,4,3,1,0.7989133496077001
43057,703-004-5387,7583.8037,4,3,1,1.174261715095984
43117,703-004-5396,7644.542,3,1,2,0.5070894342097199
43138,703-004-5387,9008.627,5,3,2,2.3331215538795202
43242,703-004-5392,2562.599,6,4,2,1.1812676942683014
43638,703-004-5390,1831.55,4,3,1,1.3248611544735132
43669,703-004-5388,1956.1833,6,3,3,1.7202426609643358
43964,703-004-5398,9286.373,4,2,2,0.6312629537382048
4397,703-004-5390,9091.486,1,0,1,0.27920371738274696
43987,703-004-5398,1437.3159,5,2,3,0.5821921191232988
440,703-004-5391,1567.3059,3,1,2,0.5527075293195316
44035,703-004-5380,1563.7786,4,1,3,0.33853450732658075
44357,703-004-5381,9710.37,1,0,1,0.27920371738274696
4438,703-004-5381,190.75334,1,1,0,0.3978652972704144
44509,703-004-5382,3102.8772,3,2,1,0.836315350454537
44624,703-004-5396,4749.2437,1,1,0,1.7050704388829077
44710,703-004-5390,2973.451,5,2,3,0.6626858996827009
44786,703-004-5387,5219.2046,7,3,4,1.6111422706468654
44937,703-004-5380,2998.2747,"","","",0.27920371738274696
44967,703-004-5394,5615.034,"","","",0.27920371738274696
4517,703-004-5389,3374.7273,3,1,2,0.36951836429724944
45182,703-004-5393,4312.854,6,4,2,0.7695445942762493
45330,703-004-5389,3716.0605,4,0,4,0.27920371738274696
45597,703-004-5381,4407.1147,5,1,4,0.6987803387222001
45912,703-004-5384,8731.749,5,2,3,0.5278772885482905
46053,207-008-2398,2193.135,1,1,0,0.32666834933781397
46227,703-004-5395,76.69985,2,2,0,0.7043126122686448
46503,703-004-5390,4271.2437,2,2,0,0.6682438153222636
46825,207-008-2398,4094.9429,7,5,2,2.5536114153298755
46991,703-004-5386,162.22537,7,5,2,2.2713978015747958
47377,703-004-5393,8377.313,3,2,1,0.7334776724360449
47717,703-004-5398,1840.5879,5,3,2,0.7552257935082086
47884,703-004-5384,4440.038,4,2,2,0.8174709741651395
47944,703-004-5393,2861.1685,6,5,1,2.6437465734497207
47975,703-004-5380,8531.683,4,2,2,0.5051057000938939
48136,703-004-5393,6597.539,5,1,4,0.33853450732658075
48186,703-004-5384,9658.792,8,4,4,1.5801805155523936
4843,703-004-5382,7349.7095,2,2,0,0.9067090584265766
48599,207-008-2399,1590.8838,9,3,6,1.76881203439331
48651,703-004-5387,2125.4612,2,0,2,0.27920371738274696
48654,703-004-5380,339.5641,2,0,2,0.27920371738274696
48677,703-004-5395,9649.232,4,3,1,0.8331671635453013
4879,703-004-5394,9579.59,"","","",0.27920371738274696
48855,207-008-2399,7129.2646,4,3,1,1.335949053090069
48940,703-004-5398,2785.0002,4,2,2,0.5878923989482145
49529,703-004-5391,9694.348,1,0,1,0.27920371738274696
49581,703-004-5396,3478.664,3,1,2,1.0030531669385652
49880,703-004-5394,7095.4385,4,1,3,0.4214301568636002
49958,703-004-5396,6584.4814,6,2,4,0.9980971880027404
5142,703-004-5393,8465.274,6,3,3,1.3475832696429544
520,703-004-5395,217.0539,3,2,1,1.1593839422373975
5275,703-004-5384,1868.0054,4,4,0,2.5622732544657367
5323,703-004-5391,5878.9604,4,1,3,0.5961420047985176
5350,703-004-5388,4905.558,4,2,2,0.7167422630493034
5432,703-004-5381,2328.2952,2,1,1,0.4590130926562781
5499,703-004-5389,2118.5117,4,4,0,2.0639779642116185
5527,703-004-5389,7158.2974,5,2,3,0.9529236107204976
5883,703-004-5386,807.8736,1,1,0,0.7075928949808665
5894,703-004-5380,5002.8374,6,3,3,1.4688400859713102
6139,703-004-5389,635.1536,7,3,4,1.4708660927601884
6150,703-004-5380,630.675,5,3,2,1.7525499176304375
6670,703-004-5389,9087.942,4,3,1,3.6641362556886747
6786,703-004-5391,8954.918,3,2,1,0.7388933893045981
6789,703-004-5398,3518.2996,5,4,1,1.0884478699216698
6864,703-004-5380,2655.9626,5,4,1,1.0521470730783224
6866,703-004-5395,8911.226,5,3,2,0.7144835636570656
6962,703-004-5385,3072.0496,4,2,2,0.973578265205991
7000,703-004-5399,7594.473,5,1,4,0.7679468124792707
7171,703-004-5393,9984.78,5,3,2,1.3233685850568733
7379,703-004-5396,3759.2388,1,1,0,1.8774473113066383
7537,703-004-5393,7692.839,1,0,1,0.27920371738274696
7553,703-004-5382,697.31,5,1,4,0.5616815519193535
7633,703-004-5389,9505.61,4,1,3,0.5085476005067392
7770,703-004-5391,4415.7646,4,2,2,0.6711206667054836
7815,703-004-5392,561.4728,1,0,1,0.27920371738274696
7966,703-004-5384,8633.253,6,3,3,1.0713703480776653
7970,703-004-5387,8746.486,3,1,2,0.5106258957364647
8059,703-004-5385,6968.0337,1,0,1,0.27920371738274696
8083,703-004-5387,447.2989,5,3,2,1.5764841793783921
826,703-004-5386,6294.335,6,2,4,1.2808261541716568
8261,703-004-5390,4366.14,5,4,1,2.9281776739974648
8721,703-004-5386,3722.1318,4,2,2,0.8800051713662996
8961,703-004-5399,5335.043,2,2,0,0.6930100388352859
9152,703-004-5388,4873.266,5,1,4,0.37512182779194486
9239,703-004-5383,3998.4531,3,2,1,0.7739780074218624
9524,703-004-5384,7411.91,5,3,2,3.942148651512822
9556,207-008-2399,354.1249,4,1,3,0.8074165012626294
9636,703-004-5389,129.565,4,3,1,1.960852599097597
10171,703-004-5393,8071.737,5,3,2,0.9054185752059941
10310,703-004-5383,9627.828,5,3,2,1.1532729739765364
10316,703-004-5393,2140.9548,3,0,3,0.27920371738274696
10473,703-004-5383,5776.844,6,4,2,1.7212124562348217
10490,703-004-5392,6864.437,5,5,0,2.034932853719748
10513,703-004-5381,8631.355,5,1,4,0.7617461535672998
10673,703-004-5382,2718.8635,1,0,1,0.27920371738274696
10969,703-004-5384,4183.8706,2,1,1,0.44829646872267315
11229,703-004-5397,4596.528,4,2,2,0.9781742475517037
11258,703-004-5388,9833.585,5,3,2,1.3863731081529198
11469,703-004-5394,6987.9604,5,3,2,1.6084972646298952
11509,703-004-5385,2599.132,10,5,5,1.120723863143676
11898,703-004-5395,1576.6543,4,2,2,0.9449643615745273
11976,703-004-5386,7592.363,3,1,2,0.32666834933781397
11980,703-004-5381,8481.617,5,2,3,0.6817020227180569
12111,703-004-5387,5853.553,2,1,1,0.41828374002871693
12281,703-004-5381,8215.731,2,1,1,0.5734695389299637
12282,703-004-5386,3603.3225,1,0,1,0.27920371738274696
12404,703-004-5393,2382.3643,3,2,1,0.8554337267310764
12448,207-008-2398,4541.67,6,3,3,1.3751307726606306
12579,703-004-5399,9363.978,3,2,1,0.9552230070154809
12613,703-004-5399,1769.8043,5,2,3,0.5795756471487561
12649,703-004-5397,4640.0903,7,3,4,1.2022286457683204
12691,703-004-5393,6284.8525,5,1,4,0.3919322182760311
12858,703-004-5387,6065.8145,9,6,3,2.3474978064984304
12989,703-004-5394,1588.2838,6,3,3,1.2690701614951374
13106,703-004-5385,4602.058,4,1,3,0.4600726178589457
1322,703-004-5394,7790.4087,1,0,1,0.27920371738274696
13454,703-004-5389,2214.325,9,7,2,1.98194177833227
13710,703-004-5390,4271.215,6,3,3,0.9163060936984633
13754,703-004-5387,1137.9647,2,1,1,0.3807252912866403
13859,703-004-5391,8561.026,3,1,2,0.974095881833794
13870,703-004-5380,657.5978,6,3,3,1.6286217486310786
14341,703-004-5384,2856.459,"","","",0.27920371738274696
14368,703-004-5397,7089.1826,2,0,2,0.27920371738274696
1454,703-004-5396,692.42,1,1,0,0.4352162946873856
14788,703-004-5390,3306.12,5,0,5,0.27920371738274696
14819,703-004-5390,1660.5931,5,2,3,0.690947374961757
15054,703-004-5396,2183.656,3,2,1,0.8976694941522435
15085,703-004-5386,4017.1755,6,2,4,2.0154547197056845
15098,703-004-5398,9226.16,4,1,3,1.3646530942644917
15291,703-004-5396,8656.05,2,2,0,0.5334727192175809
15575,703-004-5381,6066.284,"","","",0.27920371738274696
15709,703-004-5381,5363.7793,5,2,3,1.0362105905157455
15832,703-004-5391,1349.0593,2,1,1,1.2633040360853616
15918,703-004-5380,6129.705,4,1,3,0.5979039895645881
1610,207-008-2398,7686.7173,3,2,1,0.6120890445397565
16377,703-004-5388,6218.3013,2,0,2,0.27920371738274696
16425,703-004-5389,6179.645,5,2,3,1.1650358973886756
16498,703-004-5398,1538.9758,6,2,4,0.6772900759057828
17217,703-004-5399,4808.3545,5,1,4,1.2177339388995838
1733,703-004-5399,9429.732,2,2,0,0.639314819707136
17513,703-004-5383,4393.5757,2,0,2,0.27920371738274696
17693,703-004-5383,5558.5586,5,4,1,1.3136991743648776
17791,703-004-5393,3404.3933,7,3,4,0.9183974140408734
17825,703-004-5382,800.8039,2,2,0,1.1038241186769644
17831,703-004-5387,2063.5415,2,0,2,0.27920371738274696
18523,703-004-5396,2808.9285,4,2,2,0.4873173155222126
18840,703-004-5392,7854.237,4,2,2,0.9971949501898594
19030,703-004-5384,8011.9424,1,0,1,0.27920371738274696
19336,703-004-5384,3329.5024,5,4,1,1.8816656800213967
19372,703-004-5380,954.4134,4,1,3,0.5753672934632869
19592,207-008-2399,46.0273,2,1,1,0.41298070434754036
19744,703-004-5385,6918.8804,6,3,3,0.6066203502219315
19757,703-004-5390,838.16406,3,1,2,0.5273583006430681
19827,703-004-5380,2938.5293,6,3,3,1.2034918198521816
20184,703-004-5380,5496.6123,3,2,1,2.3566817925988937
20382,703-004-5398,3027.0427,6,3,3,2.4705554888966055
20458,703-004-5383,4239.161,2,1,1,1.041204313934892
20474,207-008-2399,4455.2485,5,4,1,2.0307383081021095
20544,703-004-5393,5375.9355,7,3,4,0.9637459978591035
20665,703-004-5390,6006.726,5,4,1,1.594730355487062
20833,703-004-5383,4424.6445,3,2,1,0.8661519524860394
21017,703-004-5394,8321.941,3,1,2,0.3187575773453028
21153,207-008-2399,619.89667,"","","",0.27920371738274696
21210,207-008-2398,7753.125,3,1,2,0.5146804662149527
21260,703-004-5394,1038.1377,7,3,4,1.292980450619736
21835,703-004-5393,8451.85,1,0,1,0.27920371738274696
2209,703-004-5382,2620.3774,5,3,2,0.9932812524006435
221,703-004-5396,9091.817,4,2,2,1.6679696543047269
2210,703-004-5389,7140.701,3,0,3,0.27920371738274696
22475,703-004-5390,9472.618,4,2,2,0.548130411268164
22681,703-004-5385,7552.357,2,2,0,1.141810097586842
2277,703-004-5382,9647.005,1,1,0,0.4706842898828402
22997,703-004-5383,2553.1858,4,2,2,1.017985418901488
23190,703-004-5381,1247.9413,"","","",0.27920371738274696
23247,703-004-5384,4491.8184,5,2,3,0.9547304352282108
23295,703-004-5399,7253.0693,9,3,6,2.0989024653093042
23326,703-004-5390,1749.5394,1,0,1,0.27920371738274696
23407,207-008-2398,556.3837,1,0,1,0.27920371738274696
23493,703-004-5393,8700.995,5,5,0,1.6609532809827787
23991,703-004-5386,9116.102,3,2,1,0.5513589950876077
24068,703-004-5384,4506.23,3,1,2,0.3978652972704144
25293,703-004-5397,2263.9514,5,1,4,0.5986009830969032
25556,703-004-5382,5823.753,6,3,3,0.9668572034702042
25620,703-004-5391,7595.7173,3,1,2,0.42764647505756354
25653,703-004-5392,7213.262,5,4,1,3.035989463376031
25688,703-004-5399,5888.386,5,4,1,0.8658864472727523
25689,703-004-5380,9838.877,5,3,2,3.4071305119005837
25736,703-004-5393,6837.9272,9,2,7,0.5338118612285886
2601,703-004-5390,5828.246,5,4,1,1.4537342822624482
26203,703-004-5380,4444.3066,3,2,1,1.012895218262344
26359,703-004-5390,1133.8252,2,1,1,1.1449521700746699
26420,703-004-5385,4661.301,4,3,1,0.8655945919796655
26635,703-004-5388,1751.2101,1,1,0,1.197460601078276
26638,703-004-5393,1042.7021,6,1,5,0.5114678943166849
26768,207-008-2399,7237.839,6,3,3,1.2925959857506992
27501,703-004-5388,8150.0654,2,2,0,0.6288596047880799
27540,703-004-5381,2110.557,1,1,0,0.3978652972704144
27842,703-004-5394,7691.666,4,1,3,0.7365566143558864
28726,703-004-5395,5063.098,7,4,3,1.396979670289161
28867,703-004-5398,9160.87,3,2,1,1.2786430217171423
29199,703-004-5395,9203.936,3,1,2,0.788299127720781
29280,703-004-5391,3785.5369,4,2,2,1.2355536556428894
29320,703-004-5393,4632.5117,3,2,1,1.958374953597107
29531,703-004-5399,5284.223,3,3,0,0.6457326985431293
29681,703-004-5382,1259.9337,7,3,4,0.7789845395951794
2979,703-004-5398,7452.296,"","","",0.27920371738274696
30394,703-004-5391,4882.974,5,4,1,1.0668341277510867
30621,703-004-5388,6690.4736,8,7,1,2.194590269853827
30666,703-004-5384,6579.9194,"","","",0.27920371738274696
30692,703-004-5386,2011.8839,3,1,2,0.4381014372877658
30800,703-004-5385,9678.48,"","","",0.27920371738274696
30908,703-004-5390,4284.0303,6,4,2,2.764427118575141
31086,703-004-5388,7054.659,3,0,3,0.27920371738274696
31249,703-004-5386,2913.0752,7,2,5,1.9958399561259395
31481,703-004-5380,6582.2104,4,3,1,1.5114299941175413
320,207-008-2399,2452.6982,3,1,2,1.5385419436093242
32116,703-004-5396,1612.7217,4,3,1,2.652602329584241
32466,703-004-5389,6970.963,3,1,2,0.4049039066507512
32699,207-008-2398,133.67236,5,0,5,0.27920371738274696
33379,703-004-5384,3128.1418,2,1,1,0.8837496011913688
33382,703-004-5386,272.25137,3,0,3,0.27920371738274696
33407,703-004-5391,8635.162,11,6,5,4.9965672874649005
3347,703-004-5391,8678.143,3,1,2,0.5876546252240652
3350,703-004-5392,5469.026,6,1,5,0.4178275780746777
34295,703-004-5399,2006.0444,3,3,0,0.9514709163879994
34367,703-004-5395,452.1924,6,4,2,1.2031337098398527
34680,703-004-5382,7996.5703,5,2,3,0.8828992031180358
34867,703-004-5383,9308.047,2,0,2,0.27920371738274696
35807,703-004-5395,7364.818,2,1,1,0.5165268771580819
35841,703-004-5382,2713.0718,4,3,1,0.7300633014368847
35912,703-004-5382,3818.9739,3,1,2,0.4987276401749318
35935,207-008-2399,3031.2854,5,1,4,0.6913653269717148
35982,703-004-5381,4305.853,3,2,1,1.644670227833672
36166,207-008-2398,9333.47,2,1,1,0.4185580141043368
36176,703-004-5394,2925.4312,6,3,3,1.1550673229439339
3618,207-008-2399,7086.6333,2,1,1,0.7353622620416367
3619,703-004-5389,2539.577,4,2,2,0.6993149199242101
36331,703-004-5391,4853.6567,5,4,1,2.3575884545918724
36415,703-004-5394,1120.4427,1,1,0,0.32666834933781397
36548,207-008-2398,8175.3315,1,1,0,0.4006622118998408
36591,703-004-5391,9567.421,4,1,3,0.8626127569961496
36750,703-004-5381,5512.184,4,1,3,0.3254817335389373
37104,703-004-5384,5988.0425,2,1,1,0.5255431688927126
37236,703-004-5385,120.91338,"","","",0.27920371738274696
3724,703-004-5387,3331.182,"","","",0.27920371738274696
37797,703-004-5397,9558.238,4,0,4,0.27920371738274696
37868,703-004-5391,6416.7505,7,4,3,2.2133911200241743
38474,703-004-5391,9041.973,5,3,2,2.279804476557761
38480,703-004-5387,2397.6946,6,2,4,0.6824565961501151
38491,703-004-5397,5835.1113,6,4,2,1.030508388444514
3852,703-004-5396,4102.689,2,1,1,0.5964366841565568
38785,703-004-5397,7218.1455,2,2,0,0.7746825001288765
39236,703-004-5389,4404.896,4,3,1,1.162340165416154
39303,703-004-5381,1984.3625,3,3,0,2.3760553842552095
39311,703-004-5385,187.92212,6,3,3,1.41556624119607
39349,703-004-5394,1699.0131,5,2,3,1.0933873360665012
39514,207-008-2399,865.5709,6,4,2,2.2056267868165507
39734,207-008-2398,2013.2804,3,1,2,0.8659890488066266
39919,703-004-5382,5999.5537,4,3,1,1.1418755852319493
40700,207-008-2398,2292.4548,6,0,6,0.27920371738274696
40736,703-004-5389,1097.4735,6,4,2,0.9050495071766258
41261,703-004-5388,4041.7712,2,1,1,1.2495314483206301
4138,703-004-5387,7258.2197,5,3,2,5.110874867751477
41444,703-004-5387,7440.3696,6,2,4,1.458535549524601
41599,703-004-5387,4597.6465,4,1,3,0.6945222310236941
41975,703-004-5386,8596.374,2,1,1,0.44829646872267315
41989,703-004-5383,6666.643,3,2,1,1.491218930397228
42321,703-004-5384,7852.4424,5,1,4,0.8704392912924628
4255,703-004-5386,7019.005,2,2,0,0.6385482116215809
42782,703-004-5388,2612.021,6,3,3,1.4094695322000759
42828,703-004-5397,7731.6133,6,3,3,1.237136611621755
42845,703-004-5395,5124.623,8,6,2,3.391457499838321
42969,207-008-2399,2780.0781,4,2,2,0.42772846154214406
43196,703-004-5394,8235.99,8,2,6,0.41764222725169237
43233,703-004-5390,6425.0435,2,1,1,0.35831143730785864
43259,703-004-5390,4282.1016,2,1,1,0.42482454898989314
43321,703-004-5397,7002.964,3,2,1,4.219438968107643
43389,703-004-5398,5080.8687,7,2,5,0.9580005078513886
43501,703-004-5387,4611.8506,5,3,2,1.6419952811181755
43517,703-004-5383,4024.7124,2,1,1,0.4794826906900395
43539,703-004-5386,7848.538,4,1,3,0.5686600011179055
43773,703-004-5398,2793.579,7,4,3,1.8362688428577432
43882,703-004-5395,8702.026,8,6,2,1.7148012032226918
43898,703-004-5389,5356.2666,4,2,2,0.7478315744696615
4399,703-004-5399,4466.352,6,2,4,0.6602769350397342
44238,207-008-2398,3767.2656,4,2,2,0.574857410751944
44792,703-004-5398,4078.3228,3,2,1,0.9871513781845
45377,703-004-5389,9466.194,3,1,2,0.3690557427011291
45634,207-008-2399,3637.1003,6,4,2,1.3183820535835395
45878,703-004-5396,6364.83,4,2,2,0.8223132282248581
45985,703-004-5394,2140.2573,3,2,1,0.5956345970831934
46173,703-004-5380,2521.5935,2,1,1,0.8095745197928801
46482,703-004-5382,341.92563,3,0,3,0.27920371738274696
46712,703-004-5387,2649.3723,4,2,2,0.5005039491586034
46851,703-004-5384,2504.959,5,2,3,1.326978745252639
4686,703-004-5390,2927.345,6,2,4,0.730083441653332
46966,703-004-5395,8860.699,2,2,0,1.3373417809341193
47190,207-008-2399,208.48512,"","","",0.27920371738274696
47224,703-004-5382,9505.924,6,4,2,0.9750190275256014
47292,703-004-5397,7060.3496,2,1,1,0.5732585450232344
47305,703-004-5384,892.933,2,0,2,0.27920371738274696
47409,703-004-5398,9941.638,5,2,3,0.9381226811199249
47764,703-004-5380,8589.504,4,1,3,0.3585536231202931
47953,703-004-5394,3143.2766,6,5,1,1.906120615027423
47996,703-004-5386,8091.1465,4,2,2,1.818577590080532
48061,703-004-5380,1363.9832,5,2,3,0.8397351167535668
48491,703-004-5398,1903.1709,5,3,2,0.5837038501902209
48685,703-004-5395,7812.6104,3,2,1,0.8597198894366297
48864,703-004-5385,769.5305,3,0,3,0.27920371738274696
4892,703-004-5391,1687.063,4,3,1,1.0272385600569203
49119,703-004-5388,9443.514,2,1,1,0.7699565767493249
49410,703-004-5394,2158.3652,1,1,0,0.7497365806502203
49567,207-008-2399,7703.077,2,2,0,3.1991743723128816
5349,207-008-2399,969.79974,4,2,2,1.2710013762439405
5580,703-004-5384,1074.6765,3,2,1,1.5105609848291923
5669,703-004-5385,4864.1753,4,2,2,1.3184254899202077
5734,703-004-5380,2542.101,7,3,4,0.9153489974165493
5769,703-004-5392,4092.2063,2,1,1,0.4335141907906921
6048,703-004-5393,832.0689,4,3,1,1.772605200399215
610,703-004-5391,5094.2354,1,0,1,0.27920371738274696
6497,207-008-2398,4361.6396,5,0,5,0.27920371738274696
6573,703-004-5393,22.085308,7,6,1,1.7692688577300553
6859,703-004-5384,4568.62,"","","",0.27920371738274696
7022,703-004-5394,9227.578,4,2,2,1.765849155203947
7319,703-004-5387,2529.76,3,3,0,1.4417859993144213
7764,703-004-5398,7576.755,3,1,2,1.1535268997552617
7926,703-004-5397,3014.9985,4,3,1,1.7463012578105968
804,703-004-5380,1135.5508,7,4,3,2.1899184073604085
8184,703-004-5396,2167.7769,2,1,1,0.568308909012598
8282,207-008-2398,9833.64,3,2,1,1.0589293508413995
8344,703-004-5394,4641.9824,1,0,1,0.27920371738274696
8368,703-004-5390,2088.1182,3,1,2,0.46089182288271385
8620,703-004-5385,2678.8157,1,0,1,0.27920371738274696
8653,703-004-5381,8918.537,2,2,0,0.8369384248949433
8661,703-004-5391,3382.8152,8,4,4,1.20216504315627
9125,703-004-5390,3542.1777,3,1,2,0.531493218884306
9269,703-004-5389,3973.667,4,4,0,1.9279860049809654
9542,703-004-5396,289.2065,4,0,4,0.27920371738274696
9647,703-004-5396,4004.3813,2,0,2,0.27920371738274696
9720,703-004-5396,7057.446,2,0,2,0.27920371738274696
9954,703-004-5380,3263.4229,4,2,2,0.4499211366536455
10034,703-004-5395,6971.2812,3,0,3,0.27920371738274696
10132,703-004-5387,171.93198,4,2,2,1.4066976763310208
10227,703-004-5387,7988.065,6,4,2,2.37115083018843
10273,703-004-5398,9509.082,6,5,1,1.4104263511433808
10374,703-004-5391,2647.6265,3,0,3,0.27920371738274696
10380,207-008-2398,6253.39,8,7,1,3.68249558413034
10467,703-004-5381,7622.1953,3,2,1,0.47697301719552604
10555,703-004-5387,4437.79,"","","",0.27920371738274696
11276,703-004-5384,5634.1665,1,0,1,0.27920371738274696
11308,207-008-2399,7036.024,3,1,2,0.8389189561135877
11400,703-004-5390,2955.8962,3,3,0,0.79404894280812
11482,703-004-5390,7242.386,4,1,3,1.004461192453405
11503,703-004-5384,4823.7183,4,1,3,0.37210876615711747
11875,207-008-2399,1204.5466,6,3,3,0.7207077707996538
12320,207-008-2398,3300.1917,8,4,4,1.5791894026534998
12359,703-004-5395,4578.1396,4,2,2,0.6162078943349804
12465,703-004-5390,8104.978,9,3,6,1.5867398407908253
12565,207-008-2398,1943.832,5,5,0,1.887232464578256
12624,703-004-5393,410.56216,6,5,1,1.3171345370954408
12779,703-004-5387,3611.5276,2,1,1,1.1333243866848584
13198,703-004-5395,4993.411,5,2,3,0.7525764891868405
13306,703-004-5384,2164.2393,3,2,1,0.4242118761798481
13398,703-004-5393,3658.6172,3,0,3,0.27920371738274696
13400,703-004-5387,9467.08,6,0,6,0.27920371738274696
13415,703-004-5397,4440.6743,4,2,2,0.9616078669024876
13421,703-004-5390,921.4127,3,0,3,0.27920371738274696
13503,703-004-5399,2855.1167,2,1,1,1.0960822128468692
13515,703-004-5396,5234.5938,2,0,2,0.27920371738274696
13551,703-004-5394,6903.6816,"","","",0.27920371738274696
13579,703-004-5397,4229.7017,1,0,1,0.27920371738274696
14182,703-004-5381,5408.78,3,3,0,0.7790317667196625
14346,703-004-5384,5382.6226,5,2,3,0.5228805200649806
14385,703-004-5380,3919.2576,6,4,2,0.9750230684915079
14588,703-004-5386,5865.1245,3,0,3,0.27920371738274696
14944,703-004-5385,4660.8164,4,1,3,0.9373149223410049
1511,703-004-5398,9920.395,2,2,0,0.5406132136847848
15224,703-004-5388,6533.7275,3,2,1,0.9213677987852051
15351,703-004-5387,7061.1226,6,1,5,0.40712162083373177
15423,703-004-5391,5646.4873,4,1,3,0.834451639024491
16041,703-004-5381,9943.312,5,3,2,1.741299591525025
16066,703-004-5386,1673.8862,2,1,1,1.1322720108654047
16416,703-004-5387,6707.49,8,3,5,0.7986112323967139
16600,703-004-5393,2036.9524,2,1,1,1.0857336289021606
1670,207-008-2399,8141.8203,5,0,5,0.27920371738274696
16823,207-008-2399,9341.823,4,3,1,0.7016173190060635
1687,703-004-5385,1753.4197,3,2,1,0.9215434437135022
17061,703-004-5388,8169.4614,1,0,1,0.27920371738274696
17073,703-004-5382,1806.8445,3,1,2,0.591413391637166
17634,703-004-5384,2337.6096,5,2,3,1.6206770143526117
17639,703-004-5380,4578.6094,4,0,4,0.27920371738274696
17684,703-004-5382,1071.6384,"","","",0.27920371738274696
17723,207-008-2399,3614.447,1,1,0,0.8821506878439198
1795,703-004-5395,1153.1091,9,6,3,3.181079447902768
18128,703-004-5396,7288.2563,7,7,0,1.840073438271517
18332,703-004-5385,2397.8018,4,2,2,0.6529013109740659
18393,703-004-5385,4920.371,4,2,2,0.8238851008193351
18428,703-004-5384,1784.7568,4,2,2,2.3851231631635423
18557,703-004-5392,1032.2225,7,4,3,2.0170670706143405
18644,703-004-5391,9874.921,5,4,1,1.4812982158800814
18778,703-004-5397,6175.2773,7,4,3,1.0158449075257028
19350,207-008-2399,3099.0063,5,1,4,2.209972377365878
19537,703-004-5399,6037.0337,5,4,1,1.1105396413082145
19572,703-004-5397,7910.009,8,5,3,0.8628308022578869
19705,703-004-5389,2286.3967,2,1,1,0.4599635773575985
19728,703-004-5384,719.9925,3,2,1,0.6265933925559429
19941,703-004-5383,3929.435,3,2,1,0.8556297650467645
19991,703-004-5399,742.3836,7,1,6,0.342470116392855
19994,703-004-5399,8323.516,2,2,0,1.1228682438665314
2001,207-008-2398,1251.908,3,2,1,1.4372489478766088
20084,703-004-5395,1748.2358,4,1,3,0.5669580486103406
20142,703-004-5389,7313.499,2,1,1,0.7409469806860223
2039,207-008-2399,7885.956,4,1,3,0.35831143730785864
20532,703-004-5382,6079.386,4,2,2,1.4183178021273617
20542,703-004-5380,2735.7202,5,1,4,0.8138375982017074
20644,703-004-5388,7612.797,"","","",0.27920371738274696
20825,703-004-5395,2361.1206,2,2,0,0.8428636629776359
2087,703-004-5399,1455.521,4,3,1,0.8496459730811347
21052,703-004-5387,4565.1006,8,4,4,1.6694628197320196
21141,703-004-5396,7250.7544,3,1,2,0.35831143730785864
21193,703-004-5387,2638.191,4,3,1,3.283891167153713
21240,703-004-5382,7021.27,3,2,1,0.7991422967358527
21245,703-004-5382,9168.2295,3,2,1,0.8796165983861395
2130,703-004-5393,8522.255,4,3,1,0.7675262895691934
22034,207-008-2398,6467.5195,5,1,4,0.42142749026423426
22116,703-004-5394,512.8843,3,0,3,0.27920371738274696
22394,703-004-5389,3272.822,1,1,0,0.46909768877871777
22615,703-004-5394,9659.272,3,1,2,0.5165268771580819
22701,703-004-5380,223.4,5,2,3,0.47574284506276204
22704,703-004-5387,7193.388,"","","",0.27920371738274696
22807,703-004-5387,7164.52,3,1,2,0.4095774606144744
22976,703-004-5388,6348.432,3,2,1,2.0967698301324065
23026,703-004-5380,2505.5474,7,2,5,0.5874582538905196
2316,703-004-5391,1099.6628,3,1,2,0.8398739664260816
23542,703-004-5381,1039.4025,3,1,2,1.2739010161691906
2394,703-004-5380,3560.5771,6,4,2,2.137088950052651
24027,703-004-5391,6283.8286,2,1,1,1.4997249019413397
24540,703-004-5394,689.98456,6,3,3,0.9811258450615531
24741,703-004-5387,1928.522,3,0,3,0.27920371738274696
24973,703-004-5399,78.04155,7,3,4,1.4766233765401882
25430,703-004-5394,2395.7258,7,6,1,2.0267722144577722
25664,207-008-2398,1728.9603,3,3,0,1.0683208513947202
26380,703-004-5381,6499.971,4,2,2,1.1545593561918863
26557,703-004-5382,3233.5205,2,2,0,0.6488535209321454
26739,703-004-5382,922.9672,6,3,3,1.5790285582346513
26760,207-008-2399,6523.0703,5,2,3,1.089735053578624
26797,703-004-5389,8419.452,3,1,2,0.35831143730785864
26893,703-004-5383,5360.609,10,6,4,1.2373065834409083
27076,703-004-5381,9258.915,6,4,2,2.2807850514025487
27122,703-004-5381,5420.3916,6,2,4,0.42145111619602443
27309,703-004-5380,4282.7725,4,2,2,0.5006221052593883
27529,703-004-5394,3305.875,1,1,0,0.5659337372705341
27714,703-004-5393,2582.1482,5,2,3,0.6568902802501462
28181,703-004-5398,9174.859,5,2,3,1.5142385153767872
28195,703-004-5389,7453.4766,5,2,3,1.655454152856891
28287,703-004-5396,8574.922,5,3,2,0.8058274559752349
28676,703-004-5391,6287.054,4,3,1,1.1352122385655736
28952,703-004-5395,8579.543,5,3,2,0.9598700812997294
29040,703-004-5384,3264.15,3,3,0,1.3453833115225091
29501,703-004-5386,3708.2898,2,1,1,0.649640524316669
29621,703-004-5382,7143.445,6,3,3,0.7723937643414608
29685,703-004-5396,8158.085,2,1,1,0.8784896059273002
29884,207-008-2398,1063.8809,1,0,1,0.27920371738274696
30174,703-004-5397,3275.5369,5,2,3,0.8238279142199264
30263,703-004-5382,1979.3904,3,0,3,0.27920371738274696
30269,703-004-5383,2593.4941,4,2,2,0.972695179663695
30301,703-004-5383,4184.748,"","","",0.27920371738274696
30622,703-004-5392,1955.7422,5,2,3,1.1208569944877627
30934,703-004-5383,7207.7544,4,2,2,1.603770953637598
31164,703-004-5390,6577.5127,6,3,3,1.068242153551239
31293,703-004-5383,1812.9211,3,2,1,0.8604181656652274
31396,703-004-5384,4277.0605,5,4,1,2.1815756099972026
31406,703-004-5385,4197.954,5,4,1,1.3219134540130466
31567,703-004-5393,9704.656,4,2,2,1.3092699583089242
31674,703-004-5381,4556.1743,5,3,2,1.2747051290442253
31927,207-008-2399,3060.7502,11,4,7,2.088510635147758
32199,703-004-5394,2318.5676,1,1,0,0.40272256277423135
32813,703-004-5381,5420.039,1,1,0,0.4095084497726735
33065,703-004-5394,2845.8882,4,3,1,1.8647489371122774
333,703-004-5390,4648.122,5,2,3,0.6173301562160489
33318,207-008-2399,4016.5608,5,2,3,0.9133494406290553
33389,703-004-5395,6693.5156,3,2,1,1.0257059191057454
33550,703-004-5383,3704.8381,4,1,3,0.8325569456216867
33725,703-004-5398,3632.9192,5,2,3,0.9197236885962055
33873,703-004-5385,9028.77,2,2,0,0.4531629531620037
34123,703-004-5393,562.61896,1,1,0,0.619992777357749
34164,703-004-5386,543.98474,3,2,1,0.8088491538866481
34339,703-004-5387,2992.7473,6,5,1,1.8620215129100568
35086,703-004-5389,8341.976,6,3,3,1.0000222921347408
35133,703-004-5391,2832.1533,3,2,1,0.7712039398956633
3547,703-004-5397,8748.1045,3,1,2,0.6833473490956031
35545,703-004-5389,7138.8403,7,4,3,0.8755544623064537
35821,703-004-5399,9032.716,3,2,1,1.0293761120309335
3586,703-004-5398,9013.474,7,3,4,1.8985676898900987
3613,703-004-5395,7421.5215,5,2,3,1.0917853403135673
36172,703-004-5381,6693.463,"","","",0.27920371738274696
36228,703-004-5380,8102.6914,5,0,5,0.27920371738274696
3631,207-008-2399,1860.0135,3,1,2,1.2812920156589305
37860,703-004-5399,6756.615,4,2,2,1.3015870132682141
38218,703-004-5389,4681.445,4,3,1,1.4345477286511223
38300,703-004-5380,1818.2474,3,2,1,0.7003125690120988
38312,703-004-5382,3522.1792,6,2,4,0.5240334293027444
38441,703-004-5385,570.3962,6,2,4,0.5075675158571885
3854,703-004-5382,1088.9613,7,4,3,1.8248567552663808
38644,703-004-5385,9777.288,5,1,4,0.9686078099940053
38697,703-004-5383,291.65448,1,1,0,0.8380273281176319
3893,703-004-5399,8305.7,5,1,4,0.47756451130842376
39316,703-004-5397,4917.2925,2,1,1,0.32666834933781397
39346,703-004-5389,5194.899,5,2,3,0.8136959338432035
39436,703-004-5381,8825.323,4,1,3,0.5834654646819581
39712,703-004-5381,4177.09,5,2,3,0.6136754605647573
40274,703-004-5390,6306.676,2,1,1,0.5651938141671045
4045,703-004-5399,1510.6577,5,3,2,2.451948638284978
4084,703-004-5380,6537.5537,8,2,6,0.4483653446281287
4171,703-004-5385,774.9516,1,0,1,0.27920371738274696
41952,703-004-5390,6877.279,5,3,2,1.6334100273732104
42076,703-004-5399,4821.666,11,5,6,1.7341339932001107
42082,703-004-5383,8619.8,2,1,1,0.7978980648999514
42211,703-004-5380,961.31683,4,4,0,5.062494968437842
42350,703-004-5398,5407.015,5,3,2,0.5144264935886824
42631,703-004-5381,6468.8247,5,1,4,0.47915499100371267
42698,703-004-5390,7301.5635,6,2,4,0.9834350995867954
4306,703-004-5384,4857.2725,5,4,1,1.1345638098126023
43118,703-004-5384,826.02264,1,1,0,0.3978652972704144
43220,703-004-5386,564.2319,5,2,3,0.9718523509062926
43279,703-004-5396,3247.4082,2,1,1,0.32666834933781397
43595,703-004-5387,4189.3267,3,2,1,1.017013100266885
43719,703-004-5390,5480.367,4,3,1,1.0843464318435772
43917,703-004-5387,9894.208,2,1,1,0.33853450732658075
44190,703-004-5394,4280.5044,3,0,3,0.27920371738274696
44338,703-004-5383,1058.1565,10,5,5,1.5480199968877462
4439,703-004-5385,2980.7705,1,1,0,0.35831143730785864
44581,207-008-2399,14.344454,5,2,3,1.72666765841709
44762,703-004-5382,9809.124,5,4,1,2.0452827211624256
4482,703-004-5383,1566.8607,3,2,1,0.7543852540098995
44895,703-004-5386,1562.6501,3,1,2,0.4675454886211377
45117,703-004-5399,3582.595,2,1,1,2.298324295024465
45391,703-004-5381,8101.1157,6,5,1,1.6596181576924083
45529,703-004-5398,9763.642,4,1,3,0.6071116522301307
45615,703-004-5383,8764.493,2,0,2,0.27920371738274696
45811,703-004-5397,2479.8667,4,1,3,0.42252806286765043
45860,703-004-5388,9265.57,2,1,1,0.8468719879926748
4597,703-004-5380,4241.1357,7,3,4,1.60482404372015
46294,207-008-2398,8835.64,5,2,3,1.6093949647463655
46693,703-004-5398,3819.421,2,2,0,2.627672717273928
46947,703-004-5390,1254.2015,3,1,2,0.32666834933781397
47048,703-004-5395,1708.4772,4,1,3,0.43872814278610617
47174,703-004-5386,5030.5884,5,5,0,2.435194442704724
47334,703-004-5398,2299.131,3,2,1,1.6836966669288616
47401,703-004-5396,1775.5139,5,3,2,0.5187389267764877
47403,703-004-5388,8713.693,2,2,0,1.0478460192395165
47487,703-004-5399,8993.266,5,2,3,2.449965664400551
47611,703-004-5384,5474.7437,2,1,1,0.49677599336208556
47729,703-004-5393,1714.9233,2,0,2,0.27920371738274696
47833,703-004-5394,944.17694,8,4,4,0.836526921251445
47887,703-004-5386,8427.71,5,2,3,1.175403695386601
4816,703-004-5396,9382.167,5,3,2,1.2922501976012128
48238,703-004-5384,279.76572,3,3,0,1.637647321757012
48713,207-008-2398,8584.614,6,5,1,0.9137788427250308
48743,703-004-5381,9335.951,1,0,1,0.27920371738274696
48851,703-004-5383,7070.3076,1,1,0,0.511014748892102
4898,703-004-5387,286.37827,9,5,4,1.4139340369032818
49303,703-004-5387,7862.6353,1,1,0,0.551464480261268
49389,207-008-2399,5644.671,5,2,3,1.3405573373875304
49904,703-004-5390,9343.948,4,2,2,0.8268610172521275
518,703-004-5399,3862.4858,3,1,2,0.9654366473552831
5263,703-004-5394,4971.0947,6,2,4,1.2555734525624829
5477,703-004-5397,7114.904,"","","",0.27920371738274696
5813,703-004-5386,5549.118,5,2,3,0.7833874768679943
5851,703-004-5396,919.17456,2,0,2,0.27920371738274696
5878,703-004-5391,2864.4783,4,1,3,0.35831143730785864
5942,703-004-5388,8639.465,3,0,3,0.27920371738274696
5944,703-004-5396,2258.5332,8,5,3,1.2698973531046702
7055,703-004-5389,5280.262,4,1,3,0.32666834933781397
721,703-004-5383,3469.5017,8,3,5,1.0895305997366724
735,207-008-2399,725.3796,5,3,2,1.1588171083693697
7548,703-004-5384,3956.2554,3,1,2,0.7056528422848072
764,703-004-5392,9847.589,3,2,1,0.8346215474826055
7666,207-008-2398,7100.442,4,3,1,1.3737207675026535
7667,703-004-5395,7417.7812,3,1,2,0.5301297998156732
7677,703-004-5389,7669.855,3,0,3,0.27920371738274696
7722,703-004-5389,7923.382,2,1,1,0.5255749300521302
8000,703-004-5381,1996.1852,1,1,0,1.7318326332784084
8311,207-008-2398,7876.487,7,4,3,2.175808724190946
8374,703-004-5396,1876.3447,2,1,1,0.35831143730785864
875,703-004-5399,8074.5186,3,1,2,0.3833377001313547
8823,703-004-5397,6209.9653,4,1,3,0.5355906652049838
887,703-004-5399,5179.674,4,3,1,1.3012480963571267
915,703-004-5382,6795.8643,2,1,1,0.5568718143198889
9336,703-004-5394,2270.4988,3,2,1,1.9206399564964904
9395,703-004-5382,7448.4976,2,0,2,0.27920371738274696
9461,703-004-5382,1625.3937,"","","",0.27920371738274696
9594,703-004-5387,512.0188,6,4,2,3.2310461984046537
9827,703-004-5382,8731.464,3,1,2,0.34693970256862383
9903,703-004-5389,9011.148,1,0,1,0.27920371738274696
10234,703-004-5382,5568.2314,4,2,2,0.693965078780991
10255,703-004-5396,5336.401,3,1,2,0.5322148848762895
10349,703-004-5383,8408.386,1,0,1,0.27920371738274696
10367,703-004-5384,9909.894,1,0,1,0.27920371738274696
10398,703-004-5396,457.37445,2,1,1,0.3486207416170325
10576,207-008-2399,8285.458,7,1,6,0.3978652972704144
10594,703-004-5385,5676.2476,3,1,2,0.33853450732658075
10629,703-004-5395,3607.7256,3,2,1,0.6330977865111447
10822,703-004-5380,2115.8772,9,3,6,1.2341526859945422
10846,703-004-5398,6423.8423,7,4,3,0.8687844129085144
10849,703-004-5383,2349.6907,4,1,3,0.5165268771580819
10914,703-004-5384,4224.068,7,4,3,0.6397989105432337
10949,703-004-5391,6065.7812,5,4,1,1.5368384462796094
11081,703-004-5394,234.3887,2,1,1,0.3978652972704144
11390,703-004-5395,9862.186,4,2,2,0.9881106839457537
11549,207-008-2399,6717.793,3,2,1,0.8646604187379706
11893,703-004-5389,8136.109,6,3,3,1.152964363236641
11949,703-004-5382,3142.2776,3,1,2,1.0140628168108394
12179,703-004-5384,8432.906,4,1,3,0.5396311225729421
12251,703-004-5388,7824.0806,5,3,2,1.3671332829981933
12275,703-004-5390,6876.049,4,3,1,1.9304010934935052
1249,703-004-5391,3137.2148,4,2,2,1.1358668265244816
12521,703-004-5393,2780.2676,"","","",0.27920371738274696
1255,703-004-5387,8824.092,5,3,2,0.9079618207635506
12629,703-004-5398,1700.6898,1,1,0,0.6940736161463312
1273,703-004-5399,3164.0327,5,2,3,0.6292800582847979
12768,703-004-5390,7202.1455,5,2,3,1.0230907768178519
13230,703-004-5397,7733.239,4,2,2,0.5524302454615935
13243,703-004-5391,3603.2634,3,3,0,1.3275531167143484
13278,703-004-5398,913.0466,7,3,4,1.3951418089021694
1335,207-008-2399,7890.576,2,0,2,0.27920371738274696
13411,703-004-5389,9842.093,3,2,1,2.172112136560987
13472,703-004-5385,9374.756,5,3,2,2.070812709413751
13615,703-004-5392,7350.8184,4,1,3,0.7251346801289156
13670,703-004-5390,9613.715,2,1,1,0.44860262618509233
13686,207-008-2399,3909.3481,4,3,1,1.4350867526638025
13721,703-004-5393,1998.9818,4,1,3,0.4426268018685607
13742,703-004-5396,6160.4194,5,4,1,1.3681608458387235
13832,703-004-5386,3457.1982,3,2,1,0.5250814874924018
13904,703-004-5393,6629.01,4,2,2,1.2343992014736413
14032,703-004-5387,8157.5703,4,1,3,0.4056599986737422
14098,703-004-5393,4247.1006,2,0,2,0.27920371738274696
14129,207-008-2398,8760.108,2,1,1,0.4646170000665455
14249,703-004-5390,875.16846,2,1,1,0.8891769814140111
14716,703-004-5396,9701.722,1,1,0,0.9967954758997056
15187,703-004-5388,6082.164,2,0,2,0.27920371738274696
15218,703-004-5392,1744.1439,4,3,1,0.9313144243950193
15305,703-004-5382,7352.9326,10,3,7,0.8817837008273068
157,703-004-5391,9844.702,3,2,1,1.4490359047184453
15789,703-004-5398,9532.529,2,0,2,0.27920371738274696
15983,703-004-5399,1789.2563,5,1,4,1.1200225942526543
16228,703-004-5384,2725.5398,1,1,0,0.4056599986737422
16354,703-004-5384,4579.7993,7,1,6,0.5488752728307059
16688,703-004-5383,4459.5938,4,1,3,0.9900335206135574
16894,703-004-5387,4816.9917,4,2,2,0.5202320413116102
16959,207-008-2399,3793.0786,5,3,2,1.481608221460106
17212,703-004-5388,8469.3,"","","",0.27920371738274696
17355,703-004-5396,984.10187,3,2,1,0.5572875528560536
17428,207-008-2398,9401.889,7,4,3,1.38048641161836
17440,703-004-5380,167.50752,6,4,2,1.1307517034478451
17604,703-004-5392,6613.1035,3,1,2,0.4230808829965438
17612,703-004-5380,4199.21,1,0,1,0.27920371738274696
17622,703-004-5387,2919.5535,2,1,1,0.3978652972704144
17733,703-004-5385,9239.661,8,3,5,1.326800021969217
18007,703-004-5398,1096.04,4,2,2,0.7388224585096442
18188,207-008-2399,9686.874,6,2,4,0.43481603087748644
18229,703-004-5395,6335.692,5,1,4,0.43042908269607644
18784,703-004-5387,853.7948,7,3,4,1.0607429661663197
18811,703-004-5381,4254.857,4,3,1,2.9259959540064706
18908,703-004-5396,8434.9795,"","","",0.27920371738274696
191,703-004-5399,3116.9434,3,1,2,0.3983714694813131
19125,703-004-5392,1677.4642,2,1,1,1.5745464952236892
19295,703-004-5391,1165.6171,3,1,2,0.5165268771580819
20123,703-004-5382,4124.237,4,3,1,1.3858542083717678
20391,703-004-5382,8751.2,6,3,3,2.2885470080053008
20514,703-004-5395,2365.8384,3,1,2,0.9731144980328881
20545,703-004-5396,603.3528,1,0,1,0.27920371738274696
20633,703-004-5393,642.58514,7,4,3,1.2827783335923013
20662,703-004-5395,672.80176,5,2,3,0.6137244005453164
20860,703-004-5398,6665.5137,4,1,3,0.6281740484790569
21010,703-004-5398,613.0773,"","","",0.27920371738274696
21048,703-004-5393,1558.6567,1,0,1,0.27920371738274696
21163,703-004-5385,9424.57,4,1,3,1.1010224106333484
21353,703-004-5385,1851.387,3,2,1,0.9389756300285973
21362,207-008-2399,7528.965,4,2,2,0.5416718745760483
21740,703-004-5398,7300.013,2,2,0,0.4730655027003579
2189,703-004-5389,9361.927,4,3,1,1.1184702649432419
21908,703-004-5386,2337.1838,2,1,1,0.4726357743674418
21938,703-004-5388,4302.631,3,2,1,0.745923294275337
22194,703-004-5394,1324.0331,6,4,2,1.135479262725369
22277,703-004-5382,6144.5933,4,2,2,1.1281335202729028
2232,703-004-5387,9902.925,4,2,2,2.2655440661443893
22422,703-004-5387,8728.366,1,1,0,0.3949395738931663
22487,703-004-5394,8020.9043,3,0,3,0.27920371738274696
22786,703-004-5382,842.85736,5,4,1,1.9183618017397088
23078,703-004-5384,2479.1724,5,3,2,2.2608422068389573
23148,703-004-5381,394.879,3,2,1,0.7135762967195424
23166,703-004-5389,607.0393,2,1,1,1.0089268311872246
23191,703-004-5399,4626.455,1,0,1,0.27920371738274696
23327,703-004-5386,2601.2253,10,4,6,2.0224345597429068
23419,703-004-5386,5839.808,3,1,2,0.5992728539108865
23446,703-004-5396,1691.3289,1,0,1,0.27920371738274696
23615,703-004-5391,7683.997,2,1,1,0.5935362639532611
24021,703-004-5380,4819.2017,1,0,1,0.27920371738274696
24030,703-004-5380,9761.915,1,0,1,0.27920371738274696
24066,703-004-5399,9861.188,4,2,2,0.3943054498737844
24419,703-004-5385,9648.114,3,1,2,0.3670962564376612
24738,703-004-5387,5880.782,1,1,0,0.6345891657339748
24751,207-008-2399,8676.277,3,3,0,0.992499699858139
2486,703-004-5393,4209.551,4,3,1,1.887072370347532
24960,703-004-5391,6444.899,5,3,2,1.6825194583738843
24986,703-004-5392,3572.8425,3,2,1,0.5539611608498622
25047,703-004-5386,7702.4688,2,1,1,0.365062748153401
25154,703-004-5383,5602.307,8,2,6,0.6590590849318967
2517,703-004-5390,4392.2656,2,1,1,0.33473733677017536
25420,703-004-5387,6006.954,4,2,2,0.6356860173452141
2558,703-004-5393,2074.9795,2,1,1,0.35831143730785864
260,703-004-5392,7457.8965,2,0,2,0.27920371738274696
26727,703-004-5385,9648.066,5,4,1,1.303026759276486
27168,703-004-5394,2872.0164,4,0,4,0.27920371738274696
27738,703-004-5389,8320.044,5,2,3,2.559262870109981
27768,703-004-5390,8848.497,3,0,3,0.27920371738274696
27855,207-008-2398,9692.019,4,1,3,0.568308909012598
27865,703-004-5381,3500.6475,2,2,0,0.5295516634034642
28104,703-004-5394,645.3437,2,2,0,0.59377090747837
28323,703-004-5389,3334.6135,3,3,0,1.6247030843601347
28346,703-004-5386,5978.658,5,3,2,0.903598224840753
28565,703-004-5380,9994.74,5,2,3,0.8996516458190156
28694,703-004-5399,9665.409,3,0,3,0.27920371738274696
28752,703-004-5397,3640.4937,6,5,1,2.1952891080599968
28813,703-004-5388,8718.05,7,3,4,1.1821187188251459
29035,703-004-5396,2889.8757,2,1,1,0.47429712063617313
29087,703-004-5384,4491.45,2,2,0,1.449376250991557
29099,703-004-5380,2362.3389,2,1,1,0.6361173872471328
29323,703-004-5390,5045.0317,2,1,1,0.33853450732658075
29542,703-004-5398,3430.1753,4,3,1,1.7618008069008027
2963,703-004-5380,3926.1497,3,2,1,0.7556408630384307
29945,703-004-5381,2288.9863,3,1,2,0.5573023323584535
30425,703-004-5389,7967.723,4,1,3,0.5161586695869816
30779,703-004-5380,8110.343,6,2,4,0.5899200307354003
31107,703-004-5390,4463.1587,"","","",0.27920371738274696
31190,703-004-5380,7427.956,4,3,1,1.6302227864689611
31286,703-004-5395,3848.4944,3,0,3,0.27920371738274696
31307,703-004-5391,9859.268,7,2,5,1.030310403721419
31399,703-004-5399,4418.1562,3,3,0,0.636666030475534
31553,703-004-5382,5020.384,6,5,1,2.136048578865282
31624,703-004-5397,1785.5513,1,1,0,0.3554845439956296
31871,703-004-5391,7946.42,2,1,1,0.3851028017760176
31874,703-004-5399,938.3607,4,3,1,1.4758751278229425
31925,703-004-5386,5641.83,1,1,0,0.4230808829965438
32112,703-004-5390,3501.1213,3,2,1,0.8827131473813743
32123,703-004-5396,3746.3147,1,1,0,0.5204943922413138
32398,703-004-5391,4376.948,2,0,2,0.27920371738274696
32599,703-004-5383,1924.9194,4,1,3,0.33556796782938897
32636,703-004-5394,152.93956,4,2,2,0.7843618997171898
32846,703-004-5390,5486.7686,4,3,1,2.3210658823691497
33039,703-004-5399,6466.6426,3,2,1,0.6752689629574958
33145,703-004-5393,1499.3865,4,1,3,0.3978652972704144
33275,207-008-2399,3498.9697,2,1,1,0.33853450732658075
34208,703-004-5394,5707.594,4,3,1,0.5463886346943786
34304,703-004-5394,5498.2573,1,1,0,0.5165268771580819
34327,703-004-5392,5553.4414,7,5,2,1.6158847629167201
34640,703-004-5395,3869.4382,3,1,2,0.402145227354162
35034,207-008-2398,2780.6157,4,2,2,1.2943243848448094
35482,703-004-5384,2731.6057,5,2,3,0.7399749099676709
35763,703-004-5398,497.6511,4,2,2,0.8890388471299818
36026,703-004-5391,529.87695,4,0,4,0.27920371738274696
36490,703-004-5388,5670.1245,2,1,1,0.5111579845078366
36718,703-004-5382,7707.298,6,2,4,0.873513583812891
36728,703-004-5388,4220.6343,6,2,4,0.7598604611776255
37099,703-004-5391,972.9379,2,1,1,0.8317211557834517
37357,703-004-5380,1303.4033,2,1,1,0.46452021176129105
3749,703-004-5399,7621.6245,9,5,4,2.188634375030826
37600,703-004-5394,2813.1646,7,1,6,1.3604815560112373
37769,703-004-5382,2867.5479,2,1,1,1.2232524715624142
37812,703-004-5394,4501.3057,2,2,0,1.8858801582237543
38052,703-004-5390,3108.3054,4,2,2,1.2803593946135816
38060,703-004-5390,2454.4292,3,2,1,0.8507191423492513
38511,703-004-5385,4000.4282,2,2,0,1.0721775894171988
38683,703-004-5396,4974.65,5,1,4,0.5599360386536386
38725,703-004-5380,5015.3228,14,7,7,2.581518441234094
39062,703-004-5385,7897.973,4,3,1,2.591144159403906
39185,703-004-5393,9639.802,6,1,5,1.230444357490977
39275,703-004-5388,8065.0107,3,2,1,1.9147511873174028
39378,703-004-5390,7655.5044,3,0,3,0.27920371738274696
39467,703-004-5383,6586.492,3,1,2,0.32666834933781397
39499,207-008-2399,5475.294,1,1,0,1.011523823585186
39825,703-004-5389,6420.297,3,1,2,1.148914083972346
39834,703-004-5399,6735.3354,4,2,2,1.5419912509277975
40020,703-004-5381,7431.8237,4,2,2,1.5647418984926327
40210,703-004-5390,8040.229,2,0,2,0.27920371738274696
40378,703-004-5392,6506.1265,5,4,1,2.331958412755061
40649,703-004-5385,3738.6655,7,5,2,1.1689994295597588
41360,703-004-5382,2850.2708,5,3,2,0.9961553583167742
41388,703-004-5388,7451.3105,5,4,1,1.4063973520188335
41501,207-008-2399,7014.2915,3,3,0,0.6633058451202288
41511,207-008-2399,9037.218,2,0,2,0.27920371738274696
41832,703-004-5391,4264.1987,5,3,2,1.7841039427020107
42041,703-004-5388,3673.7913,8,4,4,1.8517580869454815
42183,207-008-2398,5542.1553,6,2,4,0.6784440550792203
42369,207-008-2398,5636.265,1,1,0,0.4956721065529212
42522,703-004-5394,4623.9287,3,3,0,2.971042574463757
42566,703-004-5398,2578.3223,3,3,0,1.1528289959263611
42752,703-004-5396,9204.001,2,1,1,0.6417817421633508
43005,703-004-5388,4528.1865,5,1,4,0.4222558779826999
43232,703-004-5384,9191.652,4,1,3,0.9861394926405302
43284,703-004-5382,8389.758,3,1,2,0.3978652972704144
43445,703-004-5395,7618.3193,4,2,2,0.6661716511300295
43868,703-004-5397,8161.2915,5,2,3,2.9054067583130756
43904,703-004-5383,4265.345,4,2,2,1.4337750147861217
44065,703-004-5397,673.80725,4,2,2,0.8583179744904311
44731,703-004-5391,1434.4567,4,4,0,1.8068422496128165
44810,207-008-2399,3560.652,4,2,2,0.4491850977430084
45153,703-004-5381,2638.2847,"","","",0.27920371738274696
45184,703-004-5399,5576.811,"","","",0.27920371738274696
45399,207-008-2398,379.44733,1,1,0,0.3978652972704144
45691,703-004-5380,6300.907,5,3,2,2.9488399888459367
45936,703-004-5382,6881.6953,5,3,2,1.2247460039281999
46266,703-004-5399,5065.8486,"","","",0.27920371738274696
46636,703-004-5394,9739.128,3,1,2,0.7811069683495048
46883,703-004-5388,6353.868,3,1,2,0.594484445333343
47005,703-004-5392,6069.6733,4,1,3,0.3750289224143126
47279,207-008-2399,2690.5872,5,0,5,0.27920371738274696
48241,703-004-5398,8979.211,2,1,1,0.5616262452383626
4853,703-004-5380,5765.478,3,1,2,0.4330552317226923
4905,703-004-5381,8068.4434,7,4,3,1.1303638349953817
49611,703-004-5388,2061.249,4,3,1,1.406137573350934
49632,703-004-5385,6305.555,4,2,2,0.3936379784869163
49802,703-004-5392,7112.5156,9,7,2,2.1337254955290597
49820,703-004-5392,1963.9945,3,2,1,0.5928297558975655
49900,703-004-5393,7319.311,4,2,2,0.47103993820114265
5235,703-004-5393,3362.7886,7,5,2,1.5282323958954958
5526,703-004-5399,8587.159,8,6,2,2.713817001238116
6080,703-004-5391,5455.727,3,2,1,0.647990431556521
6103,703-004-5380,3867.821,2,1,1,0.3187575773453028
6107,703-004-5388,1948.3226,4,1,3,0.3978652972704144
6148,703-004-5389,9442.48,3,1,2,0.4819172496908456
6328,703-004-5387,8354.443,3,3,0,2.338559134077855
6597,703-004-5391,3227.439,2,1,1,0.6712536534351532
6686,703-004-5382,8849.202,4,1,3,0.4247800444357455
6702,703-004-5382,6010.843,8,4,4,1.2631324802803692
6705,703-004-5386,8514.188,5,3,2,0.8702909348574629
7062,207-008-2398,9772.202,5,1,4,0.5165268771580819
7774,703-004-5383,2727.9275,4,2,2,0.9286633200812576
7842,703-004-5383,6344.997,2,0,2,0.27920371738274696
7959,703-004-5390,358.71863,3,2,1,0.9917676443924293
8049,703-004-5397,2982.3906,3,3,0,0.9008458496044368
8109,207-008-2398,293.0361,9,4,5,2.050769297993656
8176,703-004-5390,6325.4863,5,3,2,1.9896700753006096
8269,703-004-5387,7112.5464,4,1,3,0.5165268771580819
8852,703-004-5383,1121.7213,3,2,1,1.0243463599680638
8915,703-004-5396,8149.191,4,2,2,1.2189476243687738
9127,703-004-5392,2600.5405,6,1,5,0.5419164489292432
9142,703-004-5381,143.88263,4,3,1,2.1802533309504417
9316,703-004-5383,1211.6921,4,2,2,1.29231512905672
9343,703-004-5395,9545.587,3,1,2,0.5165268771580819
9453,703-004-5389,1387.4656,4,1,3,0.37684920607081673
1006,703-004-5388,8621.765,4,4,0,1.0940033384114494
10489,703-004-5388,5543.581,5,3,2,0.7041553111763474
10578,703-004-5385,9547.036,5,3,2,1.37483625051873
10953,703-004-5390,4391.2554,7,4,3,1.36250067400119
11285,703-004-5390,5394.3027,5,1,4,0.5489539167468661
11450,703-004-5392,9498.717,4,2,2,0.6456537154082561
11484,703-004-5381,8382.648,4,0,4,0.27920371738274696
12042,703-004-5388,5674.965,2,0,2,0.27920371738274696
12083,703-004-5381,3723.288,1,1,0,0.385921668098264
12349,703-004-5389,3751.3035,5,4,1,1.0803016172382063
12854,703-004-5397,6435.876,4,1,3,0.9074411313121525
13654,703-004-5380,9705.972,5,1,4,0.6007496805554654
13714,703-004-5393,5933.398,3,2,1,0.4941422464679227
13931,703-004-5394,5741.722,1,0,1,0.27920371738274696
14003,703-004-5398,1445.4686,5,4,1,2.4289479640907117
14246,703-004-5393,7443.6333,6,3,3,0.989381340784823
14380,703-004-5386,5626.7803,3,1,2,0.41565895824086074
14407,207-008-2399,1880.4902,3,1,2,0.6189811218960154
1462,703-004-5388,129.33493,7,4,3,1.335038893292325
14721,703-004-5399,257.2602,2,2,0,1.8763079618509855
14760,703-004-5397,9813.233,9,4,5,3.4697971725184744
14770,703-004-5389,8496.632,4,3,1,0.5523890435241324
15042,703-004-5385,5367.726,3,1,2,0.7795026722111638
15204,703-004-5380,6419.093,2,1,1,2.055697140291485
15279,703-004-5381,6155.2314,3,2,1,0.6838225036234142
1543,703-004-5397,4960.8584,6,6,0,2.3743640452088948
15513,703-004-5380,3604.6106,3,1,2,0.5333552816144115
15800,207-008-2398,4191.4146,2,2,0,0.4788847870937163
15806,703-004-5382,451.46048,5,3,2,1.3043484662018963
1608,703-004-5382,1440.9309,6,3,3,1.2602163192435119
1648,703-004-5385,5312.0283,6,4,2,1.326508975894049
16608,703-004-5395,7699.9707,7,5,2,1.104475242644508
16924,703-004-5391,1383.5729,6,4,2,1.0694228061649107
17103,703-004-5391,8614.258,"","","",0.27920371738274696
17365,703-004-5394,2369.8933,5,2,3,1.1489216299877723
17386,207-008-2398,119.24148,3,2,1,0.9668909635862244
17480,703-004-5397,7021.974,4,3,1,1.8428142665488545
1753,703-004-5398,531.75214,2,0,2,0.27920371738274696
17618,703-004-5387,815.91425,2,1,1,0.4596627621243818
17735,703-004-5389,4523.011,4,2,2,0.7094730184756207
17737,703-004-5394,1509.0281,5,3,2,0.9959438995865848
17849,703-004-5390,8931.981,5,3,2,1.2264957861101835
17870,703-004-5395,3332.9917,5,3,2,0.9064708144024449
18555,703-004-5387,2241.351,4,2,2,1.2726438571537018
19052,703-004-5381,9056.151,1,0,1,0.27920371738274696
19081,703-004-5380,7665.551,6,2,4,0.8169987537748835
19280,703-004-5384,405.7586,2,1,1,0.39905191306929116
19282,703-004-5393,4146.097,6,3,3,1.3441041380705716
19456,703-004-5391,6024.176,5,2,3,0.4656243555412694
202,703-004-5383,3250.0447,4,3,1,1.5819924484398986
20307,703-004-5395,6491.766,7,4,3,1.609426798027981
20562,703-004-5384,7945.859,2,0,2,0.27920371738274696
20937,703-004-5383,6890.188,5,4,1,0.6573913571047306
21098,703-004-5389,3601.0408,7,3,4,1.0772085882511706
21114,703-004-5391,4504.1523,4,2,2,0.7024300189820942
21131,703-004-5396,2201.3206,7,4,3,0.6185477949945691
21225,703-004-5384,6263.1895,4,1,3,0.5114678943166849
21355,703-004-5381,5466.35,3,2,1,1.1631593968654403
21639,703-004-5382,3808.002,2,1,1,1.1454036722245362
21896,703-004-5396,69.484116,2,0,2,0.27920371738274696
21934,703-004-5396,5630.599,2,1,1,0.7924433166427544
21970,207-008-2399,1013.422,6,4,2,1.3340270525441897
22276,703-004-5387,8115.9097,4,2,2,0.7988796081183037
22733,703-004-5395,6977.2446,5,3,2,0.8032333295658987
22946,703-004-5389,6261.6235,7,5,2,1.0068581002745944
23001,703-004-5383,4291.5557,5,4,1,1.3970733465832008
23064,703-004-5384,6234.1655,5,3,2,1.9111362141186718
23322,703-004-5382,3859.6482,8,7,1,1.7197422132313562
23337,703-004-5395,7376.93,3,1,2,1.2698282907841971
23374,703-004-5394,7054.19,3,1,2,0.5165268771580819
23415,703-004-5384,7925.0312,1,0,1,0.27920371738274696
24207,207-008-2398,8725.7705,4,2,2,0.6667804427681613
24239,703-004-5393,6556.5664,5,2,3,1.5922457297131756
2442,703-004-5389,2470.6775,1,0,1,0.27920371738274696
24559,703-004-5380,2072.277,3,3,0,0.9513886133056707
24743,703-004-5397,8106.9604,4,2,2,0.6033135858839453
248,703-004-5389,2968.1384,1,1,0,0.3637500930527101
24948,207-008-2399,2771.8318,3,1,2,1.072450690163015
25292,703-004-5386,2120.5562,1,1,0,0.44979642176092904
25731,703-004-5391,6230.931,3,2,1,0.7770829128504054
25828,703-004-5394,7907.077,6,2,4,0.8478209371755101
26066,703-004-5399,5854.9243,2,0,2,0.27920371738274696
26387,703-004-5385,4315.9893,2,2,0,1.161989145843006
26563,703-004-5387,7398.3027,4,3,1,1.062613790532535
26591,703-004-5392,6468.5825,4,2,2,1.947120353677309
26790,703-004-5388,4953.4155,5,3,2,1.478077522875797
27196,207-008-2399,2568.264,7,4,3,1.5425977445061454
27687,703-004-5390,5411.9575,5,3,2,1.4032151101624208
28189,207-008-2398,1012.87604,3,1,2,0.9624130815559447
28490,703-004-5398,3459.153,3,1,2,0.3978652972704144
28624,703-004-5386,937.13043,7,4,3,2.080339422827148
28911,703-004-5382,9551.319,3,2,1,0.6805873982695653
29240,703-004-5399,214.6411,4,0,4,0.27920371738274696
29307,703-004-5399,2852.6843,3,1,2,0.8388772165524839
29369,703-004-5384,6667.458,3,1,2,1.9546168942756965
29508,703-004-5384,4524.277,1,1,0,3.2756291286775543
29598,703-004-5387,5110.482,10,1,9,0.35831143730785864
29924,207-008-2398,7640.8247,3,0,3,0.27920371738274696
29942,703-004-5397,9418.925,4,0,4,0.27920371738274696
30210,703-004-5386,1185.8773,10,4,6,0.9058731972052452
30416,703-004-5389,5224.0283,5,4,1,1.2419903205209504
30605,703-004-5383,5679.8994,1,1,0,0.4827577692150498
31192,703-004-5394,6608.0874,2,0,2,0.27920371738274696
31222,703-004-5392,256.29343,4,4,0,1.3691768388206476
3128,703-004-5386,2679.2866,5,2,3,0.7182848170138267
31327,703-004-5388,6466.8457,6,5,1,2.6107594186470977
31367,703-004-5396,4308.2026,3,2,1,0.4519399711541465
31585,703-004-5398,1990.4679,4,2,2,0.4427573190679113
3161,703-004-5390,5098.931,2,0,2,0.27920371738274696
32141,703-004-5399,8248.726,3,2,1,0.607368651359976
3255,703-004-5398,7559.8364,1,1,0,0.7580322468415626
32585,703-004-5398,2479.4692,3,1,2,1.0259041881504063
32676,703-004-5397,2188.7034,3,1,2,0.6624686437423176
327,207-008-2398,8325.721,2,2,0,0.9540803284707412
32897,703-004-5396,9393.997,3,2,1,1.5656603434734948
32923,703-004-5398,7930.5825,4,2,2,1.2561201437392302
32991,207-008-2398,1903.8713,5,3,2,1.6077409010891275
3307,703-004-5387,8323.623,5,2,3,0.9140987500713849
33201,703-004-5392,6979.675,5,2,3,1.0384644125131492
33202,703-004-5380,461.37213,2,2,0,3.544402931802574
33496,703-004-5398,9.999871,4,3,1,0.8178302927977684
33515,703-004-5396,5158.1846,3,2,1,0.9014244352004684
33535,703-004-5396,9846.487,3,3,0,1.0528742456444091
33631,703-004-5398,964.5581,2,0,2,0.27920371738274696
33639,703-004-5393,1775.3822,2,1,1,0.5450045313413521
33755,703-004-5392,6791.0947,2,1,1,0.4142921237483007
33874,703-004-5398,6681.481,3,2,1,3.8224394376272848
33907,703-004-5382,7481.9585,7,4,3,1.627057475504145
34354,703-004-5397,1595.6777,1,0,1,0.27920371738274696
34568,703-004-5387,3361.2246,3,0,3,0.27920371738274696
34687,703-004-5397,5144.191,4,0,4,0.27920371738274696
34697,703-004-5391,4588.3394,1,0,1,0.27920371738274696
34714,703-004-5394,1464.0981,1,1,0,0.4238041895494791
34912,703-004-5386,882.8753,5,4,1,0.8481635392079547
35038,703-004-5389,3982.7651,3,1,2,0.4962641957088595
36284,207-008-2398,9574.427,6,4,2,0.9092608499177085
36476,703-004-5393,153.48972,7,3,4,0.7489523974068307
36668,703-004-5390,2844.7163,3,1,2,0.3978652972704144
36893,703-004-5387,167.44495,5,3,2,1.1067934343491526
3707,703-004-5392,5954.9956,3,0,3,0.27920371738274696
37805,703-004-5394,496.22177,9,5,4,3.4703085249499486
38301,703-004-5384,9072.6455,5,3,2,1.472312322364429
3837,703-004-5393,6498.781,3,3,0,3.291203567222294
38379,703-004-5394,5191.2505,7,5,2,2.0458333834879716
3867,703-004-5396,7544.6035,3,1,2,0.5496963678442705
39114,703-004-5380,7842.501,3,2,1,0.6628760323368139
39169,703-004-5390,634.84015,3,1,2,0.8266166082838399
39614,703-004-5394,1061.5426,1,1,0,0.53661880694019
39687,703-004-5382,8339.453,"","","",0.27920371738274696
39786,703-004-5398,9098.277,4,3,1,1.0772821444187402
39865,207-008-2398,4794.187,7,3,4,0.6047413911615591
40419,703-004-5394,287.70746,6,4,2,1.5294837033543482
40828,703-004-5398,2487.0986,9,5,4,2.8330645791373446
41299,703-004-5380,3342.9492,1,0,1,0.27920371738274696
41352,703-004-5395,9032.341,4,2,2,1.6459458954154143
41655,703-004-5387,4491.688,4,1,3,0.651016323378518
41706,703-004-5397,9863.366,2,2,0,1.222475340870361
41755,207-008-2399,4411.3247,2,1,1,0.4825724429003503
41891,703-004-5388,5492.7896,10,6,4,3.085262862200661
41892,703-004-5391,655.01514,2,1,1,0.46033195607962063
4245,703-004-5392,146.55351,2,1,1,0.5372115496813147
42710,703-004-5384,1370.1373,2,0,2,0.27920371738274696
42800,703-004-5393,1626.8807,2,0,2,0.27920371738274696
4291,703-004-5383,4167.3867,3,1,2,0.4230808829965438
43564,703-004-5396,7445.3945,2,1,1,0.35831143730785864
43912,703-004-5384,3252.5457,2,0,2,0.27920371738274696
44078,703-004-5385,3225.4016,5,2,3,0.7757394180939627
44083,703-004-5393,1173.1846,1,0,1,0.27920371738274696
44160,703-004-5394,1415.596,2,2,0,0.5482376661130473
44253,703-004-5398,8832.537,6,2,4,0.5805610773699951
44277,703-004-5386,7929.879,2,1,1,0.5199040794009333
44472,703-004-5385,368.13855,4,3,1,2.0913788007192986
44531,703-004-5387,3414.5183,5,4,1,1.201654993563251
44558,703-004-5382,2204.5183,4,1,3,0.5165268771580819
45027,703-004-5394,930.171,6,4,2,2.5015635536542185
4526,207-008-2398,146.42358,3,1,2,0.4253205955957611
45268,703-004-5399,3122.8525,3,1,2,0.533380817396221
45353,703-004-5390,8525.668,3,2,1,0.6351884570457493
45499,703-004-5394,1631.2838,3,2,1,1.293947553354103
45679,703-004-5382,8602.96,4,2,2,1.2536569298503386
45710,207-008-2398,3578.576,4,0,4,0.27920371738274696
45863,703-004-5387,3390.2847,2,0,2,0.27920371738274696
45927,703-004-5392,5308.4253,9,4,5,1.3682645060082916
46111,703-004-5382,8582.598,2,1,1,0.33853450732658075
46272,703-004-5393,1122.3733,5,4,1,1.289353142585489
46421,703-004-5397,8140.299,5,2,3,0.5080557552433662
4650,703-004-5382,9891.243,4,4,0,1.1146237133333343
46607,703-004-5386,5302.555,4,3,1,2.370849524666614
4661,703-004-5381,8838.536,4,2,2,1.424518220596984
46758,207-008-2398,7956.9756,9,4,5,1.4998868858811862
46915,703-004-5391,5458.6865,2,1,1,1.0299674609767095
47067,703-004-5381,3885.327,5,2,3,1.765973655923655
47076,703-004-5382,3278.0618,3,2,1,0.835299718131629
47194,703-004-5399,1382.6573,5,1,4,0.7348484249648407
4731,703-004-5380,9417.666,5,4,1,1.835348985104035
47946,703-004-5390,3193.041,3,3,0,1.1787023766672495
484,703-004-5381,723.2541,4,3,1,0.6551879086022636
48559,703-004-5387,6852.238,3,1,2,0.5600303001843709
48561,703-004-5386,8676.838,4,1,3,0.45245771687471364
48646,703-004-5394,4701.0293,5,2,3,0.9461586977076123
48652,703-004-5388,9912.984,1,1,0,1.5998741275301775
48824,703-004-5384,7221.714,5,2,3,0.6836701869218291
49016,703-004-5394,665.35474,2,1,1,0.39907663423176776
49111,703-004-5398,9383.466,10,5,5,1.7777107550850013
49129,703-004-5392,1026.0343,8,6,2,2.0908790282821172
49262,703-004-5381,7072.385,2,1,1,0.35439440329340494
49477,703-004-5391,5303.941,5,2,3,0.5987653798988204
49736,703-004-5395,8330.251,4,2,2,0.5528532520195263
49964,703-004-5387,8488.623,4,1,3,0.4629747799395092
5398,703-004-5380,7896.0713,3,2,1,0.43741915723297026
5517,703-004-5385,9095.711,5,2,3,0.4956792118270363
5660,207-008-2399,7050.351,6,5,1,3.4537028166869628
5866,207-008-2399,1634.4952,1,1,0,0.38535664223850585
6041,703-004-5395,8956.269,4,2,2,1.4224364341832842
6238,207-008-2399,4525.838,4,1,3,0.3978652972704144
6288,703-004-5389,9761.368,3,1,2,2.13492325167637
6304,207-008-2399,3233.7178,3,2,1,1.5868116321706391
6437,703-004-5383,3911.2156,6,3,3,1.3789522235972662
7181,703-004-5397,3289.168,6,4,2,1.0562162155180284
7756,703-004-5394,160.83717,4,2,2,0.8544653466765092
8248,703-004-5384,1673.4797,"","","",0.27920371738274696
825,703-004-5393,7804.9194,8,4,4,3.0388124546937996
8307,703-004-5389,9871.475,4,2,2,0.6162385134689672
8339,207-008-2399,1642.1407,2,1,1,0.5165268771580819
8411,703-004-5385,7465.521,6,3,3,1.145586948289731
8461,703-004-5380,1882.6556,3,2,1,0.5744995139034097
8591,703-004-5390,300.85086,4,3,1,0.8471868583477142
8716,703-004-5382,9178.444,6,4,2,1.6178866228395237
9006,703-004-5394,9333.529,4,3,1,0.822822555450336
9359,703-004-5395,293.4903,"","","",0.27920371738274696
96,703-004-5384,8672.056,6,3,3,0.8891898061164312
9624,703-004-5392,4726.339,3,0,3,0.27920371738274696
9663,703-004-5380,9166.789,2,1,1,0.5573684287859925
9708,703-004-5395,8592.855,4,2,2,0.6315778866306099
9762,703-004-5392,7715.8853,3,3,0,0.6094290057451348
9828,703-004-5388,5929.5957,5,2,3,1.2522163887855229
10314,703-004-5380,1689.027,2,0,2,0.27920371738274696
10495,703-004-5385,6507.51,3,1,2,0.6172502605512921
10507,703-004-5392,6798.8013,2,1,1,0.497015218275496
10582,703-004-5386,3618.0962,6,4,2,0.8596887600689648
10693,703-004-5385,3970.974,2,1,1,0.7595828115275779
11095,703-004-5399,3721.046,2,1,1,0.6916911460022602
11653,207-008-2399,2305.5894,3,1,2,1.2612049095237663
11920,703-004-5392,7645.417,3,2,1,0.6072196821941973
12012,703-004-5394,4093.5034,4,1,3,0.6536113736422375
12543,207-008-2399,386.15286,6,3,3,1.4672945389542884
12759,703-004-5392,5018.5405,4,1,3,0.4068967619618647
13308,703-004-5397,7181.9233,4,3,1,1.3516610721293802
13462,703-004-5397,2417.2097,8,4,4,0.9554834021657985
13838,207-008-2399,6451.333,5,4,1,2.582883739654842
14,703-004-5386,4037.4077,3,0,3,0.27920371738274696
14408,703-004-5394,2204.2905,2,2,0,1.0990693419954438
14410,703-004-5392,7545.079,1,1,0,0.46258530063414643
14458,207-008-2399,1144.759,7,5,2,2.019048177117267
14488,703-004-5384,3502.478,"","","",0.27920371738274696
14571,703-004-5386,4492.4746,2,2,0,0.7916137470254389
14581,703-004-5391,3111.6587,7,3,4,2.6837180760981716
14698,703-004-5397,4316.607,6,3,3,0.9881502440697948
14947,703-004-5391,9190.991,5,1,4,0.4789270905878653
15111,703-004-5390,6792.624,2,2,0,1.0537895934964308
15360,703-004-5397,2550.935,5,3,2,2.064857360484054
15367,703-004-5383,4683.2754,7,4,3,1.343533475453268
15476,703-004-5390,4916.2505,4,2,2,1.116371763305825
15529,703-004-5397,1885.0344,4,2,2,1.5359432427949915
15541,703-004-5387,73.091385,2,0,2,0.27920371738274696
15637,703-004-5387,4868.1587,6,3,3,0.9411667310020362
15754,703-004-5382,7230.3457,1,1,0,0.8518355128404729
16050,703-004-5390,1412.0078,2,1,1,0.5462103049075749
16095,703-004-5397,4126.417,4,1,3,0.4534830987397157
16299,703-004-5396,4879.663,4,3,1,3.2979364284932124
16501,703-004-5385,187.86014,3,2,1,0.5764897666254735
16645,703-004-5385,1681.9036,6,2,4,0.47813361442808233
1681,703-004-5383,2538.2937,7,3,4,0.6007969320624863
17200,703-004-5395,9089.353,3,2,1,0.5974214601754738
17219,703-004-5392,299.84595,2,1,1,0.5125141940332478
17547,703-004-5384,2883.7043,2,2,0,0.7070024863402132
182,703-004-5388,4019.8887,4,2,2,0.8063653773234325
18455,703-004-5389,357.50687,8,5,3,3.312459605353542
18611,703-004-5395,4094.6091,3,2,1,0.6700786789568303
18953,703-004-5385,2903.478,4,2,2,1.2686495945143468
19863,703-004-5395,6872.7817,5,2,3,0.6028679000903254
19940,703-004-5398,9866.677,2,0,2,0.27920371738274696
20266,703-004-5396,508.70538,5,2,3,0.45228481626889744
20310,703-004-5399,2698.6533,2,2,0,0.7686219667411804
20697,703-004-5396,6445.79,3,2,1,1.4322573266695615
20832,703-004-5394,7912.8735,4,2,2,1.2406012531236468
20843,703-004-5394,25.030972,5,2,3,0.5705970332970111
20991,703-004-5385,443.34888,4,3,1,0.6819746734481373
21,703-004-5394,5352.9907,6,4,2,1.5517417687221329
21099,703-004-5395,1219.5999,3,1,2,0.8322467735069066
21475,703-004-5398,3987.8982,7,6,1,2.9800693334953885
2158,703-004-5399,1919.1467,5,1,4,0.33853450732658075
21614,703-004-5381,1925.447,8,4,4,1.4578475893211376
21625,703-004-5396,3033.1897,2,0,2,0.27920371738274696
2166,703-004-5396,7439.155,1,1,0,0.8745576147344842
22131,703-004-5391,6362.2075,4,2,2,0.4895300335432206
22356,703-004-5394,9001.37,2,1,1,0.33853450732658075
22383,703-004-5390,7396.077,2,1,1,0.6604145714389789
22598,703-004-5387,3723.1135,8,5,3,1.708308483949513
22707,703-004-5384,6807.207,6,5,1,1.1131746457382365
22784,703-004-5384,8535.6,6,3,3,1.239323630048783
23010,703-004-5384,6441.0693,4,2,2,1.6569851518299457
2307,703-004-5395,5133.1387,2,1,1,0.35831143730785864
23251,703-004-5396,5816.828,3,1,2,0.9484517746087123
23266,207-008-2398,22.243858,5,4,1,1.8948973790602626
23359,703-004-5390,3889.689,7,5,2,1.5391016128209645
23578,703-004-5397,7768.243,3,0,3,0.27920371738274696
2372,703-004-5387,7864.545,2,2,0,1.4811695018455826
23890,703-004-5396,3089.224,5,2,3,0.688304794127494
23982,703-004-5384,8727.227,6,3,3,1.4284122972452709
24609,207-008-2398,4221.472,2,2,0,1.052791912661611
2469,703-004-5399,5241.8945,5,2,3,2.028295344230066
24996,703-004-5399,8215.567,7,5,2,1.219141851967586
25235,703-004-5392,7151.6045,3,1,2,1.2461403601704386
25276,703-004-5397,571.08997,4,3,1,0.9400188753691541
25315,207-008-2398,3552.7117,4,2,2,1.1692746037372028
25561,207-008-2398,4874.2856,3,1,2,0.31887058837376725
25600,703-004-5383,3219.043,3,2,1,0.9097917770870797
25951,703-004-5390,5810.3896,6,2,4,0.7600093990919065
25966,703-004-5392,1832.1729,3,2,1,1.6384992092124542
26877,703-004-5383,6886.204,3,3,0,0.7076022801737184
26903,703-004-5389,5513.098,4,2,2,0.6446162235456961
27104,703-004-5393,2136.9272,4,3,1,1.9880515509177308
27140,703-004-5395,3384.6272,"","","",0.27920371738274696
27165,703-004-5386,2316.003,2,1,1,0.3902511792276225
27180,207-008-2398,3910.8198,"","","",0.27920371738274696
27304,703-004-5396,2047.1967,2,0,2,0.27920371738274696
27359,703-004-5395,4020.0032,4,1,3,0.5253870611236798
27473,703-004-5385,7259.6323,2,0,2,0.27920371738274696
27511,703-004-5398,2021.7854,3,1,2,1.3649856679890446
27549,703-004-5391,1107.716,"","","",0.27920371738274696
27681,703-004-5387,9942.244,4,3,1,0.7585526102591069
27784,703-004-5385,504.1921,2,1,1,0.4180377658513179
27821,703-004-5393,3061.5735,6,5,1,1.3584125011351036
2822,703-004-5381,335.17838,3,2,1,1.4657719171764205
28223,207-008-2398,6976.3076,5,2,3,0.4883441339056989
28257,703-004-5381,1733.777,3,2,1,3.7666834974304595
28329,703-004-5393,6765.204,6,3,3,0.6178260468490748
28616,703-004-5393,8748.508,5,3,2,0.8536029758474072
28820,207-008-2398,5101.503,4,4,0,0.8100940925741722
29341,703-004-5388,7867.189,5,3,2,0.6389625772982884
29399,703-004-5384,1851.3566,6,2,4,0.4566316206710325
29919,703-004-5385,8566.41,6,3,3,1.1676885346694807
30161,703-004-5399,2542.849,3,2,1,0.5021886029216555
30274,207-008-2398,2668.5005,4,3,1,1.5114994965279416
30429,207-008-2399,4425.799,3,1,2,0.41757632737852945
3043,703-004-5398,4137.4824,7,4,3,1.2085449336625522
30577,703-004-5385,9491.327,5,1,4,0.614967989660107
30807,703-004-5384,3790.2993,2,0,2,0.27920371738274696
3102,703-004-5393,9719.1455,1,1,0,1.9150470037283363
3104,703-004-5393,8265.957,3,3,0,1.150418962029306
31088,207-008-2399,3848.741,3,2,1,0.43741915723297026
31207,703-004-5389,2840.9922,4,2,2,0.5313184254032696
31219,703-004-5398,9918.406,6,1,5,0.3682501995636531
31356,703-004-5380,7883.893,3,3,0,2.1573351596264936
31442,207-008-2399,5239.0273,8,3,5,2.9523720645103397
31578,703-004-5399,2312.885,4,3,1,0.8829235660582776
31834,703-004-5392,1625.2506,1,1,0,0.4422027021721919
31923,703-004-5399,1043.4777,5,1,4,0.671291346582489
32032,703-004-5391,6940.3887,6,3,3,1.4440304517768063
32453,703-004-5399,1949.19,2,0,2,0.27920371738274696
32551,703-004-5386,7341.473,3,1,2,0.6835262796761462
32572,703-004-5384,9602.413,2,1,1,0.3978652972704144
32756,703-004-5381,4593.043,2,1,1,1.1933669065817387
32810,703-004-5399,351.3533,3,2,1,0.8069527783310999
32968,703-004-5388,7571.466,2,2,0,1.1569996530182745
33140,703-004-5392,1826.868,3,1,2,0.42466444607829695
33150,703-004-5392,1927.8419,6,4,2,1.3479876963369901
33208,703-004-5383,2449.3582,7,4,3,1.0576920874775393
33276,207-008-2399,7865.6387,5,1,4,0.6469995721758003
33411,703-004-5397,2229.603,5,2,3,0.6491883424567186
33589,703-004-5398,6789.789,2,0,2,0.27920371738274696
33697,703-004-5384,6956.7188,6,5,1,2.194778926427064
33863,703-004-5395,6237.0303,4,1,3,0.4749248683873007
33913,703-004-5398,3113.9963,3,1,2,0.6559817666069884
34084,703-004-5384,3333.9507,6,4,2,1.0215309902397007
34194,703-004-5387,9334.5,3,1,2,0.33853450732658075
34228,703-004-5384,9166.269,4,3,1,2.287537068230049
34235,703-004-5388,1868.6873,5,4,1,0.7754371605772074
34522,703-004-5392,6089.2407,4,1,3,0.6099372333780216
34554,703-004-5392,6519.8755,5,3,2,1.2125183081481832
34736,703-004-5399,6705.949,3,1,2,0.35831143730785864
34988,703-004-5392,3622.647,7,5,2,1.4407595326091975
34994,703-004-5396,1264.6902,5,2,3,0.622591646161425
35412,703-004-5389,9191.937,4,2,2,0.6799770231627247
35510,703-004-5386,3142.9678,2,0,2,0.27920371738274696
35589,703-004-5397,3063.348,9,6,3,1.7027557378589222
35604,703-004-5399,6478.4854,5,2,3,1.1401841168829414
35779,703-004-5384,677.7519,4,0,4,0.27920371738274696
36004,703-004-5386,2590.887,"","","",0.27920371738274696
36121,703-004-5395,2295.583,2,2,0,1.4002780460317985
36365,703-004-5392,8392.885,5,3,2,2.1353972182364194
36578,207-008-2399,8067.599,5,3,2,0.829862879398875
36933,703-004-5389,9543.284,2,1,1,0.9004928283430035
37149,703-004-5384,6350.7207,2,2,0,0.6064829852342436
3725,703-004-5385,5626.6265,4,3,1,1.6841038775629324
3752,703-004-5389,591.48254,5,1,4,0.3889656787788394
37740,207-008-2399,2148.6675,7,0,7,0.27920371738274696
37749,703-004-5398,6757.05,9,4,5,1.8278431914731004
37962,703-004-5383,494.9069,2,1,1,0.3978652972704144
38004,207-008-2399,5071.946,4,0,4,0.27920371738274696
38057,703-004-5399,5633.572,3,2,1,0.925334011600658
38178,703-004-5388,313.93408,2,0,2,0.27920371738274696
38188,703-004-5393,7998.9985,3,0,3,0.27920371738274696
38254,703-004-5398,3967.0105,1,0,1,0.27920371738274696
38331,207-008-2399,9156.836,1,0,1,0.27920371738274696
38488,703-004-5395,3443.3853,4,3,1,1.5563286218630177
38730,703-004-5386,2936.5085,7,5,2,2.307053345663889
3886,703-004-5391,4133.7534,5,3,2,1.097876556041064
38866,703-004-5387,8751.663,5,3,2,1.316867888027212
39282,703-004-5393,5473.652,5,1,4,1.2712874526163012
39358,703-004-5388,2471.7576,7,6,1,1.5551204910371381
39386,703-004-5389,9209.426,2,2,0,0.7864819714025253
39460,703-004-5399,3633.9128,1,1,0,0.728900156638162
39510,207-008-2398,3330.1807,2,0,2,0.27920371738274696
39516,703-004-5399,7897.5796,4,3,1,0.7023337231528932
39585,703-004-5382,4336.406,6,3,3,0.7837824986865372
39926,703-004-5399,978.5229,2,2,0,0.5125844389479758
4031,703-004-5385,7854.886,3,2,1,0.6305020489537234
40347,703-004-5390,1751.1499,5,2,3,0.8414722698316008
40507,703-004-5397,1878.8784,2,1,1,0.8704101502254422
40533,703-004-5393,398.1292,3,2,1,0.793381363246825
40534,703-004-5396,3082.072,5,2,3,1.2517161523311084
40779,703-004-5386,104.32899,3,1,2,0.7713518318681111
41092,703-004-5397,6796.4185,4,3,1,1.250336622434159
41366,703-004-5385,3924.3638,5,1,4,0.8255760566681939
41470,703-004-5395,4809.437,3,1,2,1.570683473384648
41493,703-004-5397,942.713,4,0,4,0.27920371738274696
41509,703-004-5386,8467.471,7,1,6,1.1397051878948359
41613,703-004-5393,4056.3481,1,0,1,0.27920371738274696
4162,703-004-5389,669.0711,4,2,2,1.296736487743707
42006,703-004-5381,2082.7896,4,1,3,0.7034910818464636
42040,703-004-5389,255.02562,2,1,1,0.4281827135290317
42551,703-004-5390,1950.3772,3,2,1,0.592430585659979
42597,703-004-5395,6287.866,6,4,2,1.1270487818859154
42657,703-004-5388,160.84015,5,2,3,0.818479666132153
42806,703-004-5396,3281.6313,4,0,4,0.27920371738274696
43001,703-004-5382,5172.9746,6,1,5,0.5496888479191975
43004,703-004-5381,5417.1895,4,3,1,0.9630488515716786
43174,703-004-5394,6857.8164,4,3,1,0.7088489071840846
43226,703-004-5393,6172.2744,5,2,3,1.427048489756487
43296,703-004-5388,72.660446,5,3,2,0.8751341136855065
43679,703-004-5399,6679.743,7,4,3,3.1043236285808913
43683,703-004-5387,1077.134,4,1,3,0.41813410422148917
43764,703-004-5392,7439.6465,3,2,1,0.8078207785168254
43998,703-004-5397,2422.5486,4,2,2,1.041090825318694
44097,703-004-5396,7856.366,6,3,3,1.0780613122623226
44144,207-008-2399,7853.693,3,2,1,1.176268241750295
44510,703-004-5387,9555.243,3,2,1,0.776695654291885
44776,207-008-2398,8682.258,3,1,2,0.6846307819989441
44918,703-004-5382,9588.561,3,2,1,0.4718495852254324
45048,207-008-2399,6861.296,6,4,2,1.4311698660092105
45168,703-004-5394,3854.6897,3,0,3,0.27920371738274696
45285,703-004-5382,8438.105,1,0,1,0.27920371738274696
45458,703-004-5382,9536.909,4,3,1,0.7187974538130276
45839,703-004-5381,7777.313,7,2,5,1.5619519972644815
46259,703-004-5383,4706.202,4,2,2,1.134060061589294
46510,703-004-5382,6769.3022,5,3,2,0.6719278456347989
46842,703-004-5387,274.90735,4,1,3,0.5298013573005297
46989,703-004-5388,2713.951,7,4,3,1.0956346938078683
4710,703-004-5399,9063.627,3,2,1,1.3457128183841134
47304,207-008-2398,297.5923,1,0,1,0.27920371738274696
47337,703-004-5392,6170.28,2,0,2,0.27920371738274696
47371,703-004-5397,8846.507,3,2,1,1.1177218086357499
47964,703-004-5392,8394.042,3,1,2,0.3978652972704144
48757,703-004-5386,365.6316,10,7,3,1.6965247105929104
48954,703-004-5381,8692.909,2,1,1,1.2330449895460027
49341,703-004-5396,4989.9023,6,3,3,1.1088304565593694
49468,703-004-5384,940.2442,5,0,5,0.27920371738274696
49616,703-004-5381,7165.232,1,1,0,0.42043925020618733
49908,703-004-5397,2558.1968,1,0,1,0.27920371738274696
5281,703-004-5390,7991.2515,4,3,1,0.8748056315205363
5290,703-004-5384,6635.7573,4,3,1,3.0889881758965165
6020,703-004-5390,4848.5825,3,1,2,0.509627021503895
6105,703-004-5399,6354.9365,6,3,3,2.3021074206618626
6186,703-004-5385,3931.75,4,2,2,2.997079055785513
6400,703-004-5387,8300.947,4,3,1,0.9085660198291434
6602,703-004-5392,425.49313,3,1,2,0.6701045587782102
6722,703-004-5380,1864.4268,2,1,1,0.7629818920369785
6723,703-004-5381,5861.588,4,0,4,0.27920371738274696
7059,703-004-5393,9354.151,3,1,2,0.3187575773453028
7735,703-004-5388,7992.386,4,1,3,0.41943821970561723
831,703-004-5390,7212.0386,3,1,2,0.7857156369013356
8318,703-004-5390,9528.916,3,1,2,0.4398418311556768
8346,703-004-5392,8901.831,4,1,3,0.344918747536162
8369,703-004-5387,4491.116,5,3,2,2.253401723836018
8685,703-004-5381,8899.878,5,3,2,0.8845245143163609
9160,703-004-5382,4203.298,3,0,3,0.27920371738274696
9232,703-004-5394,8286.54,6,4,2,1.9729152357327064
939,703-004-5395,9105.4795,1,1,0,1.0189110349596073
9416,703-004-5384,2213.04,5,4,1,1.201875850848682
9607,703-004-5397,8566.837,6,6,0,1.456112548582334
9805,703-004-5383,5369.7993,7,4,3,2.203199832640315
9809,207-008-2399,617.11847,5,4,1,1.4049309101556118
9816,703-004-5384,2695.757,3,0,3,0.27920371738274696
9886,703-004-5394,3392.6875,7,4,3,2.0126443975488852
9923,703-004-5390,4901.793,3,1,2,0.7668948126402001
10030,703-004-5391,7667.087,1,0,1,0.27920371738274696
10307,703-004-5381,523.8247,2,2,0,0.5406581547006454
10326,703-004-5397,5356.705,7,2,5,0.7327819613474245
10859,703-004-5392,7859.888,3,0,3,0.27920371738274696
10927,703-004-5392,271.36386,3,2,1,1.1234469554096727
10968,703-004-5384,3183.75,4,2,2,0.730476565356855
11189,703-004-5388,2320.131,4,2,2,0.7894717363125747
11191,703-004-5396,1723.1041,4,1,3,0.4369606083848485
11402,703-004-5393,4740.371,2,2,0,1.0521043779103467
11403,703-004-5398,536.95264,3,0,3,0.27920371738274696
11498,703-004-5390,5714.036,5,1,4,0.3978652972704144
11587,703-004-5386,9090.042,4,2,2,1.1291444723448547
11596,207-008-2398,1768.0645,4,1,3,0.3897748848305734
11781,703-004-5392,4377.243,2,0,2,0.27920371738274696
12198,703-004-5381,1168.0192,5,5,0,1.2630616419357676
12236,703-004-5389,7643.624,4,2,2,0.9440325195275954
12553,703-004-5394,3446.628,6,2,4,0.7000809609529093
12777,703-004-5383,8694.443,5,3,2,1.1686171824983211
1279,703-004-5382,6519.664,2,1,1,0.39209683221196123
13373,703-004-5392,2191.8904,5,1,4,0.47494606329679057
13499,703-004-5381,4797.536,1,0,1,0.27920371738274696
13601,703-004-5391,4450.973,1,0,1,0.27920371738274696
13695,703-004-5394,2845.4238,3,0,3,0.27920371738274696
137,703-004-5392,4188.9824,4,2,2,0.7745403095924438
14134,703-004-5389,5109.0054,4,4,0,1.2101169193691064
14166,703-004-5383,5454.5615,4,0,4,0.27920371738274696
14413,703-004-5387,384.4303,4,2,2,1.0894815227401966
14880,703-004-5398,6754.6855,5,4,1,2.3891371735161258
14910,703-004-5382,1070.2354,2,0,2,0.27920371738274696
15342,703-004-5393,9800.111,7,3,4,1.9444155245395316
15373,703-004-5384,3492.32,5,2,3,2.0852842114978847
15630,703-004-5392,2906.1436,6,3,3,2.624221210226102
15975,703-004-5396,3842.4827,5,3,2,1.2192341223763552
16038,703-004-5389,3955.0674,8,2,6,0.9661292747294171
16140,703-004-5398,6274.7783,5,4,1,0.8177385098339752
1618,703-004-5389,1684.4928,5,1,4,0.3978652972704144
16249,703-004-5399,2192.728,"","","",0.27920371738274696
16252,207-008-2399,663.44855,6,3,3,0.6301237088833564
16378,703-004-5395,6034.8047,2,2,0,0.9803678508584347
16559,703-004-5381,2616.1797,7,4,3,1.5931083686587224
16699,703-004-5383,5817.6304,4,3,1,1.3700474475512099
16915,703-004-5395,1320.3496,6,4,2,1.5251743287190873
17129,703-004-5386,8900.045,5,2,3,0.9990397064410159
17281,703-004-5388,3421.5503,5,3,2,1.2211265341034727
17302,703-004-5399,3611.068,4,3,1,1.4227519473616177
17420,703-004-5390,5519.5796,8,5,3,2.6425026839848504
17456,703-004-5383,428.59436,6,2,4,1.1381424512734937
17490,703-004-5399,3327.1719,3,2,1,3.560127460315095
17868,703-004-5397,8512.613,1,1,0,0.36023661478492536
18050,703-004-5381,7537.8354,2,1,1,0.4561164709111534
18374,703-004-5381,7883.4297,2,0,2,0.27920371738274696
18578,703-004-5382,7882.99,5,3,2,1.0389596535992758
18701,703-004-5390,7371.3096,6,4,2,1.0594516751870842
18973,703-004-5397,5283.5625,9,4,5,2.5398109902364627
19068,703-004-5386,2641.8281,5,4,1,1.6911227077338593
19188,703-004-5383,8285.084,4,2,2,0.6657199550995356
19203,703-004-5388,3150.7952,7,3,4,0.8265756455838352
19210,703-004-5395,6458.2407,3,1,2,0.7890467414065553
19899,703-004-5387,429.37158,1,1,0,0.3978652972704144
20031,703-004-5392,1442.1934,"","","",0.27920371738274696
20055,703-004-5397,9380.195,1,0,1,0.27920371738274696
20108,207-008-2398,6840.461,5,2,3,0.682810290873005
20260,703-004-5392,8178.5176,3,1,2,0.6220881556149991
20486,207-008-2398,8179.311,2,0,2,0.27920371738274696
21208,703-004-5385,1351.0096,6,2,4,1.2236525966820702
21233,703-004-5396,1646.834,2,2,0,1.550053847338776
21746,703-004-5386,7559.614,2,1,1,0.5223314678446608
21789,703-004-5390,5479.3896,8,5,3,1.9082436998615933
21854,703-004-5388,7204.9717,2,0,2,0.27920371738274696
21937,703-004-5390,822.91187,6,3,3,1.2274899539475668
2196,703-004-5383,9764.423,9,6,3,1.3386933210891152
21969,703-004-5396,8908.913,2,1,1,0.3978652972704144
22036,703-004-5396,9626.571,1,1,0,0.5894617330469776
23150,703-004-5384,3505.5984,10,6,4,2.9471993637081577
23209,703-004-5391,3168.2522,8,2,6,0.9307071289498999
23256,703-004-5383,9303.067,4,1,3,0.33853450732658075
23527,703-004-5392,3872.6694,8,4,4,4.053767723448643
23904,703-004-5398,1587.6865,5,1,4,0.5323484211431042
2411,703-004-5396,3117.1792,3,1,2,0.3860872871481011
24235,703-004-5383,4575.574,5,1,4,0.4817900714910437
24501,703-004-5396,5943.128,9,7,2,2.008432702406545
24530,703-004-5385,9551.776,1,1,0,1.309889405561622
2466,703-004-5384,5673.7334,6,1,5,0.73010854832958
24734,703-004-5386,3274.9373,4,1,3,0.41270136440497823
24838,703-004-5395,2191.4966,1,0,1,0.27920371738274696
24851,703-004-5382,8801.352,3,1,2,0.7940008827412944
25061,703-004-5395,5994.9126,5,3,2,1.066293398540355
25487,703-004-5382,9778.399,7,5,2,4.0618385753308415
25507,703-004-5388,2548.7888,5,3,2,1.278324307829742
25575,703-004-5387,6216.6978,2,1,1,2.1777903565939782
25693,703-004-5395,2985.9602,1,1,0,0.5577382579130835
25907,703-004-5397,6578.1284,2,1,1,0.8608518942428143
25959,207-008-2399,8611.84,4,2,2,0.43445261773577853
26235,703-004-5391,7472.806,5,3,2,1.3487235913713822
26290,703-004-5397,3175.2354,5,4,1,0.7838938325590723
26566,703-004-5391,796.0099,3,1,2,0.4720274780401501
2730,703-004-5382,4487.9414,5,2,3,0.5115826446627625
27314,703-004-5399,828.56415,2,2,0,1.2549994474939283
27678,703-004-5382,3164.8003,3,1,2,0.3587761951624187
27811,703-004-5381,6559.378,4,1,3,0.35831143730785864
27854,703-004-5382,7617.4136,7,4,3,2.003482264903254
28405,703-004-5391,5836.2817,4,2,2,1.8542688708860628
28562,703-004-5389,6730.7217,7,3,4,1.2421635750183573
28862,207-008-2398,8450.648,5,3,2,1.7249887469668619
29060,703-004-5387,9487.695,5,4,1,1.1216212092052122
29142,703-004-5395,9385.809,5,1,4,0.3401166617250829
29200,207-008-2398,7672.1294,6,3,3,0.8793212410287983
29645,703-004-5394,3673.4766,2,1,1,0.44829646872267315
29802,703-004-5384,7871.971,2,1,1,0.6827845593766243
29809,703-004-5381,5947.889,7,4,3,1.8093627390451803
29940,703-004-5399,9433.726,6,4,2,1.9006269094907664
30055,703-004-5388,7275.506,5,2,3,0.5685380631393832
30101,703-004-5397,8572.822,5,3,2,1.6466473031112614
30344,703-004-5387,7932.1875,2,1,1,0.6071772384941234
30355,703-004-5385,7951.9624,3,3,0,0.8978001473540307
30860,703-004-5393,8813.064,5,2,3,1.4851323236359706
30905,703-004-5396,5758.087,4,2,2,0.6037536234200666
31076,703-004-5394,448.122,1,1,0,0.7598644395663575
31108,207-008-2398,5387.829,2,1,1,0.4305166378520671
31121,703-004-5395,1264.317,3,3,0,0.8662453147140707
3136,703-004-5390,8162.9326,2,1,1,0.4561164709111534
31369,703-004-5380,204.51486,6,4,2,1.6986620549172942
31409,703-004-5382,1830.6345,"","","",0.27920371738274696
31443,703-004-5385,468.3,5,3,2,1.5797048222600987
31473,703-004-5382,2081.8948,3,1,2,0.4395830829884218
32007,703-004-5393,2777.3494,4,1,3,0.6579125737673662
3203,703-004-5399,5478.756,8,7,1,2.211347615776634
32296,703-004-5399,9960.363,5,1,4,0.5532788632266057
32337,703-004-5392,6249.4897,4,1,3,0.6593773828850114
3260,703-004-5382,1428.3347,3,1,2,0.5603489286525104
32761,207-008-2399,4153.0405,6,4,2,3.058773835200584
32979,703-004-5380,2262.2395,5,1,4,0.623010568037715
3298,703-004-5390,6282.962,6,1,5,0.5716380332561454
33112,703-004-5389,3611.9348,1,0,1,0.27920371738274696
33373,703-004-5384,7969.8633,1,1,0,0.7874794464919891
33656,703-004-5384,597.8292,4,3,1,0.8537279220752176
33683,703-004-5393,4879.324,2,1,1,0.4655015127014745
33771,703-004-5391,1912.8842,3,0,3,0.27920371738274696
33825,703-004-5391,68.45057,1,0,1,0.27920371738274696
34090,703-004-5390,7187.454,3,2,1,1.4567713254808539
34207,703-004-5380,8776.298,7,2,5,1.1143618964439892
34516,703-004-5391,8576.42,4,2,2,0.7354189823264407
34563,703-004-5398,4870.772,2,2,0,0.9605705565081012
34572,703-004-5382,1690.4766,"","","",0.27920371738274696
35079,703-004-5380,3854.6736,7,4,3,1.2125962437935152
35270,703-004-5388,523.1321,3,1,2,2.1961254315479617
35464,703-004-5382,1333.9645,5,3,2,0.704111058030503
35626,703-004-5384,6605.024,4,2,2,0.9076829262605539
35984,703-004-5398,7414.0854,2,1,1,0.8647897688040429
36371,703-004-5396,8485.884,3,3,0,0.8897052269099502
37082,703-004-5395,6429.4414,9,5,4,0.8952456120052341
37250,703-004-5380,1893.8899,5,5,0,2.879132706792919
37441,703-004-5384,9615.122,5,2,3,1.2334659389709646
37554,703-004-5389,659.35254,3,2,1,0.8035289983638338
3762,703-004-5389,4357.036,4,2,2,0.5165268771580819
37705,703-004-5394,2197.398,3,1,2,1.2364918873222488
37756,703-004-5380,8400.021,7,7,0,2.167944510645501
37821,703-004-5398,1726.8843,4,0,4,0.27920371738274696
38135,703-004-5391,1846.2396,6,3,3,0.8318815846300024
3829,703-004-5380,2700.0671,5,2,3,0.9291077506628712
38606,703-004-5387,6183.5005,2,1,1,0.3978652972704144
38797,703-004-5394,4561.646,4,2,2,1.0138135150808667
38836,703-004-5388,5842.595,4,2,2,1.3409051469798463
3938,703-004-5385,3257.8748,1,1,0,0.4554203136236768
39502,703-004-5387,8955.642,2,1,1,0.6870948554542843
39552,703-004-5382,9146.94,3,2,1,0.7713089787622898
39557,703-004-5389,873.98706,5,2,3,0.43547794477361995
39672,703-004-5390,3444.8105,5,1,4,0.5165268771580819
39935,703-004-5395,9628.092,6,2,4,1.0613634096574325
40432,703-004-5395,7383.489,5,1,4,0.6131887292861672
40600,703-004-5397,7176.0186,1,1,0,0.35831143730785864
41066,703-004-5390,9726.723,3,1,2,0.3919322182760311
41308,703-004-5388,4755.4033,4,3,1,1.2888383789732933
41427,703-004-5386,2546.3044,3,1,2,0.6150192145447271
41572,703-004-5382,9402.709,3,1,2,0.33853450732658075
41795,703-004-5381,6864.2964,4,2,2,0.9650299293854968
41903,703-004-5391,6916.9414,4,1,3,0.4360174673205472
42012,207-008-2398,3395.908,5,2,3,0.636878306674851
42067,703-004-5390,3175.2593,4,1,3,0.9132385175167833
42245,703-004-5382,3467.6404,1,1,0,0.6936468488634937
4233,703-004-5385,7085.0723,1,1,0,0.9998119232026099
42556,703-004-5381,7234.858,2,1,1,0.8703914894217248
42946,703-004-5390,7546.598,6,2,4,0.8251919215412169
43193,703-004-5399,5049.2,5,3,2,1.2659524449104882
43315,703-004-5396,2351.176,"","","",0.27920371738274696
44663,207-008-2399,7677.4644,2,0,2,0.27920371738274696
45336,207-008-2399,8916.458,5,3,2,1.2996098834034502
45407,703-004-5386,9553.819,8,7,1,2.107555583206681
45572,207-008-2399,1438.9294,2,0,2,0.27920371738274696
45678,703-004-5395,6715.366,5,1,4,0.820680637911962
45781,703-004-5386,5634.278,5,2,3,1.2998065151458522
45997,703-004-5395,8328.908,3,0,3,0.27920371738274696
46507,703-004-5386,3423.2063,2,1,1,0.3271627725873459
46576,703-004-5396,7859.2383,5,1,4,1.2539884110615298
46667,703-004-5385,2349.9639,2,1,1,1.4954626791374122
46891,703-004-5388,9675.005,2,0,2,0.27920371738274696
469,207-008-2399,6605.978,4,3,1,1.7047182468434094
46918,703-004-5390,77.70479,8,4,4,0.9748005974345377
47742,703-004-5388,444.64468,4,1,3,1.1309593727157308
47821,703-004-5384,9015.505,4,4,0,1.067707843773769
47900,207-008-2399,2149.2612,3,0,3,0.27920371738274696
48144,703-004-5386,9561.537,7,6,1,3.5975060606857157
48536,703-004-5398,7624.055,5,1,4,2.7704696708143413
4857,703-004-5396,3249.2786,2,0,2,0.27920371738274696
48580,703-004-5391,6475.8677,6,4,2,2.3457995655355197
48681,207-008-2398,662.01746,3,1,2,0.6507374855675198
48893,703-004-5396,9151.694,"","","",0.27920371738274696
49187,703-004-5381,5582.9243,4,2,2,0.8118886422369
49408,703-004-5393,8782.49,3,1,2,0.545038196929883
49501,703-004-5394,8770.506,8,4,4,3.014938793642202
49512,703-004-5391,6478.0166,1,1,0,0.5607328289741073
49719,703-004-5393,5204.227,5,2,3,0.49188705261536325
49974,703-004-5399,828.58563,5,3,2,1.0970820559183354
5126,207-008-2398,6907.592,5,5,0,4.786814548147911
5171,703-004-5381,8291.827,1,0,1,0.27920371738274696
5319,703-004-5388,3138.504,4,3,1,1.0488057637741623
5335,703-004-5380,8131.2715,5,0,5,0.27920371738274696
5548,703-004-5390,676.4418,2,1,1,0.3187575773453028
583,703-004-5390,2345.258,6,4,2,0.905701134892451
5844,703-004-5396,8165.676,4,3,1,1.8761448725224552
5900,703-004-5398,8206.335,2,1,1,0.35534489781066697
5994,703-004-5398,4318.1855,2,2,0,0.431171552948494
6123,703-004-5396,907.23035,1,0,1,0.27920371738274696
6563,703-004-5385,9700.356,6,2,4,2.0279257118189276
6636,703-004-5397,8488.938,4,1,3,0.4080549618718091
72,703-004-5384,9038.3955,6,4,2,1.866623369573935
74,703-004-5385,2367.09,5,4,1,0.6294168934132474
7453,703-004-5396,8886.336,4,3,1,1.0748167690421728
7568,703-004-5397,5426.336,7,4,3,1.670649433340568
7631,703-004-5389,4285.2124,6,4,2,0.8814957467627649
767,703-004-5394,7795.014,10,5,5,2.4364728579378307
7686,703-004-5398,5721.2246,7,2,5,0.9599480105630851
7897,703-004-5397,985.99554,4,1,3,0.35831143730785864
8230,703-004-5393,7245.704,6,0,6,0.27920371738274696
8401,703-004-5393,3049.0823,3,1,2,0.427686080080102
8520,703-004-5394,4547.5293,7,3,4,0.9749651477987669
8830,703-004-5380,4047.565,6,3,3,0.9309486540615067
9022,703-004-5393,94.5127,4,2,2,0.5782927147175186
9392,703-004-5384,8188.2734,8,5,3,1.6304205081430159
9703,207-008-2399,2318.8157,6,1,5,0.5264283142466679
9806,703-004-5399,2482.636,1,1,0,0.5551882285602469
10220,703-004-5399,6839.1807,2,0,2,0.27920371738274696
10268,703-004-5390,8543.945,7,1,6,1.13199346211923
1030,703-004-5396,3178.7456,3,1,2,0.7389414185218878
10522,703-004-5384,1361.7933,1,0,1,0.27920371738274696
10528,703-004-5391,2729.9363,2,2,0,1.1639377275191904
1071,703-004-5398,8315.907,3,1,2,0.5489039920632
11046,207-008-2399,8700.831,8,6,2,3.156867741058358
11119,703-004-5395,9255.04,4,1,3,0.44779035589488436
11183,207-008-2398,2246.8025,2,0,2,0.27920371738274696
11230,703-004-5389,3802.181,7,1,6,0.9905747757928974
11289,703-004-5394,751.05133,4,2,2,0.7307852955303124
11595,703-004-5388,7495.23,8,4,4,0.9052423249677566
11615,703-004-5380,7882.021,3,2,1,0.8588655483529577
11850,703-004-5386,7705.9766,6,3,3,2.712631117149245
11880,207-008-2399,9530.379,3,0,3,0.27920371738274696
12112,703-004-5381,5940.3574,5,2,3,0.7522117637929271
12184,703-004-5399,3111.5098,5,2,3,0.7477726970617482
12389,703-004-5393,2539.9768,2,1,1,0.48394108885892967
12652,703-004-5383,5929.545,5,2,3,1.1732190755727672
12837,703-004-5382,986.5838,2,1,1,0.6668535511917031
13382,703-004-5396,1546.2786,3,0,3,0.27920371738274696
13957,703-004-5398,1432.5381,3,0,3,0.27920371738274696
13992,703-004-5393,7527.9253,3,1,2,0.6910288446317948
14961,703-004-5386,6740.183,4,2,2,1.3581987017348933
14978,703-004-5380,7906.5474,3,1,2,0.3919322182760311
15177,703-004-5398,3650.8423,5,3,2,1.2465453038477095
15321,207-008-2398,5090.1987,5,1,4,1.1682174552175122
15383,703-004-5382,608.76843,3,2,1,0.8519479325478336
15389,703-004-5384,9540.455,4,2,2,1.2380873104708043
15390,703-004-5395,8569.8,4,0,4,0.27920371738274696
15643,703-004-5388,3388.7607,4,2,2,0.7734214354639725
15752,703-004-5386,2443.037,3,2,1,1.4859391671696849
15819,703-004-5384,8907.784,7,0,7,0.27920371738274696
15878,207-008-2398,5565.5986,6,5,1,1.5142415532476663
1607,703-004-5396,5772.44,3,0,3,0.27920371738274696
16195,703-004-5396,1276.8972,4,2,2,0.43592798554136847
16222,703-004-5390,9353.669,4,2,2,0.6008426880192932
16343,703-004-5383,851.1895,6,3,3,2.2323065183844975
16433,703-004-5392,8751.341,7,3,4,1.4235745600095993
16470,703-004-5393,114.71093,3,1,2,0.535420928895925
16540,703-004-5394,6921.151,4,2,2,0.5906244414879365
16780,703-004-5398,6824.7725,4,2,2,0.851970578392757
16922,703-004-5397,7234.8804,3,2,1,0.6861345084144029
16931,703-004-5398,6589.6123,4,1,3,0.35831143730785864
17122,703-004-5396,7250.6577,3,3,0,0.8478815840479954
17601,703-004-5386,6967.935,1,1,0,0.9647584212786138
17936,703-004-5395,6238.4727,3,0,3,0.27920371738274696
17971,703-004-5383,7216.9243,4,3,1,1.0414588586475912
18061,703-004-5390,6255.042,2,1,1,0.6633361403759463
18070,703-004-5395,1217.8976,5,1,4,0.4780252569884144
18232,207-008-2398,3951.674,4,3,1,1.6620119409514906
18356,703-004-5391,4666.664,4,2,2,0.6355791435303564
18405,703-004-5388,3811.1335,6,4,2,2.134361739720317
18548,703-004-5396,5684.1094,5,1,4,0.4831196935418044
18675,703-004-5390,5860.688,5,1,4,0.9708583926293105
1898,703-004-5384,9188.355,1,1,0,0.39002674349778016
19001,207-008-2399,1814.5948,7,5,2,2.639121861897039
19540,703-004-5392,9327.88,7,3,4,2.180178980288699
20234,703-004-5393,6963.47,"","","",0.27920371738274696
20298,703-004-5381,3812.886,6,2,4,1.382648454524969
20316,703-004-5391,3021.6467,3,2,1,0.7150358509652603
20438,703-004-5398,9675.353,2,0,2,0.27920371738274696
20521,703-004-5398,9288.621,4,3,1,2.0464394370925114
20530,703-004-5399,6152.106,5,2,3,0.8662180206288852
20588,207-008-2398,6023.436,4,4,0,5.095494021044073
20820,703-004-5389,1186.9669,3,2,1,0.8007995964874554
20882,703-004-5396,3467.743,5,4,1,1.3380859657644641
2091,703-004-5384,5147.8994,4,2,2,0.7379906845624714
21380,703-004-5397,5319.996,7,1,6,0.6074154606537197
21819,703-004-5388,3222.9011,4,1,3,0.3978652972704144
21945,703-004-5399,7869.362,1,1,0,0.49549689325377144
22057,703-004-5387,449.05484,3,3,0,0.9463108548841574
22152,207-008-2399,8149.177,7,2,5,0.5989714475599236
22229,703-004-5391,3093.2463,3,1,2,0.5062256034026554
22295,703-004-5380,3568.1326,7,3,4,4.571536697128301
22402,703-004-5384,5824.731,4,3,1,1.0498396741713774
22632,703-004-5392,7770.219,2,1,1,1.052981681371154
22667,703-004-5396,2128.6536,3,1,2,0.38114674590492886
22854,703-004-5387,1152.8135,5,4,1,1.2646167368360741
22978,207-008-2399,4829.676,3,2,1,0.9280617555163013
23670,207-008-2398,8133.6924,2,2,0,0.6028905672846058
24144,703-004-5389,3578.019,5,3,2,1.290177672388162
24376,703-004-5384,4399.9297,4,2,2,1.1934484838446295
24621,703-004-5380,4391.9766,5,2,3,0.7365828176038702
24762,703-004-5392,4399.5913,3,2,1,0.41362898653378766
24910,703-004-5386,3653.122,3,3,0,0.7479462497697723
25056,703-004-5383,6874.2563,3,1,2,1.3114993314901313
25063,703-004-5386,4350.8687,4,1,3,0.9109907319648974
25248,703-004-5399,381.72067,2,1,1,0.8362786278676424
25814,703-004-5388,173.47633,4,2,2,0.9063078296733346
26035,703-004-5395,9958.058,6,3,3,1.492822524560551
26224,703-004-5391,5638.5083,4,1,3,0.49422658741478165
26373,207-008-2399,8939.546,3,1,2,0.8058531795711152
2638,703-004-5388,5475.042,3,1,2,0.4730976611043934
26682,703-004-5399,5342.999,2,1,1,0.6977702498675501
2741,703-004-5399,2955.2734,6,3,3,2.5078178601429926
27600,703-004-5398,7115.7793,3,1,2,0.39657116849562796
27858,207-008-2399,7977.552,6,3,3,0.8341565003225546
27970,703-004-5387,407.04788,1,1,0,0.3978652972704144
28192,703-004-5392,5967.994,1,0,1,0.27920371738274696
28753,703-004-5396,2388.9893,1,0,1,0.27920371738274696
29236,703-004-5382,1864.6044,4,1,3,0.7316410082690453
29336,703-004-5383,3169.9895,1,1,0,0.450271036803435
29381,703-004-5380,4888.6494,4,2,2,1.4086330855850413
29583,703-004-5380,8037.503,3,1,2,0.37175974969512765
29612,703-004-5395,173.64442,4,2,2,0.5553267416651014
300,207-008-2399,6672.0737,3,1,2,0.4932600334496528
30077,703-004-5395,467.56744,1,1,0,0.44594026725907027
30410,703-004-5393,3755.0808,2,2,0,0.5032755117547804
30448,703-004-5398,6240.5513,1,0,1,0.27920371738274696
30475,703-004-5384,2185.8525,3,2,1,1.4667818494542793
30803,703-004-5396,5405.202,3,1,2,1.0943867746938873
30951,703-004-5396,3033.0305,7,3,4,1.3230998679505563
31270,703-004-5390,814.7806,1,1,0,1.2426096859493172
31277,703-004-5385,7786.017,4,3,1,1.2059908018120669
31359,703-004-5399,661.2998,4,2,2,0.8510270749996179
31360,703-004-5389,7755.9595,1,0,1,0.27920371738274696
31428,703-004-5396,6875.0513,6,4,2,1.9116617049260338
31598,703-004-5385,7044.4165,3,0,3,0.27920371738274696
31835,703-004-5390,7388.8477,7,2,5,1.722590487143392
32223,703-004-5392,3179.4644,6,4,2,1.7497130193032568
32380,703-004-5390,8012.3438,5,4,1,1.731173698202952
32914,703-004-5396,5823.2437,2,1,1,0.38941065970341815
33133,703-004-5394,2232.6929,5,1,4,0.5165268771580819
33144,703-004-5398,8568.648,7,4,3,1.8718302709276913
33163,703-004-5386,3103.2915,10,5,5,1.7231398229315662
33238,703-004-5394,5476.323,7,5,2,1.0140125000911488
33388,703-004-5387,4601.8003,4,3,1,1.192866842452889
33464,703-004-5380,3907.6406,2,1,1,1.3741199697003519
33527,703-004-5380,5120.066,2,1,1,0.533168996722038
3372,703-004-5383,7547.85,2,1,1,0.3978652972704144
33803,703-004-5385,2793.7227,4,3,1,1.251050558460639
33817,703-004-5399,6309.379,3,2,1,0.5244590503623189
3393,703-004-5389,663.1142,6,3,3,0.80441830476044
34018,703-004-5391,9091.134,4,2,2,0.6708227376359149
34196,207-008-2398,1636.2119,2,1,1,0.4753287575941594
34271,703-004-5381,7060.564,3,1,2,0.3919550190720685
34328,703-004-5391,1028.5247,5,3,2,2.1415842484281824
34863,703-004-5385,5976.143,2,1,1,0.3927664851911464
34892,703-004-5385,794.39996,7,3,4,1.0743907316264496
35030,703-004-5398,730.91565,4,4,0,0.8411251408478746
35239,703-004-5399,1737.1094,5,3,2,0.6815311208377035
35314,703-004-5398,6083.5464,3,1,2,0.47887764728512744
35341,703-004-5382,8745.225,3,2,1,1.0248701053472518
35441,703-004-5389,4426.878,"","","",0.27920371738274696
3558,703-004-5383,5377.5596,6,4,2,1.1037340277030163
35586,703-004-5392,6310.4062,1,1,0,1.3314016622236993
35850,703-004-5381,1699.1234,1,1,0,0.32666834933781397
35939,703-004-5384,6171.7383,1,0,1,0.27920371738274696
36126,703-004-5385,3458.6633,4,2,2,0.8511235967784245
36131,703-004-5399,7869.8613,3,1,2,0.8215227446648511
36169,207-008-2398,5441.0728,1,0,1,0.27920371738274696
3633,703-004-5390,1721.4716,6,3,3,1.4181736423735845
36336,703-004-5394,1963.6912,4,3,1,1.1929565038103673
36597,703-004-5380,6634.1416,4,3,1,0.9496470140120942
37083,703-004-5387,9280.57,4,2,2,1.6610391646881637
37234,703-004-5397,6693.319,2,0,2,0.27920371738274696
3738,703-004-5394,6089.7964,9,4,5,1.235512408088766
37549,207-008-2399,1865.5675,2,1,1,0.7901159304127559
37565,703-004-5383,4403.932,7,4,3,1.2872225226137377
37789,703-004-5394,9854.886,5,1,4,1.046349586439295
38276,703-004-5389,1419.1747,5,2,3,0.7445748755563966
38563,703-004-5397,5692.7026,5,1,4,0.40125848283001475
38587,703-004-5388,2825.6775,8,4,4,1.0455858185845859
38789,703-004-5398,2071.7954,7,3,4,0.5864416572392379
38865,703-004-5390,2794.295,3,1,2,0.35831143730785864
39069,703-004-5395,2585.7634,2,1,1,0.43915581889695127
39147,207-008-2398,5314.7935,3,2,1,0.5105087940868233
39344,703-004-5394,1064.3822,7,1,6,0.45174218675253625
39507,703-004-5393,2868.0146,5,1,4,0.7178118802686243
4013,703-004-5396,4673.78,4,4,0,1.8831920476393578
40150,703-004-5399,7210.865,4,2,2,0.8323612979736597
40233,703-004-5383,7212.6133,8,3,5,0.7434966708358645
40599,703-004-5384,7392.2114,3,3,0,0.8723306607617841
4125,703-004-5382,6411.718,4,2,2,0.4344938196732395
41257,703-004-5388,6363.5625,7,0,7,0.27920371738274696
41808,703-004-5396,9139.54,2,0,2,0.27920371738274696
42114,207-008-2399,5658.299,7,3,4,2.6943736328697154
42716,703-004-5386,3512.4707,5,1,4,0.4426795432940417
42753,703-004-5392,1303.4279,3,2,1,1.6661951737435536
4279,703-004-5398,7359.5103,7,4,3,0.6120686008380842
42793,703-004-5391,4984.919,3,1,2,0.48712917117384913
42877,703-004-5394,23.290516,3,1,2,0.39942348473079525
4297,703-004-5387,298.66516,4,4,0,1.6609343869076443
43,703-004-5383,847.6561,8,7,1,2.400767848969038
43032,703-004-5381,5345.7124,6,2,4,1.3190957314547793
43131,703-004-5392,805.974,7,4,3,2.0178270769267566
43430,703-004-5392,8464.405,2,1,1,0.5165268771580819
43436,703-004-5391,1038.7892,2,1,1,0.9579685900289007
43523,703-004-5382,2704.5142,8,3,5,1.739820823894864
43578,703-004-5385,3998.9656,4,0,4,0.27920371738274696
43605,703-004-5384,2188.5503,4,1,3,0.5329935434402889
43763,703-004-5393,6409.3916,3,2,1,1.2384689504732584
43913,207-008-2399,6146.535,5,2,3,3.560817339552058
44250,703-004-5396,2391.1428,3,1,2,0.7951271701374271
44307,703-004-5396,2945.649,"","","",0.27920371738274696
44390,703-004-5385,5700.8613,3,1,2,0.35770033017143715
45232,703-004-5399,7190.6274,3,1,2,2.285526729375864
45309,703-004-5395,1605.1758,6,0,6,0.27920371738274696
45384,703-004-5380,2890.9338,6,2,4,1.2169552273515751
45659,703-004-5393,6437.672,6,3,3,0.9792724976197215
4575,703-004-5383,1221.4487,5,2,3,0.853518827666599
45769,703-004-5384,2653.68,3,2,1,1.2711417167207812
45771,703-004-5385,6787.2124,6,3,3,1.5146983085668266
45956,703-004-5397,6655.26,4,3,1,2.1983272832078242
46239,703-004-5388,7138.498,1,1,0,0.3978652972704144
46335,207-008-2398,5225.596,3,1,2,0.8942003167005523
46829,703-004-5391,4513.2686,5,0,5,0.27920371738274696
4721,703-004-5399,3104.337,3,0,3,0.27920371738274696
47221,703-004-5382,5168.7695,4,3,1,0.7214591687180327
47299,703-004-5397,995.08527,3,3,0,1.9351360913206352
47362,207-008-2398,2611.2515,3,2,1,0.5823818366689233
47509,703-004-5389,8536.869,7,4,3,1.1191043106288652
48026,703-004-5394,9727.655,3,1,2,0.5165268771580819
48456,703-004-5385,308.3843,2,1,1,0.36330026154103034
48673,207-008-2398,5167.4263,3,1,2,0.33853450732658075
48820,207-008-2399,3345.8389,7,4,3,1.013068724779805
48969,703-004-5399,8814.388,8,4,4,1.2118596222298097
49316,703-004-5384,6623.451,5,2,3,1.6911592471062775
49356,703-004-5398,2926.3,5,4,1,1.8471005008985208
49440,703-004-5396,4514.214,3,2,1,0.6833489896393038
49569,703-004-5388,426.6852,3,2,1,0.969082655761652
49631,703-004-5393,1485.2196,2,1,1,0.5299868399515195
49865,703-004-5386,9769.741,4,2,2,0.5207260688488617
503,703-004-5382,8720.234,5,2,3,0.5398900954745202
5376,207-008-2398,2912.9458,1,0,1,0.27920371738274696
5723,703-004-5394,5932.8687,4,2,2,0.8983595425309914
5788,207-008-2398,7623.1543,1,0,1,0.27920371738274696
5816,703-004-5394,3356.58,6,5,1,2.0189086968674195
5818,703-004-5384,4108.936,5,2,3,0.4571363444049297
6210,703-004-5381,6670.316,6,3,3,1.694815336133892
633,703-004-5394,3454.178,3,0,3,0.27920371738274696
6536,703-004-5394,3752.5176,5,2,3,0.712374609387912
6584,703-004-5380,9010.971,5,1,4,0.6696310257067258
7217,703-004-5380,7477.3613,2,1,1,0.43231212781278827
7606,703-004-5391,3626.4395,1,0,1,0.27920371738274696
7790,703-004-5385,7520.5664,2,0,2,0.27920371738274696
8040,703-004-5397,5513.4106,3,2,1,0.4974775754982269
8052,703-004-5395,9215.378,3,1,2,0.9723069943531117
8200,703-004-5382,3483.7192,1,1,0,0.5165268771580819
8336,207-008-2398,8039.2666,8,6,2,1.2747782548126363
8408,703-004-5399,6197.3413,3,1,2,0.5165268771580819
8558,207-008-2398,7112.595,4,2,2,1.069238562575651
8577,703-004-5396,5129.062,3,1,2,0.4314860782385869
873,207-008-2398,4244.466,4,1,3,0.33853450732658075
8837,703-004-5381,2853.002,1,1,0,0.9752814489939088
8935,703-004-5394,1312.9454,2,1,1,0.35831143730785864
897,703-004-5392,6469.931,4,3,1,1.2936166169414949
9192,703-004-5392,222.29732,3,0,3,0.27920371738274696
9369,703-004-5396,8696.536,2,1,1,0.9392330673762366
9443,703-004-5390,4579.6807,2,1,1,0.3131070259220805
9451,703-004-5396,5762.9917,2,2,0,0.8856047999530676
9609,703-004-5380,2799.7065,4,2,2,1.4757551952516028
9667,703-004-5399,1484.7535,2,0,2,0.27920371738274696
9679,703-004-5390,5624.3604,4,3,1,0.6739109391933883
9713,703-004-5399,8350.508,3,2,1,0.9350612023034556
10134,703-004-5394,1179.0282,6,2,4,0.795457880028355
10443,703-004-5392,5850.886,4,2,2,0.7668145980923852
10463,703-004-5385,5169.159,4,2,2,0.5404262541373399
10621,703-004-5397,2313.7092,2,0,2,0.27920371738274696
10641,703-004-5382,989.4747,8,1,7,0.3978652972704144
10681,703-004-5391,3642.1526,4,0,4,0.27920371738274696
10696,703-004-5384,8613.358,3,3,0,0.8152836162135063
10850,703-004-5380,5104.8896,6,5,1,1.8358320195426139
10869,703-004-5391,2010.8516,4,3,1,1.436841777944698
11023,703-004-5394,9702.176,6,2,4,0.8489259341240516
11383,703-004-5381,2255.0422,7,2,5,0.45521839421612037
11487,703-004-5388,5361.8867,4,2,2,0.8673368681928197
11746,703-004-5395,352.77487,4,1,3,0.4032545106903127
11867,703-004-5381,1124.3141,6,2,4,1.0109993414725316
11942,703-004-5385,4765.2905,2,2,0,1.5192871778955592
12283,703-004-5395,7118.146,5,3,2,1.0319240354593682
12344,703-004-5382,5846.1006,2,0,2,0.27920371738274696
12537,703-004-5399,248.42203,4,1,3,0.42420157569548284
12611,703-004-5399,2054.0452,5,3,2,0.8589250469899966
12936,207-008-2398,9577.165,6,1,5,0.5165268771580819
13104,703-004-5392,5004.725,2,0,2,0.27920371738274696
13113,207-008-2399,3041.9546,7,4,3,1.097950390577021
13405,703-004-5397,2523.9963,4,2,2,0.7563222890866022
13773,703-004-5386,1851.0801,4,3,1,0.8429154750025476
13877,703-004-5382,5108.118,3,1,2,0.4304755752163947
14200,703-004-5380,8330.282,6,2,4,0.546252110066188
14224,703-004-5387,8476.931,4,2,2,0.8428547866280939
14315,703-004-5385,1160.0118,6,4,2,1.1858469994857141
14468,703-004-5399,72.58594,3,2,1,0.5022039416762838
15029,703-004-5380,5521.081,2,1,1,0.3978652972704144
15431,703-004-5399,3198.846,3,1,2,1.0976118228841771
15482,703-004-5381,1033.1207,4,2,2,0.9055252146529096
1568,703-004-5398,5112.358,5,3,2,0.950630297523099
16110,703-004-5399,5777.891,6,2,4,1.1920761382245824
16367,703-004-5397,566.04443,3,1,2,1.9108558012995251
16533,703-004-5388,1409.6958,4,1,3,0.465483094648128
16793,703-004-5393,9607.404,3,1,2,0.9481298995170726
16808,703-004-5396,6370.0713,8,5,3,2.2833484524768095
16991,703-004-5391,8491.686,3,1,2,0.3978652972704144
17044,703-004-5384,3562.9524,7,5,2,2.2853271155552672
17207,703-004-5395,1327.5612,4,2,2,0.6060731079389368
17794,703-004-5392,3139.0518,7,2,5,0.8077729256878801
17913,703-004-5395,7303.0356,2,2,0,0.5691366834574656
17948,703-004-5388,7347.5146,3,1,2,0.738663058676076
18,703-004-5387,1615.963,3,2,1,0.9110222273710744
18021,703-004-5393,2651.5615,2,1,1,0.5670343205312884
18250,703-004-5384,2590.1675,4,1,3,0.4660775419199834
18299,703-004-5385,3178.4385,4,3,1,1.0798685356150877
18594,703-004-5384,470.99887,6,3,3,3.653734880862598
18978,207-008-2399,4106.7417,5,3,2,1.4828923429701573
19309,207-008-2399,1315.7069,2,1,1,0.3986619975335105
19411,703-004-5391,2963.887,5,2,3,0.5796795168313563
19599,703-004-5390,5823.656,1,1,0,0.7152105864521533
1978,207-008-2399,5212.2456,4,3,1,2.1365459049602684
20135,207-008-2398,5122.141,5,1,4,2.035401821955039
20247,703-004-5388,3518.4734,4,2,2,0.5044926152644743
20522,703-004-5394,9698.28,4,0,4,0.27920371738274696
21067,703-004-5390,6506.8813,5,4,1,2.4528818830348382
21377,703-004-5386,8881.21,8,5,3,0.8664072236291929
21432,703-004-5389,7972.428,2,1,1,0.9278405724765942
21536,703-004-5395,9627.327,3,2,1,0.7064149241064437
21926,207-008-2399,8876.747,4,0,4,0.27920371738274696
22239,207-008-2399,1542.6249,4,3,1,1.311983654500966
22344,703-004-5395,8209.763,6,3,3,0.9795392479742329
2251,703-004-5383,7700.5083,7,3,4,2.381995753049993
2258,703-004-5396,2919.7515,3,1,2,0.980667133647496
22709,703-004-5397,8753.1,1,1,0,0.839385647625101
23338,207-008-2399,4950.492,3,1,2,0.3978652972704144
23364,703-004-5395,2499.895,1,0,1,0.27920371738274696
23552,703-004-5399,4441.482,7,3,4,1.030558009389768
23687,703-004-5392,674.6608,5,3,2,0.505706499020587
23932,703-004-5399,4629.3267,8,4,4,1.766636391525721
24132,703-004-5392,1165.0979,5,3,2,1.8934653137056372
24147,703-004-5399,294.28064,3,1,2,0.7074406053322532
24160,703-004-5391,8486.242,1,0,1,0.27920371738274696
24592,703-004-5390,4774.1885,2,2,0,0.7833665448484006
24657,703-004-5399,115.04531,4,3,1,1.3959404696286148
24694,703-004-5384,9764.6,4,2,2,1.1276128282561035
24720,703-004-5397,5570.667,3,2,1,0.6105277679019776
25080,703-004-5389,6434.195,7,2,5,0.44000663890552083
25121,703-004-5381,2379.4746,8,4,4,1.0967730171701053
25234,703-004-5381,5598.757,6,3,3,1.257120922288006
25348,207-008-2399,1559.2938,3,1,2,0.5165268771580819
2552,703-004-5398,2643.4028,5,4,1,1.8186383228351863
25699,703-004-5389,2782.5374,2,1,1,0.4746254981775985
25764,703-004-5388,534.7234,5,5,0,2.4394779152481174
25825,703-004-5393,7208.901,2,1,1,0.39517288799712996
26336,703-004-5388,570.7389,5,2,3,0.7186768468625617
26492,703-004-5382,5108.0044,4,2,2,0.9027113376944016
27175,703-004-5381,896.6458,6,5,1,1.1479128910962553
27531,703-004-5390,1676.4343,4,3,1,1.3089220986654215
27645,703-004-5399,1101.2394,2,1,1,0.6491705269590236
27722,703-004-5387,4014.1152,4,0,4,0.27920371738274696
27727,703-004-5386,161.09288,5,2,3,1.4568211368343496
27801,703-004-5389,4017.421,4,1,3,0.3978652972704144
27899,703-004-5383,1993.7104,5,2,3,1.0159607005073874
28070,703-004-5385,2271.4465,7,4,3,1.1147407442585033
28266,703-004-5390,9708.214,2,1,1,0.496942697799964
28494,703-004-5380,9346.697,9,6,3,3.211278859151688
28869,703-004-5387,6652.3057,2,2,0,0.7597906572080628
28959,703-004-5390,5743.6377,4,1,3,0.3978652972704144
29080,703-004-5392,990.13684,4,2,2,1.2948702366813913
29131,207-008-2398,6267.6567,1,1,0,0.3978652972704144
29191,703-004-5399,622.8608,2,1,1,0.3695741929225091
29282,703-004-5381,6323.097,2,1,1,0.5704997730857156
29428,703-004-5391,8219.841,6,2,4,1.095568858587079
29499,207-008-2399,5128.434,7,3,4,1.7367690980977815
30380,703-004-5384,2455.914,4,3,1,1.4787351537168687
30626,703-004-5392,9208.882,4,2,2,0.9093928937314656
30711,703-004-5383,4083.379,4,2,2,1.1570246993294653
30758,703-004-5382,581.733,8,5,3,3.152268171794215
3114,703-004-5381,9436.742,5,1,4,0.44829646872267315
31177,703-004-5387,7210.158,3,2,1,0.818235881495938
31247,703-004-5393,7321.011,4,3,1,0.9103023184473986
3125,703-004-5384,8532.577,3,1,2,1.2354159114268883
31279,703-004-5395,9177.108,2,0,2,0.27920371738274696
31352,207-008-2399,6956.5894,5,3,2,1.7316612844236756
31416,703-004-5386,2001.1008,1,0,1,0.27920371738274696
31417,703-004-5382,4731.6865,6,5,1,2.548783739979292
31573,703-004-5397,8260.008,5,2,3,0.6512566781981652
31719,703-004-5382,2190.3777,4,0,4,0.27920371738274696
31838,207-008-2398,8567.085,5,2,3,0.8179939659177571
31876,703-004-5393,7269.204,5,1,4,0.6677868728549801
31892,703-004-5395,6101.352,2,1,1,0.32666834933781397
32014,703-004-5394,4974.837,4,2,2,1.131096264242723
32164,703-004-5391,4855.701,8,4,4,1.991484265030229
32246,703-004-5382,4487.0835,4,1,3,0.39017420964103994
3243,703-004-5380,4654.5137,4,3,1,2.538306696442231
3309,703-004-5388,1588.7021,1,0,1,0.27920371738274696
33716,703-004-5386,6213.188,7,4,3,2.8715004557246337
33947,703-004-5381,3530.962,5,1,4,0.9897521110899281
34312,703-004-5392,3100.629,4,2,2,1.0241013102328202
34490,703-004-5397,1639.9156,2,1,1,1.110336672789534
34511,703-004-5394,2676.677,3,0,3,0.27920371738274696
34911,703-004-5392,5374.3965,4,2,2,0.692768805128851
35184,703-004-5386,410.80893,5,2,3,0.5214450577297143
3523,703-004-5389,5656.5825,2,1,1,0.32666834933781397
35268,703-004-5398,7708.371,6,2,4,0.9262547172048745
35302,703-004-5383,8808.198,4,2,2,0.708779724151548
35316,703-004-5387,9382.917,2,1,1,1.5866820278476594
359,703-004-5382,6295.36,8,3,5,1.1830956288958332
36105,703-004-5392,9080.369,1,0,1,0.27920371738274696
36245,703-004-5392,2034.6737,5,4,1,0.7310396955985272
36363,703-004-5398,2228.6934,6,2,4,0.4672247836582666
36443,207-008-2399,2568.1167,4,3,1,2.0888458411669344
36473,207-008-2398,7484.188,7,6,1,1.7480777322893348
36482,703-004-5394,6146.0684,5,3,2,1.7743442048225129
36491,207-008-2398,5705.418,5,3,2,1.6735573174768361
36549,703-004-5398,1912.7465,2,2,0,1.1026335134439231
36661,703-004-5380,7119.059,9,3,6,0.7500518202495556
36987,703-004-5399,4897.761,4,2,2,2.2869894181313093
37026,703-004-5381,4003.496,4,1,3,0.7275107663602174
37416,703-004-5380,2094.8416,7,5,2,1.6894175146858255
37447,703-004-5393,7875.3667,2,0,2,0.27920371738274696
37755,703-004-5398,3843.115,3,1,2,0.5165268771580819
37792,703-004-5383,1197.089,2,1,1,0.3978652972704144
37857,703-004-5387,5826.2725,1,0,1,0.27920371738274696
38045,207-008-2399,5265.713,2,2,0,1.5545135686762592
38132,703-004-5382,7140.982,7,5,2,2.0621262131201155
38136,703-004-5382,7693.2324,1,0,1,0.27920371738274696
38153,703-004-5395,1759.5887,2,1,1,0.5165268771580819
38154,703-004-5391,9290.48,5,2,3,0.9801691809183254
38217,703-004-5397,2205.2139,4,4,0,1.090733372867152
38321,703-004-5383,9204.682,3,1,2,0.5575531147430723
38494,703-004-5380,8675.87,5,2,3,0.7293191801900141
3876,703-004-5391,1869.132,7,4,3,1.2218883834313703
38912,703-004-5393,7337.8066,2,1,1,0.4180377658513179
3905,703-004-5387,6538.212,3,1,2,0.7956155894307354
39099,703-004-5388,7270.2153,4,2,2,0.4876639991033522
39422,703-004-5399,7745.705,7,2,5,0.5711344653299012
39629,703-004-5381,1150.7827,8,5,3,2.8155562863232637
40329,703-004-5385,6380.82,3,2,1,1.113263012661245
40404,703-004-5389,9530.819,5,3,2,1.3573791751625808
40642,703-004-5399,4379.63,2,1,1,0.5675828837066774
40710,703-004-5392,8980.128,3,2,1,0.9098687360105749
40723,703-004-5386,1180.5403,5,1,4,0.6248768379103514
4240,703-004-5386,6940.3647,2,1,1,0.9308291932905698
4295,207-008-2398,9979.362,3,1,2,0.728530452950097
4296,703-004-5385,100.57748,5,1,4,0.6285674679561547
42961,207-008-2398,8495.119,1,0,1,0.27920371738274696
42998,703-004-5393,3090.7976,7,4,3,1.4336894969769476
43009,703-004-5398,69.66353,4,2,2,0.45719608721424815
43218,703-004-5395,708.96985,3,2,1,1.2379927228775542
43247,207-008-2399,986.6297,3,0,3,0.27920371738274696
43272,703-004-5390,3987.891,3,1,2,1.5696778708010335
43438,703-004-5387,7986.1855,2,0,2,0.27920371738274696
43794,703-004-5398,2449.0493,3,2,1,0.4054464537632376
43842,703-004-5388,927.5633,4,1,3,0.6763778762451366
43852,703-004-5385,8085.9277,4,3,1,0.668398506338554
44019,703-004-5398,3929.944,7,6,1,2.300975042232342
44183,207-008-2398,4096.7827,5,2,3,1.6841301363151042
4431,703-004-5394,2640.2683,2,1,1,0.4764089274319659
44323,703-004-5388,2388.9846,7,4,3,0.983789027401937
44442,703-004-5388,3124.957,4,2,2,1.3739750825054455
44737,703-004-5383,9511.478,3,1,2,0.44590253250851974
44795,207-008-2399,5654.346,3,2,1,0.8511912579278119
44925,703-004-5391,5932.934,2,2,0,1.0613362116916842
45058,703-004-5390,7092.3574,4,3,1,0.9564756990188932
45175,703-004-5390,918.42413,2,0,2,0.27920371738274696
45177,703-004-5380,4389.5776,6,4,2,1.9562214444573778
45419,207-008-2398,886.2829,3,1,2,0.39486647096220484
45502,703-004-5390,6031.689,6,2,4,0.962390700396713
45519,703-004-5393,6155.4736,4,0,4,0.27920371738274696
45671,703-004-5386,1636.8514,5,1,4,0.5434460633724587
45742,703-004-5385,7306.565,4,1,3,0.3807252912866403
45800,703-004-5392,712.2141,3,2,1,1.0352404320875863
45990,703-004-5380,7077.7285,3,1,2,0.4662587140241128
46092,207-008-2398,2289.2659,7,3,4,1.3941958677424293
4617,703-004-5399,7738.1475,5,5,0,1.7090139321197666
46290,703-004-5398,7224.229,6,4,2,0.7694582410550589
46405,703-004-5394,3033.4841,4,1,3,0.5009478239402255
46424,703-004-5386,2447.4973,3,1,2,0.5920736854088049
46481,703-004-5393,8681.394,4,1,3,0.3978652972704144
46562,703-004-5398,9737.956,2,0,2,0.27920371738274696
46737,703-004-5382,281.74997,4,1,3,0.8853471665877161
46840,703-004-5382,9134.379,3,3,0,0.8251927316476295
46860,703-004-5391,8634.942,1,0,1,0.27920371738274696
46862,703-004-5389,2360.301,2,2,0,0.8363274059598031
46962,703-004-5383,5097.5693,5,1,4,0.8000820002829726
47131,703-004-5380,514.02985,3,2,1,1.0999484143661504
47369,703-004-5399,5355.9673,4,2,2,0.920439674722563
4759,207-008-2399,7137.3315,4,3,1,0.8833267058824507
47664,703-004-5387,4436.8525,1,1,0,0.3784863780050097
47708,703-004-5387,4983.3364,1,1,0,0.7213404722185675
4809,703-004-5385,6686.8228,7,3,4,0.6361002582107577
481,703-004-5383,6831.5264,4,2,2,0.7336021432833574
48962,703-004-5384,2543.1956,5,2,3,0.6706128607082013
49065,703-004-5395,1611.6017,7,2,5,0.6616795474294849
49492,703-004-5395,8230.812,3,2,1,2.2068924628362945
49598,703-004-5384,7273.56,3,2,1,1.7054912461138363
49651,703-004-5382,7795.1426,7,1,6,0.3807252912866403
49831,703-004-5394,8648.979,5,4,1,0.9416865969408051
49891,703-004-5391,6487.4,9,5,4,2.523770010689012
5030,703-004-5392,9204.372,4,2,2,1.2759378544273579
5196,703-004-5385,7597.4155,4,1,3,0.6878669953375474
523,703-004-5399,441.06662,7,3,4,1.928356925630473
5267,703-004-5392,6452.5425,1,1,0,1.1896645670277437
5384,703-004-5389,2577.7632,5,2,3,0.46087583658214404
5624,703-004-5389,7672.2007,2,1,1,0.47332252553648185
5811,703-004-5399,2696.9636,1,1,0,0.7430981095371584
6234,703-004-5382,7527.2886,5,1,4,0.4569101290221921
6643,207-008-2399,6101.5825,3,1,2,1.0862403508766698
7098,207-008-2399,7384.921,5,2,3,0.6634094088755241
7131,703-004-5389,2990.7036,3,3,0,1.0012902651074802
7277,703-004-5390,675.72473,2,1,1,1.2994559311996583
7439,207-008-2399,3262.9138,3,2,1,0.5102856076714903
7481,703-004-5395,6500.736,5,3,2,1.6140494416765616
7570,703-004-5388,4598.09,3,1,2,0.46023141508423776
7638,703-004-5394,3279.7659,5,3,2,0.8920860972303453
8012,207-008-2398,7648.868,3,1,2,1.085543155172817
8041,207-008-2398,178.56181,3,2,1,0.8056652835869353
8417,703-004-5380,9561.114,5,1,4,0.9383902844971224
8567,703-004-5398,1358.7272,5,4,1,1.1579261291878047
8590,207-008-2399,1862.1152,4,1,3,0.33853450732658075
8642,703-004-5396,5528.2305,3,0,3,0.27920371738274696
8730,703-004-5399,3471.0176,3,3,0,1.1568217783484425
8816,207-008-2399,222.99886,2,1,1,1.1474454855651308
8841,703-004-5381,2799.2893,3,2,1,1.3376207759155414
8868,703-004-5387,9306.347,4,1,3,0.44113051839492234
9118,703-004-5386,1055.1339,4,3,1,1.6448496561183408
9220,703-004-5392,2939.642,7,3,4,1.5842565782235087
9330,703-004-5385,1383.8636,1,0,1,0.27920371738274696
10205,703-004-5391,5006.9346,2,1,1,0.4882400649071856
10773,703-004-5381,8379.141,8,6,2,1.9242534232137922
11181,703-004-5389,3053.4048,7,6,1,1.8866061621252037
11192,703-004-5387,5815.8506,3,2,1,1.1837900369824543
11193,703-004-5381,3770.1196,5,3,2,0.5229198009849975
1152,703-004-5397,5677.1714,3,3,0,4.880213650857517
12497,703-004-5391,4910.115,1,1,0,0.9119556467845165
12588,703-004-5392,9640.407,3,1,2,1.0863777537466714
12698,703-004-5388,8203.645,1,1,0,0.4779093262691007
12904,703-004-5383,1883.4078,6,2,4,1.881417407601317
12948,207-008-2398,578.5048,3,0,3,0.27920371738274696
13000,703-004-5385,2057.8896,7,3,4,0.7960523952204855
13335,703-004-5398,4932.685,3,2,1,0.8165080324803871
13667,703-004-5385,6818.01,6,3,3,0.6881993916742741
13679,703-004-5392,4380.135,4,3,1,1.9150828287633581
14042,207-008-2398,2160.1384,5,3,2,0.8100094432608393
14215,703-004-5392,1775.487,5,3,2,1.0702390006738511
14225,703-004-5393,368.78168,8,2,6,0.7900536248329717
14248,703-004-5395,231.73451,4,2,2,0.43692473398343834
14289,703-004-5385,3976.9958,7,2,5,1.6405623065889483
14427,703-004-5383,4587.6807,8,2,6,0.6750667945734586
14622,703-004-5385,3511.4229,4,1,3,0.5436430938746291
14915,703-004-5388,3239.4368,3,2,1,0.9910947118163748
1505,703-004-5382,8173.78,5,4,1,1.133025449607952
15138,703-004-5393,2979.5486,6,4,2,1.5140437805299758
15274,703-004-5385,645.3532,5,5,0,3.179344485068589
15330,703-004-5387,1947.5764,3,1,2,0.8332310846278028
15339,703-004-5382,3587.5894,4,1,3,0.6690115410027053
15460,703-004-5387,9768.248,3,1,2,0.6666244481397583
15686,703-004-5393,1729.3733,2,0,2,0.27920371738274696
15748,703-004-5389,7244.9673,4,3,1,0.8574697173192046
15827,207-008-2399,9284.377,7,6,1,4.828043921639503
1592,703-004-5390,1042.3386,3,1,2,0.37512182779194486
16556,703-004-5388,3659.1506,11,3,8,1.1155096703467515
16732,703-004-5382,4413.364,1,1,0,1.2740601470291844
16805,703-004-5393,5247.811,2,2,0,0.7315536860912486
16897,703-004-5382,472.50928,4,2,2,0.7051655889528323
16907,703-004-5399,1960.7294,7,4,3,0.9641820695131462
17707,703-004-5398,598.942,8,7,1,3.45230565291548
18362,703-004-5387,4424.214,6,3,3,1.636920956344815
18459,703-004-5398,1407.5679,5,5,0,2.1381597441803515
1861,703-004-5392,6392.0386,8,4,4,2.1378660338421422
18779,703-004-5395,1198.9999,4,2,2,0.8464949348786116
18891,703-004-5391,8680.641,3,1,2,1.2387414136433532
18896,703-004-5394,6437.716,5,5,0,1.3842448734229174
19020,703-004-5388,3393.563,3,2,1,0.4904626004939279
19127,703-004-5383,1756.5269,3,1,2,0.5791252162946852
19169,703-004-5391,185.66072,5,3,2,1.004735900304078
19332,703-004-5392,5909.5786,4,1,3,0.5585646079071476
19391,703-004-5383,7396.0513,2,1,1,0.5627517519631527
19500,703-004-5384,3100.8816,2,0,2,0.27920371738274696
19503,703-004-5391,3676.4895,4,3,1,0.6587479940378532
19654,703-004-5392,8451.207,4,2,2,0.9218633962993511
1981,703-004-5391,3562.1304,2,0,2,0.27920371738274696
20125,703-004-5384,3121.2617,6,1,5,0.3978652972704144
20390,703-004-5390,667.9696,2,0,2,0.27920371738274696
2048,703-004-5383,4587.862,3,2,1,0.6462452898344653
20934,703-004-5399,9748.335,5,2,3,0.7565396140441598
21271,703-004-5391,6953.0625,4,2,2,0.7250746038106575
21319,703-004-5387,8390.204,5,2,3,1.3466818092000687
21489,703-004-5389,6678.8013,4,1,3,0.5117426764213557
21502,703-004-5397,2615.084,4,1,3,0.8104142167564499
21872,703-004-5398,5491.378,2,2,0,1.2824221226039139
21949,703-004-5399,6124.0195,5,3,2,1.5669312546139487
22954,703-004-5398,1738.6824,4,3,1,0.503908065719742
23444,703-004-5385,6369.549,5,2,3,1.5371368790447297
23832,703-004-5386,5887.716,4,4,0,1.5577561642609405
24011,703-004-5384,1401.6259,4,3,1,1.387063282564856
2479,703-004-5398,1411.1603,4,2,2,1.0123313808631376
24964,703-004-5391,6316.817,2,1,1,0.42240469460520097
25037,703-004-5386,2693.1697,"","","",0.27920371738274696
25057,703-004-5399,8526.347,5,3,2,1.5727228662335657
25078,703-004-5383,4583.2603,2,1,1,0.5162633289651126
25820,703-004-5396,7871.2773,6,3,3,1.3977773545460273
25846,703-004-5381,4030.568,4,4,0,1.5170309703612823
26101,207-008-2398,2867.3523,8,3,5,0.8333952881267447
26558,703-004-5398,830.49176,4,2,2,0.6346759629521121
26845,703-004-5391,6255.1416,3,0,3,0.27920371738274696
273,703-004-5385,3912.1567,4,0,4,0.27920371738274696
27484,703-004-5390,1864.8827,4,2,2,0.5421057635428945
27792,703-004-5388,4780.657,6,2,4,0.536827429155572
27853,703-004-5397,2892.4065,2,1,1,1.5292269078779028
28062,207-008-2398,9829.708,2,1,1,0.4264162212898034
28174,703-004-5396,4826.2246,1,0,1,0.27920371738274696
28339,703-004-5388,5746.9272,4,2,2,0.7607322697002367
2847,703-004-5393,255.23961,1,1,0,0.779173916265469
2856,207-008-2399,310.3596,4,3,1,0.9972605808605967
2866,703-004-5383,5378.2017,9,3,6,1.2335138883746508
28792,703-004-5394,8605.463,8,2,6,1.3133180844111956
28903,703-004-5397,6129.405,2,2,0,0.6708465502155557
29490,703-004-5397,8602.258,8,4,4,1.9076276454397683
29839,703-004-5391,4106.9575,4,2,2,0.6326904179124369
30384,703-004-5387,5205.772,4,4,0,0.9650567633374408
30420,703-004-5398,5895.6206,1,1,0,0.7574530433595371
30453,703-004-5389,8991.443,3,2,1,0.797686395073601
3068,703-004-5384,2554.015,3,2,1,0.7498545295031401
31002,703-004-5398,7935.9233,3,1,2,0.4987276401749318
31089,703-004-5380,1998.7482,5,2,3,0.5279645349972543
31282,703-004-5391,6375.9937,3,1,2,0.435938084921039
3149,703-004-5395,7517.724,2,2,0,1.4270347787431954
31560,703-004-5389,8111.759,2,2,0,1.2769495826716688
31630,703-004-5390,7675.618,4,3,1,0.6444855300270419
31648,703-004-5386,4548.232,3,2,1,0.4754996760212895
31787,703-004-5392,9036.724,5,3,2,0.9590458297463443
3196,703-004-5395,7770.623,3,1,2,1.222632711390559
32083,207-008-2398,7406.739,3,1,2,0.5881183723923983
32162,703-004-5395,885.76495,4,2,2,1.0221350044339834
32758,703-004-5399,200.153,2,0,2,0.27920371738274696
3296,207-008-2399,6641.074,6,1,5,0.6699657813448321
33125,703-004-5381,1470.6295,5,3,2,1.6987439311895463
33134,703-004-5393,5293.998,5,3,2,1.0310227559442453
33816,703-004-5394,0.846982,4,3,1,0.4747817333536004
3389,703-004-5388,8582.638,4,1,3,0.4746254981775985
34137,703-004-5380,5308.365,4,0,4,0.27920371738274696
34276,703-004-5383,1187.3656,6,3,3,1.111482950872007
34303,703-004-5383,4768.409,3,1,2,0.33853450732658075
34538,703-004-5380,6668.2383,2,0,2,0.27920371738274696
34837,703-004-5384,8550.157,6,1,5,0.8522512112467983
34908,703-004-5388,6508.4424,6,4,2,1.4915279349455846
35177,703-004-5380,831.6815,8,3,5,2.9033450168008472
35323,703-004-5394,2155.8506,2,2,0,0.5384860821776595
35360,703-004-5384,477.55838,3,2,1,0.7050908416144084
35891,207-008-2398,4532.603,4,1,3,0.47892884543091635
3600,703-004-5388,4103.5776,2,0,2,0.27920371738274696
36073,703-004-5385,4720.2925,2,2,0,1.0049722815937856
36114,703-004-5384,2271.4717,6,2,4,0.6312102102820729
36229,703-004-5393,4964.162,2,1,1,0.33853450732658075
3624,703-004-5385,8600.529,4,2,2,0.5944225581438307
36249,703-004-5393,876.6979,5,2,3,0.4835317394083179
36257,703-004-5380,3136.645,3,1,2,1.1169587663818854
36457,703-004-5383,6319.6396,5,2,3,0.47723098710396245
36694,703-004-5385,8097.7954,5,5,0,2.7288259545379003
36830,703-004-5391,8428.412,12,5,7,1.3989191905472258
36876,703-004-5395,891.0513,2,1,1,0.45147398274063383
36990,703-004-5391,5877.4883,4,1,3,1.2225842692798623
37045,703-004-5382,2269.964,4,1,3,0.4844492918675457
37095,703-004-5394,3570.8262,4,3,1,0.8322404514497888
37718,703-004-5380,8729.384,4,0,4,0.27920371738274696
38097,703-004-5392,9925.959,2,1,1,0.3978652972704144
3811,703-004-5397,2488.2598,6,4,2,1.1972261321431061
3855,703-004-5395,4004.454,8,4,4,1.4585760637802532
39288,703-004-5399,8281.338,5,1,4,0.9709601982660391
39299,703-004-5398,9994.072,3,2,1,0.6003686996974619
3931,703-004-5382,4013.396,3,1,2,0.6639199776303986
39347,703-004-5390,5959.4663,4,2,2,0.5340615977027324
3946,703-004-5389,6622.9023,7,2,5,1.2255274243776904
39513,703-004-5391,184.60512,2,1,1,0.4351823228833842
401,703-004-5394,5539.5215,3,1,2,0.5529354105229476
40631,703-004-5394,1234.1439,4,3,1,1.2135472578446151
40871,703-004-5391,4022.7795,5,2,3,0.833616121270847
40969,703-004-5381,6770.076,7,4,3,1.4806786292886929
4148,703-004-5383,1555.1758,2,0,2,0.27920371738274696
41605,703-004-5387,485.9334,2,1,1,0.5165268771580819
41828,703-004-5392,2267.5698,4,3,1,1.0230189214078547
421,703-004-5391,341.17044,7,3,4,0.5899851703939141
42150,703-004-5391,7502.4385,1,1,0,0.6834788098517439
42578,703-004-5397,3075.6401,6,4,2,1.2298732067685407
42670,703-004-5386,7292.815,3,1,2,0.3913581388057816
42954,703-004-5395,255.46252,6,5,1,2.6402349824826565
43199,703-004-5397,7727.551,4,2,2,1.0075035154366034
43789,703-004-5393,993.30365,3,1,2,0.35958595703386825
44039,703-004-5399,4915.7744,7,1,6,0.40255897817581643
44118,703-004-5396,5075.806,4,0,4,0.27920371738274696
44210,703-004-5381,6874.1284,2,1,1,0.8255662812679453
44279,703-004-5381,6636.315,4,2,2,0.5550897556352744
44398,703-004-5385,1069.4122,5,2,3,1.1930963508622885
44528,703-004-5388,9347.655,5,3,2,2.998972151225882
44640,703-004-5382,7504.5073,7,4,3,1.003186398243471
45111,703-004-5391,237.50842,6,5,1,2.2338780391517785
45163,703-004-5392,8151.759,5,1,4,0.35831143730785864
4547,703-004-5395,9795.758,2,2,0,0.5017015960208664
45527,207-008-2399,7237.3677,1,0,1,0.27920371738274696
45534,703-004-5381,9153.384,3,0,3,0.27920371738274696
45745,703-004-5387,7588.2715,4,1,3,0.9037906800188574
45795,703-004-5383,4846.4336,5,4,1,1.596699108235724
46152,703-004-5384,5315.1514,3,1,2,0.6701687828533659
46191,703-004-5398,6248.6167,6,5,1,0.9178872910372948
46413,703-004-5390,6991.038,1,1,0,0.8803656904967355
46676,703-004-5387,701.52344,2,2,0,1.6919275480114437
46707,703-004-5394,2294.3843,2,2,0,1.1824522256054015
46861,703-004-5387,7515.3037,5,3,2,1.4118102906430974
47898,703-004-5387,9920.475,3,3,0,1.5281379686243017
48342,703-004-5397,2046.3639,3,2,1,0.5137523633526545
48736,703-004-5396,8245.357,5,4,1,2.2640721680928526
4877,703-004-5381,819.245,3,1,2,0.3978652972704144
4901,207-008-2398,6685.284,3,1,2,0.5040596375626402
49132,703-004-5390,9962.887,8,3,5,0.635884764381086
49344,703-004-5382,19.758343,6,2,4,0.9085658346880298
49448,703-004-5395,6912.599,4,2,2,0.8102500366031617
49606,703-004-5396,4243.559,2,0,2,0.27920371738274696
49623,703-004-5383,782.1798,6,3,3,0.990772070344912
49675,703-004-5384,8576.584,1,0,1,0.27920371738274696
49685,703-004-5385,3473.6157,6,3,3,1.3414987113000028
49708,703-004-5380,1179.3644,"","","",0.27920371738274696
4976,703-004-5392,2338.882,2,1,1,1.6745859866701147
49869,703-004-5391,1202.8933,6,2,4,1.0047052736454802
5,703-004-5397,5423.153,3,1,2,0.5573684287859925
5261,703-004-5380,6114.021,1,0,1,0.27920371738274696
5474,703-004-5397,426.61368,5,5,0,1.0929188100575884
6188,703-004-5396,2352.7783,4,0,4,0.27920371738274696
6386,703-004-5381,3690.911,5,2,3,1.063000306410495
6939,703-004-5389,852.6087,7,2,5,0.886399543214397
6964,703-004-5383,1883.1473,6,3,3,2.236334516950809
7577,703-004-5387,4615.867,1,0,1,0.27920371738274696
7765,703-004-5383,7752.7417,5,1,4,0.6537288391989649
7908,703-004-5393,1292.6584,4,2,2,1.7601370005992962
8090,703-004-5390,7288.65,5,3,2,1.5321583299969619
8241,703-004-5383,3836.8262,2,1,1,0.4254434101003284
8319,703-004-5381,7403.243,3,1,2,0.3709598358574893
8749,703-004-5386,6781.446,2,0,2,0.27920371738274696
9027,703-004-5397,5659.952,1,0,1,0.27920371738274696
9072,703-004-5392,8140.8022,4,2,2,0.7594688002860591
9421,703-004-5388,8852.91,5,3,2,1.6825890140246527
9727,207-008-2398,3932.7742,3,2,1,0.8870861260117794
9842,703-004-5384,7174.456,5,3,2,1.4249274541846746
9849,207-008-2399,9803.638,5,4,1,1.6106909196910824
10074,703-004-5387,4024.2905,3,2,1,0.800902473931567
10083,703-004-5384,8574.96,6,4,2,1.135577516420014
10111,703-004-5380,917.2982,5,3,2,1.339617573034096
11381,703-004-5393,9399.549,2,0,2,0.27920371738274696
11441,703-004-5393,8603.814,3,0,3,0.27920371738274696
11462,703-004-5385,9267.652,7,3,4,1.1298208378527494
11727,207-008-2399,2598.0925,4,0,4,0.27920371738274696
11763,703-004-5381,4188.869,4,1,3,0.39972357452152435
11856,703-004-5390,3845.3633,2,2,0,1.1880219878918816
12306,703-004-5387,2993.8782,3,0,3,0.27920371738274696
12323,703-004-5385,5410.8955,3,2,1,1.6056946825962612
12439,207-008-2399,6192.5586,"","","",0.27920371738274696
12807,703-004-5382,4808.3047,4,3,1,1.3884792793383853
12979,207-008-2399,2352.336,1,0,1,0.27920371738274696
13575,703-004-5392,3226.7683,2,1,1,0.35831143730785864
13617,703-004-5393,4295.9126,3,1,2,0.44351330184842397
13625,207-008-2398,7503.4927,1,0,1,0.27920371738274696
13767,207-008-2399,807.2072,5,3,2,2.128883819262755
13872,703-004-5399,2538.7126,2,1,1,0.6262523194043175
13892,703-004-5388,3172.9895,2,2,0,1.3405591899917388
14593,703-004-5398,7103.706,5,1,4,1.2747253167894974
14652,207-008-2398,3832.5876,3,2,1,0.56674965180798
14729,703-004-5381,7751.576,1,1,0,0.8430491870133079
1481,703-004-5395,6747.431,2,1,1,0.41467568775450064
14997,703-004-5399,9688.898,3,2,1,0.6130199517209648
15000,703-004-5382,8107.1753,4,1,3,0.3978652972704144
15166,703-004-5389,6940.4043,4,1,3,1.4802341619217203
15336,703-004-5395,8515.564,6,4,2,1.313358315037302
15391,703-004-5393,6465.432,7,4,3,4.795088940216033
15502,703-004-5399,7015.47,4,3,1,1.4539560964065967
15509,703-004-5385,3272.6008,3,2,1,1.1858264403080343
15519,207-008-2399,8492.798,3,2,1,0.9611785549959802
16022,703-004-5398,5181.9155,1,1,0,0.493672404270495
16089,703-004-5389,7360.364,5,2,3,1.1649281119807953
16371,703-004-5382,4611.7334,9,3,6,1.091352864959447
16885,703-004-5381,5759.4023,3,0,3,0.27920371738274696
16952,703-004-5382,8676.681,6,1,5,0.6157695152485587
17412,703-004-5392,6412.123,3,3,0,1.7242558133399137
17641,703-004-5393,8592.284,6,2,4,0.8002540398203244
17646,703-004-5388,5147.522,7,5,2,1.4874698637229593
18252,207-008-2399,545.56665,1,0,1,0.27920371738274696
18261,703-004-5383,4206.922,6,4,2,1.6731054340820237
1838,703-004-5382,4857.089,6,3,3,0.7474888669255787
18401,703-004-5386,4824.5986,4,2,2,1.1320175421832381
18844,703-004-5392,9928.411,1,0,1,0.27920371738274696
18863,703-004-5380,6954.4917,6,4,2,1.2680503693982295
18897,703-004-5380,1184.5017,4,2,2,0.6149651003850802
19046,703-004-5394,9988.593,3,2,1,0.6302482396561095
19090,703-004-5394,1057.8687,3,2,1,1.2738460737599213
19586,703-004-5384,6911.154,5,5,0,1.1568547240948386
19753,207-008-2398,2172.8652,9,5,4,1.7604712543657255
20220,703-004-5397,2320.093,10,5,5,3.0689980553962943
20366,703-004-5393,4120.148,2,2,0,0.7268618745183931
20721,703-004-5393,4048.158,5,2,3,0.6779788278657615
20867,703-004-5390,6814.271,4,3,1,3.8845824655761616
21003,703-004-5394,6094.5874,2,0,2,0.27920371738274696
21142,207-008-2399,4480.3887,6,2,4,1.598598809417769
21235,703-004-5399,4874.8696,4,1,3,0.7002566949323753
21359,703-004-5382,3887.5962,6,2,4,1.579579514622302
21403,703-004-5393,6910.6147,1,1,0,0.5961422254813828
2142,703-004-5398,1885.2776,2,1,1,0.6297422198135235
21511,207-008-2398,9824.603,7,2,5,0.98644852650934
21529,703-004-5395,1449.8103,4,2,2,0.702312197664047
21550,703-004-5381,6944.942,3,3,0,0.8919735026355653
21880,703-004-5396,1767.2819,7,1,6,0.5675400090242141
21906,703-004-5385,8356.924,6,2,4,0.38990861454758957
2218,703-004-5384,8240.955,6,1,5,0.35831143730785864
222,703-004-5394,3887.2935,3,1,2,0.7838128113218455
22472,703-004-5385,8376.55,4,0,4,0.27920371738274696
2255,703-004-5385,233.54947,5,2,3,0.6079392466913889
22574,703-004-5399,1939.7092,3,3,0,0.9696280972469367
22625,703-004-5384,3514.657,5,4,1,0.9161647398538688
22642,703-004-5389,189.46231,3,0,3,0.27920371738274696
22703,703-004-5385,8555.225,3,1,2,0.8953562949232549
22778,703-004-5395,1160.2688,4,1,3,0.40498508110004056
22845,703-004-5381,1469.0316,1,1,0,0.40724112958636094
2314,703-004-5398,3584.1204,4,1,3,0.35831143730785864
23599,703-004-5385,3448.5989,4,1,3,0.3978652972704144
23829,703-004-5383,2549.407,4,3,1,2.047467116747869
23957,703-004-5383,8274.569,4,4,0,1.472228258221888
24125,207-008-2398,842.61237,4,2,2,0.7109516069227922
24445,703-004-5390,5783.073,3,1,2,0.45006723977548607
25022,703-004-5396,9563.346,4,3,1,1.0387447567714378
25095,703-004-5382,6023.6157,3,3,0,0.645220332440458
25097,703-004-5391,2032.4075,5,4,1,1.0513068780169894
25207,703-004-5394,3394.5603,3,1,2,0.40506337327756176
25220,703-004-5386,8298.257,2,1,1,0.3978652972704144
253,703-004-5395,1557.2173,4,3,1,0.6084315030869951
25339,703-004-5391,3649.1865,6,4,2,0.9820681756610498
25425,207-008-2399,4075.0068,4,1,3,0.3525563506833067
25500,703-004-5382,6053.445,4,1,3,0.7431479663227173
25577,703-004-5394,7275.178,3,1,2,0.6825660239888841
25683,703-004-5397,8083.4873,4,1,3,0.35831143730785864
25843,703-004-5389,6854.176,4,3,1,1.436921720378782
25940,703-004-5382,7868.0254,10,7,3,1.7773672083642664
25988,703-004-5392,6561.041,5,0,5,0.27920371738274696
26299,703-004-5394,4416.7153,2,1,1,2.2327793681535426
26806,703-004-5389,1811.0245,4,3,1,1.2317347767986242
26994,703-004-5383,4225.32,5,3,2,0.8873076958248376
2757,703-004-5389,9717.196,8,5,3,1.3632406019994916
27912,703-004-5382,2682.33,2,1,1,0.6617305108671128
28141,703-004-5385,1901.1473,5,3,2,0.9752548677587068
28296,703-004-5388,2510.581,4,1,3,1.1002012170668318
28312,207-008-2398,4715.0796,6,1,5,0.6601716638445988
28416,703-004-5398,7127.153,2,2,0,0.804404038464289
28531,703-004-5382,6598.3037,1,0,1,0.27920371738274696
28665,207-008-2399,8619.903,3,2,1,1.8803369802792145
28744,703-004-5389,5402.019,1,0,1,0.27920371738274696
28983,703-004-5397,366.9071,1,1,0,0.6613695598274296
29071,703-004-5384,7037.847,3,3,0,2.0454406626587787
29699,703-004-5394,1382.2913,4,2,2,0.5207645393170907
29780,703-004-5398,2937.8975,6,4,2,3.160614782254233
29883,703-004-5397,2684.6946,5,3,2,2.4304392462809092
29988,703-004-5381,7630.408,3,1,2,0.4657313250795166
30160,703-004-5390,9204.266,4,2,2,1.0584462589379176
3077,207-008-2399,9722.844,4,2,2,1.0577408057394118
30977,703-004-5381,8144.93,4,3,1,1.0732377749348712
31069,703-004-5380,2680.5151,2,2,0,0.8906038715774106
3108,703-004-5392,6966.388,5,1,4,0.7536738722782799
31186,703-004-5385,8033.464,4,4,0,0.932201550230076
31652,703-004-5385,3560.2708,3,1,2,0.6915199479076818
31728,703-004-5383,5673.17,1,0,1,0.27920371738274696
31862,703-004-5394,9206.573,1,1,0,0.5150874360831983
31963,703-004-5399,9153.366,6,5,1,2.0631820204336417
32132,703-004-5380,3088.187,3,1,2,1.1441134518612521
32145,703-004-5392,5855.0684,1,1,0,0.8670582786427444
32176,703-004-5394,1356.3037,3,1,2,0.7854931249034613
32917,703-004-5385,128.1923,6,2,4,0.8870540312069034
33157,703-004-5393,1300.227,2,1,1,0.4854233473746404
33356,207-008-2398,9267.293,8,4,4,1.1081949421109094
33358,703-004-5385,933.59827,3,3,0,1.34810625056512
33469,703-004-5388,818.761,2,1,1,0.5184517989164558
33508,703-004-5389,3796.2896,4,2,2,1.0370408426686735
33547,703-004-5385,6760.4106,4,1,3,0.47526493109036183
33705,703-004-5384,1091.1035,4,3,1,1.0668202218325706
33910,703-004-5392,1023.33307,3,0,3,0.27920371738274696
3428,703-004-5398,7353.0,6,3,3,0.9367421904203967
3432,703-004-5391,505.8825,7,1,6,0.5165268771580819
34500,703-004-5386,4645.623,"","","",0.27920371738274696
34594,207-008-2398,4402.477,1,0,1,0.27920371738274696
34670,703-004-5398,7405.4546,3,2,1,0.841826153616322
3481,703-004-5389,3989.6453,4,2,2,0.47697301719552604
34931,703-004-5385,2464.5417,3,2,1,0.6838441134428157
35045,703-004-5391,2872.7168,7,2,5,0.7457321680648699
3516,703-004-5389,1785.745,5,4,1,3.0118962091336776
35533,703-004-5386,2809.651,4,2,2,0.9123039199539642
35776,703-004-5390,5773.188,7,5,2,1.6592048105085317
35899,703-004-5383,5948.2017,3,2,1,0.3712653264455956
362,703-004-5393,3308.6025,4,2,2,0.949911811762112
36471,703-004-5396,8974.702,6,2,4,1.414007235028392
36518,703-004-5388,5881.1406,7,3,4,1.9005617656691685
36562,703-004-5380,4278.443,5,3,2,1.1215780822935904
36841,703-004-5397,8964.84,6,5,1,1.7010349347443001
37076,703-004-5393,8148.2524,4,3,1,1.2592112403383182
37117,703-004-5397,4105.8936,4,1,3,0.35831143730785864
37327,703-004-5391,7713.0234,1,0,1,0.27920371738274696
37698,703-004-5384,1594.2985,3,0,3,0.27920371738274696
37737,703-004-5398,4638.671,1,1,0,0.5454804180160976
3779,703-004-5396,4006.7815,4,3,1,0.7877055674808097
37879,703-004-5393,3331.5444,2,0,2,0.27920371738274696
38053,703-004-5398,6530.961,2,0,2,0.27920371738274696
38058,703-004-5392,6897.227,7,2,5,0.9809274414830647
38105,703-004-5398,3117.4124,5,3,2,0.9113728501361656
38177,703-004-5395,1897.7803,2,1,1,0.44829646872267315
38532,703-004-5386,8460.422,3,3,0,0.7110000219739814
38594,703-004-5393,6209.0654,5,1,4,0.35831143730785864
38610,703-004-5399,6651.967,7,4,3,1.5552530929159671
38742,703-004-5394,8740.53,2,2,0,1.6568942865162877
38783,703-004-5390,1853.0201,3,3,0,0.8180875102674071
40273,703-004-5393,8052.785,2,0,2,0.27920371738274696
40647,703-004-5391,3841.69,2,1,1,0.4901125697597904
40768,703-004-5390,9249.747,1,1,0,0.8539870609308707
40807,703-004-5389,1305.5027,4,3,1,0.6958181729076002
40835,703-004-5394,9382.725,1,1,0,0.6718690170050885
41197,703-004-5387,9551.635,4,3,1,1.1085173688046355
4124,703-004-5383,3683.2322,6,5,1,2.9194619352162627
41449,703-004-5395,202.56221,4,2,2,0.6154654801432029
41618,703-004-5392,3245.4949,7,7,0,2.2042274225910674
42020,703-004-5384,6432.8237,5,3,2,1.5163955092654766
42306,703-004-5393,2867.0203,5,3,2,1.4580546804837016
42454,703-004-5388,8189.214,3,2,1,0.9404150405040507
42629,703-004-5394,7814.977,6,3,3,0.8501326994032194
42907,703-004-5393,8261.509,2,2,0,0.8806381967352142
42965,703-004-5399,1756.8881,4,2,2,0.4701396758676199
43303,703-004-5399,3894.316,5,3,2,2.0575768274147084
4339,703-004-5398,4596.3164,"","","",0.27920371738274696
43472,703-004-5381,7733.9136,5,3,2,0.9934709594429958
43897,703-004-5393,373.1507,5,4,1,1.1299549812530472
43907,207-008-2398,5926.3027,2,2,0,0.5440638011431322
43956,703-004-5397,70.346,9,5,4,1.8220662566306436
4470,703-004-5395,7180.9365,5,1,4,0.5873298793792827
44948,207-008-2399,3521.4531,4,2,2,0.6846151800024257
45236,703-004-5395,9398.134,1,1,0,0.3618589241232504
45365,703-004-5395,4851.59,3,1,2,0.5602181145937226
45386,703-004-5381,4259.42,2,0,2,0.27920371738274696
45904,703-004-5391,2410.6716,6,4,2,1.3625173544621738
45957,703-004-5380,1192.7473,6,3,3,1.1186443168066924
45984,703-004-5386,4073.1782,2,1,1,0.8295625818984561
46296,207-008-2399,8146.316,2,0,2,0.27920371738274696
46554,703-004-5383,463.14835,4,2,2,1.6169778811959583
46869,207-008-2398,3721.674,3,1,2,0.5610261155448428
46914,703-004-5389,2947.5378,3,2,1,0.7306752010181811
47491,703-004-5396,4131.5254,4,3,1,1.0299010087698075
47610,703-004-5396,3489.7358,4,3,1,1.082973867318723
47652,703-004-5395,288.37384,2,2,0,0.4057760692629256
47930,703-004-5393,9915.115,4,1,3,0.5418743090840864
4801,703-004-5399,7616.9575,2,1,1,0.38008938077997684
48021,703-004-5393,9099.57,6,5,1,1.707649572205758
48121,703-004-5397,7485.5,3,1,2,0.4087426087601173
48295,703-004-5396,6344.2725,1,0,1,0.27920371738274696
48488,703-004-5385,483.79837,3,3,0,0.9068015789166548
48693,703-004-5392,6408.7896,4,2,2,0.7769915948260926
49185,703-004-5395,2585.653,5,3,2,1.492688477696526
49496,703-004-5396,357.0092,5,3,2,0.5794504760485144
49859,703-004-5383,4134.7573,8,3,5,1.1072801347079237
49948,703-004-5394,1413.7363,7,4,3,2.182426390638711
5206,703-004-5395,8340.922,5,4,1,0.9586311286197943
5272,703-004-5397,6816.142,1,1,0,0.9128318305188095
5343,703-004-5384,1759.7025,4,1,3,1.1022775599235708
5633,703-004-5389,8731.398,3,1,2,0.8678899367741805
5783,703-004-5386,2612.8013,4,3,1,2.1148486486415945
5918,703-004-5387,2953.6123,7,4,3,2.22842124950424
6189,703-004-5393,4479.482,1,0,1,0.27920371738274696
6202,703-004-5382,3659.8533,7,2,5,0.6794969146532969
6235,703-004-5399,6821.239,6,3,3,1.6727363278098966
6540,703-004-5383,4995.936,5,4,1,1.412426372117719
6634,703-004-5387,4326.2563,2,2,0,2.0829353918058358
6923,207-008-2398,304.7371,5,3,2,1.2191724229230163
6940,703-004-5390,3454.8325,4,1,3,0.6705572640709431
7085,703-004-5395,4877.274,3,3,0,0.9010740057857255
7193,703-004-5392,30.20823,"","","",0.27920371738274696
7265,703-004-5382,5454.3184,3,2,1,0.6162792049462044
7339,703-004-5385,2620.266,3,2,1,0.5657679012168244
7512,703-004-5387,4933.3203,3,1,2,0.3978652972704144
7961,703-004-5393,2620.0093,6,3,3,1.1183225840370172
8158,703-004-5393,5956.9746,2,1,1,0.4541493412787991
8239,703-004-5397,4203.1816,4,3,1,1.3679795209236
8440,207-008-2399,498.4069,10,5,5,3.317624334265101
8740,703-004-5381,852.74457,7,3,4,1.186549903910588
8818,703-004-5399,3599.45,8,7,1,3.9537300035302216
9059,703-004-5392,4283.083,4,3,1,1.1217200719033549
9099,703-004-5394,7213.097,7,3,4,1.0366991073190421
9222,703-004-5399,2358.2773,1,0,1,0.27920371738274696
9688,703-004-5389,7735.9624,"","","",0.27920371738274696
969,703-004-5388,6049.027,2,1,1,0.3743585701408674
10085,703-004-5384,5935.6484,5,0,5,0.27920371738274696
10199,703-004-5394,5523.423,4,2,2,1.099118882787918
103,703-004-5395,2563.5886,6,2,4,0.8696836356252121
10348,703-004-5388,8848.706,2,1,1,0.5522911282882418
10645,703-004-5395,7092.223,4,3,1,1.612962193583462
10678,703-004-5390,8073.051,9,5,4,3.3570112287378575
10885,703-004-5395,7004.009,4,2,2,2.2477981794259048
11039,703-004-5385,794.5186,5,2,3,0.7182240921661215
11179,703-004-5386,3128.2407,5,2,3,0.6384870092334775
11269,703-004-5387,3091.764,4,3,1,1.1927743783794256
11317,703-004-5380,1044.8373,3,2,1,0.4373507747836631
11495,703-004-5392,6047.0825,1,0,1,0.27920371738274696
11565,703-004-5394,7829.208,5,2,3,2.4419553094511324
11800,703-004-5386,323.67526,6,1,5,1.2609678772119939
11948,703-004-5393,9001.64,4,3,1,1.8301713966601354
12133,703-004-5382,3739.59,1,1,0,0.42050988209897766
1231,703-004-5391,9622.549,9,3,6,1.4735641305147955
12478,703-004-5396,2151.9768,5,3,2,2.274368665236178
12988,703-004-5399,978.5807,3,3,0,0.9329314928407403
13117,703-004-5380,551.0265,2,0,2,0.27920371738274696
13566,207-008-2398,9927.44,1,1,0,0.7748192045148427
1397,703-004-5386,4288.8965,5,2,3,0.8843624718873512
14268,703-004-5381,5905.0874,3,1,2,0.6176665292142264
1461,703-004-5387,4481.517,5,0,5,0.27920371738274696
14763,703-004-5391,8803.967,3,2,1,0.5527490905838213
14858,207-008-2398,2923.2122,7,4,3,1.6409652012727374
14882,703-004-5392,8433.818,4,0,4,0.27920371738274696
15084,703-004-5397,289.75726,4,4,0,1.475296962808906
15481,703-004-5383,4842.9556,2,0,2,0.27920371738274696
15646,703-004-5390,723.5074,6,1,5,0.6803390853267596
15657,703-004-5398,3430.276,3,1,2,0.490507698920142
15875,703-004-5384,1447.2949,4,3,1,0.6784579575326223
16008,703-004-5399,9518.2,5,2,3,0.8588436861999127
16198,703-004-5394,3648.8027,3,1,2,0.6764383619336259
1627,207-008-2399,1015.85626,1,1,0,0.33853450732658075
16500,703-004-5395,760.97485,5,1,4,1.0680941737330725
16555,703-004-5397,2177.323,6,2,4,0.9249104512971039
16650,703-004-5398,8122.485,6,5,1,2.570652946779882
16813,703-004-5390,3624.8582,1,1,0,0.3896005611942858
17396,703-004-5393,3370.1753,6,6,0,2.153526704471022
17573,703-004-5383,5532.9243,"","","",0.27920371738274696
17768,703-004-5380,2545.0845,5,2,3,0.44103332938414264
17808,207-008-2398,3834.0188,5,3,2,0.8771294194282997
1802,703-004-5390,9733.534,6,3,3,1.609419535325412
18139,703-004-5393,5877.108,3,0,3,0.27920371738274696
1817,703-004-5388,953.13904,2,1,1,0.3187575773453028
18240,703-004-5388,8984.42,3,2,1,1.1502667077408455
18517,703-004-5384,851.90295,2,0,2,0.27920371738274696
18860,703-004-5392,8883.878,6,1,5,1.1902301189151576
18927,703-004-5394,9455.35,3,2,1,0.6829141369657992
20189,703-004-5385,4522.5107,4,0,4,0.27920371738274696
20196,703-004-5388,3322.2134,2,0,2,0.27920371738274696
20199,703-004-5385,2112.9739,5,2,3,1.403999839022381
20233,703-004-5393,307.706,3,2,1,0.73569006417105
20295,703-004-5381,8567.258,7,5,2,1.8773976784110247
20322,703-004-5383,1571.2965,8,6,2,4.077878612663713
20561,703-004-5392,1823.0695,4,2,2,0.6322417436079663
20847,207-008-2399,8080.0615,3,0,3,0.27920371738274696
21127,703-004-5398,1341.4078,5,3,2,1.0201933006701338
2152,703-004-5385,2133.8247,6,3,3,1.0891673090945229
22137,703-004-5396,7292.9307,6,4,2,1.8428499688493916
22289,703-004-5396,8548.351,5,0,5,0.27920371738274696
22493,703-004-5392,1402.3322,5,3,2,0.8093830375675508
23261,703-004-5393,2056.4873,2,0,2,0.27920371738274696
23263,703-004-5394,572.6486,4,3,1,0.9180424291692224
2328,703-004-5393,4040.63,3,2,1,0.5956345970831934
23498,703-004-5399,4555.5747,9,2,7,1.0376745521272
23500,703-004-5398,6318.768,4,2,2,0.5045701281260702
23707,207-008-2399,7154.809,3,1,2,0.7284340355674369
23774,703-004-5388,8197.0205,3,3,0,1.126457533457308
23794,703-004-5393,8937.438,3,1,2,0.4180377658513179
2435,703-004-5386,39.514305,4,1,3,1.6701606256338088
24490,703-004-5394,6857.808,2,1,1,0.3978652972704144
24693,703-004-5397,9477.77,4,1,3,0.6794808102661176
24847,703-004-5387,1636.2941,6,5,1,1.254099307663265
24914,703-004-5394,5588.0127,7,2,5,0.7025332954454867
24972,703-004-5380,6013.507,1,0,1,0.27920371738274696
2507,703-004-5383,9253.7,2,0,2,0.27920371738274696
25238,703-004-5398,5223.0234,1,0,1,0.27920371738274696
25387,703-004-5395,1266.3687,4,1,3,0.3978652972704144
25574,703-004-5396,4280.777,6,3,3,2.107833254603289
2629,703-004-5397,1320.3478,5,4,1,1.7685662248030773
26383,703-004-5384,1384.247,1,1,0,0.3187575773453028
26490,703-004-5384,1513.474,2,1,1,0.4658826324613648
26898,703-004-5399,3771.9263,3,2,1,0.49875945129238564
27058,703-004-5385,5881.7393,"","","",0.27920371738274696
27605,703-004-5389,4369.5825,2,1,1,0.35831143730785864
27763,703-004-5398,6703.648,4,3,1,1.1132370214320186
27861,207-008-2399,5487.276,7,2,5,1.8274577899199884
27870,703-004-5385,1581.9001,1,1,0,0.35831143730785864
27937,703-004-5386,8819.723,4,2,2,0.9832768833188069
28366,703-004-5399,9025.944,3,2,1,2.074962458947311
28373,703-004-5397,6707.3535,5,4,1,1.5486778353087343
28587,703-004-5397,5880.98,9,7,2,2.858591540028363
28686,703-004-5383,3983.0566,6,3,3,0.6170563084079145
28845,703-004-5384,1882.1973,3,1,2,0.49750245431745643
28857,703-004-5385,9644.147,2,2,0,2.433992216093653
29005,703-004-5386,6656.666,2,1,1,0.3851240101299761
29083,703-004-5383,4998.947,2,0,2,0.27920371738274696
29296,703-004-5390,272.19177,3,2,1,0.48488097755754955
29792,703-004-5381,4511.155,7,2,5,0.7538500369334169
29926,703-004-5397,7017.387,5,3,2,1.478530409467919
30072,703-004-5393,5136.14,3,2,1,1.2320756884444164
30109,703-004-5384,7246.989,8,2,6,1.0776125553880072
3053,703-004-5384,7239.155,4,3,1,0.6639686617287259
30789,703-004-5399,7837.0225,2,1,1,0.4063239498262308
3079,703-004-5393,5869.639,4,0,4,0.27920371738274696
31011,207-008-2398,8569.925,8,6,2,2.7174567406698626
31474,703-004-5395,1808.3685,6,4,2,3.3385129507237763
31831,703-004-5396,4296.438,5,2,3,0.9682752474796313
31993,703-004-5389,3171.8623,1,0,1,0.27920371738274696
3240,703-004-5385,8651.442,3,2,1,0.5719697871278175
32502,703-004-5397,9340.612,2,2,0,0.7827902778060202
32508,703-004-5398,3423.2659,4,1,3,1.0033557198035876
32563,703-004-5397,1793.9169,3,1,2,0.35831143730785864
32778,703-004-5395,3495.2415,4,3,1,1.7180697666033415
32908,703-004-5399,2096.7668,6,1,5,1.038749733136488
33219,703-004-5386,1421.6238,3,0,3,0.27920371738274696
33425,207-008-2399,2779.23,4,1,3,0.32666834933781397
33459,703-004-5389,7320.9243,4,2,2,0.705827063978598
33601,703-004-5383,6512.946,4,1,3,1.571882266743718
33609,703-004-5391,8497.356,1,0,1,0.27920371738274696
33712,703-004-5380,7659.777,5,2,3,0.9213647063658801
33890,703-004-5391,7915.5005,1,1,0,0.3919322182760311
34007,703-004-5389,9735.031,2,0,2,0.27920371738274696
34265,703-004-5393,4701.824,8,2,6,0.43661053491499563
34322,703-004-5385,6438.3047,1,1,0,0.3978652972704144
34489,703-004-5384,9808.635,6,4,2,1.1393989805953941
34699,703-004-5381,6882.0493,6,3,3,1.6408648088230289
34853,703-004-5385,8628.931,2,1,1,0.40476817716827035
3495,703-004-5384,3167.2632,5,1,4,0.4615539664815064
35348,703-004-5384,5796.721,1,1,0,0.7282858788870235
35716,703-004-5383,612.1981,5,3,2,2.7122632640717166
35927,703-004-5392,3626.7532,4,4,0,1.9430114500654225
36580,703-004-5393,5392.0635,3,1,2,0.46288106204689533
36695,703-004-5394,2241.1328,5,3,2,0.6209238783805859
369,703-004-5392,593.52997,6,1,5,0.6236470572789358
37309,703-004-5399,3721.7122,3,1,2,0.35831143730785864
37491,703-004-5396,858.9506,6,5,1,4.7948599256935065
3763,207-008-2398,4034.629,1,1,0,0.7919270304434824
37748,703-004-5396,3398.6729,6,3,3,0.6604652276490083
37948,703-004-5384,8606.631,4,0,4,0.27920371738274696
38,703-004-5390,830.3344,5,3,2,1.1916605270644294
38081,703-004-5382,9988.656,10,5,5,1.9203442809614177
38226,703-004-5385,715.3517,4,3,1,1.635725610936412
38294,703-004-5392,2660.4307,3,2,1,1.3723016802724972
38410,703-004-5391,3945.9568,4,1,3,0.9642898979996983
38465,703-004-5396,7733.7993,6,4,2,2.0096949602869456
38508,703-004-5391,8048.3125,6,2,4,1.1424004061879935
38595,703-004-5382,3390.4993,4,1,3,0.40217534954433426
38655,703-004-5397,4699.4795,3,1,2,1.0940718571434007
38761,703-004-5381,3520.0857,3,2,1,0.571121443006726
38787,703-004-5396,9591.638,4,1,3,0.4606333005828856
3880,703-004-5387,7408.571,2,1,1,0.9497952761458484
38868,703-004-5390,9495.364,4,2,2,0.5349589879890235
38905,703-004-5384,44.91985,3,3,0,1.3259539096962234
3899,703-004-5382,6088.3657,3,3,0,1.4354867413205195
39407,703-004-5398,6950.263,4,1,3,0.6580765108823301
39820,703-004-5381,5670.1455,6,5,1,2.276254081264451
40,703-004-5397,4959.5396,3,3,0,3.16746404196391
40115,703-004-5392,5032.789,5,4,1,1.1173344085801404
40207,703-004-5384,4943.629,1,1,0,0.6156262381415722
40369,703-004-5394,3964.2656,3,2,1,1.3553773992504785
40393,703-004-5398,5667.277,4,1,3,0.35534489781066697
40428,703-004-5390,1040.1827,2,0,2,0.27920371738274696
40568,703-004-5397,401.81757,3,2,1,1.4514671339249834
40760,703-004-5394,6103.9478,3,1,2,1.0022732360603732
41002,703-004-5388,905.2378,2,1,1,0.44829646872267315
41149,703-004-5398,7649.365,4,3,1,0.6402616758855895
41167,703-004-5390,3495.5085,5,1,4,0.37175974969512765
41184,703-004-5395,7149.8013,6,2,4,0.5686936514274665
41304,703-004-5389,960.04364,2,1,1,0.7488254634405138
41546,703-004-5393,3862.1013,4,2,2,0.8296052996363358
41762,703-004-5386,6377.984,2,1,1,0.4002776176136768
41768,703-004-5393,6893.6816,3,1,2,0.5333164663902169
42565,703-004-5380,4535.4556,5,1,4,0.8210991354534813
42827,703-004-5396,5944.124,2,1,1,0.7187469925028842
42853,703-004-5399,271.0855,4,3,1,1.3138841731355115
42887,703-004-5397,2911.5576,4,2,2,1.1310795668016824
42892,207-008-2399,6658.0356,6,3,3,1.1801666464811655
43280,703-004-5385,5553.4707,3,2,1,0.5763524954471246
43290,703-004-5381,3433.5364,7,5,2,2.6168673598921774
43324,703-004-5387,9723.915,6,2,4,0.6558449402525844
43351,703-004-5381,8188.1553,7,5,2,1.5822235005789893
43373,703-004-5383,8206.399,"","","",0.27920371738274696
43535,207-008-2399,3493.2876,3,2,1,1.1995731758101051
43585,703-004-5397,7969.2695,1,1,0,1.6515843497652793
43591,703-004-5390,411.44193,7,3,4,0.9985539359662441
43610,207-008-2399,4628.1006,4,2,2,0.9601182611350593
43940,703-004-5386,6575.9194,6,0,6,0.27920371738274696
43949,703-004-5399,9668.217,6,2,4,1.2099327036496792
44133,703-004-5383,3412.3594,6,3,3,1.4534828025768105
44227,703-004-5382,5198.501,1,1,0,0.6221320886877898
4427,703-004-5389,2691.6301,5,3,2,1.507185579471199
44297,703-004-5394,9293.151,5,2,3,0.7649772464673114
44367,703-004-5396,7001.8027,5,2,3,1.508368868405184
44628,703-004-5390,4169.757,4,2,2,0.6656595001788261
44788,703-004-5391,2283.8086,6,4,2,1.940152375811163
44834,703-004-5391,5128.9473,2,1,1,0.5781823596576786
44958,703-004-5386,6248.3354,7,4,3,2.1047386733808664
45038,703-004-5384,7110.2554,4,1,3,0.4517835740987158
4533,703-004-5382,9260.347,3,1,2,0.3896447485111028
45506,703-004-5387,1031.4822,4,4,0,1.201306750950736
45614,703-004-5395,6126.1396,6,2,4,2.1458003583021688
45773,703-004-5397,3156.361,8,4,4,2.3885611282706014
45879,703-004-5388,9029.599,"","","",0.27920371738274696
4614,703-004-5382,6194.7573,2,2,0,0.5072110597330259
46267,703-004-5393,8341.782,2,2,0,0.8008326396056693
46419,703-004-5399,1012.78125,8,6,2,2.1273452524189667
47121,207-008-2399,4348.119,3,1,2,0.3554141170656014
47382,703-004-5384,3200.516,5,2,3,0.5514070074634007
47702,703-004-5392,3633.7446,4,1,3,0.7305437686348614
47771,703-004-5389,6557.26,5,5,0,2.3547374036379347
47951,703-004-5382,8535.688,1,1,0,0.35831143730785864
48283,703-004-5399,7539.317,1,1,0,0.5165268771580819
48552,703-004-5392,1087.1309,3,1,2,0.6080544890118375
48878,703-004-5385,3809.3286,3,1,2,0.4470623219109421
49228,703-004-5386,6336.5327,8,5,3,0.8276065036981392
49297,703-004-5391,6282.7993,2,0,2,0.27920371738274696
49298,703-004-5380,3779.1216,2,2,0,2.2241486757184643
49420,703-004-5385,1886.2098,4,3,1,2.157402593848352
49506,703-004-5385,7963.8784,2,0,2,0.27920371738274696
49574,703-004-5386,9095.172,2,0,2,0.27920371738274696
5200,703-004-5398,1598.3516,4,3,1,1.7653550451598707
5305,703-004-5386,366.01068,3,1,2,0.3672334675933156
5888,207-008-2399,6083.105,3,2,1,0.9558263337615432
6354,703-004-5383,4568.5117,6,3,3,0.8087904569782001
6618,703-004-5381,1265.5813,4,3,1,1.0580482333878036
6725,703-004-5380,3087.0044,5,4,1,1.7328500569768828
6874,703-004-5392,3933.0203,3,2,1,0.8230867701150417
6906,703-004-5382,2202.2021,3,1,2,0.518875283306792
7120,703-004-5391,7434.9067,1,1,0,1.0071568806154703
7240,703-004-5383,1879.1318,2,2,0,0.8629272851161852
7634,703-004-5387,3954.9744,3,2,1,0.9247744051594331
7793,703-004-5390,9937.554,2,2,0,0.8417132811436673
7941,207-008-2399,7529.905,"","","",0.27920371738274696
8667,703-004-5393,8457.91,8,6,2,2.19489304632799
8776,703-004-5381,3727.278,5,3,2,0.8432544502627003
8928,703-004-5393,9866.277,3,0,3,0.27920371738274696
8934,703-004-5394,7960.9067,2,2,0,0.7574840478174766
9098,703-004-5399,8380.656,5,2,3,1.3637045676459867
9128,703-004-5383,7307.075,3,0,3,0.27920371738274696
9146,703-004-5385,7247.0146,4,2,2,3.0264178219364624
941,703-004-5389,162.47093,3,3,0,0.8067923301539384
9520,207-008-2399,9223.652,3,2,1,0.9204706000156445
9555,703-004-5391,5851.478,3,1,2,0.3978652972704144
9912,703-004-5383,7639.733,3,1,2,0.5308290344282175
9929,703-004-5399,5674.658,2,2,0,0.9982182264632852
9982,703-004-5394,9689.661,3,2,1,0.5723677533747645
10099,703-004-5395,3862.124,2,0,2,0.27920371738274696
10123,703-004-5386,1228.8684,6,4,2,1.3660918461471792
10198,703-004-5396,8175.9023,2,2,0,0.5005993199109771
10527,703-004-5392,162.15146,2,1,1,0.7241430831832724
1075,703-004-5398,3736.7856,3,2,1,0.6195389007631977
10898,703-004-5382,4131.5205,5,3,2,0.9347278399506481
10908,703-004-5380,9483.39,7,3,4,1.0853168933113193
11073,207-008-2399,1157.4852,5,3,2,0.6529681537352845
1115,703-004-5388,7088.1685,4,1,3,0.8608908849780842
11290,703-004-5383,3362.956,9,5,4,2.0364424869318567
11436,703-004-5390,1964.016,4,2,2,0.7230367684870098
11568,207-008-2399,2554.4512,4,1,3,0.7598542479571022
11626,703-004-5397,392.01855,4,0,4,0.27920371738274696
11785,703-004-5396,7368.0864,4,3,1,0.9230816216438723
11799,207-008-2398,9404.419,8,2,6,1.641012134324665
11838,703-004-5393,3000.086,4,2,2,1.0117243837933245
11895,703-004-5387,3405.285,2,1,1,1.4916577986815045
12162,207-008-2399,1608.2137,3,3,0,0.9970383523576244
12248,703-004-5391,8488.649,1,1,0,0.45900085134286905
12597,703-004-5394,4411.006,6,2,4,0.6721651944342456
12745,703-004-5393,999.8417,6,3,3,0.7233477665762557
13052,703-004-5380,8933.911,5,2,3,0.8502687714094117
13099,207-008-2398,5500.533,6,3,3,0.9245676140322407
13319,703-004-5391,7445.448,2,1,1,0.3919322182760311
13407,703-004-5388,6083.773,4,1,3,0.454814500828866
13453,703-004-5392,2931.6152,7,3,4,1.637837412055834
13783,703-004-5393,7572.577,6,5,1,2.184992015754971
13867,703-004-5395,8129.5083,5,4,1,2.2552923949911046
14376,703-004-5381,4115.3174,1,0,1,0.27920371738274696
14535,703-004-5390,6364.1836,4,1,3,0.428964519665974
14587,703-004-5382,8583.538,1,1,0,0.4412584567704295
15143,703-004-5397,8919.364,7,6,1,2.4852375514552283
15537,703-004-5390,9337.898,6,1,5,0.38271542381814605
15638,703-004-5391,9324.877,4,1,3,0.4423633897282897
15666,703-004-5385,809.4132,11,4,7,1.2922615561400939
16040,703-004-5390,8367.489,5,3,2,1.268638810645661
16384,703-004-5381,8134.976,3,3,0,0.9661721149643592
16409,703-004-5394,2857.0913,5,4,1,2.0734877488829127
16454,703-004-5387,2316.8916,2,0,2,0.27920371738274696
16709,703-004-5391,8173.658,1,1,0,0.8037035319195214
16821,703-004-5384,1810.1115,7,2,5,0.6144593914916854
17141,703-004-5389,483.3269,"","","",0.27920371738274696
1720,703-004-5383,6336.9067,2,1,1,0.5044488353783574
17279,703-004-5385,662.2481,4,2,2,0.5000586944218505
1743,703-004-5391,1650.408,3,2,1,0.5497057673469852
17649,703-004-5396,8334.133,2,1,1,0.3978652972704144
17858,207-008-2399,7877.305,2,1,1,0.40656631791996994
17975,703-004-5395,7811.2944,5,4,1,0.7232372515244269
18017,703-004-5390,130.1831,4,1,3,1.5208554836132895
18530,703-004-5391,4066.543,4,1,3,0.4284421867134667
18816,703-004-5390,4444.1436,5,5,0,1.8075425187599745
18903,703-004-5397,9703.946,4,2,2,0.791775155506449
19152,703-004-5384,7258.5576,4,2,2,1.582444270551829
19171,703-004-5386,4455.761,3,0,3,0.27920371738274696
19261,703-004-5388,8605.556,8,5,3,0.9722334900966811
19330,703-004-5394,68.004135,1,0,1,0.27920371738274696
19413,703-004-5393,8031.3726,1,1,0,0.5824149060580106
1949,703-004-5398,8440.088,3,1,2,0.6253567922832218
19907,703-004-5392,2323.7754,7,5,2,1.209797699907837
1993,703-004-5390,904.0308,7,4,3,1.758635268214717
20340,703-004-5383,7592.052,3,2,1,0.48984595036478185
20790,703-004-5383,1145.063,3,0,3,0.27920371738274696
20961,703-004-5398,5898.9053,3,1,2,0.9862932392358713
21105,703-004-5394,2125.4248,4,2,2,0.9588209164581435
21161,703-004-5394,4617.958,2,1,1,0.4498807911328027
21317,703-004-5396,648.93427,3,1,2,0.6189029433992307
21388,703-004-5381,9901.858,4,1,3,0.36721723609005286
21417,703-004-5396,4230.277,6,1,5,0.5193500201789302
21473,703-004-5393,6084.279,4,2,2,0.7336141195502739
21702,703-004-5397,7766.6025,9,4,5,1.203848571747869
22042,207-008-2399,4845.286,6,3,3,1.6199290210733894
2208,703-004-5398,4534.4336,7,5,2,2.0368635085013027
22221,703-004-5390,6193.395,5,0,5,0.27920371738274696
22321,703-004-5383,781.24164,3,2,1,0.6029673412827474
22371,703-004-5387,1098.3998,5,2,3,0.8839241680260224
22454,703-004-5385,9182.405,5,2,3,0.837299890158728
22588,703-004-5385,4378.098,4,0,4,0.27920371738274696
23040,207-008-2399,4823.485,3,2,1,1.0536856221266335
23066,703-004-5396,1695.0608,4,1,3,1.3745002147494045
23129,703-004-5381,6592.263,4,1,3,0.5961922914585438
23381,703-004-5385,2952.317,7,4,3,1.187120380787487
23806,703-004-5385,8576.706,9,7,2,1.6124838541408848
23876,703-004-5380,1535.2136,7,3,4,0.9303275623582689
23900,703-004-5380,480.17563,1,0,1,0.27920371738274696
23992,207-008-2398,80.05977,2,2,0,2.499068106956437
24456,703-004-5395,350.675,3,1,2,0.6570678419343638
24463,703-004-5386,420.93158,5,2,3,1.2800782835720814
24546,703-004-5394,3774.3455,5,1,4,0.4270965009222711
252,703-004-5396,1137.7102,2,1,1,0.35831143730785864
25560,703-004-5389,8628.878,2,2,0,0.9927708083389344
25569,703-004-5382,5207.2056,5,4,1,1.4317248689414954
25750,703-004-5381,672.301,1,0,1,0.27920371738274696
25778,703-004-5381,8612.113,4,0,4,0.27920371738274696
26081,703-004-5395,6676.458,4,2,2,0.7592901771258767
26457,703-004-5385,8514.327,4,2,2,2.121409912771468
26670,703-004-5397,2644.8108,3,1,2,0.8794006840944604
26970,703-004-5396,6728.8145,5,3,2,1.6407754986181604
27157,703-004-5388,1449.2339,6,4,2,1.1385333773203745
27362,703-004-5382,5330.289,4,2,2,0.9321722239695034
27486,703-004-5392,6974.0723,6,0,6,0.27920371738274696
27606,703-004-5384,70.04022,4,2,2,1.767734136784284
28063,703-004-5397,9142.919,8,4,4,1.2478670849858373
28064,703-004-5390,836.05945,6,3,3,1.4628362850643442
28218,703-004-5381,5628.4,2,2,0,0.9912419436149702
28258,207-008-2399,8191.8364,4,3,1,1.235052818861675
2828,703-004-5386,1226.1212,8,2,6,0.6366309479336678
28505,703-004-5399,3753.0535,7,5,2,0.7775514228637774
28717,703-004-5385,7902.753,6,4,2,1.1090750270207266
29062,703-004-5391,4535.466,6,2,4,0.8197939562100087
29063,703-004-5395,5894.7656,5,2,3,0.545287384895464
29174,207-008-2398,6248.158,4,2,2,0.6424309069618409
29738,703-004-5395,6570.834,6,2,4,1.6360654253778406
29882,703-004-5397,5055.7363,3,2,1,0.5869008575918364
30011,703-004-5383,6925.74,"","","",0.27920371738274696
30184,703-004-5384,145.91455,5,3,2,1.0320733407838827
30454,703-004-5389,8927.004,3,1,2,0.6624691376373685
31235,703-004-5390,8427.436,4,2,2,0.5376835118678864
31347,703-004-5387,8386.832,3,2,1,0.9296270815919488
31455,703-004-5385,2511.4573,4,3,1,2.565890489282706
31509,703-004-5387,4085.8281,7,5,2,1.8427976093840643
31937,703-004-5395,1225.3213,4,2,2,0.6874158028990359
32175,703-004-5387,2641.7178,5,3,2,1.916903586569542
32577,703-004-5390,5558.557,1,1,0,0.8285219261673161
32630,207-008-2399,5352.8335,5,4,1,0.9669711173928478
32714,703-004-5397,2750.6494,4,3,1,1.1011852646764488
32849,703-004-5391,5034.0635,8,5,3,1.4985349541801583
33044,703-004-5388,2853.1306,6,4,2,1.3916412482663403
33182,703-004-5385,3784.9062,9,5,4,2.313216298084078
33242,703-004-5393,9357.647,3,3,0,1.3479688026432322
33400,703-004-5388,3886.2031,5,2,3,0.7643001341137514
33479,703-004-5386,5137.872,6,3,3,4.038211217990006
33696,703-004-5396,5147.671,8,3,5,0.9792890310139128
33860,703-004-5383,2122.3616,6,3,3,1.5539152461735193
33894,207-008-2398,8334.036,6,3,3,0.9210250118598077
34054,703-004-5386,8863.904,7,5,2,2.405640131520903
34079,207-008-2398,5479.729,2,1,1,0.4234867220805346
34287,703-004-5397,8958.488,2,2,0,0.5121507246480824
34860,703-004-5386,544.31616,5,4,1,5.17407748765022
34946,703-004-5399,2811.838,1,1,0,0.38865920434732637
35065,703-004-5381,1915.8853,6,4,2,2.7269441660791096
35198,703-004-5388,4559.163,3,2,1,1.444126129185686
35255,703-004-5396,355.22937,9,6,3,3.352602210707105
35304,703-004-5394,8937.837,4,3,1,1.1719027586850668
35487,703-004-5382,443.29645,5,4,1,0.9111821086536253
35684,703-004-5382,8148.7783,1,0,1,0.27920371738274696
35804,207-008-2398,1303.3718,4,2,2,1.916924708286229
35813,207-008-2398,3690.2922,4,0,4,0.27920371738274696
35857,703-004-5386,4241.905,4,2,2,1.4237622588256826
36093,703-004-5397,6564.95,2,2,0,0.5098686440643849
36194,703-004-5391,1016.4875,4,2,2,0.6354905220061439
36326,207-008-2399,464.9383,5,2,3,0.6086230958483979
36380,703-004-5396,9401.759,6,3,3,1.3155831324499832
36568,703-004-5385,2787.2253,2,2,0,0.628025423299261
36577,703-004-5380,882.20654,4,3,1,0.6890274034204573
36721,703-004-5393,5291.866,5,2,3,0.7825406129772267
36725,703-004-5386,1414.4128,7,1,6,0.5374549911269816
36817,703-004-5397,3216.5295,3,2,1,0.6201447232361157
36898,703-004-5384,1400.8331,2,1,1,0.5774466541326354
36975,703-004-5391,3150.6592,3,2,1,0.7147014262665846
36988,703-004-5383,1443.4808,6,1,5,0.3457389603911891
3710,703-004-5389,5169.109,5,2,3,0.7927188091307596
37187,703-004-5381,8526.854,3,1,2,0.33853450732658075
37409,703-004-5392,4843.282,6,4,2,1.721902529314177
37503,703-004-5397,1170.063,8,4,4,1.645751680468069
37810,207-008-2399,3761.214,6,3,3,1.843484960146595
3784,703-004-5397,8006.706,4,1,3,0.36951836429724944
38329,703-004-5381,5767.7686,1,1,0,1.2868118031355118
38386,703-004-5392,7485.329,2,1,1,0.44113374924509363
3839,703-004-5385,1120.7068,2,1,1,0.5681548723242101
38692,703-004-5385,4815.803,2,0,2,0.27920371738274696
38843,703-004-5396,3580.914,7,2,5,1.0146550112004364
3888,703-004-5393,7629.932,2,1,1,0.3978652972704144
39,703-004-5386,573.6703,4,3,1,1.2596995516658893
39031,703-004-5386,6156.333,2,1,1,0.47099049587618946
3932,703-004-5389,6987.777,2,1,1,0.4705326329403791
39646,703-004-5394,4802.718,4,1,3,0.3978652972704144
39860,703-004-5397,2618.651,6,5,1,1.5705951436794918
40165,703-004-5395,6485.124,5,1,4,0.5258945435655761
40234,703-004-5386,3708.7322,1,0,1,0.27920371738274696
40300,703-004-5392,6395.5386,1,1,0,1.3245287013726335
40848,703-004-5398,9898.281,4,3,1,1.1135595483134113
41182,703-004-5388,2439.339,3,2,1,0.6548860272626719
41471,703-004-5382,2920.4702,2,1,1,0.4951648201723722
41817,703-004-5392,9718.29,2,1,1,0.5836286618833184
41875,703-004-5384,1051.3132,6,1,5,0.3902511792276225
4220,703-004-5380,7626.9688,4,3,1,2.437074101000553
42368,703-004-5386,3270.8083,7,4,3,1.439976365149696
42381,703-004-5384,8887.285,2,1,1,0.5837684390944268
4254,703-004-5394,8279.852,6,3,3,1.1346600678475918
42550,207-008-2398,8901.193,4,3,1,1.1041942288914108
426,703-004-5385,1715.5498,4,2,2,1.4424998519570045
42764,703-004-5380,4607.677,3,3,0,1.4255149837163048
43106,703-004-5382,3219.8596,2,2,0,0.5651368293402715
43145,703-004-5382,3746.904,5,2,3,0.4809093575961903
43172,703-004-5382,7813.0166,5,1,4,0.5277902482150109
43229,703-004-5385,5256.247,4,2,2,0.7470519308656298
43387,703-004-5390,6531.9395,3,1,2,0.9238446348213611
43393,703-004-5384,9614.642,4,3,1,0.7859468646338468
43647,703-004-5382,7407.8726,3,2,1,1.6255677585504678
43666,703-004-5395,424.30817,3,1,2,0.43371804605075964
43822,703-004-5384,1207.496,6,3,3,1.5181696536964568
43836,703-004-5382,1383.7975,11,7,4,2.265832275023104
44024,703-004-5385,9583.9795,1,1,0,0.4524502497731667
44914,703-004-5392,6323.7812,2,0,2,0.27920371738274696
4500,703-004-5394,4637.4355,1,0,1,0.27920371738274696
45007,703-004-5385,1339.9071,5,2,3,0.49335779543267444
45324,703-004-5383,7062.468,2,1,1,0.5120696476608122
45389,703-004-5383,660.2144,4,2,2,1.4753574219522712
46175,703-004-5395,1759.6936,7,5,2,1.5188279003978973
46301,703-004-5383,8323.089,3,2,1,1.1119874073473144
46639,703-004-5388,3486.2583,6,4,2,0.9279891250209024
46674,703-004-5384,1477.105,6,4,2,1.1057883689021706
46684,703-004-5394,6513.2812,4,1,3,0.3842955421724792
4671,703-004-5382,995.84875,4,1,3,0.35831143730785864
4674,703-004-5382,6039.826,3,3,0,1.8809342438228278
4676,703-004-5386,2380.0833,5,1,4,0.4269193634591063
46797,703-004-5396,1107.2135,2,2,0,1.4034684477569739
47106,703-004-5386,1684.0989,5,3,2,0.9664126397035429
47137,703-004-5396,5235.266,3,2,1,0.5758061606414018
47379,703-004-5387,1961.5889,4,1,3,0.33853450732658075
47418,703-004-5383,9378.531,4,3,1,1.4505877187433798
47431,703-004-5386,7617.646,4,4,0,1.7539974163759322
47556,703-004-5384,1854.5842,2,0,2,0.27920371738274696
47703,703-004-5389,8031.374,4,0,4,0.27920371738274696
47793,703-004-5399,1657.0991,2,2,0,1.25813471683186
48006,703-004-5392,3149.867,4,1,3,0.7701783827574719
48203,703-004-5385,8314.318,6,1,5,0.8540795180785331
48367,703-004-5387,4250.745,3,1,2,0.6290668680430279
48618,703-004-5399,7410.2134,6,4,2,1.620608938911829
48839,703-004-5391,1304.4966,5,3,2,1.280327030877966
48848,703-004-5385,435.94836,4,4,0,1.9555992423988249
4908,703-004-5397,1285.0214,3,0,3,0.27920371738274696
49140,703-004-5381,9390.989,"","","",0.27920371738274696
49156,703-004-5399,4936.3364,3,2,1,1.051198189096529
49244,703-004-5394,1873.3763,4,1,3,0.9108533225923404
49398,703-004-5398,6462.9756,5,3,2,1.3080483836996137
49956,703-004-5393,1188.7485,2,2,0,1.321779796032925
49973,703-004-5399,8600.7295,1,0,1,0.27920371738274696
5279,703-004-5399,776.096,6,5,1,1.9837856659581228
5402,207-008-2398,4187.8657,1,0,1,0.27920371738274696
5661,703-004-5390,6901.3105,2,2,0,0.854287141127406
5715,703-004-5397,1855.5635,4,2,2,0.5709928778655317
5825,703-004-5380,6900.6987,3,3,0,1.455920527878666
6010,703-004-5397,6292.998,3,0,3,0.27920371738274696
6331,703-004-5391,2103.0068,1,0,1,0.27920371738274696
6624,703-004-5382,7165.585,3,1,2,0.38649359469715194
6656,703-004-5395,3156.3855,9,3,6,0.8108156197463126
6830,703-004-5397,5775.385,5,3,2,0.937486571209373
6887,703-004-5389,8484.439,5,4,1,1.1231559692001218
689,703-004-5391,3859.753,2,2,0,1.0018895625302795
7105,703-004-5383,4236.598,3,2,1,1.4067825035043908
746,703-004-5387,6312.3926,2,0,2,0.27920371738274696
7546,703-004-5397,2149.4072,4,3,1,1.3194139169660195
7595,207-008-2399,8663.52,6,3,3,0.9708310032373204
7871,703-004-5395,6685.594,5,3,2,2.433014002300255
795,703-004-5391,3930.0454,4,2,2,0.8904343270644356
855,703-004-5397,1862.1177,3,2,1,1.184687905985613
8624,703-004-5389,4373.2695,1,0,1,0.27920371738274696
8689,703-004-5393,1140.4592,1,1,0,0.35534489781066697
882,703-004-5385,8297.395,7,6,1,1.33365487775918
8921,703-004-5391,7224.37,1,1,0,1.616075825976487
8945,703-004-5392,3430.7122,7,2,5,1.079978192838083
9132,703-004-5396,789.20605,2,2,0,2.6912554450126187
9289,703-004-5392,1787.0116,3,1,2,1.0651131461754806
9340,703-004-5388,1508.9816,7,5,2,1.67179466034372
9523,703-004-5393,704.07745,6,4,2,1.132999966038889
9567,703-004-5394,7948.2456,4,2,2,1.3934015998482794
9652,703-004-5398,8836.819,"","","",0.27920371738274696
10274,703-004-5389,938.14197,"","","",0.27920371738274696
10376,207-008-2399,9064.327,4,3,1,2.233334904719044
10397,703-004-5393,5054.63,3,3,0,1.587152462051106
10727,703-004-5389,233.86359,2,1,1,0.5374801372284489
10754,703-004-5395,2046.7609,3,1,2,0.8438816892195385
10804,207-008-2398,2208.0999,3,2,1,1.2315997931826392
10937,703-004-5391,3095.2734,3,1,2,0.5747829699153709
11200,703-004-5393,900.40625,4,4,0,1.4591869974183855
11415,703-004-5397,7360.024,6,1,5,0.6313978787993377
1170,703-004-5396,6303.2544,5,2,3,1.3268776427320734
11773,703-004-5390,2743.455,3,2,1,1.5853890416640588
12051,703-004-5399,4247.3916,5,1,4,0.5165268771580819
12161,703-004-5391,3074.3342,6,3,3,1.7697067610967985
12674,703-004-5385,8151.713,6,2,4,1.1724446012005036
12790,703-004-5396,9383.375,7,4,3,1.220394269675495
12855,703-004-5380,1220.1202,4,3,1,1.4562846204668007
13285,703-004-5381,2727.396,3,3,0,2.1345933608986067
13464,703-004-5384,3092.4653,4,3,1,1.1744639036281446
135,703-004-5397,7426.8853,3,1,2,1.134118288679507
13671,703-004-5390,2388.925,3,2,1,0.7470837067505167
13840,703-004-5388,2772.3838,5,3,2,1.6589751046188883
14110,207-008-2399,8108.022,4,0,4,0.27920371738274696
14133,207-008-2399,9203.313,3,3,0,1.1148398380813904
1426,703-004-5392,8415.342,7,2,5,1.0342851512713578
14294,703-004-5397,1341.2422,4,1,3,0.4882870856365851
14638,703-004-5390,8788.595,5,3,2,1.41061656593268
14678,207-008-2398,8570.266,2,2,0,0.5050402491424393
14679,703-004-5394,6355.5884,4,2,2,0.6846524570009738
15094,703-004-5385,4831.9185,3,2,1,0.6160050414612361
15122,703-004-5399,3084.061,6,2,4,0.4890944835464524
15404,207-008-2399,1835.1096,4,2,2,0.4947520501219432
156,703-004-5398,969.96484,5,2,3,1.5190978274785014
16160,703-004-5384,8263.913,5,2,3,0.9431697041268695
16579,703-004-5388,566.73645,4,3,1,0.6633476113300717
16878,703-004-5386,5669.7925,3,1,2,0.5936956336665569
17066,703-004-5394,5995.847,3,2,1,0.7570793498988061
17326,703-004-5396,7846.637,2,2,0,1.0917746744045942
1739,703-004-5381,3420.794,3,1,2,1.4932690281493437
17592,703-004-5396,6728.9253,6,3,3,0.8119227560621441
17879,703-004-5394,3601.159,7,3,4,1.7436282584760374
18192,703-004-5391,4391.8296,4,2,2,4.3244613125533595
18391,703-004-5380,7108.2026,1,1,0,1.2688931264109768
18573,703-004-5397,5113.9565,1,1,0,0.46887916121416895
18685,703-004-5382,3848.5217,"","","",0.27920371738274696
18716,703-004-5395,4755.8643,3,0,3,0.27920371738274696
18723,703-004-5385,5097.8594,3,2,1,1.342130958175492
18754,703-004-5385,6518.7256,2,1,1,1.2372044642607178
190,703-004-5391,9205.094,6,1,5,0.5477011643549125
19003,703-004-5395,6741.1787,6,6,0,2.194421792954818
19077,703-004-5394,1141.6698,4,1,3,0.37541046719229154
19099,703-004-5396,1907.1752,3,2,1,0.5607966201523235
19200,207-008-2399,2840.544,7,3,4,2.89453100589304
19420,703-004-5392,1586.8545,2,2,0,0.7213788668448521
1955,703-004-5383,1002.46844,10,3,7,1.089671201456117
19701,703-004-5386,6253.247,2,0,2,0.27920371738274696
19825,703-004-5382,88.145134,4,3,1,1.774087037976647
19897,703-004-5387,961.2793,7,5,2,3.387687598460699
20068,703-004-5390,5356.7334,5,2,3,0.691885059478585
20104,703-004-5382,1464.4337,3,1,2,0.724071126032722
20300,703-004-5399,8464.435,5,3,2,1.2956492487580116
20460,703-004-5383,1782.0948,5,3,2,0.9480144181045204
20625,703-004-5394,5749.472,4,2,2,1.3877465500772654
21192,703-004-5398,4947.825,4,2,2,0.6433501234673817
21325,703-004-5385,8953.969,2,0,2,0.27920371738274696
21391,703-004-5390,1764.3564,6,2,4,0.5809362554934083
2143,703-004-5392,2955.342,7,4,3,1.597825374403866
21451,703-004-5394,7844.396,2,2,0,0.4870607417578749
21517,703-004-5387,5896.168,2,1,1,0.5462103049075749
21561,703-004-5383,1467.3853,6,3,3,0.6608136744176193
21598,703-004-5386,2046.1536,3,1,2,0.6046138219321168
22696,703-004-5390,8729.136,6,3,3,1.6275592147954911
22752,703-004-5387,185.84192,5,3,2,0.635125472483115
22802,703-004-5399,8284.178,6,4,2,0.9840590121562508
23128,703-004-5392,908.9482,3,0,3,0.27920371738274696
23229,703-004-5393,6113.2754,5,3,2,1.5774911600951402
23501,703-004-5397,5095.821,1,1,0,0.7565662747349946
23537,703-004-5380,9364.06,2,1,1,0.5972312958982636
2362,703-004-5382,947.83545,5,4,1,1.0593426938825987
2370,703-004-5395,9420.912,6,5,1,1.568346945619385
23971,703-004-5381,8501.734,4,2,2,0.43741915723297026
24040,207-008-2398,2750.178,3,0,3,0.27920371738274696
24108,703-004-5394,8371.999,7,5,2,3.1675376475585004
24159,703-004-5390,6351.628,8,4,4,0.9949189855344933
24324,703-004-5390,7550.081,2,1,1,0.5165268771580819
24678,703-004-5390,5989.6147,4,3,1,1.2203143056954364
24687,703-004-5384,777.8448,3,3,0,1.0594345113682933
24771,703-004-5384,5946.54,8,3,5,1.7984176745945857
24951,703-004-5397,3594.5952,9,4,5,1.4908432631548407
25068,703-004-5381,5213.378,4,2,2,0.7775823529109502
25163,703-004-5393,3436.8037,6,2,4,1.0998569404471983
25541,703-004-5384,7910.8223,1,0,1,0.27920371738274696
25590,703-004-5387,4023.9246,5,1,4,1.6806610911373208
25681,703-004-5387,2417.3284,5,2,3,1.0188516357305146
25792,703-004-5383,2311.5283,6,3,3,0.9125488450588146
25892,703-004-5388,164.83844,5,0,5,0.27920371738274696
2593,703-004-5386,3205.6868,4,2,2,0.6912247259353483
25973,703-004-5389,5773.77,2,1,1,0.5037597165270232
26013,703-004-5399,1660.1646,1,0,1,0.27920371738274696
26048,703-004-5391,3316.1592,4,2,2,0.5758576671019155
26129,703-004-5392,6971.5913,4,3,1,1.3002544230248654
26337,703-004-5396,1079.6946,5,1,4,0.5731703559442333
2665,703-004-5399,944.497,3,2,1,0.9251183016325267
2672,703-004-5396,8831.323,"","","",0.27920371738274696
27001,703-004-5391,1071.6981,8,4,4,1.613957550823492
27161,703-004-5382,820.0872,8,4,4,2.755107981121417
27216,703-004-5396,7269.574,5,4,1,1.6353044437775337
27637,703-004-5398,2156.1016,6,4,2,1.644160635672268
28150,703-004-5390,7046.5024,5,4,1,1.7463321959148015
288,703-004-5398,891.1437,4,3,1,1.9419870971664703
28880,703-004-5387,9065.733,4,2,2,0.5976191742383721
28917,703-004-5390,6076.3438,5,2,3,0.5542816378496642
28920,703-004-5383,2805.9531,4,1,3,0.831446716692208
28956,703-004-5399,4198.126,4,3,1,1.5024444471995813
29057,703-004-5389,5291.298,2,2,0,0.8088122858579417
29081,703-004-5389,3036.4739,5,2,3,0.8901068785825493
29158,703-004-5387,3525.0752,4,2,2,2.6297588607031073
29234,703-004-5390,6327.4507,6,4,2,2.130325201059244
29545,703-004-5386,7156.877,5,4,1,1.1077362365595584
29566,703-004-5381,1187.1677,4,1,3,0.3863359665390255
29571,207-008-2399,5045.5366,2,1,1,0.42043925020618733
29674,703-004-5399,1441.9043,2,0,2,0.27920371738274696
29757,703-004-5387,301.28778,5,1,4,0.5341869603099971
29775,703-004-5385,255.09894,3,0,3,0.27920371738274696
29840,703-004-5399,9816.143,3,0,3,0.27920371738274696
29976,703-004-5393,699.4873,4,3,1,0.5804239555882138
3004,703-004-5399,3515.1208,2,2,0,0.7454220367878476
30267,703-004-5388,8356.179,6,3,3,1.3126924073706103
30270,703-004-5395,7495.446,3,1,2,0.44305852085286834
303,703-004-5387,3287.9548,5,4,1,0.8090386502971716
30310,703-004-5387,8458.751,3,1,2,0.44829646872267315
30561,703-004-5383,9229.467,3,2,1,0.8290908180022873
30579,207-008-2399,6571.9556,1,0,1,0.27920371738274696
30639,703-004-5399,4306.611,4,2,2,1.4096467398840764
30808,207-008-2399,674.27576,5,4,1,1.6280943365789027
30832,703-004-5396,4022.8164,6,2,4,1.5509398188943655
30918,703-004-5389,7483.546,5,2,3,0.8055745368730118
31012,703-004-5381,7115.4956,3,0,3,0.27920371738274696
3109,703-004-5388,1723.283,4,1,3,0.47695459872511914
31133,703-004-5399,3529.604,5,4,1,2.2288489564827865
31226,703-004-5387,2506.6704,4,1,3,0.5401831982547654
31266,703-004-5385,7697.673,7,5,2,1.1803150761853198
31816,703-004-5392,5035.5073,7,2,5,1.6677647771230497
31958,703-004-5386,4339.238,6,3,3,0.7405160032713687
31969,207-008-2399,8164.742,6,4,2,3.0630647913442774
32095,703-004-5390,9693.373,1,0,1,0.27920371738274696
32148,703-004-5384,7052.132,7,2,5,1.6914793288301324
32457,703-004-5383,296.13257,7,2,5,0.9021812849397755
32545,703-004-5392,5371.115,4,3,1,0.6944761303034425
32765,207-008-2398,7395.16,1,0,1,0.27920371738274696
32772,703-004-5383,8331.8125,3,1,2,0.35831143730785864
33180,703-004-5391,5645.6206,8,5,3,1.480647819010471
3322,207-008-2398,9975.663,3,0,3,0.27920371738274696
33384,703-004-5395,1439.811,6,3,3,0.8458399735154384
33503,207-008-2398,7711.693,2,0,2,0.27920371738274696
33590,703-004-5386,4509.8774,4,2,2,0.9076881226874306
33598,703-004-5392,9769.1875,1,0,1,0.27920371738274696
338,703-004-5388,242.64217,2,0,2,0.27920371738274696
3410,703-004-5394,3532.4329,7,3,4,1.925519291429694
34139,207-008-2398,6926.2036,3,2,1,0.5388756009961564
34152,703-004-5390,1247.4102,3,0,3,0.27920371738274696
34405,703-004-5395,1315.7356,5,2,3,1.0899632268514297
34835,703-004-5392,9452.8,7,3,4,1.2032221628224538
34898,703-004-5390,214.41281,1,1,0,0.6361907983491313
35023,703-004-5386,8550.2,2,0,2,0.27920371738274696
35228,703-004-5385,8619.789,4,3,1,0.9241999386949855
35293,703-004-5396,4002.6719,2,2,0,0.981042735031878
35406,703-004-5396,8693.887,4,2,2,1.1517804121512947
35583,207-008-2399,1134.5685,"","","",0.27920371738274696
35621,703-004-5397,622.80475,7,2,5,0.7877293388976364
35852,703-004-5380,148.22125,6,2,4,0.8146315685530436
35885,703-004-5388,5533.2188,9,4,5,2.112237341334869
36142,703-004-5380,792.26196,6,5,1,2.229928351554114
36450,703-004-5383,7085.7227,1,0,1,0.27920371738274696
36510,703-004-5387,2668.1143,1,1,0,0.5568718143198889
36535,703-004-5391,2874.3887,2,0,2,0.27920371738274696
36777,703-004-5391,5445.6274,4,2,2,0.9041493811310338
36806,703-004-5382,4254.842,6,3,3,1.5168273598003488
36968,703-004-5384,4020.9055,3,1,2,0.4766179653881147
37220,703-004-5384,9852.17,3,2,1,1.559342365358763
37271,207-008-2398,4201.515,5,4,1,1.321828555127967
37366,703-004-5395,948.987,3,3,0,2.8449152025212237
37688,703-004-5399,1754.0222,4,1,3,0.3978652972704144
37897,703-004-5385,9681.203,2,2,0,1.8615691351676613
37898,703-004-5382,1882.5304,4,3,1,1.524105756104065
38046,207-008-2399,3822.6355,6,2,4,1.2568042848088168
38307,703-004-5391,5133.3584,3,1,2,1.329552705499555
38555,703-004-5393,5510.9604,3,1,2,0.4403887165574029
3861,703-004-5386,6515.8843,3,2,1,0.7211853103000821
38703,703-004-5399,2884.581,3,2,1,0.5508621776435855
38744,703-004-5397,2079.7717,3,0,3,0.27920371738274696
39026,703-004-5393,1857.4905,5,2,3,0.510136914748747
39256,703-004-5389,3586.4668,2,2,0,0.7712915769510161
39342,703-004-5397,8397.79,5,1,4,1.020208318227108
39356,703-004-5380,3173.3037,8,4,4,1.8184418909212328
39390,703-004-5393,4448.158,4,4,0,1.1210445766941564
39675,703-004-5389,681.1929,4,3,1,3.165763241779461
40523,703-004-5386,6112.3667,3,1,2,0.4905736669625285
40591,703-004-5397,6833.477,5,3,2,1.5035028546292013
4100,703-004-5382,8563.784,3,2,1,0.43741915723297026
41110,703-004-5397,8887.281,4,4,0,1.540622635911676
41379,703-004-5385,7054.3184,5,3,2,0.8091562071028068
41504,703-004-5386,2019.4769,4,0,4,0.27920371738274696
41645,703-004-5392,6409.7905,5,2,3,0.8356777835758354
42126,703-004-5399,4822.059,4,4,0,2.0506308836719587
42425,703-004-5391,3039.294,3,1,2,1.009232382700095
42576,703-004-5385,9952.583,3,1,2,1.601237647362568
42700,703-004-5385,8484.28,4,3,1,0.6411700084978751
42717,207-008-2398,6298.5293,3,3,0,1.9910435536918814
42741,703-004-5380,7560.0513,3,3,0,1.9488069845003886
42771,703-004-5391,7589.03,4,3,1,0.9130727454761222
43628,703-004-5391,7568.6455,2,1,1,0.3918388272177862
44,703-004-5382,9635.918,2,2,0,0.9765315923539011
44079,703-004-5391,3511.0051,2,1,1,0.37305184245390444
44222,703-004-5383,5161.187,5,2,3,0.9852034142205398
4491,703-004-5388,7555.775,6,4,2,1.4798794565362505
45619,703-004-5390,4635.1997,4,0,4,0.27920371738274696
45971,703-004-5398,3858.863,5,3,2,0.6026412518013476
46107,207-008-2399,6038.729,7,5,2,1.5898840356351958
46299,703-004-5389,9172.428,7,3,4,0.8536189628879423
46438,207-008-2398,2710.9421,2,1,1,0.5791080740318881
46442,207-008-2398,7059.4893,4,4,0,1.3799927165117112
46678,703-004-5382,9029.828,4,1,3,0.8437307235832376
46817,703-004-5385,129.57573,3,1,2,0.3187575773453028
47125,703-004-5397,2192.3489,2,1,1,0.6406174281645348
47180,703-004-5390,7984.8076,3,1,2,0.47419354502379135
47265,703-004-5389,5923.554,8,1,7,0.5060180959376475
47447,703-004-5390,7891.4263,5,3,2,2.199802125763658
47471,703-004-5389,9681.707,4,3,1,1.7310411650933448
48152,703-004-5388,5558.0054,4,1,3,0.8004523472684318
48862,703-004-5392,9182.301,4,2,2,1.517840692990974
48892,703-004-5385,5756.6577,5,4,1,1.468234802386865
48928,703-004-5384,3883.6687,6,2,4,0.6628688843037629
48993,703-004-5390,9394.065,3,1,2,0.4503203078907572
49158,703-004-5387,5203.976,2,1,1,0.37622208183426253
49402,703-004-5380,1438.9342,4,2,2,0.5316133148794107
49467,703-004-5380,1119.6262,6,4,2,1.484601597981335
49776,703-004-5387,297.67633,8,4,4,0.8394351559706046
5012,703-004-5385,1251.4508,2,0,2,0.27920371738274696
5100,703-004-5387,4992.4146,4,1,3,0.7499735818035184
5207,703-004-5385,8079.9204,3,1,2,0.35831143730785864
5212,703-004-5393,4140.992,5,3,2,1.390918392343766
5231,703-004-5382,1335.6698,3,1,2,0.5165268771580819
5239,703-004-5384,3948.3499,3,1,2,1.7263624097952854
5452,703-004-5384,5788.028,3,2,1,0.7243065708781787
6175,703-004-5397,4900.98,2,1,1,0.8921178011258997
6190,703-004-5384,2060.5088,3,2,1,0.6649383649172103
6589,703-004-5392,7726.6934,3,3,0,0.8795219473681476
6659,703-004-5388,451.85446,4,2,2,0.6482616035967553
7132,703-004-5384,6448.864,8,7,1,2.9377642198913527
7331,703-004-5399,6271.7188,4,2,2,0.631584314872329
7366,703-004-5388,3020.1035,4,3,1,1.3849649540172082
7524,703-004-5389,4258.1064,4,1,3,0.7813545118312198
7599,703-004-5383,6586.3354,3,3,0,1.70613133262859
7787,703-004-5397,7725.735,6,3,3,2.0476076989600305
779,703-004-5397,6921.456,5,2,3,0.5734320171403763
7838,703-004-5391,8349.287,6,2,4,0.5658385751290508
8066,703-004-5393,2359.0522,3,1,2,0.4272362619352401
8250,703-004-5384,2542.534,3,3,0,0.7883761260303833
8712,703-004-5397,5332.901,4,4,0,3.326455146981579
9412,703-004-5381,6147.7183,2,1,1,0.44758063398788817
9464,703-004-5395,2132.9434,3,3,0,1.1813511273110187
957,703-004-5388,6387.712,5,5,0,2.8666915309600096
9737,703-004-5390,579.9532,3,2,1,0.5255475690300471
9746,703-004-5387,2983.7185,9,6,3,1.0371869777397984
9876,703-004-5388,1985.7102,5,2,3,0.9334245441681933
9908,703-004-5382,8295.203,1,0,1,0.27920371738274696
10350,703-004-5391,3837.2576,3,1,2,0.46835384349468456
10634,703-004-5387,1902.2638,2,1,1,0.5566182918890931
1076,703-004-5382,7593.6997,3,3,0,0.9756009940874167
10921,703-004-5384,2996.8018,1,0,1,0.27920371738274696
11100,703-004-5391,4595.562,5,1,4,1.597230057492214
11110,703-004-5387,1978.2692,7,2,5,0.8676035716055738
11342,703-004-5386,9270.882,6,3,3,1.038657254104281
11395,703-004-5384,3632.7964,2,0,2,0.27920371738274696
11435,703-004-5391,5679.384,5,3,2,1.9195366917979544
11714,703-004-5384,9467.804,6,3,3,2.230040828856314
1191,703-004-5395,6268.915,1,1,0,0.3822662437476815
11967,703-004-5380,9676.398,4,3,1,1.0616017165067868
12149,703-004-5393,9652.565,3,2,1,1.0496643021846692
12308,207-008-2398,1651.9874,8,3,5,1.0070636650816018
12332,703-004-5390,9572.833,7,4,3,1.322366615943334
12493,703-004-5382,424.0346,2,0,2,0.27920371738274696
12741,703-004-5395,6242.158,3,1,2,0.3554141170656014
12810,703-004-5386,4930.9844,2,0,2,0.27920371738274696
13157,703-004-5395,1591.7975,2,2,0,0.5313318177181933
13326,703-004-5397,7120.0596,3,2,1,0.5171595799874121
13358,703-004-5390,6786.292,3,1,2,0.40314944574978717
13428,703-004-5392,6289.0435,4,2,2,0.7342431007318111
13903,703-004-5394,3878.5112,8,5,3,2.0629488969499095
13997,703-004-5382,4587.7837,6,4,2,2.334911897932501
14199,703-004-5387,4196.7725,3,1,2,0.4926359057159434
14219,703-004-5382,9200.93,1,1,0,0.3187575773453028
14271,703-004-5383,5731.881,2,1,1,0.38985718570065164
14286,703-004-5396,3423.5586,5,4,1,1.496271748101414
14304,703-004-5388,2578.0803,10,3,7,1.5590981057619266
14449,703-004-5383,2512.6152,2,0,2,0.27920371738274696
14687,703-004-5385,2029.0083,2,1,1,0.44249813125703374
14807,703-004-5394,6359.221,4,1,3,0.9130501965106962
14929,703-004-5397,8752.213,4,0,4,0.27920371738274696
15209,703-004-5383,8509.614,7,5,2,2.610485989049158
15601,703-004-5387,3610.6914,2,1,1,0.47738201646812023
15797,703-004-5380,8398.129,2,0,2,0.27920371738274696
16710,703-004-5393,1790.6367,2,1,1,0.3367545836282657
1721,703-004-5381,6143.29,6,3,3,2.6144118930824884
17572,207-008-2399,4202.7295,2,1,1,0.35831143730785864
17654,703-004-5399,54.261684,5,3,2,1.573382989658335
1770,207-008-2398,7727.9453,6,6,0,2.6935413868232683
17857,703-004-5380,7398.386,7,2,5,0.6894606360910911
18200,703-004-5395,6737.6147,1,0,1,0.27920371738274696
18342,207-008-2398,9803.08,4,2,2,0.47795398332519984
19078,703-004-5380,431.6628,2,1,1,1.01881825165531
19710,207-008-2399,4302.803,5,2,3,0.5423568842684757
19922,703-004-5395,7549.072,1,1,0,0.7619888009317315
19974,703-004-5398,4031.884,8,6,2,2.209891177344199
20238,703-004-5382,9910.912,1,1,0,0.32666834933781397
20308,703-004-5393,2300.2373,3,1,2,0.7977394147472493
20526,703-004-5397,6000.7065,2,2,0,0.9882340396602163
20951,703-004-5396,1237.2833,4,3,1,1.3830138303574455
21352,703-004-5380,1623.9274,3,3,0,0.982660279504039
21679,703-004-5399,6589.4043,2,2,0,0.884842320608783
21708,703-004-5398,5368.0303,1,0,1,0.27920371738274696
21817,703-004-5387,2303.2964,6,5,1,1.8683455123612809
22039,703-004-5393,2775.396,4,1,3,0.6941496705373442
22360,703-004-5381,6920.184,6,6,0,2.8105196979945246
22666,703-004-5388,5275.742,3,2,1,2.849978808202223
22772,703-004-5399,9856.174,5,4,1,1.004602333535001
22930,703-004-5380,5351.0957,2,1,1,0.46273239155088225
22983,703-004-5393,2654.5464,2,1,1,0.4463273731954955
23287,703-004-5384,6933.5215,4,3,1,1.1578537936441735
23347,703-004-5397,712.1009,3,0,3,0.27920371738274696
23673,207-008-2398,8400.486,5,2,3,2.4254146491794084
24221,703-004-5384,318.48907,4,2,2,0.8366714220574032
24333,703-004-5395,2274.4316,3,1,2,0.35831143730785864
24351,207-008-2398,9737.513,4,1,3,0.4330153003973981
24455,703-004-5396,1544.1597,5,2,3,0.580637091847391
24774,703-004-5395,9148.042,2,2,0,0.9575313188550233
24975,703-004-5381,233.97089,3,2,1,0.708259840007886
25134,703-004-5397,1908.1664,2,1,1,0.38310807430263444
25476,703-004-5389,116.75656,3,2,1,0.7387445921510477
25680,703-004-5388,6971.9614,2,1,1,0.37512182779194486
25862,703-004-5387,4603.475,8,5,3,2.564736414349914
25869,703-004-5393,7324.596,4,1,3,1.2288301955536358
26068,703-004-5381,1359.846,2,1,1,0.4622867421781412
26389,703-004-5382,9891.137,6,2,4,0.8829798396220419
2640,703-004-5396,1354.8523,4,3,1,0.9418043212141297
26861,703-004-5383,7883.208,1,0,1,0.27920371738274696
27184,703-004-5396,6753.3247,9,4,5,1.859449464817006
27401,703-004-5383,6699.578,4,1,3,0.600894206666512
27528,703-004-5398,1395.5695,3,1,2,0.6029288561425491
27693,703-004-5394,9295.347,4,3,1,0.9565088263870426
2776,703-004-5389,9994.532,5,2,3,0.37808836728913653
27889,703-004-5397,3734.1052,3,0,3,0.27920371738274696
27901,703-004-5396,9104.121,6,2,4,0.5848365027044947
27935,703-004-5393,9268.954,8,5,3,3.2434863126059614
2805,703-004-5383,8956.78,4,2,2,1.4581403842980678
2823,703-004-5398,9132.013,3,2,1,0.5852352280680383
28342,703-004-5392,9290.762,4,2,2,1.5439645910757995
28496,703-004-5399,4460.6226,6,3,3,1.8044506485502014
28529,703-004-5395,5151.3623,3,1,2,0.33853450732658075
28700,207-008-2398,6736.7935,2,1,1,0.41555431907085644
28733,703-004-5380,9462.657,5,4,1,1.5222353508337676
28885,703-004-5380,2962.1982,4,2,2,0.6292553780513659
29357,703-004-5399,7775.384,4,2,2,0.6571569896425417
29367,703-004-5390,756.8616,7,3,4,1.3100723443604305
29475,703-004-5380,1826.7798,2,1,1,0.6435963407521272
29878,703-004-5391,4831.6455,6,3,3,2.8667916418165316
30096,703-004-5390,6440.993,7,6,1,3.0150751203473014
30122,703-004-5388,4365.953,6,4,2,1.2752635402326489
30566,703-004-5386,7108.043,1,1,0,0.33853450732658075
30841,703-004-5394,471.7344,2,0,2,0.27920371738274696
30924,703-004-5390,3754.3142,4,1,3,0.4841709164706822
30968,703-004-5388,6320.018,7,5,2,0.8513880764660358
31433,703-004-5390,6191.206,2,1,1,0.6079277486448538
31523,703-004-5396,1423.3738,6,3,3,1.1129018263989328
31730,207-008-2398,7151.7036,3,2,1,1.0248518412944778
3176,703-004-5386,4882.474,8,2,6,2.075681136285794
31817,703-004-5381,7013.5938,2,1,1,0.7331380690809133
32155,703-004-5395,595.6566,4,3,1,0.7612084367747707
32523,207-008-2398,3440.0857,4,2,2,0.77185655880896
32532,703-004-5384,7305.3623,5,2,3,0.7620080358451871
33082,703-004-5397,7876.1216,3,1,2,0.38700117040069915
33399,703-004-5389,7964.504,6,2,4,1.4983634641433974
33540,703-004-5393,6924.433,2,0,2,0.27920371738274696
33551,703-004-5396,7170.4717,5,3,2,1.0311964860025742
33828,207-008-2398,3240.0059,3,2,1,0.5227005703867268
33836,703-004-5385,7158.98,7,4,3,1.130772426321537
33963,703-004-5382,2156.0222,3,0,3,0.27920371738274696
34066,703-004-5392,8647.093,4,2,2,1.1326188679918654
34097,703-004-5396,4345.334,6,0,6,0.27920371738274696
34249,703-004-5392,865.38196,2,2,0,1.0713143954824533
34402,207-008-2398,7011.586,5,4,1,0.9922258047616679
34869,703-004-5380,5405.4033,4,2,2,1.0245984157823613
34970,703-004-5383,8555.564,2,1,1,0.4851044474999894
34991,703-004-5382,1099.0525,3,1,2,1.7697694369040475
35041,703-004-5384,2663.8,5,1,4,0.4778623631318895
35102,703-004-5393,9839.478,1,0,1,0.27920371738274696
3524,703-004-5393,5038.7485,4,2,2,3.083494839804587
3527,703-004-5389,1270.1147,2,2,0,0.6241797807099471
35275,703-004-5386,5757.909,3,1,2,0.484974927873701
35405,703-004-5387,1813.2454,4,1,3,0.4095084497726735
35407,703-004-5383,6514.1553,7,3,4,2.3488351296650745
35414,703-004-5381,591.47595,4,3,1,2.1721948544432794
35656,703-004-5386,2239.85,7,6,1,2.8859645506899794
35746,703-004-5392,6642.9,7,6,1,2.7440148278649046
36197,207-008-2399,4690.744,6,3,3,0.8140870283785672
36203,703-004-5392,7506.0903,2,1,1,0.32666834933781397
3622,703-004-5388,8287.415,2,0,2,0.27920371738274696
36503,703-004-5398,1212.6803,3,3,0,1.6768432890543046
3653,703-004-5391,3556.9727,7,1,6,0.6877170265259784
3672,703-004-5395,2592.0015,7,2,5,0.5006672659609395
36856,703-004-5383,6700.375,6,4,2,1.7184132199869422
37061,703-004-5398,996.48474,6,2,4,0.5095478183113554
37181,703-004-5381,8652.488,3,3,0,1.1832478975991632
37285,703-004-5389,5771.4834,2,2,0,1.7246843448009297
38065,703-004-5392,8523.285,3,3,0,1.186760136223622
38102,703-004-5395,1824.7843,7,2,5,0.9633611586778564
38283,703-004-5382,3910.3533,1,0,1,0.27920371738274696
3860,703-004-5385,2055.4375,4,2,2,1.401711284520341
3883,207-008-2398,1226.8651,6,1,5,0.7135612719074481
38978,703-004-5397,7808.8174,4,0,4,0.27920371738274696
39046,703-004-5386,7311.1855,1,1,0,0.5594972017749035
39121,703-004-5390,6019.012,4,2,2,1.639206337784776
39439,207-008-2399,4419.5415,4,2,2,1.391782799192421
39442,703-004-5399,119.25816,5,4,1,1.1384359504779107
3958,703-004-5389,1533.2842,5,2,3,1.184655217558968
39606,703-004-5390,6062.0923,2,0,2,0.27920371738274696
3976,207-008-2398,3085.476,7,5,2,1.236052280871211
39975,703-004-5391,6895.1655,3,0,3,0.27920371738274696
40033,207-008-2398,1033.752,4,3,1,1.0106742402409854
40367,703-004-5386,6579.426,3,0,3,0.27920371738274696
40460,703-004-5394,7470.5596,2,0,2,0.27920371738274696
40509,703-004-5384,8324.618,4,2,2,0.7075529854821195
40829,207-008-2399,4513.468,7,5,2,1.9583392263712167
41101,703-004-5399,7646.4814,1,1,0,0.34042710458987235
41244,703-004-5385,5467.808,1,1,0,0.6788370863778606
41482,703-004-5399,4776.6685,"","","",0.27920371738274696
41512,703-004-5381,6193.464,4,2,2,0.7774071179954616
41555,207-008-2399,1566.2897,7,4,3,0.7168147052345772
41639,703-004-5381,4746.633,2,2,0,0.9446926191490248
41757,703-004-5386,905.35284,3,1,2,0.5148296390889471
41771,703-004-5380,7565.5625,7,4,3,1.255052249774321
41992,703-004-5399,2635.793,2,0,2,0.27920371738274696
42201,207-008-2399,8569.001,6,2,4,1.036461427153199
42539,703-004-5394,2227.0596,6,3,3,1.3385644510597854
43016,703-004-5384,2683.4363,3,1,2,0.7899494215545318
43224,703-004-5383,3743.152,3,2,1,1.3176835528885562
43633,703-004-5383,515.24817,6,3,3,1.3098899915233366
43908,703-004-5394,3283.0828,4,1,3,0.5637277520015664
44397,703-004-5393,658.8334,8,4,4,2.1017180462508267
44783,703-004-5397,7684.24,3,1,2,0.5537018789094884
44880,703-004-5389,9097.589,6,1,5,0.6361010798133849
44926,703-004-5382,1505.3242,3,2,1,0.7202141987159835
45026,703-004-5381,4252.163,4,2,2,0.5834658320942185
45151,703-004-5396,1042.4763,6,2,4,1.008718436154017
45410,703-004-5387,1294.9634,4,1,3,0.33252108455414836
4549,703-004-5399,7473.0586,7,6,1,1.689948106104828
45556,703-004-5388,7870.8643,5,1,4,0.3978652972704144
4570,703-004-5385,3603.0442,3,1,2,0.8725228765578907
45952,703-004-5380,5518.896,2,1,1,0.878329531095721
46178,703-004-5388,3928.6829,6,4,2,1.5780671321296187
4652,703-004-5398,9512.631,4,4,0,2.085401292371158
4667,703-004-5380,129.2497,1,0,1,0.27920371738274696
46714,703-004-5392,9797.918,4,3,1,1.570937506284862
46738,703-004-5397,2982.4622,5,4,1,2.9930141297299575
4699,703-004-5396,4918.248,2,1,1,0.35831143730785864
47113,703-004-5381,8103.0195,4,3,1,1.1409682495145839
47157,703-004-5382,9041.282,2,1,1,1.5942172853613517
47217,703-004-5386,3351.9863,5,2,3,1.2054012253373836
47725,703-004-5391,7013.46,3,0,3,0.27920371738274696
48345,703-004-5382,6659.2417,4,1,3,0.4239033200327499
48846,703-004-5383,7504.257,7,2,5,0.9404133885844992
48916,703-004-5380,2182.3115,5,3,2,1.2900962089873704
49071,703-004-5396,8575.67,6,2,4,0.5770960452867074
49394,703-004-5396,4990.9844,4,1,3,0.8269228345631295
49996,703-004-5395,6485.7417,2,2,0,0.907594958320708
5571,703-004-5399,506.71338,5,1,4,0.4314860782385869
5607,703-004-5387,5363.252,5,3,2,0.9369941361887023
6024,703-004-5384,8646.715,3,3,0,1.3435973153784442
6161,207-008-2399,1129.4312,4,1,3,0.3978652972704144
6307,703-004-5380,4920.667,3,0,3,0.27920371738274696
6351,703-004-5394,9009.938,4,1,3,0.39062550187366724
6420,703-004-5397,2457.6997,1,0,1,0.27920371738274696
6468,703-004-5385,3607.7422,2,1,1,0.35041302589658574
6812,703-004-5387,5543.9224,7,3,4,0.8864646358778431
6816,703-004-5392,2256.6497,6,4,2,1.864256796773567
6894,703-004-5388,5504.1743,2,1,1,0.961160641138152
7155,207-008-2399,8231.909,5,2,3,1.1944219261864921
7306,703-004-5398,8475.553,2,2,0,1.505910692215076
7407,703-004-5393,3961.885,2,2,0,0.7064286670126838
7416,703-004-5395,9102.601,2,1,1,0.3769891840405616
7444,703-004-5388,8139.227,6,3,3,1.9093350586215023
785,703-004-5392,9029.962,4,1,3,0.43381103618717576
7989,703-004-5382,4991.8306,8,4,4,1.9783999054026622
824,703-004-5385,1353.218,5,4,1,1.5682494374746034
8342,703-004-5399,7592.808,6,4,2,1.1709311942730947
8438,703-004-5382,5612.548,8,3,5,0.7767372389562729
8574,703-004-5383,3447.6663,3,2,1,1.063859147011216
8803,703-004-5391,5769.413,6,4,2,2.342482149082772
8804,703-004-5381,9422.316,3,2,1,1.0230712876159556
8872,703-004-5399,939.2673,2,2,0,0.7550209512795678
9054,703-004-5381,8930.304,1,0,1,0.27920371738274696
9202,703-004-5381,2538.9749,2,0,2,0.27920371738274696
928,703-004-5390,9967.724,4,2,2,1.7523462471984084
9710,703-004-5395,5175.1035,3,1,2,0.3401166617250829
10184,703-004-5384,2111.761,4,4,0,0.6551433303939533
10261,207-008-2398,7603.6377,3,1,2,0.44766632919517446
10671,703-004-5398,4019.3896,5,3,2,0.8188476589517609
10826,703-004-5392,2613.7798,4,2,2,0.8870003704664241
10923,703-004-5381,5244.5693,7,2,5,0.8137942968211612
11027,703-004-5380,7051.926,2,1,1,0.5669580486103406
11310,703-004-5390,7801.2812,3,2,1,0.616892130865309
11437,703-004-5384,8383.447,4,1,3,0.5100797553135417
11693,703-004-5380,5742.1074,"","","",0.27920371738274696
11855,703-004-5398,4515.544,3,1,2,0.40077657867591204
1189,703-004-5386,934.91077,3,2,1,0.8388997689117289
12062,207-008-2398,7755.611,4,3,1,0.6552900582942198
12119,703-004-5381,1648.77,1,1,0,0.4120775189618227
12152,703-004-5386,2488.3276,6,3,3,1.1214079536758164
12336,207-008-2399,7950.355,5,1,4,0.6251659842050284
12859,703-004-5387,5762.3706,7,3,4,0.759422651267142
12908,703-004-5397,3642.7056,3,2,1,1.0578932494609619
12939,207-008-2398,4133.9053,5,4,1,0.9868986943700843
13507,703-004-5397,340.91055,4,3,1,0.7187605987896681
1352,703-004-5399,4498.8403,5,3,2,0.889753338951329
13611,703-004-5399,6854.403,8,2,6,1.2818643786342356
13883,703-004-5391,8192.632,4,1,3,0.5153365718093971
13907,703-004-5381,6553.443,5,3,2,2.3751172339216335
1395,703-004-5398,3237.0,7,4,3,5.654633386069369
14285,703-004-5398,4748.2305,5,3,2,2.259900228887563
14370,703-004-5391,5204.995,4,1,3,0.4398418311556768
14540,703-004-5388,3333.94,10,5,5,2.1941048770137486
14625,703-004-5387,6330.657,4,2,2,1.9891476579768907
14683,207-008-2399,3614.3745,2,2,0,0.7647203360541258
15013,703-004-5383,4360.0386,5,1,4,0.4714448030337685
1503,703-004-5395,3315.0583,1,1,0,0.5367614642461369
15421,703-004-5391,1408.757,3,2,1,0.7779016886692958
15546,703-004-5391,5352.5347,3,3,0,1.073300395441962
15573,703-004-5398,2934.7688,4,1,3,0.3807252912866403
15605,703-004-5392,4527.924,4,2,2,1.4393988495052028
15610,703-004-5397,1257.6616,5,3,2,1.1924028424293687
15627,703-004-5381,702.7972,5,2,3,0.9664343426832243
15710,703-004-5383,4373.434,3,1,2,0.5339329323362992
15865,703-004-5380,7914.983,4,2,2,0.525031485600158
16002,703-004-5382,4211.023,2,1,1,0.6337221518892349
16084,703-004-5383,7306.292,4,1,3,0.48551005863744434
16281,703-004-5395,8512.129,1,0,1,0.27920371738274696
16700,207-008-2398,3433.2466,5,2,3,0.9746805056577803
16774,703-004-5390,8883.545,2,1,1,0.9108271143321774
16855,703-004-5391,4179.0566,7,3,4,0.5537083676216158
16859,703-004-5380,2090.8708,4,3,1,1.4721625595203196
17553,703-004-5380,1975.2426,6,4,2,1.5256141516089845
17912,207-008-2398,8317.145,3,0,3,0.27920371738274696
18230,703-004-5395,3283.6396,"","","",0.27920371738274696
18501,703-004-5387,3036.7512,5,4,1,1.4705178697347356
18702,703-004-5381,886.93976,6,2,4,0.9158230618710572
18946,703-004-5395,5527.8325,7,5,2,2.6829519001136695
19436,703-004-5390,8198.791,3,3,0,1.2544712521513435
20001,207-008-2398,8483.444,6,2,4,0.8211573971506662
20025,703-004-5381,2744.6675,4,0,4,0.27920371738274696
20049,703-004-5384,3940.3254,1,0,1,0.27920371738274696
20686,703-004-5383,2786.4438,4,0,4,0.27920371738274696
21066,703-004-5382,1476.3588,2,1,1,0.38650543378812163
21656,703-004-5397,3893.7659,6,3,3,1.3181456180507491
21729,703-004-5394,7346.673,1,0,1,0.27920371738274696
21832,703-004-5396,4854.5015,4,0,4,0.27920371738274696
22122,703-004-5396,9463.603,3,2,1,0.9829023009259272
22456,703-004-5386,3597.797,6,2,4,1.1122859333158488
22743,703-004-5394,5275.4653,6,3,3,1.2306881372085747
22884,703-004-5386,9630.744,6,3,3,0.8636421689493737
23240,703-004-5399,1846.6145,1,1,0,0.3978652972704144
23255,703-004-5391,9815.3545,6,4,2,3.003478102113222
23313,703-004-5393,2654.2837,5,4,1,1.6472121489788751
23481,703-004-5394,8884.02,6,5,1,2.1594449309179446
23548,703-004-5392,142.43364,3,1,2,0.3978652972704144
24002,703-004-5382,2099.399,3,2,1,0.6761543420021899
24122,703-004-5398,9181.942,3,2,1,0.8124856347169546
24196,703-004-5390,2557.5625,4,2,2,0.501336546854962
24255,207-008-2399,3371.1487,4,2,2,1.6776712657283475
2432,703-004-5395,2375.301,5,3,2,0.6658506642246392
24452,703-004-5398,5733.8076,4,4,0,2.0699063181944846
24485,703-004-5391,3789.9226,5,3,2,0.9437550651011168
2462,703-004-5391,8243.435,4,2,2,0.8849568982260415
24676,703-004-5387,6126.617,2,1,1,0.7089780722613901
24922,703-004-5395,7727.909,5,4,1,0.8796069355585642
25002,703-004-5386,8536.887,2,1,1,0.413558785633808
25540,703-004-5389,4332.8857,2,0,2,0.27920371738274696
25687,703-004-5388,5098.723,3,2,1,0.42905791072421884
25700,703-004-5395,1375.6991,6,2,4,0.7990323295721216
25855,703-004-5388,6397.598,4,2,2,0.8096789039357747
25880,703-004-5384,4872.129,6,4,2,1.1247118837164471
26483,207-008-2399,3374.9836,4,3,1,1.136399387304966
26594,703-004-5388,1762.8539,4,2,2,0.5195569633056778
26856,703-004-5394,2566.5994,2,1,1,0.33853450732658075
26873,703-004-5395,7658.8945,2,1,1,0.3299645043346936
27227,703-004-5383,1315.1759,6,3,3,1.2314451808656104
2750,703-004-5391,5774.5435,4,1,3,0.8509561045159524
27639,703-004-5381,328.91272,4,3,1,0.9277944722311203
28049,703-004-5399,6040.564,5,3,2,0.9111158877854277
28649,703-004-5380,928.23444,1,1,0,0.43310761207551646
28892,703-004-5399,3201.394,7,5,2,1.0305740543369704
28947,703-004-5382,5616.3413,3,2,1,1.49743254527383
29173,703-004-5393,1509.0865,10,4,6,2.026563493112737
29331,703-004-5397,5624.8105,3,1,2,1.8354884833731895
29423,703-004-5387,761.4136,4,2,2,2.4448392697663466
2950,207-008-2398,5519.083,5,3,2,0.8886001874814584
29506,207-008-2398,7586.1523,6,2,4,1.0543993986504714
29634,703-004-5390,8505.744,6,5,1,3.911099448680411
2970,703-004-5381,8999.316,5,3,2,0.834516028866606
29729,207-008-2399,1721.3715,2,1,1,0.33853450732658075
29741,703-004-5397,9042.081,2,2,0,0.5149743881545517
29866,703-004-5388,3393.092,4,3,1,1.4902553652508552
29963,703-004-5389,3686.956,3,3,0,1.4113879499247077
29974,703-004-5397,2832.9067,4,1,3,0.37457796221745976
30010,703-004-5399,7423.2314,2,2,0,1.5348872218436123
30209,207-008-2398,4781.957,3,1,2,0.6463266016347362
3055,703-004-5398,7228.7876,6,3,3,1.5358595431502542
30642,703-004-5390,7544.3726,6,5,1,2.368238987017446
30766,703-004-5398,2767.0896,3,3,0,0.8936681042163517
30864,703-004-5399,9259.167,2,1,1,1.3583477468825387
31877,703-004-5385,5241.455,4,2,2,1.3548989750957199
32571,703-004-5399,1785.8428,4,3,1,0.8797511650612517
3271,703-004-5388,4438.909,8,3,5,1.1031959260109592
32725,703-004-5385,358.51837,1,0,1,0.27920371738274696
32910,703-004-5393,7722.501,4,1,3,0.35534489781066697
3302,703-004-5396,2498.9617,7,4,3,1.3699683354151753
33106,703-004-5391,5077.2363,4,2,2,0.8366329696800492
33427,703-004-5382,8742.173,4,1,3,0.6160901058985402
33481,703-004-5385,7121.355,2,1,1,0.5405096414926598
33733,703-004-5387,3162.0574,5,1,4,0.5542804125962302
33740,703-004-5387,5421.094,6,2,4,0.713560011782256
34140,703-004-5388,4422.278,2,1,1,0.612330583948782
34156,703-004-5392,6757.8374,11,5,6,1.0006516413250666
34206,703-004-5380,5577.8013,4,0,4,0.27920371738274696
34378,703-004-5397,5996.777,5,1,4,0.8811112797143515
34475,703-004-5395,2560.5095,3,1,2,0.8565552222646331
34884,703-004-5391,4286.8965,5,1,4,0.9719044779063055
34997,703-004-5396,4819.416,5,4,1,2.10082314022039
35263,703-004-5391,1487.6031,2,2,0,0.6708925109767934
3554,703-004-5386,1903.2269,5,3,2,0.5612972320186994
35637,703-004-5399,347.76627,5,3,2,0.545650626978077
35653,703-004-5382,2380.5774,8,4,4,1.068975682977933
35764,703-004-5384,4221.07,3,2,1,0.679781050154935
35877,703-004-5389,1015.19763,2,2,0,0.45015073687648327
35882,703-004-5385,5456.063,4,1,3,2.123835234324529
36140,703-004-5394,7704.5957,5,2,3,0.6847851799075794
36234,703-004-5394,7711.257,2,1,1,0.5426387834990812
36364,703-004-5398,2468.6587,7,2,5,0.9635355549663154
36527,703-004-5383,2064.0195,8,5,3,1.6121119806712205
36808,703-004-5391,959.6479,4,1,3,0.6722220640357065
36936,703-004-5398,2597.4036,4,1,3,0.8551536443834604
37005,703-004-5395,1561.6202,7,1,6,0.7217507002244964
37069,703-004-5391,9484.779,1,0,1,0.27920371738274696
37169,703-004-5393,9872.1875,5,2,3,0.8937466717286006
37625,703-004-5390,7367.785,"","","",0.27920371738274696
37836,703-004-5399,5319.7437,6,2,4,0.6507647882681429
37913,703-004-5393,7795.487,5,1,4,0.5192058688781354
38210,207-008-2398,2064.1816,5,0,5,0.27920371738274696
38444,703-004-5392,1073.1823,4,1,3,1.0597001334895035
38503,703-004-5388,965.10175,3,2,1,0.6326131648276588
38726,703-004-5389,2303.2976,3,1,2,0.6962430081424263
38929,703-004-5398,2049.616,5,2,3,0.8449178597846532
38934,703-004-5382,7476.714,5,1,4,1.0251442154949724
38982,703-004-5398,8339.31,7,3,4,0.5715984970319072
38985,703-004-5382,5757.374,4,2,2,1.112888916013645
39044,703-004-5390,6026.7144,4,3,1,1.4017121496575788
39891,703-004-5389,8955.563,4,1,3,0.7325999579084223
39948,703-004-5392,6698.0312,7,5,2,3.025852171991774
400,703-004-5383,9759.648,2,1,1,0.5165268771580819
40142,703-004-5399,7373.4336,6,2,4,0.5033317297873001
40527,703-004-5393,9390.521,4,1,3,0.3187575773453028
40564,703-004-5389,5469.4233,3,3,0,0.8763871058328914
40629,703-004-5391,815.7134,5,2,3,1.704456508223972
40727,703-004-5383,665.82916,2,0,2,0.27920371738274696
41823,703-004-5385,9822.501,4,0,4,0.27920371738274696
42011,207-008-2399,729.267,1,1,0,0.3496425496660651
42391,703-004-5397,8556.863,3,1,2,0.3978652972704144
4251,703-004-5387,9826.859,4,2,2,0.6603068564576268
42773,703-004-5390,8098.6123,2,1,1,0.4034024379823445
42882,703-004-5394,2400.0417,3,1,2,0.3790442522382316
43021,703-004-5380,1517.868,"","","",0.27920371738274696
43383,703-004-5396,332.63623,4,3,1,0.788290880586339
43910,703-004-5383,1612.4719,3,2,1,1.2584926032150552
44147,703-004-5389,7554.858,4,3,1,3.849266589508092
4428,703-004-5392,3318.8677,"","","",0.27920371738274696
44280,703-004-5398,2601.642,4,1,3,0.35114230018964543
44535,703-004-5381,4652.0337,6,2,4,0.8818952994591625
44549,703-004-5388,30.35307,5,4,1,1.3064003337636934
44713,703-004-5391,6932.7646,6,3,3,2.985825998312737
44884,703-004-5394,2174.459,3,0,3,0.27920371738274696
44932,207-008-2398,5607.4624,1,1,0,0.44375766329196986
4532,703-004-5386,8917.359,4,4,0,2.486401899594471
45418,703-004-5383,1334.3174,4,3,1,0.5963781317733342
45451,703-004-5393,9379.188,5,3,2,0.7221303775747223
45650,703-004-5397,5670.481,3,2,1,1.2606646466031337
45776,207-008-2398,3135.2556,"","","",0.27920371738274696
46250,207-008-2398,6887.0415,5,1,4,0.41546504426562114
46343,703-004-5385,1593.9641,3,0,3,0.27920371738274696
46386,703-004-5397,7541.0913,1,1,0,0.5684950046398222
46653,703-004-5390,7085.078,5,2,3,1.800434495223669
47028,703-004-5395,4202.0996,2,2,0,0.5694206001141355
47273,703-004-5397,3418.355,2,0,2,0.27920371738274696
47308,703-004-5382,9361.683,3,0,3,0.27920371738274696
47454,703-004-5393,3825.1812,3,0,3,0.27920371738274696
47513,703-004-5381,3636.5872,3,0,3,0.27920371738274696
47627,207-008-2398,4993.4434,5,3,2,1.3775494876096397
47695,703-004-5388,2364.294,6,1,5,0.5042161529959283
47738,703-004-5381,2669.0828,1,1,0,0.4324524936132651
47784,207-008-2399,3167.311,4,1,3,0.740863085683915
48019,703-004-5398,8624.828,1,1,0,0.5319744974674097
48265,703-004-5399,8528.322,4,0,4,0.27920371738274696
48445,207-008-2398,7721.4663,1,0,1,0.27920371738274696
48468,703-004-5398,3360.1362,5,3,2,1.380364808610581
4872,703-004-5383,7565.8677,6,2,4,2.702394834203353
48724,703-004-5384,4268.655,1,0,1,0.27920371738274696
48769,703-004-5388,3712.4568,5,3,2,1.7595790008555234
48806,207-008-2398,6503.476,4,2,2,0.7066418670610481
49246,703-004-5387,9823.87,4,2,2,0.7059384163911662
49796,703-004-5386,1774.4839,8,2,6,0.48537341688520813
5070,703-004-5386,6675.8823,2,1,1,0.752520050722512
5077,703-004-5392,884.83453,4,4,0,1.0572946778031498
5236,703-004-5389,4676.1465,2,0,2,0.27920371738274696
5472,703-004-5386,7538.1035,3,3,0,1.0014134706162483
5771,703-004-5380,9056.711,3,3,0,3.614345983278039
5871,703-004-5388,7656.563,6,3,3,0.8865525964245641
6170,703-004-5396,788.55457,2,2,0,0.5022940016874009
62,207-008-2399,4664.8247,2,2,0,0.8400598700404251
6295,703-004-5382,3596.1228,3,1,2,0.35831143730785864
6398,703-004-5380,5122.99,2,2,0,1.281436593150405
6669,703-004-5399,5635.629,6,4,2,0.8932223828889004
704,703-004-5399,203.73106,4,2,2,0.863592525903944
7076,207-008-2399,4323.9253,7,3,4,1.703194005372133
7205,703-004-5383,9263.58,7,4,3,1.49308878916309
7278,703-004-5395,4047.305,5,3,2,0.80499286377232
734,703-004-5399,3806.6858,3,2,1,0.5280316204439767
7510,703-004-5394,7425.1113,3,2,1,0.6916852460233095
775,703-004-5383,9845.269,10,5,5,2.3596357758246658
7795,703-004-5397,1105.1143,2,2,0,0.7308847463760695
8295,703-004-5388,2873.1787,4,2,2,1.2072175735592594
8426,703-004-5398,5985.132,1,0,1,0.27920371738274696
8670,703-004-5381,3565.2925,5,2,3,0.4857243087122416
8754,703-004-5398,1276.2017,4,2,2,2.0235391833702403
8805,207-008-2398,7342.715,4,3,1,1.7264007126855292
883,703-004-5393,8552.04,1,1,0,0.35831143730785864
8864,703-004-5382,2979.871,4,2,2,1.9210132165730052
9039,703-004-5392,6443.244,7,5,2,2.382543629267516
9345,703-004-5398,3940.5178,4,2,2,0.6253076109645737
9765,703-004-5391,3024.816,1,0,1,0.27920371738274696
100,703-004-5388,5920.624,3,3,0,1.0689171739330159
10445,703-004-5397,8900.199,2,2,0,2.3484568390978904
10584,703-004-5381,3940.227,3,2,1,0.8087891943214106
10592,703-004-5398,9718.175,3,1,2,0.35831143730785864
10683,703-004-5384,8894.207,4,2,2,0.5006330147709983
10881,703-004-5387,9925.414,6,6,0,1.6664498046100433
1106,703-004-5393,2773.292,7,6,1,1.1763317457898457
11138,703-004-5395,9815.433,3,2,1,0.798314409272159
11440,703-004-5394,183.62105,2,1,1,0.9426577287413628
11982,703-004-5384,4940.4233,4,4,0,1.0308943289313055
12097,703-004-5388,5637.1753,3,1,2,0.3781089682578671
12259,703-004-5381,9625.2705,"","","",0.27920371738274696
12712,703-004-5393,302.7308,4,1,3,0.6478214806289482
12761,703-004-5387,9932.627,1,1,0,0.6101563730911301
12826,703-004-5382,982.7608,5,1,4,0.49852999907663464
12835,703-004-5384,2653.7717,2,2,0,0.9068896059658664
13162,207-008-2398,213.61649,5,2,3,0.524920102793895
13195,703-004-5399,4691.958,8,4,4,2.509018257532338
13213,703-004-5394,8982.5205,2,0,2,0.27920371738274696
13283,703-004-5386,600.9996,4,1,3,0.35831143730785864
13593,703-004-5395,1295.7406,5,1,4,0.3978652972704144
14483,703-004-5384,510.09058,5,4,1,3.0008898210052606
14603,703-004-5386,8680.623,2,0,2,0.27920371738274696
14734,703-004-5394,7448.838,6,4,2,1.304653869620252
14784,703-004-5383,1901.356,2,0,2,0.27920371738274696
14970,703-004-5393,8162.2915,9,5,4,0.9365933547177425
14977,703-004-5390,4919.93,4,3,1,2.578311678589441
15313,703-004-5383,3227.408,4,1,3,1.0363569031671904
15376,703-004-5392,1237.7483,6,5,1,1.1028088691848024
15552,703-004-5390,6117.448,4,1,3,0.37512182779194486
15755,703-004-5394,328.99796,1,0,1,0.27920371738274696
15889,703-004-5389,3966.1694,2,0,2,0.27920371738274696
16051,703-004-5389,3999.881,5,3,2,1.3248984717110552
16457,703-004-5380,279.5452,7,3,4,0.8386532318568681
16511,703-004-5382,5430.3647,6,2,4,0.7559150780389619
16792,703-004-5383,5004.4805,8,3,5,3.7623374999754424
16956,703-004-5390,2982.3386,6,3,3,2.298462124474376
1697,703-004-5396,9613.072,4,0,4,0.27920371738274696
17238,703-004-5383,8351.622,2,1,1,0.6114737688272005
17270,703-004-5398,5491.0093,4,2,2,1.5586658411130316
17460,703-004-5388,6456.101,2,2,0,0.8401022148477415
17499,207-008-2399,139.0481,3,3,0,2.408108586642895
17643,703-004-5395,1501.807,5,3,2,1.4813007086156222
17731,703-004-5397,4800.0947,4,1,3,0.9046702898656716
17809,703-004-5397,503.75104,5,1,4,0.45640523353201934
18301,703-004-5385,6086.402,5,2,3,1.1134293065466716
18866,703-004-5398,1115.138,9,5,4,1.9888554260958962
19088,703-004-5387,9212.826,4,2,2,2.9867526498843584
19201,703-004-5386,5157.595,1,0,1,0.27920371738274696
19328,703-004-5399,7922.3574,4,2,2,0.3978652972704144
19419,703-004-5383,4958.5957,2,0,2,0.27920371738274696
19452,207-008-2399,5024.2285,4,2,2,1.4967553656062995
19523,703-004-5386,9268.723,3,2,1,0.6671353431414548
19748,703-004-5396,4393.7046,3,2,1,0.6838646849735713
20638,703-004-5392,9055.947,4,2,2,0.5160324539085499
20844,703-004-5385,5719.7993,5,3,2,2.774800407612679
20977,703-004-5385,4740.6875,3,1,2,0.4230808829965438
21011,703-004-5390,4274.9775,7,3,4,1.804364551759822
21158,703-004-5398,4664.4688,3,3,0,5.458140196696022
21373,703-004-5384,2524.6018,3,2,1,0.817806761129504
21528,703-004-5394,2196.231,4,1,3,0.7493430105570772
21571,703-004-5390,5680.179,2,1,1,0.6978460937594926
21803,207-008-2398,829.54346,4,2,2,0.7495291656495143
21955,703-004-5381,4036.656,2,0,2,0.27920371738274696
2206,703-004-5394,6558.314,2,1,1,0.4929883597451673
22071,703-004-5383,166.1533,3,1,2,0.4762249124404884
22099,703-004-5390,166.7124,3,1,2,0.4045517605298771
22179,703-004-5380,7969.774,2,2,0,0.49714548577642953
22267,703-004-5392,9916.505,4,1,3,0.7591340664193532
22270,703-004-5380,5687.579,3,1,2,0.9429017025003127
22364,703-004-5393,8969.142,2,1,1,2.1744574076544416
22537,703-004-5391,5841.9336,2,0,2,0.27920371738274696
22690,703-004-5389,2186.1177,7,3,4,2.5389180832633236
22794,703-004-5391,5266.107,2,2,0,0.8461233134821201
22967,207-008-2398,5762.9033,2,1,1,0.5165268771580819
23187,703-004-5390,7880.8726,3,2,1,0.8200372865811384
2337,703-004-5395,8699.18,1,0,1,0.27920371738274696
2351,703-004-5382,9577.88,5,3,2,1.002868267993497
23512,703-004-5383,8679.97,2,1,1,0.6115583949339949
23694,703-004-5385,5147.2437,4,2,2,0.7196018601253547
23987,703-004-5397,7831.4644,5,2,3,0.6816691867342477
24248,703-004-5392,1151.1129,5,2,3,1.0259522584871854
24524,703-004-5392,3599.4143,2,2,0,1.2078976408116628
24661,703-004-5386,3667.3206,5,3,2,1.6183001066328917
24805,207-008-2399,1262.8031,5,3,2,1.9451002538570359
24931,703-004-5397,2880.3164,3,1,2,0.7282858788870235
25067,703-004-5399,221.15051,5,2,3,0.7805796623861418
25151,703-004-5393,4344.674,4,1,3,0.5274793674702837
25671,703-004-5393,5943.4243,1,0,1,0.27920371738274696
25832,703-004-5380,5496.954,6,3,3,0.6784924748019573
26149,703-004-5383,8507.417,4,2,2,1.3489511943537442
26242,703-004-5392,9296.792,2,1,1,0.3919322182760311
26304,703-004-5398,1423.7058,4,4,0,1.7758590623795467
26332,703-004-5381,2192.203,4,2,2,1.5399178540621945
2646,703-004-5381,9986.298,4,4,0,1.620627327451395
26524,703-004-5390,3507.0098,6,3,3,1.832199839110016
26567,703-004-5385,1473.13,6,4,2,2.6269876130751095
26672,703-004-5396,7066.6074,6,1,5,0.42053789941645114
26677,703-004-5385,9651.823,7,6,1,2.103983444099497
26761,703-004-5381,3586.3828,7,3,4,1.1236881563752403
27013,703-004-5380,7105.288,3,2,1,0.6692554971715897
2705,703-004-5390,1939.9524,4,3,1,1.0239263242347694
27199,703-004-5381,1795.2871,2,1,1,0.5334893357658536
27499,703-004-5391,6110.8345,5,3,2,0.9045314297184536
27599,703-004-5399,3507.3447,5,2,3,0.681596301534385
27627,703-004-5390,1301.1318,8,4,4,1.5453498523152542
27649,703-004-5394,1262.846,3,2,1,0.6368665768964408
2775,703-004-5381,2496.6455,2,0,2,0.27920371738274696
27838,703-004-5397,3830.743,6,2,4,0.5935898974929145
28160,703-004-5398,6159.552,1,0,1,0.27920371738274696
28188,703-004-5395,1395.8383,2,2,0,0.9773523634612189
2841,703-004-5394,6267.3906,5,4,1,1.959083720815758
28936,703-004-5383,2876.5618,6,2,4,0.9007875342070722
2902,703-004-5395,2563.4849,3,1,2,0.7725335308989191
29128,703-004-5395,8324.191,8,2,6,1.378480157052622
29294,703-004-5387,8020.3433,6,4,2,4.623738074270128
29410,703-004-5393,1954.7952,3,1,2,0.5529545612890024
29519,703-004-5393,3149.6448,"","","",0.27920371738274696
30135,703-004-5388,5866.295,6,4,2,1.4671387959101538
30397,703-004-5388,3194.427,6,1,5,0.527162963045202
30700,703-004-5396,4958.679,1,0,1,0.27920371738274696
31093,703-004-5396,8768.785,5,2,3,0.9703795222848385
31117,703-004-5384,586.89294,3,3,0,3.7597383574186467
31285,703-004-5383,4604.1797,"","","",0.27920371738274696
31319,703-004-5388,2880.849,7,3,4,1.1989858136544864
31431,703-004-5389,7793.066,5,2,3,0.4599151060721429
31454,703-004-5381,9064.739,7,3,4,1.0216587146655995
31586,703-004-5386,4943.545,2,0,2,0.27920371738274696
31640,703-004-5388,5372.636,4,3,1,1.4970682742200059
31668,703-004-5395,6234.3496,3,2,1,0.5568706023953707
32186,703-004-5387,735.86346,2,0,2,0.27920371738274696
32432,703-004-5398,5895.0156,2,1,1,0.8546119453467509
32844,207-008-2399,9211.13,4,2,2,1.6411445285903217
32919,703-004-5392,28.349758,4,3,1,0.8960823939554406
33291,703-004-5383,9021.57,3,2,1,0.8312609609051144
33426,703-004-5387,2475.2063,5,4,1,2.241399512265002
33529,703-004-5398,5564.068,3,2,1,0.7730384331795538
33808,703-004-5387,4592.1147,6,3,3,0.7313275880299972
34306,703-004-5397,2219.0874,7,3,4,1.4356000180984383
34320,703-004-5388,1338.9397,4,1,3,0.8582709087725653
34334,703-004-5386,4460.8066,1,0,1,0.27920371738274696
34474,703-004-5386,9564.898,5,4,1,1.4372935283086006
34619,703-004-5399,3168.8618,3,2,1,1.1618678152753668
34825,703-004-5391,4632.6167,3,2,1,1.53184202305646
34930,703-004-5399,1977.9187,4,3,1,1.0948890583931263
35272,703-004-5399,2129.5417,5,2,3,0.48698508799854806
35310,703-004-5391,9468.764,3,1,2,1.4656600328550917
36161,703-004-5388,6386.6855,4,2,2,1.2216124578561556
36217,703-004-5388,3788.666,6,3,3,1.0252817178999816
36335,703-004-5388,2500.0715,3,2,1,1.1400110544728606
3676,703-004-5388,617.47015,6,4,2,2.0296667936946484
37224,703-004-5388,6575.6514,4,1,3,0.40612378460492865
38833,703-004-5382,7870.6445,5,3,2,0.7137772043437711
39122,207-008-2399,1981.5558,6,3,3,1.2531829044401457
39617,703-004-5391,8859.358,1,1,0,0.4081156674696453
39639,703-004-5384,5715.611,2,0,2,0.27920371738274696
39856,703-004-5390,6400.4927,2,1,1,0.5808029856762794
40032,703-004-5391,2989.067,5,2,3,1.4430105755530493
40083,703-004-5399,1676.2817,4,2,2,0.9767662949792422
40134,703-004-5399,4553.724,1,1,0,0.4705741161920978
40197,703-004-5391,6795.746,5,4,1,2.023635770345417
40232,207-008-2398,6645.2993,4,2,2,0.6369221914547605
40244,703-004-5381,6859.0815,2,2,0,0.8677760294272471
40323,703-004-5392,6285.652,4,1,3,0.45372188426021015
40359,703-004-5387,4786.5303,6,2,4,1.3730935264492143
40479,703-004-5387,171.07426,4,1,3,0.4568165558389244
40637,703-004-5398,2013.4098,2,1,1,0.4018941291633186
40703,703-004-5382,4309.4287,3,0,3,0.27920371738274696
41171,703-004-5387,2278.2373,4,3,1,1.0391458975947752
41536,703-004-5396,2627.0693,2,0,2,0.27920371738274696
41770,703-004-5386,6918.0073,2,1,1,0.6637686502436667
41831,703-004-5383,5583.059,1,1,0,0.5165268771580819
42231,703-004-5396,1010.98956,4,3,1,0.6576382111497338
42294,703-004-5396,5426.322,4,2,2,1.4123682030112432
4247,703-004-5397,5955.2534,1,0,1,0.27920371738274696
42555,703-004-5386,5796.9824,3,0,3,0.27920371738274696
42973,703-004-5384,5981.9307,7,2,5,1.3477570432575805
43064,703-004-5393,1401.0262,2,1,1,0.44451413086375374
43155,703-004-5382,1856.6305,6,3,3,2.3102371203938192
43239,703-004-5399,5028.007,3,2,1,0.690847254978273
43658,703-004-5389,5336.287,3,2,1,1.1493069784820038
44000,703-004-5393,848.26587,4,3,1,1.6940159907108254
44110,703-004-5396,4133.173,6,3,3,0.8944137644351738
44151,703-004-5390,4199.8516,4,3,1,1.2495822280938147
44286,703-004-5386,6822.453,5,3,2,1.517357009898308
44347,703-004-5393,5133.968,4,1,3,0.4606333005828856
44513,703-004-5383,4186.3643,5,3,2,1.0381146416440183
44600,703-004-5381,911.73413,2,2,0,0.7748934579476127
44699,703-004-5397,6167.0356,3,1,2,0.9427143769384532
44968,703-004-5395,5332.695,2,0,2,0.27920371738274696
45060,703-004-5392,6797.1133,7,4,3,1.8440865474381365
45400,703-004-5389,7817.6367,1,0,1,0.27920371738274696
45460,703-004-5394,9983.25,2,1,1,0.7461287938532262
45613,703-004-5386,6539.3413,4,2,2,1.1408510046953384
45725,207-008-2398,493.7446,3,1,2,0.48788891004036816
45866,703-004-5381,2175.123,1,1,0,0.5549606949965645
46097,703-004-5382,6654.606,5,1,4,0.5009478239402255
4615,703-004-5383,8021.1533,6,2,4,1.6940921190156437
46374,703-004-5382,7382.2373,8,3,5,0.6740693375721872
46417,703-004-5383,9803.375,6,4,2,2.1361702671564844
46723,207-008-2398,2986.5925,8,4,4,2.066212388763438
46849,703-004-5396,5683.22,7,3,4,2.600822023218328
46923,703-004-5387,9284.183,2,2,0,0.5606261348613347
46925,703-004-5389,1698.9231,5,3,2,0.9725880171727498
47082,703-004-5390,8910.609,3,2,1,0.5309508514244273
4741,703-004-5387,2156.4995,2,1,1,0.5165268771580819
47480,207-008-2398,2246.628,4,3,1,1.192655137192322
48040,703-004-5393,9921.245,7,4,3,1.5508275171551806
48127,703-004-5387,5491.385,1,0,1,0.27920371738274696
48258,703-004-5390,3535.5151,3,3,0,1.2683366102960119
48305,703-004-5396,6829.9395,6,3,3,1.0736797382580112
48441,703-004-5387,6514.493,8,6,2,2.2531417527608895
48558,703-004-5384,8615.419,3,1,2,0.702752360934843
49045,703-004-5393,6923.239,2,1,1,0.5165268771580819
49188,703-004-5395,9749.747,7,5,2,1.7445329322535903
49219,703-004-5389,6284.473,3,2,1,0.7078557927157141
4941,703-004-5390,3355.1353,3,1,2,0.5206532398194685
49572,703-004-5399,3246.8694,8,1,7,0.4143460722548127
4961,703-004-5396,9507.971,5,3,2,1.7701365241277094
49953,703-004-5398,3603.822,4,1,3,0.6518575547047929
5189,207-008-2398,3644.9539,4,2,2,0.5820522755488398
5283,703-004-5384,8848.16,5,2,3,0.8501171741999306
5556,703-004-5398,4210.9644,5,1,4,0.37965470014365377
5644,703-004-5390,9160.077,4,2,2,1.1367687132417397
5677,703-004-5380,7122.8564,4,3,1,2.4555619270599487
5922,703-004-5393,6286.359,2,1,1,0.5566574890515558
5967,703-004-5394,6041.7007,3,1,2,0.8105694575675835
6444,703-004-5381,8188.197,2,0,2,0.27920371738274696
6448,703-004-5398,159.17897,5,3,2,0.6216841146005032
6588,703-004-5396,323.80164,2,1,1,0.3271627725873459
6910,703-004-5384,5140.7856,6,2,4,0.6116499396328348
7311,703-004-5380,9662.942,5,2,3,1.4531471700262644
7336,703-004-5395,6598.481,2,2,0,0.730296203230626
7382,703-004-5388,4346.826,4,1,3,0.7252447548140148
7480,703-004-5382,5013.566,4,3,1,2.1153962601366887
7820,703-004-5395,3341.54,5,4,1,1.8882337192434828
7880,703-004-5391,5905.2695,3,2,1,1.1156457112379403
7981,703-004-5384,855.8696,2,1,1,1.4055563031292009
8237,703-004-5392,3730.7942,4,2,2,0.7067656886481919
8263,703-004-5396,5984.305,5,3,2,0.8174968194601252
8303,703-004-5380,2468.99,1,1,0,0.3973784733180501
8891,207-008-2398,4002.2017,4,2,2,0.9272902149974971
908,703-004-5390,46.824814,4,4,0,0.8847158490392549
9086,207-008-2398,7997.226,1,1,0,0.32666834933781397
9089,703-004-5391,5382.116,7,5,2,1.8699276019863191
9818,703-004-5382,9641.506,2,1,1,0.5165268771580819
10011,703-004-5381,3916.4465,7,5,2,1.7463534450914788
1010,703-004-5399,1101.361,1,1,0,0.41235320915544693
10200,703-004-5395,3649.143,8,3,5,1.6343411918926285
10229,703-004-5380,6635.66,4,3,1,2.121760518699527
10371,207-008-2399,8630.952,3,1,2,0.5606946602711557
1039,703-004-5384,1869.2928,4,2,2,0.8450843901306784
10509,207-008-2398,6490.3843,2,1,1,0.37953170072101095
10625,703-004-5399,2074.045,6,3,3,1.003165641201258
10739,703-004-5399,8249.392,2,2,0,0.6444323472130459
11004,703-004-5380,9887.298,3,2,1,1.1338883727359736
11019,207-008-2398,9552.707,5,1,4,1.189440896333872
11231,703-004-5383,1575.445,9,5,4,2.3429985330005554
1145,703-004-5383,2609.129,5,0,5,0.27920371738274696
11900,207-008-2398,9989.047,4,1,3,1.3684740870070393
11916,703-004-5398,4939.515,7,4,3,1.4819664127804828
12134,703-004-5386,7726.6826,2,1,1,0.6547363551509371
12167,703-004-5381,7245.8193,8,3,5,0.9081040177140479
12209,703-004-5385,6375.9595,6,5,1,2.3246468145651535
12222,703-004-5398,6991.305,4,2,2,1.1539069316652102
12311,703-004-5382,3176.912,4,4,0,2.1869795593289085
12480,703-004-5387,8448.467,2,1,1,0.3348481699819454
12506,703-004-5382,9947.452,3,2,1,1.774027779710917
1266,703-004-5381,5211.911,2,2,0,1.4759732060945008
12687,703-004-5392,5864.996,3,1,2,0.40029995015737724
13090,703-004-5389,9601.12,6,1,5,0.4087426087601173
13600,703-004-5380,5370.35,4,2,2,1.54966952135903
13950,703-004-5391,7185.865,4,1,3,0.9170603384884403
13968,703-004-5390,4317.263,6,3,3,0.8407442885486276
14496,703-004-5391,1786.5056,6,4,2,3.054801324087085
14504,703-004-5389,1378.668,3,3,0,1.7632817469916
14565,703-004-5382,98.576546,2,1,1,1.3345833071884161
14643,703-004-5390,5450.5186,5,3,2,0.9034725375717357
15173,703-004-5392,4582.875,4,3,1,3.450048774749492
15201,703-004-5380,1625.1677,6,2,4,2.724225196617933
15307,703-004-5393,4626.9697,4,4,0,2.7506572003885976
15324,703-004-5389,1812.9987,5,2,3,1.752096202886387
1544,703-004-5391,5373.988,3,1,2,0.7223656674931317
15489,703-004-5386,9720.237,2,1,1,0.35831143730785864
15850,703-004-5396,5313.6553,1,1,0,0.6876592667094967
15982,703-004-5381,874.4109,4,2,2,0.5498399859378955
1636,703-004-5396,1628.7618,1,0,1,0.27920371738274696
1645,703-004-5380,6628.223,4,2,2,0.5165268771580819
16730,703-004-5384,9517.159,3,0,3,0.27920371738274696
16740,703-004-5390,9892.932,5,1,4,0.3978652972704144
16767,207-008-2398,7541.8228,1,1,0,0.3737032717388923
17077,703-004-5389,3767.3396,6,3,3,1.0232749470134839
17321,703-004-5392,1622.8206,6,4,2,1.1367379489495022
17640,703-004-5386,3754.5066,5,2,3,1.350638261247437
17914,703-004-5398,2956.3362,5,3,2,1.0853317209337348
18020,703-004-5380,8605.476,4,1,3,0.5071328354169748
18107,703-004-5399,3945.9753,5,3,2,0.9507067762043951
18305,703-004-5399,1851.5569,2,2,0,0.6914179274012617
18399,703-004-5398,8425.69,1,1,0,0.46893273858639317
1866,207-008-2399,7923.416,6,4,2,2.343656603088798
18674,703-004-5384,1185.6282,5,4,1,2.1760234506511305
18756,703-004-5394,2122.4417,4,2,2,0.6577970334316263
18981,703-004-5382,6781.6885,4,2,2,1.052594575528376
19015,703-004-5387,2823.134,8,3,5,1.2945241117208757
19027,703-004-5383,944.9941,3,2,1,0.551243275534947
19444,207-008-2398,9421.394,3,1,2,1.2793457717258414
19451,703-004-5398,2669.0037,6,2,4,1.0107471441582014
19606,703-004-5390,872.4838,8,1,7,0.8516395673419238
19640,207-008-2399,9238.031,3,1,2,0.44286634947995257
19785,703-004-5391,9009.101,2,0,2,0.27920371738274696
19873,207-008-2399,5828.0503,7,3,4,1.0904750237474623
20203,703-004-5393,3491.1257,2,0,2,0.27920371738274696
20250,703-004-5387,428.12943,2,1,1,0.3989975139080607
20255,703-004-5386,2563.737,1,0,1,0.27920371738274696
20326,703-004-5380,3391.2915,4,2,2,0.6165601676997643
2037,207-008-2399,2142.219,6,2,4,0.6050541935047189
20410,703-004-5380,4058.938,2,2,0,0.4920406425969349
2046,703-004-5382,9677.1045,7,6,1,2.3094693543658784
2094,703-004-5382,2725.1006,5,5,0,4.252229327352573
21474,703-004-5388,3469.103,5,3,2,1.1792772499908288
21660,703-004-5394,1537.7671,6,4,2,1.1982963247575809
21703,703-004-5390,3068.148,5,3,2,3.0289943698978252
21984,703-004-5386,9499.845,5,2,3,1.1036609606145305
22097,703-004-5389,5683.4185,4,2,2,1.2065798910921757
22232,703-004-5397,6665.428,3,1,2,0.4517835740987158
22381,703-004-5398,6355.9604,3,3,0,0.9939058655913519
22670,703-004-5381,2024.3776,6,5,1,1.884571664961592
22751,703-004-5395,1743.7732,7,4,3,1.8767277333669725
22844,703-004-5390,9101.078,8,2,6,0.9813266413126918
23000,703-004-5396,1048.6108,3,3,0,2.30133229278761
2306,703-004-5399,9003.492,5,4,1,1.221672719105296
23205,703-004-5380,2055.4585,4,4,0,1.4462342359030433
23224,703-004-5394,8947.663,7,2,5,1.8801409885504792
23725,703-004-5399,3175.447,7,3,4,0.5933135589207179
23731,703-004-5383,7284.332,6,3,3,0.896262751377174
23838,703-004-5385,1923.8531,3,2,1,1.6079945554288035
24083,703-004-5380,6295.6665,6,3,3,0.9130003161499807
24314,703-004-5384,7700.3887,3,1,2,0.3978652972704144
24360,703-004-5381,1735.1609,3,0,3,0.27920371738274696
24611,703-004-5386,4936.038,4,1,3,0.890289120194243
24721,703-004-5383,126.10614,6,5,1,2.6585642383060186
24946,703-004-5381,2256.9036,11,5,6,2.3092983268666605
25297,703-004-5394,9111.019,3,1,2,0.3851743228458582
25333,703-004-5392,3074.9053,7,3,4,1.0453617053538098
25647,703-004-5397,6679.6016,3,1,2,0.897010453643142
25674,703-004-5394,5818.2383,3,2,1,0.6173943875295907
25913,703-004-5398,4719.677,5,1,4,0.333139800315021
26095,703-004-5397,1198.6953,2,2,0,1.9388413636786541
26158,703-004-5389,5702.835,3,3,0,1.656270982936727
26570,703-004-5390,9719.603,4,3,1,1.6309463666163686
26674,703-004-5389,1318.5525,1,0,1,0.27920371738274696
27342,703-004-5385,359.06552,3,2,1,1.04521799359669
27352,703-004-5394,241.86372,4,0,4,0.27920371738274696
2755,703-004-5393,1957.6323,"","","",0.27920371738274696
27706,703-004-5395,9808.329,4,3,1,0.8854007904968105
27905,703-004-5388,4802.1235,6,4,2,1.600472204158428
28025,703-004-5384,2447.2446,1,1,0,0.6846307819989441
28311,703-004-5392,3897.1597,5,2,3,0.7435245072487124
28502,703-004-5397,9582.073,8,6,2,2.8246562518973692
28564,207-008-2399,4009.5317,7,3,4,0.9745868134303763
28891,703-004-5391,1287.9717,6,3,3,0.992525910913272
29332,207-008-2398,4479.8887,6,3,3,1.359566060958703
29383,703-004-5388,9161.8125,4,2,2,0.904225273865187
29408,703-004-5399,5649.9126,4,2,2,1.4134584669419612
29478,703-004-5395,869.5895,1,1,0,0.7417297116364575
29689,703-004-5382,9993.525,3,2,1,1.328802035820218
29930,207-008-2398,2088.0806,3,1,2,0.7214653140890743
30063,207-008-2399,1815.7155,3,1,2,0.5903432516733621
30176,703-004-5382,3918.0583,3,1,2,0.5080464582830405
30378,207-008-2398,7965.743,8,3,5,1.4230204899693126
30615,703-004-5395,3534.441,1,1,0,0.7239410271056176
30617,703-004-5381,8613.304,3,2,1,0.8216451881014876
30701,703-004-5395,6492.521,1,1,0,0.8639531872600231
30829,703-004-5396,6257.1,4,1,3,0.35831143730785864
30995,207-008-2398,6020.5933,3,1,2,0.8657008912464687
31246,703-004-5397,9713.646,7,4,3,1.7071048841270007
32347,703-004-5391,7001.9316,3,2,1,0.514125580772337
32479,703-004-5381,2832.3042,4,3,1,0.7832846586487102
32573,703-004-5382,6705.681,2,0,2,0.27920371738274696
3276,703-004-5387,2972.5945,6,2,4,0.6981606026528893
32861,703-004-5392,430.39203,1,1,0,0.33853450732658075
32938,703-004-5388,9305.531,9,3,6,1.7913079504412166
33001,703-004-5383,8694.435,1,1,0,0.7309754899840184
3310,703-004-5391,6675.5347,7,4,3,1.7049387310912791
33385,703-004-5389,3170.6726,3,0,3,0.27920371738274696
33499,703-004-5393,8112.7227,3,3,0,0.7519622713559273
33719,703-004-5387,8352.04,5,3,2,1.036761220955148
33827,703-004-5394,9768.467,3,2,1,1.3887181242977615
34011,703-004-5391,6921.2915,4,1,3,0.35685783295423473
34082,703-004-5385,9642.294,4,1,3,0.3721552882947532
34773,703-004-5397,7397.7075,1,1,0,0.5437417763523251
34972,703-004-5380,6687.3955,3,2,1,0.9655365360186631
35247,703-004-5382,1969.7184,4,1,3,0.8840879535579764
35309,703-004-5385,6018.5933,4,2,2,0.4618535542248391
35387,703-004-5398,5401.53,3,3,0,0.7614271972674932
35560,207-008-2398,4226.819,4,2,2,1.3444351637056102
35969,207-008-2399,4644.0156,6,0,6,0.27920371738274696
36086,703-004-5392,4427.434,2,1,1,0.35831143730785864
36407,703-004-5384,8677.507,6,4,2,1.5795147661967477
36606,703-004-5391,4425.0425,1,1,0,0.4182684967010995
36622,703-004-5382,459.13815,7,4,3,1.9368990600558573
36907,207-008-2398,8224.332,1,1,0,0.8979768089072531
37382,703-004-5387,8818.013,2,2,0,1.2121886495315286
37408,207-008-2398,8959.241,7,1,6,0.5165268771580819
37497,703-004-5384,8909.345,7,2,5,0.4057760692629256
37608,703-004-5394,6396.7905,2,1,1,0.3978652972704144
37881,207-008-2399,3314.3823,3,2,1,0.926813268941033
37961,703-004-5389,553.08405,3,2,1,0.9029571851826202
38032,703-004-5387,5748.4917,2,1,1,0.3712999360730629
38039,703-004-5394,6800.1274,5,2,3,0.9028096030491554
38088,703-004-5397,3193.0256,5,3,2,0.8911893563735908
3809,703-004-5389,5621.4536,5,4,1,1.8361671284245369
38151,703-004-5382,4500.8677,6,3,3,0.6304765873500944
38297,703-004-5389,5020.1733,5,2,3,1.1671560901387055
3849,703-004-5398,7923.612,7,5,2,2.048577312774985
38543,703-004-5397,4058.1245,1,1,0,0.7367006967228407
38660,703-004-5396,7545.073,9,6,3,2.378173376989326
390,703-004-5384,3756.6418,6,5,1,1.6466366542066289
39504,703-004-5398,6622.5557,5,3,2,1.060835199660571
39640,703-004-5390,5091.399,4,2,2,0.7369613976162874
39788,703-004-5398,794.1353,8,5,3,1.6534328566270602
39976,207-008-2398,4453.5776,5,4,1,1.67232559345931
40315,703-004-5382,419.8402,6,3,3,0.6047599703746723
40324,703-004-5388,3455.6443,2,2,0,0.7990511574452949
40633,703-004-5397,4851.395,11,4,7,1.8399874351478545
40847,703-004-5396,4176.209,5,2,3,1.8971932622191578
40863,703-004-5390,1966.0193,3,2,1,0.863175234659974
40992,703-004-5398,2176.8325,3,2,1,0.5354303302153014
40993,703-004-5388,1284.514,6,2,4,0.7340868813536545
41254,703-004-5388,4019.2717,3,1,2,0.424140916457793
41551,703-004-5390,6488.453,5,2,3,2.7556413175774006
41619,703-004-5383,6104.085,8,2,6,2.259766301078186
41885,703-004-5380,6955.844,"","","",0.27920371738274696
4204,703-004-5385,83.28796,4,2,2,0.49468305198407314
42131,703-004-5386,2528.4214,5,3,2,1.0577917873521006
42141,703-004-5399,9930.068,3,1,2,0.6040969407425251
4242,703-004-5391,1236.9854,4,3,1,1.410797700181394
4258,703-004-5391,3202.4448,"","","",0.27920371738274696
42592,207-008-2399,1955.9866,3,1,2,0.5054690119114355
43246,703-004-5389,9367.108,2,0,2,0.27920371738274696
43424,703-004-5395,7374.875,4,3,1,1.6552857278016713
4360,703-004-5384,9179.746,9,3,6,0.9811201540220982
43714,703-004-5385,8286.498,4,4,0,3.117135238381084
43801,703-004-5385,2087.3474,6,3,3,0.8543383722301324
43838,703-004-5390,9810.3,7,1,6,0.42383203551839527
4388,703-004-5396,3132.8423,3,1,2,0.8620155688598737
44028,703-004-5388,8723.785,6,5,1,2.174099123647717
44037,703-004-5389,6749.567,4,1,3,0.38392173759486425
44287,703-004-5388,1044.4062,3,1,2,0.5195343328950488
44383,703-004-5397,5117.6187,4,1,3,0.4419657317140812
45013,207-008-2399,4856.424,2,1,1,0.4542800330701461
45134,703-004-5388,7822.4136,6,2,4,0.621467015268261
45174,703-004-5396,8265.5,1,0,1,0.27920371738274696
45469,703-004-5396,8433.6045,6,2,4,0.490512123555392
45547,703-004-5386,3296.755,3,0,3,0.27920371738274696
45656,703-004-5393,8536.06,7,4,3,1.7015256874981486
45657,703-004-5387,2390.5842,2,0,2,0.27920371738274696
45859,703-004-5395,7115.0254,3,3,0,1.0159315541237512
45940,703-004-5398,2654.546,2,2,0,0.6726823431937905
45996,207-008-2398,7195.948,3,2,1,1.6695785064263975
46075,703-004-5395,9925.989,5,2,3,0.39749744637276274
46361,703-004-5392,1254.735,3,1,2,1.0610315691385697
46411,207-008-2399,9056.631,5,3,2,1.4276737479651003
46415,703-004-5383,7940.652,4,2,2,0.8376184212974345
46436,703-004-5399,1200.7058,8,4,4,1.333016416414984
46771,703-004-5394,1440.8499,3,1,2,0.4281922696920456
4682,703-004-5391,4890.802,5,2,3,0.42970868588430466
47228,703-004-5397,6347.0493,4,0,4,0.27920371738274696
4723,703-004-5399,1314.1721,4,2,2,1.6416138867014394
47429,703-004-5385,4248.975,2,1,1,0.46690797247291144
47505,703-004-5392,1498.509,3,2,1,1.6839693995943839
47612,703-004-5398,2627.5605,4,1,3,1.008657713116596
47631,207-008-2398,5253.4995,6,2,4,2.2719298049363976
47701,207-008-2399,3434.726,4,2,2,1.3185246891626787
48143,703-004-5392,5511.244,3,0,3,0.27920371738274696
48198,703-004-5390,6806.875,3,2,1,0.4464625494275162
48799,703-004-5398,8577.569,5,3,2,1.427184063977707
48918,703-004-5383,2190.1052,"","","",0.27920371738274696
49433,703-004-5384,7120.0947,1,0,1,0.27920371738274696
49933,703-004-5398,9283.28,3,2,1,1.1447532383258598
5286,703-004-5383,5345.893,4,2,2,1.3947023532699725
5348,207-008-2398,558.7667,2,2,0,0.8676328009635687
5355,703-004-5395,4835.8804,2,2,0,0.654866502377121
5457,207-008-2398,5679.9956,4,2,2,1.4787290540040887
5619,207-008-2399,7584.455,5,1,4,0.365062748153401
6002,703-004-5391,1033.1744,5,3,2,0.7768175828216991
6171,207-008-2399,7185.2124,3,2,1,1.3381394992589406
6204,703-004-5395,4068.1804,1,1,0,0.5275063480075426
6486,703-004-5388,8998.62,4,3,1,0.8193077204357243
6567,703-004-5399,2128.697,6,3,3,0.6775605295306373
6591,703-004-5385,5137.757,6,2,4,0.9013623062741257
6695,703-004-5388,3431.604,"","","",0.27920371738274696
6898,703-004-5399,7275.538,4,1,3,0.6727977119372881
6915,703-004-5384,8624.689,5,2,3,0.8740137048668254
7069,703-004-5387,9821.547,7,2,5,1.0811005983693505
7911,703-004-5383,4852.543,6,2,4,0.49378340767961226
8148,703-004-5395,4505.806,1,0,1,0.27920371738274696
8175,703-004-5385,8448.604,4,1,3,0.869433358270467
8186,703-004-5397,1524.9497,8,2,6,0.8453743586617786
8649,703-004-5381,7317.3906,6,4,2,1.5435598952386513
9577,703-004-5380,7754.428,3,2,1,0.576910391265008
9822,703-004-5389,5662.79,2,1,1,0.8630549607349505
10217,703-004-5397,5506.6387,4,3,1,2.3175843072979156
10756,703-004-5394,2958.365,2,1,1,0.35831143730785864
10798,703-004-5396,8075.562,8,7,1,3.4480306538179684
1084,703-004-5389,7363.5493,5,4,1,1.870677788055037
11034,703-004-5386,9443.611,4,2,2,0.6003630508137361
11067,703-004-5391,6470.6455,5,1,4,0.4341398801946117
11124,703-004-5386,5840.3086,6,2,4,1.2663966442106707
11164,703-004-5396,4781.8447,9,3,6,1.2739466698973643
11173,703-004-5399,6931.547,6,1,5,0.4094897372260767
11297,207-008-2399,9764.471,9,4,5,0.988703864422368
11705,703-004-5383,9571.81,4,2,2,1.2015322362305723
1206,207-008-2399,5080.1523,3,3,0,2.7128272711704544
12736,703-004-5386,1828.0077,3,2,1,0.8416366431825898
12825,703-004-5383,8453.719,1,1,0,0.6570383938404813
12877,703-004-5397,2472.7695,4,2,2,0.9576169517086225
13212,207-008-2399,7211.042,6,2,4,0.8397073257462411
13822,703-004-5389,1565.3306,3,1,2,0.4276542980547144
14104,703-004-5388,8582.197,5,3,2,0.7751656413159739
14946,207-008-2399,9752.228,6,3,3,0.7928688386295393
14993,703-004-5395,8678.511,5,1,4,0.4706805543016392
15061,703-004-5381,1128.9906,2,2,0,1.4293725151090124
1513,207-008-2399,5018.1704,2,0,2,0.27920371738274696
15315,703-004-5386,5753.8647,5,2,3,1.553440811401996
15568,703-004-5380,8645.193,3,2,1,0.7965638005298599
15695,703-004-5394,9266.804,2,1,1,0.3131070259220805
15810,703-004-5389,2099.9385,3,1,2,0.3670132864996209
16001,207-008-2398,7274.9043,5,1,4,0.7025816848939264
16257,703-004-5388,3557.1487,4,3,1,1.0916573582855233
16755,703-004-5391,606.5804,6,5,1,2.0387630408912147
16789,703-004-5394,713.2971,2,1,1,0.5573105696733294
1700,703-004-5397,8021.8257,2,1,1,0.8149870441932812
1713,703-004-5390,9039.486,5,3,2,1.229129677429552
17241,703-004-5384,7741.1895,5,2,3,0.7852606780905939
17497,703-004-5390,4338.738,5,2,3,0.8133059371446398
17524,703-004-5399,3270.006,2,0,2,0.27920371738274696
18154,703-004-5397,7204.636,1,0,1,0.27920371738274696
18190,703-004-5384,7755.805,7,2,5,1.0710022718806433
1830,703-004-5398,5133.377,1,1,0,0.4597797143980357
1842,703-004-5399,3958.7712,7,2,5,0.8379689411332074
1889,703-004-5386,2718.0422,1,1,0,0.5747362139943964
18949,703-004-5383,7503.3726,4,2,2,0.8563912152815132
19096,703-004-5383,3820.8752,3,3,0,0.6681022529915036
19107,703-004-5394,9401.539,5,3,2,1.3988816782834372
19673,703-004-5390,4346.83,5,3,2,0.7131933104206312
19805,703-004-5389,9080.61,6,3,3,1.9790182250743937
20037,703-004-5389,9913.839,4,1,3,0.7342888579198601
20038,703-004-5381,4675.771,2,1,1,0.8084836387525822
20103,703-004-5384,8983.16,4,1,3,0.5165268771580819
20167,703-004-5383,8707.183,3,1,2,0.7134683898585488
20347,703-004-5395,3423.627,6,2,4,0.892012561089809
21160,703-004-5398,5990.8335,3,2,1,0.8665214839958878
21227,703-004-5392,7203.001,4,4,0,1.2193080190058896
21264,703-004-5383,4304.2046,3,2,1,0.7852720634617029
21278,703-004-5380,7837.3184,1,0,1,0.27920371738274696
21551,703-004-5384,1949.5845,6,5,1,0.9545965303015426
21641,703-004-5388,9869.498,2,1,1,2.1599727249111442
21863,703-004-5392,2114.7478,2,0,2,0.27920371738274696
22000,703-004-5392,2860.3118,5,1,4,0.6281740484790569
22196,207-008-2399,1776.1481,5,5,0,1.2832698951362183
22411,703-004-5394,5460.986,6,2,4,0.5980567010566848
22550,207-008-2399,7040.759,2,0,2,0.27920371738274696
22558,703-004-5387,4924.2295,3,1,2,0.7788730524553694
22735,703-004-5391,5596.2915,3,2,1,0.9539562987663703
22804,703-004-5385,6894.355,1,1,0,0.7224781179984897
23039,703-004-5394,8947.084,4,2,2,1.711494061315228
2395,703-004-5395,6086.427,4,0,4,0.27920371738274696
24087,703-004-5392,672.87744,2,2,0,0.8533743347916598
24936,207-008-2399,7085.139,7,3,4,0.6620726514546074
24966,703-004-5386,5615.586,1,0,1,0.27920371738274696
25299,703-004-5396,3947.739,4,2,2,1.2486131618448026
25317,703-004-5392,5670.7065,4,3,1,1.2313972273832163
25626,703-004-5398,1563.946,4,1,3,0.7216942996491598
25776,703-004-5388,7452.176,3,2,1,0.3681999022984976
25921,703-004-5395,5457.6035,5,2,3,1.0481929888379198
25982,703-004-5383,9089.563,5,2,3,1.2195179381326058
26017,703-004-5398,8425.809,7,5,2,1.8289567454851223
26034,703-004-5385,783.57635,2,1,1,0.44829646872267315
26065,703-004-5393,6828.8,6,3,3,1.5301039357960917
26165,703-004-5387,3942.0408,5,3,2,1.2991088568313027
26835,703-004-5388,4777.2603,8,1,7,0.35954964648183846
2716,703-004-5397,5709.1562,3,1,2,0.9868687873805528
2726,703-004-5387,5671.9683,5,0,5,0.27920371738274696
27672,703-004-5387,543.40186,3,2,1,2.4909925747743507
28286,703-004-5381,1595.5496,7,4,3,1.2830115878409238
28541,703-004-5392,9777.186,4,3,1,1.2852589546441155
28658,703-004-5387,1872.4996,4,2,2,1.152517416803557
28681,703-004-5382,4711.6323,9,5,4,1.7527839996007455
29392,703-004-5396,7771.9033,7,2,5,1.6838473925262396
29657,703-004-5386,3919.3784,3,1,2,0.5606853128921726
29673,703-004-5393,3117.5798,5,3,2,1.493174534705537
29758,703-004-5384,315.78183,3,1,2,0.497015218275496
29846,703-004-5393,9392.465,4,1,3,0.4059736283681288
29927,703-004-5395,7324.7827,4,2,2,1.6798737063799438
30064,703-004-5399,400.1403,3,3,0,0.841920356516472
30488,703-004-5386,1016.5948,6,3,3,0.8569528930405982
30489,703-004-5381,3338.7537,4,1,3,0.3874144629789273
30516,703-004-5382,3179.1758,5,3,2,1.1914375107673711
30546,703-004-5387,2665.5579,3,3,0,0.7407593417679091
3097,703-004-5399,5366.575,4,1,3,0.6558746638414786
31510,207-008-2399,6564.9287,1,1,0,0.5165268771580819
31559,703-004-5395,7889.01,3,1,2,0.39423804350409825
31634,703-004-5385,9178.336,2,1,1,0.9373312748552778
31675,207-008-2399,9516.58,4,2,2,0.8064719188339713
31812,207-008-2398,7503.241,9,4,5,2.0289958935058596
32107,703-004-5392,740.4983,3,0,3,0.27920371738274696
3236,703-004-5385,5762.03,2,0,2,0.27920371738274696
32550,703-004-5394,9894.6045,8,2,6,1.1729706468757233
32631,703-004-5392,7050.3745,1,1,0,0.32666834933781397
32823,207-008-2398,2237.1453,6,1,5,0.6895750101884113
3304,703-004-5392,230.43454,1,1,0,0.400476046057697
33236,703-004-5392,5994.0728,3,2,1,0.6697560329970886
33668,703-004-5388,980.14056,4,3,1,1.7614863601535087
33847,703-004-5391,3188.0605,3,2,1,1.0969657695290147
34103,703-004-5390,360.8346,3,2,1,0.6093826673209297
34232,703-004-5396,6699.233,4,0,4,0.27920371738274696
34305,703-004-5397,8829.147,3,2,1,0.9796329155152121
34766,207-008-2399,4672.5967,8,4,4,1.294788021197862
34797,703-004-5389,6727.7373,4,2,2,0.6078006464924897
34916,207-008-2399,1006.61816,2,1,1,0.4801307336825367
34986,207-008-2398,3864.2532,4,1,3,0.35831143730785864
35368,703-004-5391,1386.9077,4,2,2,1.6243209425855138
35861,703-004-5387,5705.774,1,0,1,0.27920371738274696
36018,703-004-5383,3108.4287,6,2,4,0.7881933599941774
36302,703-004-5386,3810.6985,3,2,1,1.1650395418927215
36599,703-004-5391,6700.5615,3,0,3,0.27920371738274696
36717,703-004-5392,991.78674,4,3,1,0.8291153418807915
36862,703-004-5392,6446.436,3,2,1,0.7133187482678792
36931,703-004-5389,1715.3889,1,0,1,0.27920371738274696
37159,207-008-2398,7807.736,4,2,2,1.5482360146621983
37340,207-008-2398,8937.331,4,2,2,0.7242509965277486
37359,703-004-5390,9297.803,4,2,2,0.8366497092009006
37547,703-004-5386,8227.327,3,3,0,0.874939139560507
37863,703-004-5396,171.36633,3,2,1,1.1287374409569344
38077,703-004-5392,5091.857,5,1,4,0.38357185074194555
38385,703-004-5382,9119.904,4,2,2,0.78125543520481
38915,703-004-5387,6012.9517,7,5,2,1.1993762625762376
39208,207-008-2398,3263.1719,5,3,2,1.2078927864826032
39419,703-004-5389,131.87468,4,1,3,0.6074572738472467
39558,703-004-5397,5014.877,5,4,1,3.11397804473514
39721,703-004-5380,2234.9292,6,2,4,1.082043550776289
39769,703-004-5391,533.91876,5,4,1,1.302342012270084
39895,703-004-5394,352.88214,3,2,1,1.298721074732707
4000,703-004-5399,488.10422,1,1,0,0.9395618120901739
40077,703-004-5384,9007.096,4,2,2,1.9777366915440626
40138,703-004-5397,7676.1763,4,0,4,0.27920371738274696
40284,703-004-5380,1363.2518,5,2,3,1.586642895836336
40562,703-004-5388,9912.6,2,0,2,0.27920371738274696
40592,703-004-5395,6587.47,7,4,3,2.6168031240518355
40657,703-004-5390,659.06226,10,5,5,1.2370264717461195
41031,703-004-5399,6587.3276,5,0,5,0.27920371738274696
41080,703-004-5384,1657.1462,5,2,3,0.7300586945725355
41138,703-004-5389,1836.3768,3,1,2,0.6412361575106327
41541,703-004-5380,1368.0393,3,2,1,1.5284376341743948
41598,703-004-5389,8160.603,1,1,0,0.8881530829205128
41668,703-004-5391,766.2696,1,1,0,0.35831143730785864
41932,703-004-5393,1344.6444,8,4,4,1.5854150528242208
4228,207-008-2399,2475.1497,6,3,3,1.8904693163486581
42589,703-004-5381,1364.9857,4,2,2,0.4421758620529316
42897,703-004-5397,1820.333,3,1,2,0.606603456622901
43067,703-004-5381,6073.1606,1,0,1,0.27920371738274696
43691,207-008-2399,7890.863,5,4,1,1.884486909091842
43727,703-004-5396,9297.374,4,2,2,1.304773228683801
43924,703-004-5389,3967.6516,2,1,1,1.0964766085432165
44127,703-004-5380,7561.1157,1,0,1,0.27920371738274696
44449,703-004-5399,8747.301,3,3,0,0.9922661557500093
44477,703-004-5386,1227.9779,1,0,1,0.27920371738274696
44687,703-004-5391,1298.3,4,2,2,0.6049815664774837
44697,703-004-5392,568.589,2,2,0,0.7671975907689034
44733,703-004-5394,4462.2256,2,1,1,0.32666834933781397
44736,703-004-5397,1775.9067,3,2,1,1.8688906836455386
44831,703-004-5396,7631.7935,4,1,3,0.6359069745472669
45123,703-004-5394,6491.8784,4,1,3,1.2256139309619651
4559,703-004-5386,9003.468,6,4,2,1.242405476765617
45865,703-004-5396,4069.83,3,2,1,0.6889293888437517
46193,703-004-5381,1335.0481,2,1,1,0.6070288273939616
46655,703-004-5399,868.7174,4,2,2,1.459891803698356
4669,703-004-5399,1922.0614,4,2,2,1.0908614118462419
46814,703-004-5391,7414.2007,4,1,3,0.3860406708346084
46820,703-004-5399,3218.484,2,0,2,0.27920371738274696
47061,703-004-5384,3778.7498,3,2,1,0.6658825251344792
47711,703-004-5388,2450.5234,4,1,3,1.0912162899433335
48086,703-004-5383,6925.4805,2,0,2,0.27920371738274696
48355,703-004-5388,5686.381,5,5,0,2.7382865863752106
48459,703-004-5387,6220.623,4,2,2,1.0645773411193982
48481,703-004-5398,1833.0712,4,3,1,1.8398351903108818
48583,703-004-5397,2676.1443,3,1,2,0.5241220845763204
48668,703-004-5391,3194.319,2,1,1,0.5122503413960248
49010,207-008-2399,5813.685,2,0,2,0.27920371738274696
49160,703-004-5381,7693.1357,3,0,3,0.27920371738274696
49251,703-004-5384,2472.1372,3,1,2,0.5898136599522484
49750,703-004-5386,2073.841,5,2,3,0.7888121339539621
5198,207-008-2399,5893.6763,2,1,1,0.4900618618250862
5411,703-004-5380,7878.5054,4,1,3,0.5995549769549439
5535,703-004-5392,8010.2017,1,0,1,0.27920371738274696
6099,703-004-5382,3963.0942,4,3,1,1.517146156249672
6228,207-008-2399,4363.9966,4,2,2,0.8054338841814159
6284,703-004-5389,3616.8086,1,1,0,1.8141472674067551
6356,703-004-5395,8623.302,2,2,0,0.8049922435936998
6429,703-004-5385,2959.8237,2,1,1,0.9027192230433045
6798,703-004-5398,1376.0626,4,3,1,1.3447641297227593
6847,703-004-5398,8138.669,5,4,1,0.9786992849200937
6879,703-004-5396,538.1805,4,1,3,0.39246784346302405
6978,703-004-5380,4455.35,8,2,6,0.6667068085664575
7169,703-004-5395,8617.414,7,4,3,1.781429748681484
7176,703-004-5388,2787.124,7,4,3,2.2848491570137175
7183,703-004-5384,6005.362,4,2,2,0.8567611275178907
7347,703-004-5382,4272.2715,5,1,4,1.4953463275910268
7420,703-004-5387,9441.8545,4,0,4,0.27920371738274696
7422,207-008-2398,9939.056,5,2,3,0.4685183796285297
7563,703-004-5387,7399.201,2,1,1,0.9041383055037948
7640,703-004-5395,7064.5825,4,1,3,0.35831143730785864
7864,207-008-2398,7496.0195,"","","",0.27920371738274696
8357,703-004-5381,5237.9824,2,1,1,0.3299645043346936
9051,703-004-5396,2061.1726,5,5,0,2.011164954379445
9093,703-004-5392,7497.413,3,1,2,0.5644318532362942
9204,703-004-5387,1409.846,8,5,3,1.893826723750952
9278,207-008-2399,6621.6113,6,2,4,0.9818759814968203
9485,703-004-5387,450.266,4,3,1,1.248364351870235
9575,207-008-2398,5912.7017,4,0,4,0.27920371738274696
9695,703-004-5389,7292.261,3,3,0,1.4072451321040658
9808,703-004-5395,2196.6475,7,6,1,2.601491957525681
9900,703-004-5388,697.4471,4,1,3,0.3918917633103829
9918,703-004-5389,6625.739,4,1,3,0.5466837862989621
10137,703-004-5386,3502.404,4,1,3,0.3978652972704144
10366,703-004-5382,4116.5435,7,3,4,0.8648186238493139
10827,207-008-2398,3449.5557,"","","",0.27920371738274696
10873,703-004-5388,3675.0835,4,3,1,0.847896701539639
1101,703-004-5391,9986.479,3,2,1,0.5901817048339193
11182,703-004-5384,5467.6074,5,4,1,1.6407312167821038
11252,703-004-5393,6590.546,4,3,1,1.7555605580878704
11455,703-004-5388,2948.2056,3,1,2,0.37512182779194486
1164,703-004-5389,6613.9116,4,0,4,0.27920371738274696
12294,703-004-5394,6027.1626,4,1,3,0.3885701401792138
12641,207-008-2399,6319.896,4,0,4,0.27920371738274696
12728,703-004-5388,9650.586,6,3,3,1.0955122066388843
12755,207-008-2399,9079.44,4,2,2,0.6125278476065094
12922,703-004-5389,3730.4736,3,1,2,0.9637167259752867
12942,207-008-2399,4336.9497,3,1,2,0.5165268771580819
13193,703-004-5389,7422.9717,1,1,0,0.4230808829965438
13469,703-004-5383,5719.24,6,2,4,0.6761596865475827
13495,703-004-5392,3077.6626,1,0,1,0.27920371738274696
13558,703-004-5386,3260.271,5,3,2,1.4849879486110182
13642,703-004-5387,6571.5312,6,5,1,1.8446007487271767
14101,703-004-5387,8127.6523,4,1,3,0.3978652972704144
14288,703-004-5388,8979.016,3,0,3,0.27920371738274696
14505,703-004-5394,5573.5713,2,2,0,0.7081148643130462
14532,703-004-5387,7989.523,8,3,5,1.8915862819255027
14829,703-004-5396,45.003296,6,2,4,0.7412686133103272
15034,703-004-5388,9614.754,8,2,6,1.0383675121500247
15297,703-004-5384,1040.886,2,1,1,0.5650353096171703
15978,703-004-5396,3841.1562,2,1,1,0.4330254313757767
16059,703-004-5396,5406.2046,6,2,4,1.334205574157576
16169,703-004-5397,1850.5681,4,4,0,2.246609887036801
16206,703-004-5382,694.201,4,1,3,0.5588765357865376
16324,703-004-5390,9323.228,3,2,1,0.8674474124418258
16337,207-008-2399,5072.8916,5,3,2,0.5420023798724796
16810,207-008-2399,2538.5833,6,3,3,0.9410826469382759
16839,703-004-5384,5592.9507,5,2,3,0.6533186794930079
16932,207-008-2399,4490.5513,4,1,3,0.3886962181078445
1704,703-004-5389,1151.7983,7,3,4,0.9871980604052971
17142,703-004-5389,8135.808,4,1,3,0.3187575773453028
17190,703-004-5384,4545.0317,3,3,0,0.6782550614998311
175,207-008-2398,2703.7864,2,2,0,1.0511589744408314
17532,703-004-5384,4876.361,3,0,3,0.27920371738274696
17826,703-004-5385,6345.2876,5,2,3,0.6686924244225159
18037,703-004-5394,7797.007,5,1,4,0.5866336874071768
18458,703-004-5393,3596.6409,4,4,0,2.8473148386026828
18623,703-004-5398,6201.063,3,2,1,0.846369530720815
19130,703-004-5385,8572.169,5,3,2,1.4776138096719007
19713,703-004-5392,976.67816,4,2,2,0.5877670871250162
20008,703-004-5383,3844.2092,5,5,0,1.5596435037560115
20147,703-004-5394,3165.6033,4,0,4,0.27920371738274696
20229,703-004-5387,5610.0986,2,0,2,0.27920371738274696
20315,703-004-5399,2885.4382,1,0,1,0.27920371738274696
20454,703-004-5381,4339.3804,5,1,4,1.1043329700368896
20603,703-004-5389,2209.3284,3,1,2,0.3686450608778714
20736,703-004-5395,5494.7417,3,2,1,0.5435778356853392
20913,703-004-5397,3955.8833,3,2,1,0.7112067550613778
20924,703-004-5389,9752.793,3,3,0,1.8456346631037512
21168,703-004-5396,5408.939,4,4,0,1.623170777869397
21170,703-004-5383,456.27594,7,3,4,2.324284369324565
21190,703-004-5387,1275.0048,4,2,2,0.7542653438820139
21568,703-004-5393,1754.9574,3,2,1,0.8018932220764164
21580,703-004-5391,3278.4985,10,5,5,2.0461401689475736
21632,703-004-5381,9053.867,2,2,0,0.7896347748353947
21764,703-004-5384,85.14285,2,0,2,0.27920371738274696
2195,703-004-5381,1354.4899,7,4,3,2.794940796607373
2207,703-004-5390,1741.4337,3,1,2,0.42750908986750674
22202,703-004-5388,4000.9504,3,2,1,1.139800099816908
22231,703-004-5396,9780.513,3,2,1,0.7976913490231646
22264,703-004-5392,9032.716,3,0,3,0.27920371738274696
22302,703-004-5383,8190.094,6,3,3,1.4203366046723525
22312,703-004-5392,4570.5527,4,2,2,0.4918180752627228
22477,703-004-5388,9061.08,4,3,1,0.8688398261288492
22478,703-004-5382,823.4233,5,3,2,2.448781397783391
22601,703-004-5389,1876.3524,5,4,1,1.0064297602823735
22840,703-004-5383,1273.7483,"","","",0.27920371738274696
22963,703-004-5387,2322.4233,3,1,2,0.3913289503928928
23274,703-004-5381,1860.2955,4,2,2,1.1773367345116206
2366,207-008-2399,601.42816,3,2,1,0.9735087272219358
23753,703-004-5388,4334.842,7,3,4,1.8155404846682508
23865,703-004-5393,9488.269,3,2,1,1.7099161632629336
23925,703-004-5390,799.5814,4,3,1,0.9283803950117132
2424,703-004-5389,7485.8696,4,2,2,0.499222095590436
24245,703-004-5380,5774.3613,7,3,4,1.4019580941203926
24349,703-004-5391,9596.661,3,2,1,1.4813567563029502
24443,703-004-5394,9639.563,7,3,4,0.8235662516852118
24778,703-004-5391,5675.807,4,2,2,0.7618097026202503
24826,207-008-2399,8374.577,4,2,2,0.8433466388219439
25049,703-004-5381,7277.189,5,1,4,0.3565006121564479
25102,703-004-5384,8742.742,4,0,4,0.27920371738274696
25169,703-004-5381,8714.85,6,4,2,2.664453233063495
25222,703-004-5390,6855.4233,3,1,2,0.4839113822620203
26285,703-004-5385,2097.4512,4,3,1,2.7609787319405763
26435,703-004-5384,7139.5425,6,3,3,0.8086415480416506
26481,703-004-5390,6469.8247,8,2,6,0.5627833411270919
2656,703-004-5395,5012.228,5,1,4,0.3807252912866403
26589,703-004-5389,5074.144,7,4,3,2.1174837390912757
27034,703-004-5387,1473.6558,1,0,1,0.27920371738274696
27265,703-004-5381,3167.181,1,1,0,0.35831143730785864
28128,703-004-5385,9423.071,2,1,1,0.36112964983019075
28163,703-004-5386,9735.471,4,2,2,0.7449568333238553
28272,703-004-5385,4298.9536,4,0,4,0.27920371738274696
29949,703-004-5391,2840.9695,5,1,4,0.35831143730785864
30036,703-004-5397,5134.996,3,2,1,0.5779142651408523
30623,703-004-5381,6018.6035,1,1,0,0.7835402133293226
31326,703-004-5383,4455.753,5,2,3,0.6341680257878594
31558,703-004-5398,270.82324,7,5,2,1.171544622849691
31593,703-004-5386,609.9385,4,2,2,0.8260259691720987
31682,703-004-5391,5574.4414,6,3,3,1.0227702292615364
31959,703-004-5398,7821.9927,7,4,3,0.9921559556282303
32289,703-004-5380,8078.118,10,4,6,3.1175008688046733
32482,703-004-5393,3549.7476,8,6,2,2.614790146306619
32920,703-004-5387,2822.6233,4,2,2,0.8337580024366161
32988,703-004-5384,3337.043,4,1,3,0.49339771716171715
33105,703-004-5392,6538.0,1,1,0,0.669565357277168
33139,703-004-5385,9704.773,6,1,5,1.6583279581442383
3376,703-004-5395,3966.903,"","","",0.27920371738274696
33898,703-004-5389,5357.6777,3,1,2,0.5136377032752589
34200,703-004-5389,6630.643,4,3,1,1.5238582681150643
34226,703-004-5385,1545.8572,3,1,2,0.6987803387222001
3427,703-004-5396,244.31229,4,1,3,0.5977474135203705
34293,703-004-5395,8282.585,5,1,4,0.6200086100132488
34356,703-004-5394,577.63696,5,3,2,0.6399279841319617
34562,703-004-5381,6256.0923,3,0,3,0.27920371738274696
3501,703-004-5381,3649.3408,5,3,2,1.7687017026186722
35831,703-004-5396,6730.9624,4,2,2,1.474208660250709
36080,703-004-5386,3829.2754,3,2,1,0.6844794380773169
36185,207-008-2398,5393.0225,5,3,2,0.8657426915781543
3620,703-004-5397,6084.983,6,3,3,1.4014573211186585
36310,703-004-5388,9179.832,4,2,2,0.48800473556516044
36383,703-004-5398,896.889,5,3,2,1.8082678538583863
36397,703-004-5399,6368.9424,7,4,3,1.047847578125179
36600,703-004-5393,5510.008,8,5,3,2.4272731630965483
36627,703-004-5395,2270.651,6,3,3,1.7988424691552738
36920,703-004-5392,3089.2437,6,3,3,1.2027356120696997
36944,703-004-5380,2194.3235,6,4,2,3.297063858404088
37436,703-004-5393,2000.767,6,2,4,0.8542603412171988
37880,703-004-5392,3519.3313,3,1,2,0.32666834933781397
37944,703-004-5390,9275.611,2,0,2,0.27920371738274696
37957,703-004-5380,9690.314,6,2,4,0.626808884280024
37998,703-004-5380,7537.626,5,2,3,1.3067018542609736
38137,703-004-5397,7277.0234,3,1,2,0.4014581062170133
38389,703-004-5391,7727.49,3,2,1,0.8140807786085923
38582,207-008-2399,3553.2708,4,2,2,0.7203607373955383
38944,703-004-5394,30.226112,2,2,0,0.9748184694887001
39583,703-004-5392,3644.46,3,1,2,0.7663127845559405
39652,207-008-2398,5693.17,7,3,4,2.299506219848029
39665,703-004-5395,4997.872,1,1,0,0.3978652972704144
39757,703-004-5386,6868.236,4,3,1,0.8630234977805739
39925,703-004-5395,7563.827,2,1,1,0.34271238378512564
40243,703-004-5395,6131.0815,6,3,3,2.3553215911636114
40376,703-004-5395,6801.606,7,3,4,1.042592155442624
41375,703-004-5386,3348.5872,5,4,1,1.4628548615037262
41376,703-004-5385,2705.5962,5,5,0,2.6573951050925
41815,703-004-5393,5465.81,6,5,1,3.7203450159455995
42302,703-004-5388,5422.4707,5,4,1,3.0371221056475814
42443,703-004-5394,4803.065,7,5,2,2.172677788470333
42529,703-004-5389,5390.7876,3,1,2,0.35831143730785864
42585,703-004-5393,2975.6218,6,5,1,1.143298805993528
42870,703-004-5390,6025.0376,2,1,1,0.39905191306929116
43012,703-004-5381,6623.5786,10,7,3,3.9504179866945135
43119,703-004-5389,3816.5015,4,1,3,1.610389410440185
43202,703-004-5388,1442.1458,5,1,4,0.3978652972704144
4338,703-004-5393,7680.828,1,1,0,0.35831143730785864
43416,703-004-5385,4591.1646,5,3,2,1.3202699693295665
43488,703-004-5397,9227.937,3,0,3,0.27920371738274696
43740,207-008-2398,1911.1658,4,3,1,2.0756414403632863
44027,703-004-5392,6456.838,3,1,2,0.479942166924328
44100,703-004-5380,4724.9194,2,1,1,0.5947491417364431
44200,703-004-5394,8689.869,3,1,2,1.1700157569799736
44498,703-004-5383,4965.6294,6,5,1,1.3046707983241486
44563,703-004-5396,4765.417,4,3,1,1.8835439526850266
4463,703-004-5385,5473.998,3,3,0,3.3336777281302648
44943,703-004-5381,413.7522,5,3,2,0.8256636007426545
45041,703-004-5393,3993.9814,2,0,2,0.27920371738274696
45062,703-004-5383,4571.106,2,1,1,0.5165268771580819
45087,703-004-5387,9571.61,4,1,3,0.4487274623942092
45176,703-004-5385,5715.084,5,4,1,1.2926486148857579
4522,703-004-5395,1039.1569,2,1,1,0.3401166617250829
45432,703-004-5396,5388.5527,6,2,4,0.6173318817460312
45563,703-004-5384,6950.0645,3,2,1,0.9304930949470804
45687,703-004-5396,256.71838,6,3,3,0.8049652426835467
46054,703-004-5386,5933.73,4,3,1,2.0104423134817306
46181,703-004-5387,7959.158,2,0,2,0.27920371738274696
46460,703-004-5395,9540.814,2,0,2,0.27920371738274696
46504,703-004-5399,4968.648,3,1,2,0.4230808829965438
46782,703-004-5398,3275.3896,3,2,1,1.0860156145087272
46838,703-004-5384,1589.0515,4,1,3,0.5837684390944268
47024,703-004-5395,8514.988,7,2,5,0.700478811326933
47236,703-004-5382,2635.374,4,3,1,1.1316445778449948
47322,207-008-2399,5023.8506,2,2,0,0.8145782337075392
47599,703-004-5399,8196.925,3,2,1,1.4160685431224742
47636,207-008-2399,1441.1587,7,3,4,0.9093200737305269
47826,703-004-5394,2779.9875,3,3,0,1.0727189288472219
47915,703-004-5380,8191.8413,4,3,1,0.8369733826002684
48408,703-004-5383,3872.3652,4,3,1,0.9593333008174353
48442,703-004-5381,9625.342,4,2,2,0.5881583304830449
48667,703-004-5392,3375.1292,2,2,0,0.4453299292254814
48729,703-004-5385,4045.5562,4,3,1,1.980293291226839
48934,703-004-5395,1781.274,2,2,0,0.4967698886138591
49037,703-004-5383,6757.597,4,2,2,0.9442562544925837
49123,703-004-5386,1351.3475,3,2,1,0.5920468915924775
49266,703-004-5388,720.96826,2,2,0,0.7087468629828202
49351,703-004-5387,7044.9155,7,3,4,2.0329205433824336
49446,703-004-5381,9062.703,3,1,2,0.43808481451064746
49482,703-004-5397,6573.6396,7,3,4,1.1224861977032172
49605,703-004-5383,3410.8467,6,3,3,2.2118187402565854
49716,703-004-5388,3760.33,3,0,3,0.27920371738274696
49864,703-004-5387,9608.484,8,3,5,0.8648193099221668
49915,703-004-5399,7840.3813,4,2,2,1.144678917829114
5108,703-004-5385,4932.5835,5,0,5,0.27920371738274696
5358,703-004-5383,256.48593,"","","",0.27920371738274696
5655,703-004-5394,2795.1038,5,3,2,0.9029186808923814
5753,703-004-5394,3965.2349,3,2,1,1.0741060980020445
5767,703-004-5382,9841.355,2,0,2,0.27920371738274696
5839,703-004-5386,6265.234,5,2,3,1.2486260760462797
6009,703-004-5398,6657.257,4,2,2,0.729227250262798
6371,207-008-2399,4236.675,3,0,3,0.27920371738274696
6586,703-004-5390,5573.5195,4,2,2,0.6911804042372157
6791,703-004-5382,4466.8545,5,3,2,1.0104149479814455
7090,703-004-5390,6737.9277,7,3,4,1.2320671396647476
7094,703-004-5397,1963.79,1,1,0,0.3910314738098825
7154,703-004-5391,6771.0127,4,4,0,1.899805367045423
7241,703-004-5394,5921.407,3,2,1,0.47556281119058996
760,703-004-5382,8248.22,6,3,3,0.7953548597265838
7691,703-004-5394,5480.563,4,2,2,1.014077366921868
771,703-004-5384,4827.1406,4,1,3,0.9054463509405472
7830,703-004-5384,5411.19,3,1,2,0.4186743357850902
7896,703-004-5386,3962.49,5,3,2,1.3853189037080949
7928,703-004-5395,8599.463,6,0,6,0.27920371738274696
8327,703-004-5385,7026.6943,3,1,2,0.4230808829965438
8781,703-004-5398,5126.631,4,2,2,0.7143695828413856
8948,703-004-5380,7595.221,"","","",0.27920371738274696
91,703-004-5389,4273.1885,1,1,0,0.5241220845763204
9210,703-004-5382,4548.777,3,2,1,2.2293515127625474
9333,703-004-5397,7069.6123,5,2,3,0.5370701631761343
94,703-004-5395,5084.534,2,1,1,0.6565297868668972
9513,207-008-2399,9406.348,3,1,2,0.9143196386536137
9628,703-004-5399,2547.1938,2,1,1,0.38759983455200736
9732,703-004-5396,5000.0117,4,3,1,1.4722671964568697
9958,703-004-5384,8498.106,5,1,4,0.4949357320810988
10755,703-004-5381,7336.337,3,2,1,0.5522768423732015
10994,703-004-5397,5690.245,6,2,4,0.6497653550881108
11121,703-004-5388,8659.977,2,1,1,0.4713155303682893
11369,703-004-5390,7188.406,4,3,1,1.8920067776635805
11419,703-004-5393,9385.553,5,2,3,1.1830814570960142
12290,703-004-5392,5517.116,4,4,0,1.9217362507674236
12573,703-004-5394,7560.0596,3,1,2,0.3407018734438102
12990,207-008-2398,6115.087,2,2,0,1.9431962696596286
13517,703-004-5392,5206.961,2,0,2,0.27920371738274696
13869,207-008-2399,9060.984,1,1,0,0.6100380491985612
13919,207-008-2398,9653.39,8,2,6,0.48109874554677956
13927,703-004-5394,2821.7012,4,3,1,0.6616947380632261
13976,703-004-5394,5911.169,"","","",0.27920371738274696
14022,703-004-5398,3711.192,7,2,5,1.3931245535049037
14498,703-004-5396,6890.131,4,3,1,0.9716753922914461
15036,703-004-5380,8672.94,2,0,2,0.27920371738274696
1517,703-004-5381,8584.437,5,4,1,2.5558395962665297
161,703-004-5389,5200.381,4,3,1,2.2784214753517302
16125,703-004-5387,2963.351,4,2,2,0.3947339500233788
1615,703-004-5389,9846.7,1,1,0,0.44485314040518276
16159,703-004-5382,184.91805,3,1,2,0.6139442398854795
16221,703-004-5389,5915.0205,5,2,3,1.0705692034601104
16301,703-004-5382,3711.049,3,1,2,1.0091588319306013
16592,703-004-5395,9910.867,4,2,2,0.4100709874329306
16781,703-004-5383,5981.929,3,2,1,1.7740689932548275
17359,703-004-5390,5232.045,5,3,2,1.819589479532334
17416,703-004-5388,9967.857,2,1,1,0.5463923842495418
17515,703-004-5384,5281.62,4,2,2,0.9950157576383317
17959,703-004-5391,8533.017,2,0,2,0.27920371738274696
18005,703-004-5399,8387.429,3,1,2,0.4180377658513179
18105,703-004-5387,1193.8429,3,1,2,0.35114230018964543
1850,703-004-5390,7152.3066,3,2,1,0.9149201591669106
1885,703-004-5384,6543.1436,7,2,5,0.6452272461700217
18944,703-004-5388,215.53696,5,3,2,1.4716533933811167
18989,703-004-5391,7347.209,6,2,4,0.45703250083989255
18998,703-004-5397,9203.938,4,2,2,1.0604872811211317
19198,703-004-5393,1014.49786,5,4,1,1.7439230141000348
19636,703-004-5391,3857.4268,7,4,3,6.700894020745521
20451,703-004-5398,1267.7037,9,4,5,0.9818623891096422
2057,703-004-5399,4319.938,1,0,1,0.27920371738274696
20607,703-004-5396,4693.1963,6,3,3,2.2382222216752345
20646,703-004-5397,963.3529,3,1,2,1.0413334248056747
21080,703-004-5394,8002.5723,5,2,3,1.240848553857707
21083,207-008-2398,88.5284,1,1,0,0.7996924051466323
2182,703-004-5394,3301.6443,5,3,2,1.286772125002478
2227,703-004-5389,6170.1514,2,1,1,0.36190424625445744
2234,703-004-5393,4554.5757,4,1,3,1.3707833474526248
2239,703-004-5388,7649.4624,6,3,3,1.733112734718047
22397,703-004-5392,6331.725,4,3,1,1.8505688412874366
22680,703-004-5384,5812.8047,1,0,1,0.27920371738274696
22740,703-004-5383,470.30328,3,2,1,0.5703201267071577
23021,703-004-5387,4587.951,6,1,5,1.6119096497924013
23165,703-004-5386,9830.3125,1,0,1,0.27920371738274696
23438,703-004-5385,5875.9653,9,5,4,2.235152417686003
23600,703-004-5385,8170.2085,8,6,2,1.983555861839332
23656,703-004-5380,7953.4585,3,1,2,0.5069869973996549
24282,703-004-5381,6061.945,3,0,3,0.27920371738274696
24696,703-004-5380,5937.9272,9,3,6,0.7375642705867645
24864,703-004-5392,4695.5005,3,1,2,0.6757131922233697
2503,703-004-5385,8410.812,6,3,3,0.7080906091277476
25139,703-004-5391,533.3066,7,5,2,3.529303081861108
2539,703-004-5387,1522.8278,6,2,4,0.7405601803096943
25417,703-004-5386,7331.176,2,0,2,0.27920371738274696
25607,703-004-5384,5176.075,5,3,2,1.561055488855671
25660,703-004-5389,1952.1171,6,2,4,0.8004182535022794
25677,703-004-5382,9748.776,6,2,4,1.4782901306556981
25725,703-004-5392,5684.896,2,2,0,1.5773350401120623
26026,703-004-5381,9055.247,1,1,0,0.5371357426057581
26139,703-004-5384,2530.1575,6,2,4,0.8043279999366696
26194,703-004-5397,2694.5942,3,2,1,1.099584807143658
26195,703-004-5390,7809.9404,2,1,1,1.3398739696369337
26209,703-004-5388,5019.7495,10,6,4,1.9384163657337734
26592,207-008-2398,9986.033,1,0,1,0.27920371738274696
26722,703-004-5397,264.67322,2,0,2,0.27920371738274696
26923,703-004-5384,7315.908,3,0,3,0.27920371738274696
26940,703-004-5394,2261.159,5,3,2,1.3441900391229376
26978,207-008-2399,4429.774,3,1,2,0.5011815551724289
27204,703-004-5380,316.21994,7,5,2,2.285779205939149
27242,703-004-5383,919.534,1,0,1,0.27920371738274696
27975,703-004-5395,7549.7183,5,2,3,0.8935123310048039
27996,703-004-5391,4121.9087,5,1,4,0.4210310998131354
28467,207-008-2398,1746.2528,4,3,1,1.548535133053662
28953,703-004-5391,5396.183,4,3,1,1.5371246404175658
29139,703-004-5395,2948.46,2,0,2,0.27920371738274696
29217,703-004-5388,742.92957,1,1,0,0.7783899857246659
30023,703-004-5381,9951.924,4,1,3,0.43265538922373
3006,703-004-5389,6417.1763,8,1,7,0.3482952234211253
30527,703-004-5390,5272.2656,6,3,3,0.7356704030371007
30689,703-004-5398,5918.073,4,2,2,1.2004530179511528
30848,703-004-5391,3107.6992,4,1,3,0.7167493911430115
31517,703-004-5396,2786.749,2,1,1,0.6374119180998093
31778,703-004-5386,4825.796,3,2,1,0.8554234960573279
31828,703-004-5393,9170.0625,2,1,1,0.35831143730785864
3216,703-004-5397,75.1996,4,1,3,1.259116575907932
32483,207-008-2398,5568.74,9,6,3,1.6331905973310128
32645,703-004-5395,1723.5338,5,2,3,0.982015439369924
3290,703-004-5393,896.7972,4,1,3,0.7946201543867042
32904,703-004-5380,4789.678,4,2,2,0.8753052485893181
33029,703-004-5387,2864.946,1,0,1,0.27920371738274696
33728,207-008-2399,2434.519,4,3,1,1.2362215231625373
33754,703-004-5398,328.4168,5,2,3,3.2711990278975853
33926,703-004-5391,8812.544,6,4,2,3.193822128886872
34115,703-004-5387,4864.696,2,1,1,0.3637500930527101
34532,703-004-5394,3767.19,4,0,4,0.27920371738274696
34599,703-004-5390,8445.478,2,1,1,0.3978652972704144
34643,703-004-5393,2217.3113,5,4,1,1.458922509475778
3470,703-004-5394,678.79614,1,0,1,0.27920371738274696
34729,703-004-5388,2422.9092,3,2,1,0.8829183794647558
34936,703-004-5386,1768.5681,3,2,1,1.6725576107409907
35160,703-004-5387,394.88376,8,3,5,1.8898916458903472
35217,703-004-5393,4709.4663,5,1,4,0.46721130996548593
35250,703-004-5384,3816.3865,2,1,1,0.43792693816434414
35277,703-004-5393,2.3674965,5,2,3,0.45802939639939677
35355,207-008-2398,4945.506,7,3,4,1.2539489477626478
35403,703-004-5381,4029.3462,3,0,3,0.27920371738274696
35557,703-004-5395,3401.246,3,1,2,0.5991697233173469
35648,703-004-5387,944.69965,3,1,2,1.7777897087069703
35700,703-004-5396,9435.367,4,2,2,1.3593223026139978
35952,703-004-5399,7897.815,4,2,2,1.2704783767121146
35968,703-004-5399,1175.434,2,1,1,0.45233540716912946
35980,703-004-5381,8301.398,5,2,3,0.504131686292316
36012,703-004-5385,2203.2952,7,5,2,2.114231769269988
36063,703-004-5384,8241.956,4,1,3,0.5166855997903718
36212,703-004-5399,111.83917,5,2,3,0.7060284014894482
36449,703-004-5389,6144.2544,4,2,2,0.8451965022489718
36459,703-004-5384,2056.836,5,5,0,2.9002574662298515
36720,703-004-5389,2211.1292,2,1,1,0.4516620315763559
36835,703-004-5390,8238.125,3,1,2,0.47399190845290345
37134,703-004-5394,8876.805,2,1,1,0.3439270169014758
3719,703-004-5383,1541.4607,3,2,1,0.8013783373986642
37444,703-004-5381,3029.6826,3,2,1,1.0213438024054455
3765,703-004-5380,9110.8125,4,1,3,1.7457604478528688
37745,703-004-5397,8039.1494,6,3,3,2.2161266793965346
37912,703-004-5390,9218.669,7,3,4,1.076191849856308
38139,703-004-5395,3767.1804,2,2,0,0.6761059638962394
38145,703-004-5384,469.8068,4,2,2,0.5804809120302162
38196,703-004-5395,3900.1191,4,2,2,0.862463105479499
38221,703-004-5392,283.5804,3,0,3,0.27920371738274696
38233,703-004-5398,4490.1987,3,2,1,0.6914923294865369
3842,703-004-5387,3944.8445,"","","",0.27920371738274696
40956,703-004-5386,9455.066,7,5,2,1.9174854107937114
41030,207-008-2399,4044.398,2,0,2,0.27920371738274696
4145,703-004-5385,3477.4626,4,4,0,1.9758912911969784
41616,703-004-5399,6293.3193,7,3,4,1.3727087843756356
41993,703-004-5380,1879.9192,3,3,0,1.9408478300933794
4207,703-004-5381,925.21545,3,0,3,0.27920371738274696
4270,207-008-2399,9833.855,2,1,1,0.34271238378512564
42709,703-004-5380,459.92792,2,2,0,3.2721433177852814
42768,703-004-5392,8110.4424,2,0,2,0.27920371738274696
42947,703-004-5391,3083.455,7,1,6,1.1024647850466487
43046,703-004-5397,9594.3955,3,0,3,0.27920371738274696
43322,703-004-5383,5073.6562,3,2,1,1.292870851194805
43817,703-004-5386,5059.7314,6,1,5,0.8299584771291516
44021,703-004-5388,4505.8506,8,4,4,1.1488444654646028
4420,703-004-5385,7783.673,4,2,2,0.8349607816323529
44377,703-004-5393,8029.6616,1,0,1,0.27920371738274696
44457,703-004-5383,919.32477,3,1,2,0.35831143730785864
44596,703-004-5389,5806.269,10,4,6,0.9349121227833045
44818,703-004-5390,9167.76,6,3,3,0.8833114243362326
44828,703-004-5380,427.711,3,2,1,0.7479539586235474
45658,703-004-5396,4062.1824,3,2,1,0.5135247913835556
45775,703-004-5396,1819.6476,2,1,1,0.8943711888850072
45937,703-004-5386,53.93207,2,1,1,0.8348569813015286
45964,703-004-5398,9800.182,3,1,2,0.4986345472814583
4600,703-004-5386,3458.4033,3,3,0,0.7755432837409832
46002,703-004-5385,7561.081,6,2,4,0.45719608721424815
46170,703-004-5381,8171.9805,3,2,1,0.8958797977198328
46347,703-004-5396,859.1813,2,1,1,0.8281241063977234
46565,703-004-5394,6208.3804,4,2,2,0.6197900392314216
46631,703-004-5386,656.898,3,0,3,0.27920371738274696
47209,703-004-5388,7984.567,3,0,3,0.27920371738274696
47229,703-004-5382,7456.8213,2,1,1,1.0314863416607882
47804,703-004-5398,3639.3499,9,5,4,1.128036327547281
4798,703-004-5388,6234.8896,7,3,4,1.9550548590563512
48069,703-004-5391,5802.5513,8,1,7,0.48943304806412524
48089,703-004-5381,7402.09,2,0,2,0.27920371738274696
48151,207-008-2399,1603.3357,2,2,0,0.5747252993404297
48168,703-004-5393,2895.971,1,1,0,0.4241521333705297
48290,703-004-5389,5832.1387,7,5,2,1.759145520202076
48471,703-004-5396,6987.921,2,0,2,0.27920371738274696
48903,703-004-5390,9132.497,2,2,0,1.4793540298991528
48976,703-004-5387,3245.418,3,3,0,0.8035650731347086
4918,703-004-5389,2410.8594,4,3,1,2.483031760492898
49656,207-008-2398,9486.106,5,3,2,0.9230724223599351
4987,703-004-5396,387.22992,5,3,2,1.2688992347720236
5324,703-004-5395,8896.081,3,2,1,0.809247629351358
5389,703-004-5397,8817.828,6,4,2,1.5394349360609783
6060,703-004-5382,7925.3223,4,2,2,0.5636888602815291
6650,703-004-5387,6162.375,3,3,0,0.883825256828499
6715,703-004-5393,4203.097,4,2,2,1.066814683589824
6870,207-008-2399,7753.269,10,4,6,1.3335581081769892
7150,703-004-5392,5688.8457,2,1,1,0.3978652972704144
7380,703-004-5397,6392.045,6,4,2,2.8528331324676652
7482,703-004-5383,8535.965,3,2,1,1.4053361942700877
7683,703-004-5394,6200.0986,6,2,4,0.6511148414208076
7694,703-004-5399,728.29425,4,2,2,3.0024703398354893
8534,703-004-5391,9294.641,5,2,3,0.524081689130005
9462,703-004-5398,1433.164,5,3,2,0.7898007562568895
9465,703-004-5392,2886.9348,4,4,0,3.534674190299634
9660,703-004-5385,3099.416,5,2,3,0.7220531748634805
9755,703-004-5388,2863.2812,5,3,2,0.5203428148245105
10378,207-008-2399,9925.313,4,3,1,1.4191930312579086
10385,703-004-5389,3369.4243,6,4,2,2.114929361436621
10425,703-004-5385,4462.8936,4,2,2,0.9963899113541116
10500,703-004-5397,5819.5312,3,3,0,2.6791040113728637
1055,703-004-5392,3202.195,4,2,2,0.9162707336772226
10636,703-004-5382,2653.383,8,2,6,0.6342346321935273
10743,207-008-2399,3778.7407,3,0,3,0.27920371738274696
10789,703-004-5383,5837.605,4,2,2,0.5274041886477848
11346,703-004-5380,135.83421,4,1,3,0.5717287465096976
12021,703-004-5383,6740.495,5,1,4,0.35802457911877084
12076,207-008-2398,3077.1309,5,4,1,1.8589847521856862
12114,703-004-5386,1363.4669,1,1,0,0.7841767891430258
12235,703-004-5399,5687.0396,2,2,0,0.5693462262109079
12279,703-004-5384,7953.818,5,2,3,1.0091694413417585
12343,703-004-5394,5836.8633,5,4,1,1.2605730247523175
12360,703-004-5390,1307.9327,3,1,2,0.5451148593862336
12914,703-004-5386,4285.459,6,3,3,0.9960906826547571
13431,703-004-5399,4943.883,5,2,3,1.4842239539264117
13497,703-004-5390,8548.823,4,1,3,0.41467568775450064
13519,703-004-5395,5226.6343,4,1,3,0.3584147717670108
13535,703-004-5397,1772.1975,3,2,1,0.6949844467502504
13565,703-004-5391,9003.435,3,2,1,0.45472049914716933
13703,703-004-5398,8995.774,4,2,2,0.7801210003066814
13785,703-004-5380,5190.6167,6,1,5,0.6674066098634011
13798,703-004-5394,6944.8267,3,1,2,0.41071806140289563
13801,703-004-5384,5069.199,5,3,2,1.225936977647555
13807,703-004-5389,2493.5752,4,2,2,0.9444135995345844
14320,703-004-5389,5277.4795,2,0,2,0.27920371738274696
14448,703-004-5397,9552.879,4,3,1,1.6644074829301874
1480,703-004-5389,3195.2273,9,5,4,1.5405717268927617
14909,703-004-5381,7854.0356,3,1,2,0.6147368017998898
15096,703-004-5393,1986.6354,6,1,5,0.3978652972704144
15707,703-004-5395,1621.1313,5,3,2,1.0050739107300506
15804,703-004-5392,1781.2515,1,1,0,1.2627045946877467
16091,703-004-5399,1989.3253,2,2,0,0.9919414020771226
1631,703-004-5382,8231.086,5,2,3,0.6150777648301134
16486,703-004-5386,3553.7397,6,3,3,2.0049568325034612
17084,703-004-5388,85.72638,3,2,1,1.2146366464316205
17280,703-004-5387,139.41765,4,3,1,0.9374029907538343
17340,207-008-2398,2146.4067,4,2,2,0.6908089042060135
17419,703-004-5384,1449.492,3,1,2,0.5464802473131105
1776,703-004-5397,1912.6725,4,2,2,1.0159357165062675
17989,703-004-5397,5496.1836,2,1,1,0.3587413534392875
18246,703-004-5391,3990.1584,4,0,4,0.27920371738274696
1855,703-004-5394,8243.839,5,3,2,1.4695661345871873
18562,703-004-5383,2833.2114,2,1,1,0.6762686143762286
18693,703-004-5385,9331.767,3,2,1,0.8147728213787275
18887,703-004-5383,5282.217,4,2,2,0.5574775343029873
19012,703-004-5395,7559.84,5,3,2,0.833483865535914
19168,703-004-5399,9733.888,1,0,1,0.27920371738274696
19177,703-004-5382,6784.6494,6,3,3,1.028536015830154
19267,703-004-5389,5357.021,4,3,1,1.674395033436177
19329,207-008-2399,7962.019,2,0,2,0.27920371738274696
19443,207-008-2398,5617.498,3,0,3,0.27920371738274696
19772,703-004-5397,3450.623,6,3,3,0.9168014053413769
19791,703-004-5384,6492.464,3,1,2,0.6674572452892925
20304,703-004-5386,5782.446,7,2,5,0.8340219232475925
20348,703-004-5388,5030.703,1,0,1,0.27920371738274696
2045,703-004-5393,8698.188,4,2,2,0.6898892535693848
20488,703-004-5394,5460.793,4,3,1,0.939085172511097
20538,703-004-5389,8655.307,4,0,4,0.27920371738274696
20549,703-004-5387,6990.046,5,2,3,0.8482654096785684
20589,703-004-5380,1781.6472,2,2,0,0.6706052970067581
20923,703-004-5387,255.35345,8,3,5,2.403335625582139
21175,703-004-5383,2117.3518,2,1,1,0.35954964648183846
21400,703-004-5386,465.14093,4,1,3,0.43699141617864873
21485,703-004-5397,923.0113,5,3,2,1.0076647232012086
21587,703-004-5389,7851.096,4,3,1,0.8443247390154228
21797,703-004-5395,4549.871,1,0,1,0.27920371738274696
22172,703-004-5392,8514.698,5,2,3,0.5203661766955412
22971,703-004-5387,5885.933,5,2,3,0.5250739471515781
23053,703-004-5398,4999.662,2,0,2,0.27920371738274696
2310,207-008-2398,2796.818,3,0,3,0.27920371738274696
23836,703-004-5390,1112.4283,4,2,2,1.2491470561060534
23911,703-004-5382,5142.631,7,6,1,2.0802174775676368
23999,703-004-5399,9440.515,3,1,2,0.4720501073859889
2406,703-004-5388,8849.065,5,2,3,1.8151883338372936
24538,703-004-5397,5918.5767,1,1,0,0.3978652972704144
24775,703-004-5395,9934.041,1,0,1,0.27920371738274696
25250,703-004-5383,6617.88,4,2,2,0.5591173996450594
25636,703-004-5386,6431.793,3,1,2,0.5335428927780568
25963,207-008-2399,5704.2217,6,1,5,0.4314860782385869
26813,703-004-5398,8543.835,5,3,2,0.7719460359485963
2707,703-004-5384,1656.9751,5,2,3,0.9003302346400331
27494,703-004-5381,5105.1943,2,1,1,1.6309559101383142
27567,703-004-5394,6526.5728,1,0,1,0.27920371738274696
27575,703-004-5385,2499.4934,2,1,1,0.4911728317045353
27743,703-004-5393,4992.269,2,0,2,0.27920371738274696
28196,703-004-5393,6.042719,4,2,2,0.6708007918866135
28242,703-004-5381,4326.518,4,1,3,0.35831143730785864
28293,207-008-2399,8820.127,3,1,2,0.35831143730785864
28295,703-004-5398,7760.099,3,1,2,0.940918448762824
2849,703-004-5384,2973.7288,7,5,2,1.6130268330983897
28528,703-004-5383,2486.5396,1,0,1,0.27920371738274696
28693,703-004-5386,1451.0083,2,0,2,0.27920371738274696
29016,703-004-5388,2858.0422,2,0,2,0.27920371738274696
29020,703-004-5389,541.99097,2,2,0,0.7140577888070437
29278,703-004-5393,720.28577,2,0,2,0.27920371738274696
29365,703-004-5387,2763.3262,2,1,1,0.46717815270631413
29484,703-004-5395,3661.2893,4,2,2,0.6763862743129988
29587,703-004-5397,956.4996,6,4,2,3.933244819712319
29721,703-004-5399,1074.2706,3,2,1,0.8020447125556829
29819,703-004-5380,7064.741,7,3,4,3.71516525369429
2983,703-004-5394,5361.141,4,2,2,0.7287473463708922
30398,703-004-5381,4945.8813,4,3,1,1.1264580307652876
30564,703-004-5389,5833.6167,9,6,3,1.9761981694580408
30712,703-004-5393,1832.3982,4,4,0,1.6333336798508307
30958,207-008-2398,1471.5618,2,1,1,0.3655113260183773
31010,703-004-5396,1418.8158,2,1,1,0.47351205444880246
31170,703-004-5397,647.3225,5,3,2,3.476735985995569
31248,703-004-5392,7448.2373,4,2,2,1.9703987584229516
31589,703-004-5386,8388.047,3,1,2,0.6916156710667631
31720,703-004-5395,7044.0547,"","","",0.27920371738274696
3173,703-004-5380,7863.9146,2,0,2,0.27920371738274696
32300,703-004-5386,5934.762,2,2,0,1.068247977069913
32360,703-004-5394,925.8783,4,3,1,3.633696724068189
32566,703-004-5394,4826.2524,5,4,1,3.1062825316376728
3259,703-004-5384,9685.281,2,1,1,0.9041414463491692
32707,703-004-5391,8198.521,6,4,2,1.539260427206074
32854,703-004-5385,9374.772,6,3,3,0.9213434976992089
3357,703-004-5394,4850.138,4,1,3,0.6097562499271654
33599,703-004-5392,906.3792,5,3,2,3.1862673729208106
33626,703-004-5383,3040.5461,5,2,3,0.6166327524908154
33671,703-004-5383,6934.55,1,0,1,0.27920371738274696
34008,703-004-5384,3667.9143,6,4,2,1.211993965423167
34083,703-004-5395,7384.3086,4,3,1,0.7581971154325139
34325,703-004-5385,2267.0,3,2,1,0.7189425154606729
34586,703-004-5388,5719.181,2,1,1,0.784487656246195
34663,703-004-5383,5289.3804,5,1,4,0.7512232670905843
34690,703-004-5395,5564.516,1,1,0,0.5641527956558267
34758,703-004-5386,3166.3977,5,0,5,0.27920371738274696
34846,207-008-2399,4690.098,3,1,2,1.0217415147941824
34882,703-004-5387,7470.654,2,0,2,0.27920371738274696
34919,703-004-5386,1800.8297,8,3,5,1.2204766704228767
35289,703-004-5384,9401.919,6,5,1,0.8869146684419223
353,703-004-5396,4807.7583,7,3,4,0.8891988115180688
35344,703-004-5383,9459.117,3,1,2,1.019246411741581
35431,703-004-5380,5883.3403,4,0,4,0.27920371738274696
35467,703-004-5382,2911.7297,"","","",0.27920371738274696
35485,703-004-5384,4737.6943,4,2,2,1.1937593244240514
35515,703-004-5386,5038.1196,2,1,1,0.4587851017353377
35537,703-004-5391,8807.376,8,5,3,1.5855434481311628
35672,703-004-5395,3190.9585,4,3,1,1.0012455609078323
35715,703-004-5384,721.8331,4,3,1,2.5091388750056094
35922,703-004-5385,6260.5054,2,1,1,0.9997144496675445
36183,703-004-5389,2495.7412,3,1,2,0.5165268771580819
36211,703-004-5386,1450.0189,5,4,1,2.445525628254339
36231,703-004-5386,3641.869,3,0,3,0.27920371738274696
36346,207-008-2399,2649.9778,2,1,1,0.4383536256312919
36348,703-004-5386,9756.862,6,3,3,1.3862889988042428
36452,703-004-5383,7171.56,5,2,3,1.907160940053569
3648,703-004-5396,5362.741,6,3,3,0.6852630520777826
36957,703-004-5397,8640.979,3,1,2,0.745869388591693
37465,703-004-5384,2802.3696,6,2,4,0.4749351006988095
37635,703-004-5387,837.05066,4,2,2,1.269141000393406
3767,703-004-5391,553.65326,5,1,4,0.4565668188543465
38694,703-004-5381,9875.839,4,4,0,0.9457754824848051
38816,703-004-5396,1066.4653,3,1,2,0.7600521260684845
38835,703-004-5391,8012.7515,3,3,0,0.6765981374404476
38904,703-004-5389,3065.8198,2,1,1,0.48236389995783113
39515,703-004-5399,9768.599,2,0,2,0.27920371738274696
39822,703-004-5387,6759.549,5,2,3,1.730033757868272
39823,703-004-5389,3444.9036,2,0,2,0.27920371738274696
40043,703-004-5382,5570.3525,3,2,1,0.7538500369334169
40063,703-004-5383,4488.947,3,2,1,0.8395279452472834
40319,703-004-5388,6041.1646,4,1,3,0.35237835831347525
40518,703-004-5384,6842.991,6,3,3,0.9670509047470649
40528,703-004-5381,3847.244,3,2,1,0.6240359166138071
41674,703-004-5381,7998.697,5,2,3,0.8103833476854881
41899,703-004-5397,3034.1697,7,5,2,2.7778587864523954
42102,703-004-5388,5310.2046,3,1,2,1.1226502645384737
42203,703-004-5380,39.61861,1,1,0,0.3840988152559329
42527,703-004-5381,2812.954,2,0,2,0.27920371738274696
42742,703-004-5387,3844.114,5,1,4,0.6166808132612714
42861,703-004-5390,8557.521,5,3,2,1.163286509829252
43082,703-004-5386,2742.3567,2,0,2,0.27920371738274696
4387,703-004-5388,6477.7188,2,0,2,0.27920371738274696
44404,703-004-5382,5241.1177,3,2,1,1.1315185603909874
44611,207-008-2399,4526.7295,4,3,1,1.5695673429840202
44877,703-004-5380,7420.859,2,2,0,0.526077247691013
4527,703-004-5383,1851.2976,3,1,2,0.7370972407492853
45428,703-004-5397,1639.4198,6,4,2,1.211610569136603
45516,703-004-5394,949.3518,2,1,1,0.3978652972704144
45900,703-004-5397,8852.317,5,4,1,2.232694059454182
45974,703-004-5387,6631.8394,10,7,3,2.0353539127960993
46202,703-004-5388,316.89227,2,1,1,0.5392619636390055
46246,703-004-5390,1031.3087,4,2,2,0.7125104341527357
46770,207-008-2398,9226.1455,6,3,3,2.1641541186904814
46910,703-004-5397,9111.894,9,3,6,0.9509226925248458
48008,703-004-5396,5050.468,7,3,4,0.8607550295138773
48170,207-008-2399,5363.6987,2,1,1,0.47751908010367106
48250,703-004-5385,3507.2124,2,2,0,0.8399703765223366
48562,703-004-5398,2229.1155,7,4,3,2.8409443347354926
4886,703-004-5383,6594.676,5,2,3,0.6849894889705093
48997,703-004-5383,2463.0283,3,0,3,0.27920371738274696
49155,703-004-5389,2034.7917,3,2,1,0.5544119887427517
49276,703-004-5380,4196.989,5,2,3,1.2295443878703354
49306,703-004-5398,2318.5383,9,3,6,1.215575503058033
49585,703-004-5388,8266.791,7,3,4,1.1103386554328596
49881,207-008-2398,4491.5347,1,1,0,0.7140919115986339
49982,703-004-5384,2763.0967,1,0,1,0.27920371738274696
5003,207-008-2399,7382.5254,3,1,2,0.5394639611630696
5016,703-004-5393,7570.8164,3,2,1,0.6901773341233496
5461,703-004-5389,8806.785,5,2,3,0.5355220404725941
5466,703-004-5381,221.51709,6,3,3,1.1186057202909554
598,703-004-5388,1708.9105,5,2,3,1.2479699203217662
6063,207-008-2398,1576.3241,3,2,1,1.5901458514483215
6297,703-004-5395,9588.9375,4,3,1,1.9266878706891348
6456,703-004-5380,8460.728,7,2,5,0.8065284096072673
6657,703-004-5381,1336.8016,6,3,3,0.8031345469857364
6740,703-004-5388,6207.886,2,2,0,1.1731484458597168
6884,207-008-2399,2228.3655,4,3,1,1.8243948136460024
6942,703-004-5382,4106.2666,5,3,2,0.7801609217873985
6998,703-004-5394,7417.1094,2,0,2,0.27920371738274696
7095,703-004-5386,9990.168,4,3,1,1.3080209205688997
7167,703-004-5396,7263.2803,6,5,1,1.1170653900638594
7527,703-004-5389,8453.475,3,2,1,0.8135440085160263
7564,703-004-5398,8219.976,2,0,2,0.27920371738274696
7852,703-004-5394,344.1441,2,1,1,0.5838498858898414
791,703-004-5387,26.876331,3,2,1,0.9691614912286298
809,207-008-2399,7821.61,4,0,4,0.27920371738274696
8130,703-004-5396,1711.2482,4,2,2,0.8636699764052758
8448,703-004-5393,975.02826,3,2,1,2.438663650757611
8595,703-004-5383,9322.479,5,3,2,1.2267760979161586
8658,703-004-5387,4154.82,5,2,3,2.2284006871589725
8861,703-004-5384,618.5734,4,2,2,0.52207972829573
9207,703-004-5389,2226.1362,4,3,1,0.6129092784056428
9634,703-004-5393,2548.561,6,2,4,0.7585243698471137
9635,703-004-5399,821.5964,6,3,3,1.0524024293767293
9863,703-004-5381,7416.6924,1,1,0,0.7400418760987375
9909,207-008-2399,5063.0645,2,0,2,0.27920371738274696
10741,703-004-5380,9333.695,3,2,1,1.0896771875699227
11102,703-004-5394,41.875244,3,2,1,1.154773310590311
11116,703-004-5388,345.2295,5,2,3,0.4656012824562913
11169,207-008-2398,2383.4688,2,1,1,0.8131945646339127
11274,703-004-5390,8892.085,5,4,1,0.8198871744845738
11709,703-004-5395,4760.2866,3,1,2,0.5441488251648378
12266,703-004-5395,2797.3884,3,1,2,0.5602811264637348
12313,703-004-5380,9850.833,5,3,2,1.9364069511260535
12334,703-004-5381,7064.0425,5,2,3,1.5568939934655115
12335,703-004-5389,583.6892,1,0,1,0.27920371738274696
12368,207-008-2399,8911.734,4,2,2,1.0492214591300904
12390,703-004-5395,7441.9976,2,2,0,0.8027369739262917
12406,703-004-5390,5783.576,3,2,1,0.8252570618161954
12730,703-004-5383,1825.3124,5,2,3,1.4896004692514726
1276,207-008-2399,7666.982,4,3,1,1.2972675461169592
12841,703-004-5390,8597.493,3,1,2,0.4063639385066191
13043,703-004-5386,5760.8086,"","","",0.27920371738274696
13123,703-004-5384,9708.724,4,3,1,2.139135294464776
13652,703-004-5393,5758.6396,5,5,0,2.018767623348841
13762,703-004-5385,8425.41,5,4,1,1.517914229095579
13853,703-004-5390,6451.602,1,0,1,0.27920371738274696
1398,703-004-5388,4570.612,5,2,3,0.816717643820913
14176,703-004-5397,8137.865,6,0,6,0.27920371738274696
14190,703-004-5394,1186.9562,5,2,3,0.43272819464119633
14220,703-004-5380,5386.7285,5,2,3,2.533189784181023
1424,703-004-5391,5702.459,2,2,0,2.4888084639453583
14725,703-004-5389,6390.9746,3,1,2,0.47105310167053366
14733,703-004-5384,1169.5533,1,0,1,0.27920371738274696
14906,703-004-5398,4242.7974,5,3,2,1.6840522303335952
15010,703-004-5396,6266.518,2,0,2,0.27920371738274696
15037,703-004-5396,9528.084,5,3,2,1.347021352809328
15212,703-004-5398,7739.7563,4,2,2,0.693231703385143
15407,703-004-5388,2796.4724,2,0,2,0.27920371738274696
15693,703-004-5390,4888.7383,9,3,6,1.5039651267795378
15823,207-008-2398,5381.7524,4,2,2,0.9547268248565258
15977,703-004-5386,5009.563,8,5,3,2.366053400880946
16042,207-008-2398,5037.5474,2,1,1,0.33853450732658075
16419,703-004-5392,5596.918,7,2,5,1.1632404784845416
16459,207-008-2399,3027.8652,2,0,2,0.27920371738274696
16474,703-004-5387,6979.743,1,0,1,0.27920371738274696
16481,703-004-5383,9759.77,8,3,5,1.1701502659629566
16691,703-004-5398,520.6895,2,1,1,0.5976111842730868
17076,703-004-5398,6573.97,5,1,4,1.3321093605619219
17093,703-004-5397,7721.893,6,3,3,1.3233834652020762
17605,703-004-5391,2561.6992,8,4,4,1.4690687015681925
17743,703-004-5398,8431.465,2,1,1,1.0785770783342008
17823,703-004-5399,9029.435,6,1,5,0.3572632600188509
17843,703-004-5387,9661.231,2,1,1,0.7596564199701077
17924,703-004-5387,5530.942,4,4,0,2.907001098528436
18013,703-004-5386,3379.5269,2,0,2,0.27920371738274696
1812,703-004-5389,3015.5605,7,4,3,1.0421612830842724
18247,703-004-5393,6003.6064,4,1,3,0.5067098288590419
18257,703-004-5388,9937.767,2,2,0,0.8583163061519709
18831,703-004-5386,5123.299,9,6,3,3.439763580932762
18871,703-004-5391,6713.152,3,2,1,0.6581632204671458
18878,703-004-5384,4177.373,3,1,2,0.6710106796823955
18990,703-004-5393,5230.5938,6,4,2,1.005015856665354
19139,703-004-5382,3175.555,10,4,6,1.1183007317239833
19237,703-004-5398,7852.73,5,2,3,0.7713726851182745
19245,703-004-5387,9419.288,3,0,3,0.27920371738274696
19407,703-004-5393,4897.088,9,6,3,1.6411710222371574
19852,703-004-5382,342.6498,3,3,0,1.5034747132358461
19909,207-008-2399,8846.238,2,1,1,0.5747012673725376
19968,703-004-5390,8260.581,3,2,1,0.686102702102005
2009,207-008-2398,2687.863,6,1,5,0.658234327174086
2018,703-004-5383,7545.6973,2,1,1,0.4314860782385869
20421,703-004-5397,3367.1606,4,2,2,0.7108975313575623
20498,703-004-5383,1021.8042,5,1,4,0.4693953532146728
20702,703-004-5392,4428.9966,6,3,3,1.5541889727465783
20705,207-008-2398,9132.446,2,0,2,0.27920371738274696
20797,703-004-5382,1339.3795,8,5,3,2.005366262247483
20888,703-004-5398,8141.3765,3,1,2,1.417577021262621
20965,703-004-5388,3561.961,2,1,1,0.4180377658513179
21213,207-008-2398,3915.751,4,1,3,0.9199762487761513
2157,207-008-2399,9202.892,2,1,1,0.4015836011498383
218,703-004-5383,7838.087,4,3,1,1.7837079644612301
22251,207-008-2398,2597.8286,2,0,2,0.27920371738274696
22294,703-004-5391,3763.9404,5,3,2,1.1589885246677334
22340,703-004-5380,4972.8125,4,4,0,2.4362597816864846
22368,703-004-5398,5448.344,7,7,0,1.665619359847713
2268,703-004-5399,5086.2266,2,2,0,1.2726769857820475
22716,703-004-5387,8801.893,3,1,2,0.4450250146424749
22725,207-008-2399,7852.3164,3,1,2,1.2486816544371102
22756,703-004-5392,94.76185,2,0,2,0.27920371738274696
23302,703-004-5380,7729.921,5,3,2,1.3556304437233604
23543,703-004-5383,3148.4104,8,6,2,1.5516037619884226
2359,703-004-5392,4890.8745,3,1,2,0.4882000191906698
2360,703-004-5381,1756.9799,6,3,3,2.0465049327687033
23609,703-004-5386,6230.8677,4,1,3,0.5852599822091243
23699,703-004-5381,4772.4146,4,3,1,1.0797543133065204
23784,703-004-5387,5107.4985,3,1,2,0.5792135912815377
23980,207-008-2398,9810.569,3,1,2,0.9186442085692575
24191,703-004-5388,5707.1724,5,4,1,1.822919769468616
24483,703-004-5391,5007.537,4,3,1,2.0254108310594647
24518,703-004-5396,743.5089,4,1,3,0.4525635898938843
24532,703-004-5399,6888.6514,3,3,0,1.4848642595965327
24544,703-004-5399,241.09543,7,3,4,0.8977828414680795
24630,703-004-5396,4837.7383,7,5,2,2.4409457804936476
24777,703-004-5389,2752.66,5,1,4,0.4888582909261827
24868,207-008-2399,7220.232,3,3,0,3.502153068632473
25193,703-004-5398,9955.49,2,2,0,1.1541099537701192
25342,207-008-2398,9024.979,7,7,0,2.031752263018414
2555,703-004-5389,8268.943,2,1,1,0.35981766242161134
2597,703-004-5380,4550.012,5,1,4,0.6215884242420809
26915,703-004-5395,1876.6946,2,1,1,0.5712597089537998
27,703-004-5386,6188.298,4,2,2,1.319438768897732
27120,703-004-5383,7280.6973,9,6,3,3.002615139114503
27337,703-004-5382,6863.3784,4,3,1,0.7452974715303662
27776,703-004-5386,6168.2544,5,2,3,2.1404803768914675
27928,703-004-5388,1956.8694,5,3,2,0.890554888535167
27954,703-004-5392,8635.272,5,3,2,1.2140093830767413
28167,703-004-5399,5338.4854,7,4,3,1.303992054127254
28557,703-004-5385,4264.9434,3,1,2,0.6776064402609508
28586,703-004-5388,9835.412,2,1,1,1.9826367938645948
28622,703-004-5392,945.2272,5,3,2,1.0896548514135116
28797,703-004-5380,3479.252,5,2,3,1.9766609015026286
2892,207-008-2399,2606.4812,4,3,1,0.6745108318177927
29289,703-004-5399,3861.4333,6,5,1,3.2279217997905842
29682,703-004-5380,4370.5464,3,2,1,0.5160376618780234
3002,703-004-5399,2470.4385,5,2,3,0.9573428093696361
3052,703-004-5389,6232.673,5,3,2,1.135353945475053
30550,703-004-5383,4540.09,5,0,5,0.27920371738274696
30773,703-004-5387,2282.3228,3,2,1,0.7692772872735193
31024,703-004-5381,8577.463,3,1,2,0.9137355497199753
31040,703-004-5394,371.52707,1,1,0,0.35831143730785864
31049,703-004-5394,5245.4185,3,1,2,0.35831143730785864
31686,703-004-5388,9902.065,1,0,1,0.27920371738274696
31698,703-004-5381,9401.319,2,1,1,0.6506899701860435
31912,703-004-5395,7044.302,4,1,3,0.9182084624055638
32224,703-004-5386,6589.905,4,2,2,1.2907895748416482
32304,703-004-5399,9703.449,3,1,2,0.4542305365635556
32553,703-004-5397,6455.9126,6,3,3,0.6641073466600901
32864,703-004-5388,546.19196,1,0,1,0.27920371738274696
33047,703-004-5399,6600.3667,5,1,4,0.35831143730785864
33313,703-004-5386,5139.8774,1,0,1,0.27920371738274696
3333,703-004-5380,7964.8403,4,0,4,0.27920371738274696
3339,207-008-2399,7792.5117,3,1,2,0.5605349265614645
33555,703-004-5394,5582.048,5,2,3,0.6635657251220979
33586,703-004-5380,7191.407,4,1,3,0.5974181492010809
33653,703-004-5389,613.8796,6,4,2,1.7851078869796553
33695,703-004-5388,3529.575,3,1,2,0.6564451152639809
33918,207-008-2399,5473.765,4,1,3,0.42912396056092694
34605,703-004-5392,3292.3281,3,0,3,0.27920371738274696
34943,703-004-5390,1461.2007,5,4,1,1.2468854646194119
35114,703-004-5386,2091.9246,4,3,1,1.6304711960722107
35171,703-004-5384,1877.7412,5,2,3,1.1903221997753965
35312,703-004-5387,7202.8677,3,2,1,2.3781754800919233
3534,703-004-5384,6074.122,6,4,2,2.0944447864080913
35476,703-004-5395,4947.525,10,6,4,3.46109228384367
35736,207-008-2399,1211.1783,7,5,2,1.9379734599048455
36081,703-004-5391,2431.8535,7,3,4,0.9140182040902393
36173,703-004-5396,8868.839,3,1,2,0.39907663423176776
36250,703-004-5382,169.43454,5,1,4,0.4180377658513179
36505,703-004-5384,3067.0166,3,2,1,2.163270538641659
36528,703-004-5386,7335.6743,2,2,0,1.3184505249963072
36542,703-004-5393,6490.3804,3,1,2,0.37723973485623447
36662,703-004-5399,4113.627,6,4,2,1.3100112315363226
36912,703-004-5385,9127.192,6,4,2,3.0547816983665554
36954,703-004-5392,8474.466,1,1,0,0.4109794940287201
37368,703-004-5381,5697.493,8,5,3,0.9033906424147103
3790,703-004-5382,9810.434,3,1,2,0.9358018515403118
38256,703-004-5386,5470.727,6,4,2,1.0090080277861153
38427,703-004-5381,4631.7534,4,1,3,0.5110589148390648
38642,703-004-5381,4966.7036,3,3,0,0.8421419637801973
39280,703-004-5392,4164.802,2,1,1,0.35831143730785864
39462,703-004-5383,4202.645,4,1,3,0.5911354168156333
39814,703-004-5380,3550.7559,6,5,1,1.0405049135109852
3982,703-004-5388,7707.199,2,1,1,0.988645693160085
39894,703-004-5390,199.70238,2,2,0,1.4388731748324837
40018,703-004-5383,4062.7742,2,1,1,0.49081682248876896
40101,703-004-5386,3343.3455,7,3,4,3.781125427478745
40157,703-004-5393,3977.0854,6,3,3,1.3616312942858524
40253,703-004-5397,7627.177,2,2,0,0.6849978743377778
40288,703-004-5396,598.8383,3,3,0,1.3130035688129431
40558,703-004-5383,8880.818,7,4,3,1.1151438230532114
40675,703-004-5395,5001.455,2,1,1,0.5964728283574786
41018,703-004-5391,6471.0503,6,2,4,1.0176552279784439
41107,703-004-5396,9974.931,7,4,3,0.9536199795380838
41248,703-004-5387,6581.1255,5,2,3,0.8503863830855946
4133,703-004-5395,2544.1814,3,1,2,0.35831143730785864
41671,703-004-5382,2292.5884,5,2,3,1.126746220413292
41980,703-004-5395,6886.7617,7,3,4,1.0538936940169388
42377,703-004-5382,6540.762,2,2,0,1.3644374479230381
42384,703-004-5398,4156.7,4,2,2,0.5105937981636984
42664,703-004-5380,4860.2583,6,5,1,2.2494199916679176
42833,703-004-5395,5355.2876,4,2,2,0.6381194154521626
42951,703-004-5396,8192.627,2,1,1,0.6640371167779018
43510,703-004-5399,4998.576,4,1,3,0.3809807432988984
43710,703-004-5397,1215.0913,4,1,3,0.36947963447603616
43961,703-004-5381,7850.6724,5,3,2,1.422733483609877
44330,703-004-5387,5942.992,5,2,3,1.047625878672198
44359,703-004-5389,9049.931,5,4,1,1.1184516538224396
44598,703-004-5390,2127.0657,5,4,1,2.2621718932945316
44941,703-004-5399,9391.286,4,1,3,0.8005296394276701
44970,207-008-2399,3180.7988,2,1,1,0.49635935624316857
45172,703-004-5387,2999.2896,8,5,3,1.8630805818718617
45599,703-004-5381,6200.7324,6,4,2,1.4923250132173869
45655,703-004-5393,2075.23,7,5,2,1.8526404386189723
45709,703-004-5399,1450.044,7,5,2,1.017145413362472
45751,703-004-5393,3094.4307,5,3,2,1.5821855476839792
46326,703-004-5385,4179.8086,4,4,0,1.0370821640728547
46390,207-008-2398,1167.4572,5,2,3,0.5897836029061024
46399,703-004-5390,6874.857,5,4,1,1.580972305987701
46590,703-004-5397,947.34015,4,1,3,1.0656453097719674
46695,703-004-5382,1738.5381,6,3,3,1.0932351093881572
46857,703-004-5387,8638.021,3,2,1,0.5480470140559309
47302,703-004-5393,3352.8757,5,2,3,3.530889642942329
47360,703-004-5389,1149.416,4,1,3,0.4737573522920102
477,703-004-5383,8898.082,4,2,2,0.7904757468919908
48055,703-004-5382,2123.0107,8,3,5,1.4813513835626206
48071,703-004-5396,4207.369,4,2,2,0.6234223648901904
48815,703-004-5392,8824.164,5,3,2,1.516319136538415
48901,703-004-5394,1920.122,4,3,1,1.130930472645385
49008,703-004-5388,5738.205,2,0,2,0.27920371738274696
49014,703-004-5391,8227.249,7,3,4,1.6592539725987727
49231,703-004-5387,3619.4456,4,2,2,1.37554426396357
496,703-004-5396,3566.1536,5,2,3,0.7086324687636336
5036,703-004-5385,9110.176,6,4,2,1.3689414374659237
5042,703-004-5381,4059.102,7,5,2,3.131587508859638
5117,207-008-2398,6615.6807,2,1,1,0.364716690505545
5187,703-004-5390,8237.755,6,2,4,0.47341267537564646
5399,703-004-5398,54.062008,3,1,2,0.39916168680266934
5479,207-008-2399,8708.188,6,3,3,0.6276001331325552
5614,703-004-5394,913.6265,3,1,2,1.064426268547232
5791,703-004-5393,9372.166,5,1,4,0.35831143730785864
61,703-004-5398,8098.259,4,3,1,0.8431889598971346
6352,703-004-5397,3463.4292,5,2,3,1.8450782766465277
649,703-004-5399,6361.459,2,0,2,0.27920371738274696
6500,703-004-5384,1556.7004,5,3,2,3.5190093913074736
6523,703-004-5381,1234.5671,3,0,3,0.27920371738274696
6556,703-004-5384,3419.4673,7,3,4,1.1765355414338847
658,703-004-5388,4227.3066,2,1,1,0.6028202149763912
6690,703-004-5397,1932.7158,4,2,2,1.1563026910141538
6843,703-004-5388,500.82565,2,0,2,0.27920371738274696
6938,703-004-5386,4598.341,4,4,0,2.3348840297381632
6966,703-004-5394,5919.1357,2,1,1,0.3187575773453028
6996,703-004-5384,3495.6545,8,5,3,1.139513472056543
7108,703-004-5398,4050.6196,1,1,0,1.0297158307600185
7696,703-004-5392,1729.2172,4,2,2,0.9249147265671093
7789,703-004-5389,8045.6797,4,3,1,1.5116584855417623
8233,703-004-5381,6822.826,1,0,1,0.27920371738274696
8390,703-004-5397,9300.15,6,3,3,1.367121931786384
8702,703-004-5395,4299.2676,6,2,4,0.5824144855557382
9031,703-004-5396,348.87015,5,1,4,0.6548583870394841
9108,703-004-5396,2665.2937,1,1,0,0.35831143730785864
9257,703-004-5394,3436.1494,"","","",0.27920371738274696
9521,703-004-5396,9962.23,1,1,0,0.634115558594265
9633,703-004-5385,7009.1455,6,2,4,0.9161670328162645
9783,207-008-2399,6141.9805,3,0,3,0.27920371738274696
9789,703-004-5395,8685.873,7,5,2,1.5929229702652283
9989,703-004-5390,5576.082,5,4,1,2.08949138336428
10186,703-004-5394,5542.7266,4,3,1,1.4869712619385271
1047,703-004-5382,3642.6306,5,2,3,1.696267171038171
10695,703-004-5380,9404.66,5,0,5,0.27920371738274696
10778,703-004-5382,5158.5264,4,3,1,1.041782996004669
10901,703-004-5394,4919.9907,3,2,1,0.770492351616777
11151,703-004-5382,8295.931,1,1,0,0.3691084050195126
11370,703-004-5389,3900.3735,3,1,2,0.3383696995767367
1142,703-004-5385,4985.7163,5,1,4,0.35831143730785864
11641,703-004-5383,7931.8374,4,3,1,0.6800326727541212
11989,703-004-5397,6251.505,2,1,1,0.4322892293794864
12177,703-004-5395,5040.0664,4,3,1,1.2913973241440364
12804,703-004-5398,2272.4402,3,3,0,1.8741519804043487
13136,703-004-5380,7247.0615,2,0,2,0.27920371738274696
13225,703-004-5398,7370.0605,6,3,3,0.9285147170514669
13644,703-004-5393,2929.1982,4,1,3,0.5479118144709698
13759,703-004-5390,7515.6484,5,4,1,1.7302031664518351
13787,703-004-5392,6114.388,6,3,3,0.8779112806001201
13959,703-004-5399,3069.2678,5,3,2,1.0721633105301958
14026,703-004-5396,4656.7397,7,3,4,1.3505929331553126
14161,703-004-5385,6639.61,5,3,2,0.8624633339999841
14168,703-004-5392,3539.9539,2,1,1,0.3978652972704144
14261,703-004-5398,4670.048,5,4,1,2.8309682926962996
14774,703-004-5396,9255.846,1,1,0,0.5866378397252662
14953,703-004-5386,6838.462,4,4,0,1.8096513934802796
15027,703-004-5385,3462.7693,5,1,4,0.3978652972704144
15046,703-004-5381,8192.816,3,2,1,0.6886806742375259
15468,703-004-5380,1108.222,1,1,0,0.5126686838225454
1548,703-004-5393,3757.6497,3,2,1,0.8457996099095546
15543,703-004-5383,2610.2268,5,2,3,1.430430313981862
15591,703-004-5389,8231.451,5,1,4,0.5784411540058043
15840,703-004-5398,1927.0021,1,0,1,0.27920371738274696
16005,703-004-5391,3368.947,1,1,0,0.33556796782938897
16118,703-004-5383,7550.9243,5,3,2,0.8297343073806084
16137,207-008-2399,7870.3765,6,2,4,0.5162783723140982
16286,207-008-2399,9649.91,3,1,2,0.4433079565944446
17016,703-004-5386,6653.253,1,1,0,0.33853450732658075
17042,703-004-5380,9781.393,8,3,5,0.736605674950807
17111,703-004-5391,296.2744,3,0,3,0.27920371738274696
17322,703-004-5393,8152.275,3,2,1,1.4770896084053453
17417,703-004-5398,6755.225,7,4,3,2.180149452546023
17534,207-008-2398,2146.0027,7,2,5,1.6863126985373404
17540,703-004-5382,2839.659,11,4,7,3.0937696718085874
17725,703-004-5387,9292.319,4,2,2,0.8012112276497207
18225,703-004-5385,6113.665,4,0,4,0.27920371738274696
18286,703-004-5387,6440.229,8,3,5,0.8254946571467439
18656,703-004-5384,5321.504,8,6,2,2.4675177347485358
18952,703-004-5393,3021.8845,5,5,0,3.1870198987309646
19021,703-004-5388,2030.7231,6,4,2,1.9264710579416182
19043,703-004-5382,4571.848,6,4,2,1.3604554821144288
19172,703-004-5398,7861.8003,4,3,1,0.9265414842819695
19504,703-004-5394,9761.197,7,4,3,3.289582332137177
19569,703-004-5398,6229.178,5,0,5,0.27920371738274696
1990,703-004-5381,9827.544,2,2,0,1.4819478188171433
20092,207-008-2398,9291.886,3,2,1,0.6616302185841221
20900,703-004-5396,7597.383,2,2,0,0.9177410839915875
21241,703-004-5385,3028.1873,2,0,2,0.27920371738274696
2146,703-004-5390,27.74775,3,2,1,0.6381712758862311
21640,703-004-5396,776.6765,"","","",0.27920371738274696
22044,703-004-5390,8217.991,2,2,0,0.7595581574058434
2216,703-004-5382,6717.5513,6,5,1,3.4644969959734704
22452,703-004-5393,705.35065,3,2,1,1.0308292087162358
22498,703-004-5397,1290.2605,2,0,2,0.27920371738274696
22564,703-004-5393,4376.604,4,2,2,0.7017037483050521
22834,703-004-5395,7278.6074,4,4,0,1.2776491188482981
22956,703-004-5394,1845.1077,7,4,3,1.8561579126982433
23022,703-004-5391,3483.9993,2,2,0,0.7843432084102134
23241,703-004-5397,3757.7349,5,2,3,0.949373225956184
23477,703-004-5383,690.1413,2,2,0,0.7096339945563416
23513,703-004-5380,7285.172,5,3,2,0.930767575514151
23722,703-004-5396,595.36816,5,2,3,0.912559900033172
24084,703-004-5393,3803.83,3,1,2,0.791819378980575
24139,703-004-5384,8890.479,8,2,6,0.8623392923433116
2414,703-004-5381,1977.8019,2,2,0,0.6766511074471322
2429,703-004-5397,9596.531,3,2,1,1.9567682374175093
24331,703-004-5395,9370.934,3,1,2,0.5338695981729378
24353,703-004-5385,7660.8755,2,0,2,0.27920371738274696
24358,703-004-5387,3306.15,3,2,1,1.1649462196731868
24636,703-004-5392,4845.779,5,0,5,0.27920371738274696
24649,207-008-2399,9920.56,3,1,2,0.35831143730785864
24877,703-004-5386,9209.919,4,2,2,0.9384615446074385
25079,703-004-5392,5325.7715,7,6,1,2.159452755009289
25233,703-004-5380,1417.737,4,2,2,0.548923258151913
25291,703-004-5381,6019.1206,1,0,1,0.27920371738274696
262,703-004-5381,1465.2837,"","","",0.27920371738274696
26664,703-004-5385,3716.2048,3,1,2,0.3978652972704144
27124,207-008-2398,3444.6956,3,2,1,0.9494326080915018
27150,703-004-5391,7103.1157,3,1,2,0.393510119491447
27162,703-004-5398,889.72095,2,1,1,0.4991942815057015
27194,703-004-5393,6133.3174,4,1,3,0.3978652972704144
27496,703-004-5399,274.04547,4,0,4,0.27920371738274696
27604,703-004-5397,8964.048,4,3,1,1.5581974005142827
27675,703-004-5383,13.402104,4,3,1,0.8652511180310319
28238,703-004-5388,6877.529,4,3,1,0.6236066680527086
28304,703-004-5391,2906.5896,4,2,2,1.35406930850403
28714,703-004-5388,6114.0273,5,3,2,1.412284253409227
28882,703-004-5393,9882.48,3,2,1,0.6653631079646841
29574,703-004-5395,4499.892,2,1,1,0.36263695032186855
29648,703-004-5387,3708.3142,5,2,3,0.8479036982873801
29662,207-008-2399,72.03818,4,4,0,1.4929865565561442
29838,703-004-5383,944.9792,6,4,2,1.497700732186238
29990,703-004-5396,1914.7783,7,2,5,1.0109952247462166
30703,703-004-5392,2209.4905,5,3,2,1.040200594281857
30752,703-004-5387,7974.5205,3,2,1,0.5194436539165868
30873,703-004-5388,1825.0186,4,3,1,1.047460490277685
31262,703-004-5397,9800.978,3,2,1,1.1697286369438746
3155,703-004-5393,3920.1318,4,2,2,1.1715373061301348
31580,703-004-5398,6296.656,2,1,1,0.663472221768892
3163,703-004-5398,5734.976,2,1,1,0.35831143730785864
3166,703-004-5384,6074.284,6,2,4,0.6613192057183217
32237,703-004-5383,1598.5072,5,3,2,1.0627497105372823
3227,703-004-5387,4132.2485,2,0,2,0.27920371738274696
32431,703-004-5387,8768.362,2,0,2,0.27920371738274696
32590,703-004-5390,2719.0227,3,1,2,1.0588451626901736
32732,703-004-5387,8236.297,5,0,5,0.27920371738274696
32800,703-004-5387,3650.4834,1,1,0,0.5379524737088482
32918,207-008-2398,1185.2723,5,3,2,1.3116433642353225
32980,703-004-5387,3699.3755,1,0,1,0.27920371738274696
33017,703-004-5396,2088.0193,4,2,2,0.43445261773577853
33034,703-004-5393,4708.087,6,4,2,1.118003617630033
33471,703-004-5391,8135.179,3,0,3,0.27920371738274696
33620,703-004-5394,8001.549,5,3,2,0.8436554691441084
33748,207-008-2398,50.057175,3,3,0,1.1061282442277482
34003,703-004-5382,8293.629,4,1,3,0.37175974969512765
3404,703-004-5398,3275.3892,2,0,2,0.27920371738274696
34671,703-004-5398,9790.627,2,2,0,1.0498556109425212
34973,703-004-5381,3961.8855,5,3,2,2.0565667047886107
35214,703-004-5390,9763.018,8,3,5,1.4659263962644327
35874,207-008-2399,8961.309,3,1,2,0.5669580486103406
3591,703-004-5394,1067.577,2,1,1,1.0243687736823266
35923,703-004-5395,6819.2275,1,1,0,0.7839421461758341
36288,703-004-5389,808.0912,1,1,0,0.49143234286386905
36426,703-004-5388,7528.667,4,2,2,0.4517244699194279
36586,703-004-5391,3597.8384,4,2,2,0.45541616351593317
36894,703-004-5392,5126.496,5,1,4,0.8304683304689089
37103,703-004-5396,6085.5283,6,2,4,0.8563737130360555
37231,703-004-5382,8869.006,3,2,1,1.1658321167309844
37286,207-008-2399,7760.766,5,4,1,2.356486188516133
37495,703-004-5385,273.08167,7,2,5,0.8704032770531934
37581,703-004-5382,9052.815,2,1,1,0.8084279284552952
37819,703-004-5384,1300.1222,2,1,1,0.8104811965657385
38232,703-004-5386,3938.9902,4,2,2,0.47697301719552604
38277,703-004-5388,8853.298,2,2,0,0.5922513808556634
38376,207-008-2398,405.10715,3,1,2,0.4678256290218321
38409,703-004-5380,6637.1147,3,3,0,1.2091539112148444
38489,703-004-5388,7501.323,4,2,2,0.5997230091006487
38782,703-004-5398,2234.6013,3,1,2,0.43269741519994015
38832,703-004-5388,143.84389,4,2,2,0.8650793423159245
38958,703-004-5382,5929.4004,4,2,2,0.6976176110757917
40317,703-004-5388,1901.412,3,2,1,0.7133841909474598
40381,703-004-5390,8270.543,4,3,1,1.1708997227305835
40569,207-008-2398,1642.4203,6,2,4,1.1892720400982968
41025,703-004-5399,2450.4846,2,0,2,0.27920371738274696
41365,703-004-5380,3660.7212,10,9,1,2.2565193092497897
41564,703-004-5381,7390.965,2,0,2,0.27920371738274696
41642,703-004-5399,4287.395,4,3,1,1.0571599608329745
41935,703-004-5386,5424.1807,5,4,1,1.8389922884448038
42400,703-004-5380,3632.3196,5,2,3,1.3289203965362213
42581,207-008-2398,9863.101,5,2,3,0.6556097559725369
42941,703-004-5387,6732.521,4,3,1,0.906615487559415
43130,703-004-5391,6814.002,1,1,0,0.33853450732658075
43189,703-004-5388,125.87726,5,3,2,0.8260738483088024
43728,703-004-5395,2337.2437,2,1,1,0.3866439496029123
43729,703-004-5381,3953.8342,4,3,1,1.483493888491532
43805,703-004-5387,2852.487,7,4,3,3.745507944787082
43925,703-004-5383,9971.433,"","","",0.27920371738274696
43936,703-004-5389,872.63824,2,1,1,0.5456569166803344
44214,703-004-5394,9950.01,5,2,3,0.6801412248002763
44452,703-004-5382,8530.707,3,3,0,1.8159418550111568
44677,703-004-5398,1010.86975,2,1,1,1.0068830731964113
44765,703-004-5398,9913.127,4,1,3,0.5238339817106791
4496,703-004-5398,5358.097,4,3,1,1.2419045819264227
45121,207-008-2398,2789.5195,1,1,0,0.5156102082947547
45136,703-004-5391,5585.624,2,1,1,0.35534489781066697
45295,703-004-5396,3885.6238,5,2,3,0.6460319577928084
45557,703-004-5396,7207.9243,3,1,2,1.85706446319352
45626,207-008-2399,2061.2139,8,6,2,2.1781683632601063
45713,207-008-2399,87.142586,2,1,1,0.6121469632539963
46095,703-004-5384,3484.208,4,1,3,0.5981508890377719
46132,703-004-5383,8519.41,3,0,3,0.27920371738274696
46231,703-004-5384,6033.1367,9,4,5,1.0714919752785994
46265,703-004-5395,8356.762,3,2,1,0.7507985641059165
46874,703-004-5388,8235.253,2,0,2,0.27920371738274696
46979,703-004-5381,697.06616,7,3,4,1.2621935019145782
47055,703-004-5382,8334.801,4,1,3,0.5331918664340551
47185,703-004-5389,4501.273,5,2,3,1.1471784612365161
47285,703-004-5394,988.63245,1,1,0,0.3996976847690965
47357,703-004-5381,3616.02,3,2,1,1.3816934907688108
4737,703-004-5380,6014.306,7,4,3,2.1865958554217118
47497,703-004-5398,9959.885,3,1,2,0.4180862757371864
47532,703-004-5380,9910.563,9,6,3,1.6064519497526268
47544,703-004-5397,8168.731,3,1,2,0.43645119370345814
47786,703-004-5393,4754.385,7,2,5,0.8357933109544476
48181,703-004-5381,4843.369,4,3,1,0.5653923749868227
48214,703-004-5389,3353.787,5,3,2,0.8938253000314382
48411,703-004-5390,7263.5396,4,3,1,2.1665560491654468
48434,703-004-5392,4228.9346,5,2,3,2.3968924097862407
48811,703-004-5396,6269.183,5,3,2,0.8018943292651004
48912,207-008-2399,6282.784,1,0,1,0.27920371738274696
48980,703-004-5381,5027.4985,5,3,2,0.6094235180094179
49012,703-004-5382,4698.9756,8,4,4,1.1198858687434388
49017,703-004-5387,2338.652,7,3,4,2.327312360922166
49041,207-008-2399,4983.1294,2,0,2,0.27920371738274696
49439,703-004-5399,6511.2793,4,3,1,2.0970951123139723
49485,703-004-5393,7071.0015,3,2,1,0.5978613870080488
49578,703-004-5387,9735.645,3,0,3,0.27920371738274696
49608,703-004-5397,5103.0815,5,4,1,3.6138847976761688
49780,703-004-5390,8472.626,3,3,0,2.897708868165164
49847,703-004-5386,4685.969,5,4,1,1.4694155209112347
499,207-008-2399,3496.0461,4,3,1,1.4308805920267147
5097,703-004-5385,2116.9656,2,2,0,0.6270813448625322
5185,703-004-5386,3439.0146,6,2,4,0.6788769909886291
5504,703-004-5398,8556.172,3,0,3,0.27920371738274696
5539,703-004-5381,1441.6528,7,5,2,3.206981899649228
5668,703-004-5392,7479.164,4,1,3,1.2037544777291238
5916,703-004-5391,9871.974,3,1,2,0.5563738615385311
6391,703-004-5389,6972.4004,4,3,1,1.9045690441275607
6535,703-004-5398,5534.269,5,2,3,1.733563404760011
6925,703-004-5385,5489.7197,5,3,2,1.9823261847506022
7243,703-004-5395,4910.4316,3,2,1,0.6301956405991738
7330,703-004-5382,9756.549,7,4,3,1.971797498168398
7371,703-004-5399,2016.6212,6,2,4,1.9949059161856852
7372,703-004-5396,7855.943,3,2,1,1.1099939598393955
7719,703-004-5396,7775.0234,4,1,3,0.38415988479338886
7740,703-004-5386,2261.4211,5,4,1,1.4371069741001976
7742,703-004-5392,5380.7764,8,4,4,1.8442549381335587
7869,703-004-5385,3228.7175,4,3,1,0.9476164131247384
7914,703-004-5390,8044.729,4,2,2,1.5691062167221683
7943,703-004-5381,928.7423,6,2,4,1.5776595241736056
8541,703-004-5391,924.4895,3,1,2,0.7479207573694421
8582,703-004-5392,7949.013,5,2,3,0.8863746095645426
8587,703-004-5393,2872.3562,6,2,4,0.5956345970831934
8657,703-004-5390,8803.412,4,3,1,1.3231256098137611
8751,703-004-5393,7692.966,6,2,4,1.4700532055809397
8791,207-008-2399,4960.2754,8,4,4,1.9657729658619199
9297,703-004-5394,5261.1514,8,3,5,0.5969533264880332
9431,703-004-5391,1757.595,3,2,1,0.6713633743390139
9614,703-004-5383,4526.804,7,4,3,1.242191843358347
984,703-004-5395,36.736725,3,0,3,0.27920371738274696
9970,703-004-5392,1293.7433,1,0,1,0.27920371738274696
10064,703-004-5389,7521.7144,5,4,1,1.199293618836017
10330,703-004-5398,9532.834,5,3,2,1.1616400553171216
10680,703-004-5391,2519.939,3,1,2,0.37514543650211
11171,703-004-5392,6122.5303,3,2,1,1.061392424095448
11248,703-004-5386,9076.926,6,0,6,0.27920371738274696
11257,703-004-5380,6024.5005,5,4,1,1.319856020794793
11303,703-004-5391,7744.4507,4,2,2,1.1978715537365507
11508,703-004-5396,612.21423,6,1,5,0.9751500496141793
1153,703-004-5384,6754.8794,4,3,1,1.1259040567228715
11962,207-008-2398,5659.0146,2,1,1,0.664903813512184
12008,703-004-5381,6602.5537,1,1,0,0.9598744323774218
12424,703-004-5383,2341.5195,5,1,4,0.33561239209256655
12434,703-004-5384,2009.9801,3,0,3,0.27920371738274696
12681,703-004-5391,9119.575,5,1,4,0.4863322335767695
12801,207-008-2399,6935.828,4,3,1,1.6867992755229566
12861,703-004-5395,1730.2942,9,4,5,2.6501103011762366
129,207-008-2399,7691.035,5,1,4,0.7525027335784422
13288,207-008-2398,9465.933,8,7,1,3.6087755356985207
13530,703-004-5387,9872.983,5,3,2,1.1116008531760446
1364,703-004-5385,67.68644,4,1,3,0.3557651575727691
1366,703-004-5390,1528.7566,6,4,2,1.6248097503814611
13680,703-004-5396,5524.7114,3,1,2,0.35831143730785864
13786,703-004-5388,4606.9067,4,4,0,1.820324079703147
14170,703-004-5387,3503.092,3,3,0,2.0106448856601458
14301,703-004-5391,4761.3423,4,1,3,0.5362049512809903
14437,703-004-5398,114.43734,2,0,2,0.27920371738274696
15161,703-004-5384,4039.4927,6,2,4,2.9902624209963156
1546,703-004-5385,3704.803,4,2,2,1.308352199689593
15547,703-004-5387,9483.429,4,4,0,2.559258406001172
15778,703-004-5382,5817.194,6,3,3,2.029875180153539
16043,703-004-5387,5957.7803,4,3,1,1.3908975523702463
1626,703-004-5382,9151.265,4,1,3,0.3978652972704144
16329,703-004-5386,6191.2036,3,2,1,1.4130897104338662
16387,703-004-5384,993.31555,9,5,4,1.872179625218665
17019,703-004-5392,8330.157,3,1,2,0.41142150850670745
17277,703-004-5389,3965.7444,5,3,2,0.7552441550971226
17562,703-004-5384,115.5591,3,3,0,1.175947816421662
17821,703-004-5389,9951.398,1,1,0,0.9441331982272699
17865,703-004-5393,9083.462,4,3,1,1.2078047566355399
18357,703-004-5381,7190.7144,3,0,3,0.27920371738274696
18410,703-004-5398,8658.064,3,1,2,0.35831143730785864
18743,703-004-5398,9190.97,5,2,3,0.9703244995936806
18984,703-004-5388,3709.349,1,1,0,1.4936813532516982
19117,703-004-5380,836.1554,4,0,4,0.27920371738274696
19276,703-004-5382,2033.7909,1,0,1,0.27920371738274696
19555,703-004-5380,3326.404,1,1,0,0.44133836653395336
19670,703-004-5389,3304.7993,3,2,1,0.9838968868572565
19812,703-004-5380,3942.3447,6,3,3,5.2148138694449315
20089,703-004-5386,8949.043,7,5,2,2.668566059485502
20869,703-004-5383,5628.9263,2,2,0,0.5001805834992635
20879,703-004-5383,1626.8193,1,0,1,0.27920371738274696
20999,703-004-5398,1481.6606,1,0,1,0.27920371738274696
2114,703-004-5386,9558.709,5,4,1,1.6262396343526995
21307,703-004-5388,9276.541,3,1,2,0.3995303063517081
21546,207-008-2398,9617.078,2,1,1,0.3406017875612271
21657,207-008-2399,1628.2892,2,0,2,0.27920371738274696
21948,703-004-5399,4795.4272,3,3,0,1.5653891262238984
22591,703-004-5391,5224.096,2,1,1,0.3978652972704144
22599,703-004-5380,4767.0796,9,8,1,2.929396133133066
22619,703-004-5385,7101.606,2,1,1,0.42898451625378436
22664,703-004-5390,8032.947,2,2,0,1.3597254413919047
22717,703-004-5394,3122.8435,3,2,1,0.5399836255871497
22888,703-004-5387,8949.368,6,5,1,1.0836525802158588
23005,703-004-5396,9697.632,5,4,1,0.8026530760073636
23366,207-008-2399,5699.662,1,1,0,0.8452905679328522
23408,703-004-5381,4448.2915,4,3,1,1.2019140577085448
23650,703-004-5386,809.37683,3,3,0,1.9865571737401662
23695,703-004-5395,413.03098,"","","",0.27920371738274696
23835,703-004-5391,3349.5867,2,2,0,0.9531642842560525
24677,703-004-5386,7882.241,3,2,1,0.6023060268852686
2472,703-004-5394,2490.35,4,2,2,0.4612543544483439
24900,703-004-5399,4427.7896,4,2,2,0.5125270929600324
2499,703-004-5384,6532.649,3,2,1,0.8915418537456936
2515,207-008-2398,9408.007,4,2,2,1.1311932997738994
25363,703-004-5395,6361.035,2,2,0,1.3898299871403639
25460,703-004-5398,9821.214,5,2,3,0.7889248928400473
25474,703-004-5392,5281.5723,1,1,0,0.35831143730785864
25744,703-004-5382,8050.9077,"","","",0.27920371738274696
26402,703-004-5398,3928.3645,2,1,1,0.35590620541260554
2651,703-004-5382,7051.0947,3,2,1,1.0029513646487287
26584,703-004-5396,3963.3918,2,0,2,0.27920371738274696
26868,703-004-5388,15.919209,5,3,2,0.934710626528238
27132,207-008-2398,9570.543,2,2,0,0.4236954831988883
27174,703-004-5391,5274.1577,1,1,0,0.7992574119354321
27290,703-004-5394,6807.8213,3,3,0,0.9315715846603106
27654,703-004-5383,2023.958,2,1,1,0.5165268771580819
27848,703-004-5381,1847.7106,6,0,6,0.27920371738274696
27860,703-004-5388,7687.642,4,2,2,0.785093682459108
28073,703-004-5393,5417.3003,1,0,1,0.27920371738274696
28085,703-004-5382,9589.354,3,1,2,0.5963235897809345
28281,703-004-5388,4209.0376,1,0,1,0.27920371738274696
28660,703-004-5381,3356.6565,2,2,0,0.5006109572148828
28765,703-004-5380,1728.2903,9,5,4,2.1197776348335866
29054,703-004-5390,6301.678,3,0,3,0.27920371738274696
29145,703-004-5397,668.7808,4,2,2,0.8830767154820542
29152,703-004-5390,5883.196,3,2,1,0.8742388608993599
29192,703-004-5380,8368.914,4,2,2,0.6934395861016548
29249,703-004-5388,5995.176,6,2,4,1.1331750369283182
29363,703-004-5390,2105.961,7,4,3,1.6589716654365751
29467,703-004-5387,785.9957,4,1,3,1.1040676794636468
29532,703-004-5395,3567.3386,3,1,2,0.6341142786782636
2969,703-004-5386,1637.1763,5,1,4,0.8470475896122122
30076,207-008-2399,8552.383,2,2,0,0.7520173425386836
30118,703-004-5398,6369.052,8,5,3,2.310053295188986
30234,703-004-5384,6294.0776,4,0,4,0.27920371738274696
30402,703-004-5384,7319.523,5,3,2,0.8557197458347621
31080,703-004-5383,6015.215,5,4,1,1.3550965466198108
31115,703-004-5392,179.12328,8,3,5,0.5775530287285846
31128,207-008-2399,125.721695,3,2,1,0.8925279259854141
31216,703-004-5395,3123.2356,2,1,1,0.3766240504317727
31535,703-004-5398,1387.3607,3,3,0,0.9553489320271271
31809,703-004-5390,2653.5344,4,0,4,0.27920371738274696
31883,703-004-5394,9269.76,2,1,1,0.4961862966195591
31997,703-004-5394,7114.7188,3,2,1,0.7365863504887837
32005,703-004-5399,6.620288,6,3,3,1.2915259986725622
32230,703-004-5396,4929.8906,7,4,3,1.4961751647314923
32349,703-004-5399,11.985302,6,4,2,2.426448496810151
32356,207-008-2398,6280.102,7,3,4,1.3376770464678327
32464,703-004-5388,1411.6198,3,2,1,0.5674146023142977
32472,703-004-5395,4688.746,6,2,4,0.6111759565198932
32771,703-004-5392,6207.9985,6,2,4,0.7422251929023969
32826,703-004-5397,9682.829,3,0,3,0.27920371738274696
33079,703-004-5398,6897.204,4,1,3,0.32666834933781397
33119,703-004-5382,2225.0127,4,2,2,0.8429948023246745
33128,703-004-5397,4497.884,"","","",0.27920371738274696
33447,703-004-5399,2269.8796,2,1,1,0.8318530221121849
33536,703-004-5383,6609.5854,5,1,4,0.7608654995557472
33594,703-004-5381,4889.643,5,2,3,1.3574995753978731
33729,703-004-5390,4260.086,2,1,1,0.8879209846213211
3416,703-004-5394,4109.7754,3,1,2,0.8701625185324188
34240,703-004-5382,2152.4775,6,4,2,1.7671628127099932
34277,703-004-5389,9601.144,3,1,2,0.9435688450410569
34443,207-008-2398,2513.9695,"","","",0.27920371738274696
34487,703-004-5381,7918.922,3,1,2,0.449403590533461
34523,703-004-5387,6443.713,2,1,1,0.5165268771580819
34827,703-004-5383,5053.5996,2,1,1,0.4180377658513179
34952,703-004-5399,2290.5278,2,0,2,0.27920371738274696
34971,703-004-5398,4915.9355,6,3,3,4.275129962922632
35077,703-004-5394,708.07697,4,3,1,1.025262031668871
35122,703-004-5398,8571.0,4,3,1,0.7997463211873727
35188,703-004-5384,3365.2764,1,0,1,0.27920371738274696
35437,703-004-5392,1637.9332,4,1,3,0.6120919426240514
35635,703-004-5392,1278.0416,4,0,4,0.27920371738274696
35770,703-004-5392,1721.9877,3,2,1,0.8455587865327612
36175,703-004-5387,1954.478,1,1,0,1.938033762155181
36254,703-004-5393,3969.3796,5,3,2,0.9538465510465163
36295,703-004-5397,5359.1084,2,1,1,0.5210244249353605
36746,703-004-5392,3665.7185,3,2,1,0.8174073242099562
368,703-004-5397,1526.5966,5,2,3,2.0747808044470504
3680,703-004-5393,1336.9608,3,1,2,0.7048246663168914
36813,703-004-5381,6058.4067,3,1,2,0.8003894272551557
37108,207-008-2399,9570.624,4,2,2,0.9416167721713596
37243,703-004-5381,6364.497,6,2,4,0.4924336322083901
37425,703-004-5397,6004.8257,6,1,5,0.6602557157970191
37499,207-008-2399,2363.2915,4,1,3,0.5650353096171703
37533,703-004-5395,3375.0398,9,5,4,1.7223177472207505
37618,207-008-2398,8660.495,4,3,1,1.4408222643889663
37870,207-008-2399,8508.544,5,4,1,1.4789770088352576
38161,703-004-5399,1032.7882,2,2,0,0.8066021534348111
38230,703-004-5385,3641.2375,2,1,1,0.5774362899057784
38243,207-008-2398,9482.218,4,2,2,0.8325455486843005
38334,703-004-5384,4209.5386,4,0,4,0.27920371738274696
38358,703-004-5384,2278.7297,5,3,2,1.8530409600152453
38405,703-004-5386,5398.7017,5,4,1,1.5642415107645458
3845,207-008-2399,5314.242,4,1,3,0.4987276401749318
38552,703-004-5393,478.2975,4,2,2,0.47154293145366666
38622,703-004-5397,7017.5713,6,3,3,0.9923140491840475
38854,703-004-5385,8505.1455,6,3,3,1.979684988831182
38981,703-004-5394,1314.6353,5,2,3,1.0775088342799388
39258,703-004-5396,8681.832,4,3,1,1.6052438676702365
39490,703-004-5385,3330.4536,4,3,1,1.418655077384843
39527,703-004-5385,3388.915,4,3,1,1.394658476068594
39750,703-004-5395,9876.165,5,1,4,0.5739793613019754
40088,703-004-5397,7830.6816,4,1,3,0.5165268771580819
40126,703-004-5385,6834.635,7,3,4,1.0597089443207361
40295,207-008-2399,5921.2236,4,2,2,0.48933153833695175
40372,703-004-5389,4493.0835,3,1,2,0.7025615464606191
40540,703-004-5394,3961.8594,4,3,1,2.4121286095172416
40827,703-004-5388,3702.7585,2,2,0,1.6492799985473972
41178,703-004-5382,6863.2334,2,1,1,0.37512182779194486
41583,703-004-5392,3251.0615,2,2,0,0.8599268632038115
42008,703-004-5388,9327.025,4,1,3,0.6915771323664154
4206,703-004-5394,3301.139,2,0,2,0.27920371738274696
4227,703-004-5389,1571.3328,1,0,1,0.27920371738274696
42572,703-004-5381,7279.5605,3,2,1,0.5780836699688519
42824,703-004-5392,5327.67,6,2,4,0.7228230120720208
42839,703-004-5387,2381.9805,3,1,2,0.3804107659965474
42977,703-004-5388,2095.908,7,3,4,2.319792846697954
43015,703-004-5380,9220.673,7,4,3,1.2519486339859447
43019,703-004-5399,51.198006,4,2,2,0.7456902209180494
43088,703-004-5383,5273.003,5,5,0,2.1962569273497117
43457,703-004-5383,4465.167,5,1,4,0.4536275971022925
43685,703-004-5384,5452.0337,4,2,2,0.8255647269253907
43688,703-004-5396,8488.282,5,2,3,1.4732945475009531
44527,703-004-5380,8938.893,5,3,2,1.0616747016648234
44874,703-004-5394,3099.7617,6,2,4,0.5896255870305623
44915,703-004-5396,7092.865,6,0,6,0.27920371738274696
4501,703-004-5383,3833.3916,1,0,1,0.27920371738274696
45039,703-004-5383,5009.4385,4,3,1,3.583770182766877
45465,703-004-5397,2649.1855,3,2,1,1.3066279300966415
45510,703-004-5397,3326.7952,6,2,4,0.6575713224104532
45704,703-004-5382,1569.3605,8,2,6,0.7497897744080154
45810,703-004-5385,3651.0212,4,1,3,0.6025965079711609
45901,703-004-5387,2843.2483,1,0,1,0.27920371738274696
45931,703-004-5399,9428.492,1,0,1,0.27920371738274696
45973,703-004-5396,483.76797,3,1,2,0.3622851340020347
46777,703-004-5392,7258.744,2,2,0,1.495498709636744
4688,703-004-5390,2139.7031,6,3,3,0.7520044947261642
4695,703-004-5385,9666.331,6,2,4,0.7725634391348692
46982,703-004-5381,3433.3252,4,1,3,0.5563088151553611
47197,703-004-5385,6545.2563,6,3,3,1.5538704075821363
47347,703-004-5384,4505.5835,3,1,2,0.5469399430621418
47516,703-004-5399,6236.399,5,3,2,1.124826164493779
47694,703-004-5397,9536.892,2,0,2,0.27920371738274696
47759,703-004-5399,1785.5895,4,0,4,0.27920371738274696
47949,703-004-5392,3134.1404,2,2,0,1.3905601488558132
4795,703-004-5396,6362.178,4,2,2,0.949816294043026
48398,703-004-5383,5704.1484,2,2,0,2.6381446082733975
4849,703-004-5398,195.45078,4,3,1,0.9285698505284647
48563,703-004-5386,16.09087,4,3,1,1.5908996074573092
48611,703-004-5384,238.0085,3,0,3,0.27920371738274696
48631,703-004-5388,7233.8604,6,2,4,0.9051349057752635
48691,703-004-5387,7134.745,3,1,2,0.35831143730785864
48704,703-004-5381,1964.2174,6,3,3,2.9914663576466816
49141,703-004-5398,2527.9724,9,3,6,2.182972656958381
49890,703-004-5394,149.30606,4,1,3,0.5844229866129187
5157,703-004-5383,3052.4707,5,3,2,1.0089612424632541
5274,703-004-5383,3651.424,2,1,1,0.44541162524166134
5641,703-004-5396,7342.2754,5,3,2,1.7177145066290544
579,703-004-5393,8942.664,4,3,1,1.43277362819271
5897,703-004-5392,600.3374,6,5,1,1.6754496773784802
5993,703-004-5383,5799.7305,3,0,3,0.27920371738274696
6276,207-008-2399,4881.475,2,2,0,0.6103551154274248
6298,703-004-5384,7480.6055,1,0,1,0.27920371738274696
6467,703-004-5395,2784.2654,3,1,2,0.5278430423864637
6767,703-004-5383,8673.835,3,0,3,0.27920371738274696
7724,703-004-5391,2046.8086,3,2,1,1.017833169721601
7933,703-004-5397,6604.2695,2,2,0,0.5204269976222231
8037,703-004-5390,5850.1313,6,4,2,1.9970895734735914
8569,703-004-5381,2810.8096,5,2,3,0.4514904429146495
8678,703-004-5388,8793.181,3,2,1,4.330132256664645
8845,703-004-5386,8072.8105,6,3,3,2.165765097313976
9332,703-004-5391,8944.214,5,2,3,0.53883741044753
9399,703-004-5397,6598.957,4,4,0,1.9077567561805702
9432,207-008-2399,5786.5093,1,1,0,0.43170092969851387
9468,703-004-5395,3789.8577,4,2,2,2.264286115409813
9631,703-004-5385,8880.935,5,5,0,1.4393655012395075
9853,207-008-2399,9122.858,2,1,1,0.5667552032838696
10253,703-004-5380,3711.2212,2,1,1,0.33853450732658075
10259,703-004-5399,4394.7437,3,2,1,0.41987815339285695
10413,703-004-5395,7217.0107,2,1,1,0.42460472969839963
10486,703-004-5390,5675.0923,6,5,1,1.3992210896426278
10571,207-008-2398,2189.4414,3,2,1,0.6877658981094764
11043,703-004-5391,8168.0835,2,2,0,0.5011747777480058
11060,703-004-5392,1678.9812,8,4,4,0.9279360608969413
11065,703-004-5389,5354.758,6,2,4,0.6237210563754939
11208,207-008-2399,6880.9136,4,2,2,0.6085677325910924
11574,703-004-5391,2158.1472,5,2,3,0.3859991392816477
11638,703-004-5397,8764.002,1,0,1,0.27920371738274696
11682,703-004-5384,9665.418,4,1,3,0.588342896537679
11820,703-004-5394,7007.286,3,2,1,0.6539119852293446
11901,703-004-5388,2275.2463,4,1,3,1.947663791353969
12272,703-004-5380,1760.7803,5,1,4,0.4316047395525695
12515,703-004-5391,9502.428,4,1,3,0.48202707471774636
12784,703-004-5385,6366.902,6,3,3,1.0949699238638098
12894,703-004-5393,9358.871,5,4,1,2.834532335658685
13158,703-004-5394,3822.9507,3,2,1,0.6031064295525891
13392,703-004-5393,7075.436,5,2,3,0.5980976028099443
13498,703-004-5384,3428.9526,4,2,2,0.7456144689406656
13676,703-004-5391,6731.5825,2,0,2,0.27920371738274696
14077,703-004-5380,8723.198,3,3,0,0.7326260949085087
14156,703-004-5388,6195.696,4,1,3,0.38464771573292705
14189,703-004-5386,1873.6887,5,1,4,1.044516420137882
14357,703-004-5391,8764.923,3,3,0,0.8577228525843777
14414,703-004-5393,1492.4235,3,1,2,0.3919322182760311
14821,703-004-5397,6140.242,7,6,1,1.7726580710753939
14920,703-004-5391,9310.896,4,2,2,0.8936572564159356
15280,703-004-5392,3406.3,4,3,1,1.2911459317279907
15325,703-004-5399,9194.413,2,2,0,1.5787623656732177
1550,703-004-5394,442.52695,7,4,3,1.6534202891887053
15522,703-004-5380,7774.0283,5,4,1,1.573489712689289
1554,703-004-5399,235.30484,4,2,2,0.6616561678892792
15863,703-004-5392,3310.694,5,3,2,0.9247858443378038
15920,703-004-5398,457.81314,5,0,5,0.27920371738274696
15966,703-004-5392,7414.4487,5,2,3,2.272348791697334
16353,207-008-2399,4396.6953,6,0,6,0.27920371738274696
1663,703-004-5389,887.75696,8,2,6,0.7625561339805533
16863,703-004-5385,1766.2919,2,1,1,0.3416125195784045
17026,703-004-5396,9419.937,5,3,2,1.3596228646169148
17069,703-004-5384,7756.6284,6,1,5,0.49264777379114133
17400,703-004-5385,8970.819,2,0,2,0.27920371738274696
17408,703-004-5388,269.99295,4,2,2,0.7408112293757907
17636,703-004-5390,8979.015,4,4,0,1.5456768700164787
17681,703-004-5396,7268.671,3,2,1,0.45086746962023927
17722,703-004-5393,4307.562,11,6,5,2.31136175692009
17885,703-004-5380,2499.7402,4,1,3,0.46452021176129105
17938,703-004-5397,229.42365,5,3,2,0.6936622466903944
18010,703-004-5394,2059.449,6,2,4,0.9141914967566274
1809,703-004-5395,6928.4814,3,1,2,0.3978652972704144
18923,703-004-5384,9138.258,1,1,0,0.4314860782385869
1893,703-004-5392,7785.316,4,2,2,0.5886533775370095
19131,703-004-5398,6997.861,5,3,2,1.1110660627446918
19180,703-004-5388,8760.92,5,1,4,0.3978652972704144
19483,703-004-5387,76.76303,3,2,1,0.779574445619042
19524,703-004-5389,5220.8726,8,2,6,0.8958237118246739
19526,703-004-5393,4588.0083,1,0,1,0.27920371738274696
19628,703-004-5397,6054.753,8,5,3,2.2546524843986213
19746,703-004-5380,7265.183,4,4,0,1.8677273695552778
20067,703-004-5391,4152.5674,3,2,1,0.7474576301010418
20759,703-004-5384,4354.8906,7,4,3,0.9624614855582585
20786,703-004-5390,2380.8271,5,1,4,0.3468408179187174
20798,703-004-5383,3138.969,3,1,2,0.5590412199330227
21308,703-004-5397,4686.2417,1,1,0,0.9055931527324382
21409,703-004-5396,9444.806,1,1,0,0.35534489781066697
21933,703-004-5399,4799.6865,5,2,3,1.4124418306714013
21987,703-004-5386,7565.3555,4,0,4,0.27920371738274696
22250,703-004-5384,1631.2313,3,2,1,0.9859949004304309
22384,207-008-2399,8284.409,6,3,3,2.2441354078569744
22418,703-004-5399,4588.324,1,1,0,0.5507000578758696
22468,703-004-5382,3838.7842,4,1,3,0.5310334525883924
22986,703-004-5395,1178.053,4,2,2,0.7294932851826543
23085,703-004-5382,3357.218,9,4,5,1.0977631504153806
2334,703-004-5395,7086.1084,1,0,1,0.27920371738274696
23448,207-008-2399,3165.921,7,4,3,2.0094319631173545
23596,703-004-5380,8873.827,6,5,1,1.0041675375813321
23741,703-004-5397,1860.1632,2,0,2,0.27920371738274696
23892,703-004-5384,2218.9604,3,2,1,0.9542780939665603
24610,703-004-5389,5553.7734,5,4,1,0.8678370106782113
24620,703-004-5395,5697.8228,8,5,3,1.6436731894433056
24647,703-004-5396,6125.3906,5,2,3,0.5976122900813213
24909,703-004-5386,1334.824,4,3,1,1.0471512701335584
24953,703-004-5394,4001.7163,4,0,4,0.27920371738274696
24976,703-004-5380,9814.17,2,0,2,0.27920371738274696
25679,703-004-5386,367.55026,5,3,2,1.43861110786601
25908,703-004-5391,1427.8662,5,1,4,0.5666485234102153
25992,703-004-5388,532.74634,3,0,3,0.27920371738274696
26028,703-004-5396,6443.7964,1,0,1,0.27920371738274696
26225,703-004-5396,3811.1055,6,3,3,1.5865996515721916
26320,703-004-5387,9789.087,5,3,2,1.606958486963393
26426,703-004-5383,2132.4248,7,3,4,1.6191895167089352
26621,207-008-2399,9405.725,4,0,4,0.27920371738274696
26627,703-004-5393,6725.909,1,0,1,0.27920371738274696
27036,703-004-5388,2753.4353,7,4,3,1.4412366255343392
27255,207-008-2398,6271.645,3,2,1,0.5970201508034341
2751,703-004-5396,91.742874,4,1,3,0.416668227228821
27568,703-004-5390,2959.618,4,3,1,1.3240107635002925
27641,703-004-5387,4579.3994,2,0,2,0.27920371738274696
27667,703-004-5397,6635.832,3,2,1,0.7567694845499017
28374,703-004-5385,7716.5996,2,1,1,0.33853450732658075
28589,703-004-5386,7370.405,2,2,0,1.4255940693727247
28644,703-004-5389,4397.005,4,1,3,0.5165268771580819
2873,703-004-5384,2084.9216,1,1,0,0.33853450732658075
28893,703-004-5393,7383.8013,2,0,2,0.27920371738274696
29180,703-004-5384,8068.2944,5,3,2,1.0488620906928103
29430,703-004-5382,4487.5737,3,1,2,0.3403309117998801
29551,207-008-2398,8233.896,3,2,1,1.6551074954688136
2957,703-004-5393,3689.8428,2,2,0,0.5247705608052778
2965,703-004-5399,3898.53,4,3,1,1.4298427146769321
30091,703-004-5389,6065.922,4,2,2,0.7369792686988424
30426,703-004-5389,818.5756,6,3,3,1.3973135839848445
30565,703-004-5397,8135.574,3,0,3,0.27920371738274696
30584,703-004-5393,7988.1616,6,4,2,1.577570686439816
30837,703-004-5382,4672.378,8,4,4,1.074135123778824
30946,703-004-5392,9583.869,3,0,3,0.27920371738274696
31031,703-004-5387,4421.5093,5,4,1,1.2935039781650697
31130,703-004-5382,4178.439,7,3,4,1.8037770389971164
31173,207-008-2399,5990.2803,7,3,4,1.0909922469925006
31278,703-004-5391,3726.3538,7,1,6,0.84920905760739
31476,703-004-5384,9791.983,5,1,4,0.4287269527280686
31534,703-004-5385,2405.566,5,2,3,1.8865644402284338
31762,703-004-5392,5627.2734,4,2,2,0.7009523606400383
31845,703-004-5390,5632.756,7,3,4,0.9470653311666056
31974,703-004-5392,9394.198,2,1,1,0.35598567034206036
32061,703-004-5381,3597.986,5,2,3,0.45719608721424815
32317,703-004-5385,3255.7988,3,2,1,0.8031625354256688
32334,703-004-5383,5012.6743,5,1,4,0.6346401126581381
32342,703-004-5381,5787.5376,2,0,2,0.27920371738274696
32588,703-004-5386,9901.392,4,3,1,1.0336393589550423
32686,703-004-5389,6364.1978,2,1,1,0.5418630443947776
32700,703-004-5381,9321.445,6,3,3,0.9648624333790093
32824,703-004-5381,5742.625,4,0,4,0.27920371738274696
33032,703-004-5394,7395.0415,3,1,2,0.5669580486103406
33114,703-004-5385,8973.732,2,1,1,0.47751908010367106
33137,703-004-5396,440.1219,2,1,1,0.329176958730082
33207,703-004-5390,4759.5356,5,3,2,0.6971054268926906
33250,703-004-5391,7010.323,3,2,1,1.27476184891903
34179,703-004-5388,619.4681,5,4,1,0.9955292941666816
34805,703-004-5397,1522.37,4,3,1,0.8587937323662714
34939,703-004-5392,2445.104,5,4,1,1.2209630642003981
34945,703-004-5389,6083.7437,3,1,2,0.4546005856217786
35128,703-004-5385,183.2205,2,1,1,0.5416169078157816
35651,703-004-5386,3672.6843,2,1,1,0.6341116584434696
36255,703-004-5382,9942.03,4,2,2,1.21348911440297
36323,703-004-5394,9073.103,4,1,3,0.6361907983491313
36472,703-004-5398,8983.53,7,4,3,0.9883548763901533
36546,703-004-5389,5131.487,3,1,2,0.48865645171958855
36594,703-004-5398,3592.454,2,2,0,0.6799795776375251
36688,703-004-5392,7393.523,5,3,2,2.2941180784759476
36924,703-004-5397,2166.6462,2,0,2,0.27920371738274696
36942,703-004-5380,4114.595,5,2,3,0.669454623788913
3712,703-004-5393,6758.0527,8,5,3,2.6502489386813575
3760,703-004-5386,3816.3303,6,1,5,0.3978652972704144
37770,703-004-5384,6111.2334,4,2,2,0.5675340904610598
37803,703-004-5387,4002.5586,3,1,2,0.5878734246225262
37894,703-004-5395,2161.9558,4,2,2,0.9610377153450245
38048,703-004-5390,2869.3384,2,2,0,1.0466066968032088
38062,703-004-5382,3417.052,4,3,1,0.8100814311604738
38076,703-004-5380,4341.914,4,0,4,0.27920371738274696
38166,703-004-5384,3208.48,1,0,1,0.27920371738274696
38169,207-008-2398,5335.1665,6,3,3,0.9158923580136329
38306,703-004-5399,3067.7407,5,3,2,1.1023744392714676
38653,703-004-5392,5820.1333,4,3,1,1.0882876208698447
38705,703-004-5397,5284.127,2,1,1,0.3978652972704144
38850,703-004-5386,6043.9062,3,1,2,0.3680814154936112
39090,703-004-5392,1377.371,1,1,0,3.1057374506167106
39158,703-004-5397,1818.1211,1,1,0,0.4819673607652222
39574,703-004-5399,8596.152,3,2,1,0.4286843464912392
3980,703-004-5389,1178.4786,2,0,2,0.27920371738274696
39861,703-004-5380,1997.109,7,4,3,2.364800697871186
39888,703-004-5384,4263.258,7,4,3,1.5539130546373063
39995,207-008-2398,8617.487,3,2,1,0.9271371449503306
4009,703-004-5396,5270.373,6,4,2,3.3767307972408855
4021,703-004-5389,7290.3506,2,0,2,0.27920371738274696
40259,703-004-5392,1249.2902,8,4,4,2.0131471654540976
40830,703-004-5396,6827.951,7,4,3,1.4631795021302079
4107,703-004-5395,8652.605,3,1,2,0.6173892200625992
4146,703-004-5397,6900.5635,4,3,1,1.114961013384221
4158,703-004-5394,1263.3794,8,3,5,1.2333023335357596
41650,207-008-2398,3984.047,7,5,2,2.2030098607630397
41700,703-004-5389,4648.5234,4,4,0,3.7884282332667953
41784,703-004-5397,4930.2095,2,1,1,0.8673794100234968
41925,703-004-5399,1565.8331,6,5,1,1.3558557559538797
42714,703-004-5388,5550.0425,3,1,2,0.5901647540530284
42995,703-004-5384,1851.7965,8,2,6,1.2673345352612428
43183,703-004-5386,238.49368,4,1,3,0.7699425374993698
43603,703-004-5395,227.05376,2,0,2,0.27920371738274696
43891,703-004-5397,5293.1885,5,2,3,1.0132930354492014
43970,207-008-2398,3959.5425,12,5,7,1.4056906029813787
44479,703-004-5398,4615.3784,4,2,2,1.0736882311176763
44909,703-004-5382,1555.0333,4,3,1,1.8895055184056957
44999,703-004-5390,6869.5767,2,1,1,1.3478229076194737
45438,703-004-5393,5908.968,3,1,2,0.3187575773453028
45450,703-004-5385,569.3549,4,2,2,0.6628761590195384
45688,703-004-5386,1300.1979,3,1,2,0.4531934213037653
45728,207-008-2398,8045.552,2,1,1,0.4972693256158173
4606,703-004-5393,6234.1167,1,0,1,0.27920371738274696
46164,703-004-5393,4337.8613,7,6,1,4.2476589645249465
47042,703-004-5394,7044.01,5,3,2,1.2757490220685817
47375,703-004-5398,700.50775,10,3,7,2.3223755391087404
4756,703-004-5383,27.214886,1,1,0,0.5906149806262403
47770,703-004-5396,2302.8784,4,1,3,0.5466368341654244
47776,703-004-5390,4033.0051,1,1,0,2.602454758801266
47818,703-004-5388,6199.1333,1,1,0,0.6094009791831497
47979,703-004-5399,5593.01,1,0,1,0.27920371738274696
48870,703-004-5389,2510.454,5,3,2,1.3352264494443207
49373,703-004-5387,3262.5706,6,5,1,1.4983796474597402
49500,703-004-5391,9082.23,6,2,4,1.3147767066857365
49600,703-004-5393,9442.891,4,3,1,0.9466430443742804
49703,703-004-5383,5016.8594,6,5,1,2.143802916032794
5063,703-004-5396,6194.3525,3,2,1,0.8837594545812149
5243,703-004-5391,4077.7356,3,1,2,0.8815853356444734
5340,703-004-5392,2889.9873,7,3,4,1.8341148812889563
5690,703-004-5386,9405.904,7,4,3,2.285144060732391
6015,703-004-5399,3237.0566,3,1,2,0.3271627725873459
6417,207-008-2398,6304.3184,2,1,1,0.43269741519994015
7542,703-004-5388,2110.9294,4,3,1,1.0792628711768772
8084,703-004-5387,3671.1807,4,3,1,1.4049007936258595
8125,703-004-5380,4199.676,4,0,4,0.27920371738274696
8187,703-004-5385,1007.337,2,1,1,0.5288988149529856
8480,703-004-5396,5816.4966,5,4,1,1.5207775132765688
8526,703-004-5397,3530.5447,9,4,5,2.9884425445705616
8703,703-004-5391,3502.5793,5,2,3,0.8712297974072807
8885,703-004-5393,4363.8804,3,1,2,0.6041743660034314
9279,703-004-5382,4161.0186,7,5,2,3.8635693661620625
9347,703-004-5397,9212.855,8,4,4,1.1679661073346896
9403,703-004-5395,1198.5314,3,0,3,0.27920371738274696
9480,703-004-5393,533.815,2,0,2,0.27920371738274696
10073,703-004-5381,4394.366,4,1,3,0.712975199669364
10076,703-004-5381,9487.401,2,0,2,0.27920371738274696
10116,703-004-5393,3495.9478,3,3,0,0.6520793611056898
10214,703-004-5396,7096.924,2,1,1,0.3978652972704144
10428,703-004-5397,7494.633,4,1,3,0.5899449915709938
10441,703-004-5383,5112.933,4,2,2,0.6800420745475881
10448,703-004-5380,2900.97,6,5,1,4.0175260688863546
11012,703-004-5386,4355.144,"","","",0.27920371738274696
11057,703-004-5393,2241.2883,5,4,1,1.2093239663438118
11131,703-004-5383,9349.812,6,5,1,1.6255785757653103
11178,703-004-5392,5732.7275,3,2,1,0.47978311048373085
11805,703-004-5382,484.94577,3,1,2,1.2988091681019844
12060,703-004-5384,1687.4062,3,1,2,0.4917931362750305
1228,703-004-5388,7926.985,2,1,1,0.6268306964660546
12392,703-004-5391,6250.7373,3,3,0,1.3692235592992987
1278,703-004-5383,917.8048,3,2,1,0.6137358151050112
13648,703-004-5390,481.49048,5,2,3,0.6944427117815656
1387,703-004-5392,2020.759,1,1,0,0.5841992979144471
14050,703-004-5394,9193.819,4,1,3,0.6961649903236167
14429,703-004-5393,4882.3677,5,4,1,1.0056904107151836
14892,703-004-5381,2449.3193,5,4,1,1.7619208848965764
15051,703-004-5395,1259.9409,4,2,2,1.2582737833576492
15374,703-004-5389,5012.657,7,1,6,0.4818586619822687
15392,207-008-2399,9234.799,6,3,3,0.6949177574996727
15703,703-004-5388,854.53394,4,2,2,1.0478505810560583
16316,703-004-5389,9739.181,7,3,4,0.8347557523249821
1637,703-004-5396,557.6688,2,1,1,0.48959308829246373
1641,207-008-2398,3078.0918,3,1,2,0.819580227435495
16536,703-004-5391,2277.1465,1,0,1,0.27920371738274696
17332,703-004-5394,8971.669,1,0,1,0.27920371738274696
17505,703-004-5385,1829.015,4,1,3,0.4234219423508295
18144,703-004-5397,9530.703,5,4,1,1.4181552859856552
18610,703-004-5392,7836.3027,1,0,1,0.27920371738274696
18667,703-004-5393,8267.341,6,3,3,0.8401413852507895
18962,703-004-5380,6371.09,3,1,2,0.32666834933781397
1930,703-004-5388,8392.197,5,2,3,1.1418548579343337
19597,703-004-5388,6540.0,3,3,0,1.518085028017738
19653,703-004-5383,7103.899,5,1,4,1.3238309058440483
20170,703-004-5398,5961.7334,3,2,1,0.8884893478170818
20489,703-004-5380,4162.3677,6,3,3,1.9770012599656879
20560,703-004-5398,7690.7476,4,3,1,1.4179996958411456
20585,703-004-5385,3459.4805,9,9,0,5.273279499585563
20619,703-004-5396,4637.645,4,2,2,0.7044419154743056
20706,703-004-5398,8776.233,3,3,0,2.3526614152302
20912,703-004-5388,5878.142,1,1,0,0.8996424324431791
21229,703-004-5394,9944.636,8,3,5,0.6691549753910736
21397,703-004-5393,6781.429,2,1,1,0.6589823946245634
214,703-004-5383,7706.235,3,1,2,0.39390635760705284
21481,703-004-5397,9302.589,3,0,3,0.27920371738274696
21527,703-004-5396,6404.9995,8,6,2,2.9852113107540688
21782,703-004-5395,887.5865,3,2,1,0.68529001299832
21788,703-004-5395,1885.1351,5,1,4,0.5613086348473199
21944,703-004-5397,8282.257,1,1,0,0.6355098597903098
22089,703-004-5386,415.64108,5,4,1,1.2496482038234697
22108,703-004-5382,2376.0342,4,3,1,1.960014976647189
22215,703-004-5396,6621.0903,3,2,1,1.1097098633722757
22287,703-004-5387,9123.996,"","","",0.27920371738274696
22618,703-004-5390,505.81516,5,3,2,0.8848802919435266
22699,703-004-5386,5483.691,5,4,1,2.0325503419989044
22708,703-004-5388,2534.51,3,2,1,0.9674965482972285
22947,703-004-5391,2745.9382,4,3,1,1.0163600001462112
22953,703-004-5393,7101.1396,5,3,2,0.667368494281284
23045,207-008-2398,722.44824,3,2,1,1.060943122525547
23121,703-004-5396,7017.528,2,2,0,1.7410897097003386
23286,703-004-5390,7496.1885,1,1,0,0.5318237625384655
23333,703-004-5382,3608.5283,5,4,1,1.5880940912706722
23654,703-004-5380,3343.5117,4,1,3,0.6320452274475946
23700,703-004-5385,2898.7585,3,2,1,1.0392175380143602
2377,703-004-5392,557.07635,3,1,2,0.4122543931859086
24062,703-004-5385,2672.621,7,1,6,2.611115495299449
24265,703-004-5389,1909.6917,4,1,3,0.35831143730785864
24761,703-004-5396,5158.2573,2,0,2,0.27920371738274696
24806,703-004-5386,5762.997,2,0,2,0.27920371738274696
25103,703-004-5383,5653.127,3,2,1,3.0026633395265128
25148,703-004-5396,4199.5,3,1,2,0.5754501585311356
25340,703-004-5380,3292.3413,5,2,3,1.00273277225952
25599,703-004-5386,1511.522,3,2,1,2.7350428984079636
25859,703-004-5385,8356.356,4,0,4,0.27920371738274696
25971,703-004-5388,1691.6263,3,2,1,0.5411300508390348
26130,703-004-5389,5100.2812,7,5,2,1.5753678593624756
26184,703-004-5384,203.41635,4,2,2,1.58582248618968
26488,703-004-5397,7316.9907,2,1,1,0.48715999022307005
26796,703-004-5391,5842.145,1,1,0,0.44361890467738174
26816,703-004-5392,3863.843,2,1,1,0.3978652972704144
26907,703-004-5385,5558.983,3,1,2,0.9369268299279193
2693,207-008-2398,7284.6157,4,3,1,1.0680871427098004
27366,703-004-5382,1651.4987,5,2,3,1.1887325454065767
28030,703-004-5398,9648.883,3,2,1,1.520108879464715
28129,703-004-5390,6979.047,8,4,4,2.6438871428312627
28256,703-004-5381,3062.1838,4,2,2,0.47400647769833437
28284,703-004-5391,2761.3562,4,2,2,1.0351852981590044
28370,703-004-5385,8273.631,2,1,1,0.9674633243336244
28394,207-008-2399,6661.699,4,1,3,1.2881019635891633
28692,703-004-5397,7883.558,2,1,1,0.5884581771185176
29141,703-004-5389,5281.6963,5,0,5,0.27920371738274696
29405,703-004-5399,3173.5127,3,2,1,0.8126410583591305
29412,703-004-5382,6189.5986,5,2,3,0.6565038656519263
29480,703-004-5394,1207.7158,6,5,1,2.787313928937776
29570,703-004-5394,1059.8951,4,3,1,1.0502065276656192
29611,703-004-5389,9652.257,2,2,0,0.4160422530152382
29794,703-004-5387,5990.577,6,2,4,0.845203855890063
29944,703-004-5382,9833.406,5,3,2,0.7226720893296952
30082,207-008-2398,1858.4407,2,0,2,0.27920371738274696
30227,703-004-5382,6754.405,6,2,4,0.5758576671019155
30244,703-004-5382,5957.004,2,2,0,0.4945638891139464
3031,703-004-5386,7613.433,6,4,2,1.6860899757690797
30437,207-008-2398,4523.7036,2,0,2,0.27920371738274696
30724,703-004-5398,9258.317,5,2,3,0.7326683941697102
30954,703-004-5394,7543.6196,6,4,2,1.3824459483492353
30970,703-004-5381,9809.337,3,2,1,0.4952502242284789
3110,703-004-5382,5182.3203,6,2,4,0.7269454450660483
31183,703-004-5387,621.3665,2,1,1,0.35831143730785864
31283,703-004-5397,3950.5137,5,2,3,1.3483748203298633
31389,703-004-5388,6969.013,3,0,3,0.27920371738274696
31549,703-004-5385,4480.6987,2,0,2,0.27920371738274696
31699,703-004-5386,9322.405,4,1,3,0.4163238450191437
32187,703-004-5392,7736.44,5,3,2,1.0554916526592313
32302,703-004-5396,938.25995,2,0,2,0.27920371738274696
32346,703-004-5386,10.887384,3,1,2,0.32666834933781397
33172,703-004-5384,2589.969,1,0,1,0.27920371738274696
3328,703-004-5384,8808.204,3,2,1,0.6588861651749153
33331,703-004-5382,1903.8188,5,2,3,0.5499239728201774
33491,703-004-5382,5229.8564,4,1,3,0.6273763371173118
33727,703-004-5391,4942.005,5,2,3,0.7791138151229946
3373,703-004-5385,8778.644,6,1,5,0.47247051961951536
33737,703-004-5393,4878.5894,2,2,0,0.5978483607021977
33966,703-004-5397,924.5318,4,0,4,0.27920371738274696
34319,703-004-5395,3845.4038,5,3,2,0.7620775637610274
34461,703-004-5392,7237.219,3,0,3,0.27920371738274696
34784,703-004-5389,6118.25,4,3,1,1.0255316541415576
34812,703-004-5399,6082.483,6,1,5,0.47346261212384927
34969,703-004-5387,2605.1313,3,3,0,0.8324734485217273
35475,703-004-5397,744.92993,2,1,1,0.3978652972704144
35682,703-004-5392,618.39996,3,1,2,0.6561786164290061
35788,703-004-5380,3616.785,3,2,1,1.2625132765577254
35896,703-004-5381,7482.6787,4,3,1,2.2810688128701804
35946,703-004-5382,5765.0166,1,1,0,1.1425136864615808
36136,207-008-2398,1787.5004,3,1,2,0.5837684390944268
36359,703-004-5380,9319.834,5,3,2,0.9893451953249213
3665,703-004-5390,4330.807,1,1,0,0.4046334021973407
36850,703-004-5383,9098.245,5,2,3,0.5024358145464214
3692,703-004-5392,5857.6714,3,0,3,0.27920371738274696
37674,703-004-5385,4235.245,3,2,1,0.9651064771632923
37734,703-004-5392,9979.8545,2,2,0,0.9566971217449197
3793,703-004-5394,2349.4165,11,7,4,1.8866593933195985
3823,703-004-5388,3794.9062,7,4,3,2.2473897249734214
38388,703-004-5387,6251.3047,3,1,2,0.3884965200629352
38500,703-004-5393,6621.717,5,5,0,2.3245055591995034
38889,703-004-5383,3302.632,9,5,4,2.0704830359168698
38923,703-004-5394,7962.838,3,0,3,0.27920371738274696
39137,703-004-5391,4670.5947,9,5,4,2.0695182350876404
39220,703-004-5382,2541.054,2,1,1,0.7570638546820203
39412,703-004-5399,6097.436,3,2,1,1.139954224180326
39605,703-004-5398,1353.2365,2,1,1,0.39405506899598897
40263,703-004-5398,5565.877,5,3,2,0.8987614359331964
40385,703-004-5393,9271.177,3,2,1,0.47042685337172313
40457,703-004-5385,9277.822,6,5,1,3.849650241308105
40669,703-004-5396,1557.7817,5,4,1,1.008585038320677
40801,703-004-5395,8944.726,3,1,2,0.9949928945895397
40934,703-004-5395,7931.4814,6,4,2,1.6080938415892505
41008,703-004-5392,875.76447,2,2,0,0.7209734887202293
41436,703-004-5396,1343.1758,1,0,1,0.27920371738274696
4151,703-004-5380,6355.433,2,1,1,0.559081862327058
41519,703-004-5397,8586.743,2,2,0,0.9898373199398484
41611,703-004-5396,2658.6968,5,2,3,0.5181918862393756
4167,703-004-5396,747.8863,5,2,3,0.9434742680815329
42023,703-004-5392,2150.6245,3,1,2,0.4608864585692936
42048,703-004-5399,3440.4517,3,2,1,1.8646905436851982
42346,703-004-5393,2661.6877,5,0,5,0.27920371738274696
42353,703-004-5384,3894.8196,2,1,1,0.5165268771580819
42600,703-004-5386,444.8658,6,3,3,0.8366082485175729
42791,703-004-5399,1367.7817,6,3,3,0.9414226768985183
43076,703-004-5385,772.4827,4,2,2,1.1650573079206266
43078,703-004-5391,3528.717,3,1,2,0.3899860000121432
43208,703-004-5383,7321.8667,5,2,3,1.698232355026461
43317,703-004-5391,8421.851,4,1,3,0.6345358183563671
43386,703-004-5392,4311.468,3,2,1,1.365661428414113
43774,703-004-5385,3743.6729,4,2,2,0.9818742579617411
4390,703-004-5383,454.9426,9,4,5,1.6242226074297994
43903,207-008-2399,1302.7388,"","","",0.27920371738274696
44141,703-004-5387,1661.1677,3,3,0,1.8743745258872235
44369,703-004-5387,6282.949,7,3,4,0.6801496763069865
44686,703-004-5397,4310.8193,4,3,1,1.8087880787649344
44691,703-004-5398,7398.4985,8,6,2,3.2965114242107685
44916,703-004-5383,6279.6353,1,1,0,0.37515714373834
44930,703-004-5383,5011.375,3,1,2,0.9870623664359051
44949,703-004-5397,7595.268,6,5,1,2.924323252603241
4506,703-004-5399,7126.661,7,4,3,2.197497947518271
4508,703-004-5391,6547.8574,3,2,1,1.3024429235496824
45271,703-004-5399,7103.3022,4,3,1,1.0639820032316207
4548,703-004-5384,1286.5824,1,1,0,0.4328868395513231
45589,703-004-5386,2685.2285,6,4,2,1.0783773476014835
45596,703-004-5389,9803.574,3,0,3,0.27920371738274696
45637,703-004-5399,9394.984,3,3,0,1.180553651874894
45644,703-004-5398,4913.8457,5,3,2,1.8921805109084706
45799,207-008-2399,5641.424,2,1,1,0.35831143730785864
45961,703-004-5396,1330.6886,2,2,0,1.2089057727503105
45969,703-004-5383,1374.9933,4,1,3,1.6813791146149288
46085,703-004-5386,5457.849,"","","",0.27920371738274696
46086,207-008-2398,6174.016,4,3,1,1.5911289025447894
46150,703-004-5381,8598.165,6,3,3,1.1785634963700418
46315,703-004-5398,85.47306,8,5,3,2.5596970425907117
46567,207-008-2398,8031.317,4,2,2,0.8875217933541377
46627,703-004-5397,5452.1714,6,2,4,1.0112681449979808
46963,207-008-2399,8735.985,2,1,1,0.5521798865238298
46977,703-004-5398,593.0162,8,4,4,1.6514528539587099
47443,703-004-5389,9010.198,2,1,1,0.3919322182760311
47506,703-004-5397,3497.0742,4,2,2,0.9805926481408479
4806,703-004-5391,7368.479,4,2,2,1.77788011333248
48080,703-004-5386,9679.907,7,4,3,1.1200545946482297
48167,703-004-5398,2030.2576,4,1,3,0.7041145557224697
48207,207-008-2399,5355.853,5,3,2,1.0021758646022048
48710,703-004-5380,9771.589,3,1,2,1.2904558867637475
4878,703-004-5389,4122.295,7,4,3,1.3765778418028667
49075,703-004-5387,1498.6503,2,2,0,1.8495067113493073
49207,703-004-5390,656.67865,1,0,1,0.27920371738274696
49369,703-004-5382,263.11755,3,3,0,0.548413550982396
49376,703-004-5380,7050.1035,4,3,1,1.2209455557622455
49453,703-004-5395,5428.9536,1,1,0,1.1783057985276972
5008,703-004-5385,1290.1581,5,4,1,1.1623637263304367
5027,703-004-5396,6912.1313,2,2,0,1.117692442681706
5037,703-004-5385,8470.688,5,2,3,0.4939482707046821
5256,703-004-5391,4226.1147,3,2,1,0.6790216067354432
527,703-004-5397,3903.194,5,2,3,0.6879613683816155
560,703-004-5393,5947.785,8,5,3,2.2976455583859097
5647,703-004-5396,4888.481,2,2,0,1.2617435234284498
6079,703-004-5393,237.73015,4,1,3,0.3647043611347744
6498,703-004-5382,4831.665,6,3,3,1.0874692182123518
656,703-004-5395,1131.0846,2,1,1,0.4987276401749318
6604,703-004-5381,9186.219,7,3,4,0.7261485503501282
6608,703-004-5394,7321.729,5,2,3,1.3558363761711518
6675,703-004-5387,9558.736,4,1,3,0.35831143730785864
6917,703-004-5390,8581.787,6,5,1,1.4934638593217036
7227,703-004-5386,7438.381,4,3,1,1.3627538114858118
7255,703-004-5384,1766.5249,7,4,3,1.5731619933679584
7329,703-004-5392,3384.7659,5,5,0,1.4066325004494313
7499,703-004-5382,6601.693,3,2,1,0.47019609067300144
7556,703-004-5399,3444.9429,2,1,1,0.6849836147903915
7562,703-004-5381,4636.082,1,0,1,0.27920371738274696
7699,703-004-5395,3220.2517,3,3,0,2.8769094639804598
7922,703-004-5391,4148.9355,4,3,1,1.3640072755966814
8161,703-004-5390,9402.664,1,0,1,0.27920371738274696
8223,703-004-5384,8720.282,4,3,1,1.580918883155918
8780,703-004-5382,4568.9385,5,2,3,1.199984452699482
8810,703-004-5387,3654.1194,3,1,2,0.8784620292503528
9137,703-004-5393,2927.909,4,2,2,1.0404635817330996
9138,703-004-5380,9525.12,5,4,1,0.961738233700895
9165,207-008-2398,499.80997,4,0,4,0.27920371738274696
9295,703-004-5399,9294.589,2,2,0,2.123838030381024
9497,703-004-5385,4574.118,3,2,1,1.228298200117347
9561,703-004-5390,7978.48,4,2,2,0.6115608271827488
9735,703-004-5392,2090.3884,7,4,3,1.254651753211693
10156,703-004-5392,6123.519,2,1,1,0.4088464757028087
10732,703-004-5381,7943.944,5,2,3,0.795565123963188
10887,703-004-5398,7799.5454,1,0,1,0.27920371738274696
10893,703-004-5380,382.17484,4,2,2,1.206297830600098
11107,703-004-5384,7981.1514,2,2,0,0.7839185396613475
11858,703-004-5391,9080.228,4,2,2,1.1015401733659997
11974,703-004-5399,972.8694,1,1,0,0.3978652972704144
12200,703-004-5383,609.3198,4,0,4,0.27920371738274696
12443,703-004-5397,5761.7856,2,1,1,0.5165268771580819
12541,703-004-5385,4121.6934,4,1,3,1.4983541613691806
1260,703-004-5399,1174.1632,5,3,2,1.6976674170936545
12638,703-004-5390,7406.615,6,2,4,2.2129147953737025
13101,703-004-5391,4737.9614,5,3,2,1.1155174212285763
13127,207-008-2398,438.7486,2,2,0,0.812926304568318
13296,703-004-5386,529.6713,2,0,2,0.27920371738274696
13332,703-004-5390,2334.4053,6,5,1,1.2895062902312933
13996,703-004-5382,5239.1416,1,0,1,0.27920371738274696
14075,703-004-5398,7832.7803,1,1,0,0.3914907213872841
14949,703-004-5394,3599.9995,4,2,2,0.7960438049275874
15527,703-004-5392,5458.9673,8,6,2,1.48982824463326
15655,703-004-5386,8499.849,6,4,2,0.9968033356549645
15731,703-004-5397,645.85803,4,2,2,1.1197521802364276
15787,703-004-5388,5466.8345,4,1,3,0.35831143730785864
15854,703-004-5386,2346.717,5,1,4,0.5936974062498113
15879,703-004-5396,4569.7827,6,2,4,1.1937431067903659
1593,703-004-5394,5896.7983,1,0,1,0.27920371738274696
15944,703-004-5398,6239.86,4,1,3,0.45869254118156
15992,703-004-5395,9891.367,10,5,5,1.8868963681995043
15994,703-004-5396,9674.53,5,2,3,0.8362148142863284
16055,703-004-5396,5332.3525,5,5,0,2.9570341200439554
16069,703-004-5388,1689.0496,5,2,3,0.7768360031920569
16580,703-004-5387,209.41615,4,2,2,1.4672660003627298
16723,703-004-5398,8840.817,3,1,2,0.5442171742959881
17038,703-004-5388,3767.1829,4,3,1,0.6640588915638329
17263,207-008-2398,4137.7134,4,2,2,0.6329812664843245
17443,207-008-2398,1311.5967,3,1,2,0.3457389603911891
17859,703-004-5399,2003.1786,4,2,2,0.9355755162636796
179,703-004-5399,650.68665,3,1,2,0.7176962013653807
18055,703-004-5386,9185.617,3,3,0,3.410793496829715
18067,703-004-5384,8931.899,4,2,2,0.7494260002110683
18078,703-004-5393,3165.31,3,3,0,0.6933189418157928
18383,703-004-5393,473.45102,4,2,2,1.2822365881149362
1909,703-004-5383,1064.5461,1,0,1,0.27920371738274696
19221,703-004-5381,3687.9539,6,4,2,1.5419376185356237
19656,703-004-5398,3646.887,4,1,3,0.9339934028197201
19678,703-004-5387,39.678215,4,3,1,0.9243952068988184
19774,703-004-5395,2695.049,"","","",0.27920371738274696
19810,703-004-5397,4091.423,1,1,0,0.4462858141745765
20132,703-004-5382,2143.4832,5,4,1,2.018854243501027
20164,703-004-5398,1569.4719,4,3,1,1.339442124718083
20192,703-004-5392,4580.248,6,4,2,1.2589903493087027
20239,703-004-5385,81.24769,6,4,2,0.9815990420137163
20333,703-004-5390,6671.4395,6,2,4,1.0145207652463994
20423,703-004-5388,9405.505,3,1,2,0.36795269067373165
20427,703-004-5391,5850.739,6,3,3,1.559781343511904
20442,703-004-5388,146.12674,3,1,2,0.35831143730785864
20464,703-004-5380,9571.346,2,1,1,0.7428869610286278
20482,703-004-5385,897.01294,4,0,4,0.27920371738274696
20528,703-004-5393,5029.4595,6,4,2,1.5132072458049561
21075,703-004-5386,9779.595,2,1,1,0.4410119661795691
21081,703-004-5396,4164.5024,4,2,2,0.5299211012441496
21102,703-004-5394,8530.308,4,1,3,0.9348844814719091
21103,207-008-2399,2211.324,5,3,2,0.6525471776285441
21709,703-004-5399,7335.983,4,3,1,1.2206307389822164
21770,207-008-2398,4276.205,3,1,2,0.9339934028197201
22118,703-004-5392,469.64584,5,4,1,1.7841391940780895
22146,703-004-5383,3421.8352,5,3,2,0.8517615036783736
22354,703-004-5385,563.73956,3,2,1,2.9280617657256367
22555,703-004-5387,2067.473,3,2,1,1.2862143098638963
22605,703-004-5389,4578.881,"","","",0.27920371738274696
23031,703-004-5387,9846.809,5,0,5,0.27920371738274696
23316,703-004-5386,1549.1521,6,5,1,1.6382047648931986
23576,703-004-5392,5556.5493,4,1,3,0.4600637420615335
23790,703-004-5391,841.5067,6,2,4,1.140623873772505
23938,703-004-5394,2651.9792,2,2,0,2.0581929922549
24054,703-004-5392,577.1798,2,1,1,0.5443967741125753
24110,703-004-5387,3974.2236,3,3,0,1.106273383140338
24224,703-004-5389,8921.099,2,1,1,0.9203297949276431
24307,703-004-5388,2363.3135,4,3,1,1.2141009377516023
24371,703-004-5388,5638.452,4,1,3,0.5562168913916247
24424,703-004-5398,8302.196,3,1,2,1.288260958667659
24587,703-004-5391,5377.72,5,5,0,1.3020829899682285
24594,703-004-5392,7440.7524,2,2,0,1.4477402758575437
24832,703-004-5382,2181.8005,1,0,1,0.27920371738274696
25194,703-004-5390,3989.2454,6,3,3,1.2680848838043581
2521,703-004-5399,7168.8433,4,3,1,1.3632925199211976
25283,703-004-5381,7097.5254,2,1,1,0.6296691508941855
25304,703-004-5385,2583.7583,3,1,2,0.4323363515511755
25381,703-004-5387,6370.1655,5,3,2,1.052059178135173
25524,703-004-5393,2948.2043,6,4,2,2.4824589134771142
25797,703-004-5394,9968.326,4,1,3,0.35216515830407125
25860,703-004-5396,4119.8667,9,4,5,1.4421124065116278
26002,703-004-5393,8665.446,6,4,2,1.2137354261304238
26321,207-008-2398,7765.7773,5,3,2,1.6460885459603456
26464,703-004-5387,1427.3357,4,0,4,0.27920371738274696
26598,703-004-5383,3449.9402,2,1,1,0.6756886313287686
267,703-004-5383,529.73035,4,1,3,0.5415941359093517
27131,703-004-5392,4186.8135,5,5,0,2.374795185143056
27336,207-008-2398,5685.2954,4,1,3,0.6745477163447805
27392,703-004-5395,4885.4004,6,3,3,1.802299713756088
27986,703-004-5382,6697.7334,1,1,0,0.5370197745607886
28471,703-004-5386,7788.007,4,1,3,1.0944456483547063
28611,703-004-5399,9756.446,6,3,3,2.4876829083654726
28637,703-004-5390,7637.63,1,0,1,0.27920371738274696
2871,703-004-5395,7131.224,6,3,3,0.6866928807431297
2877,703-004-5397,1263.8367,8,4,4,1.0282941653701179
28905,703-004-5389,3039.4548,3,2,1,1.3507585669875806
29170,703-004-5399,3826.1348,2,0,2,0.27920371738274696
29340,703-004-5387,9850.385,1,1,0,0.5338695981729378
29768,207-008-2399,7739.601,3,1,2,2.690586192001619
29908,703-004-5381,2802.8257,5,2,3,0.5315119407221236
30061,703-004-5386,8787.557,3,1,2,0.5100750368035195
30247,703-004-5398,636.279,1,0,1,0.27920371738274696
30627,703-004-5385,2853.9038,7,5,2,1.4055416744347384
30658,703-004-5380,1616.9673,1,1,0,0.5158742384686997
31320,703-004-5393,1430.5264,2,1,1,0.33853450732658075
31622,703-004-5399,9983.987,4,0,4,0.27920371738274696
31800,703-004-5381,4693.882,2,0,2,0.27920371738274696
32138,703-004-5385,4538.78,5,2,3,0.8256458037730117
32404,207-008-2398,5409.5396,2,1,1,0.8542285354189718
32769,703-004-5389,3639.7332,5,2,3,1.5410919937070204
32886,703-004-5387,7386.9604,1,1,0,0.3393678165117293
33101,703-004-5380,4286.847,4,1,3,0.6900326321785655
33305,703-004-5387,1601.6334,2,1,1,0.44829646872267315
33739,703-004-5396,7581.194,2,2,0,0.45719608721424815
34065,703-004-5392,2215.9988,3,2,1,1.9154843117556233
34435,207-008-2398,9572.561,5,4,1,1.4808538822384307
34607,703-004-5396,5661.7324,2,0,2,0.27920371738274696
3463,703-004-5391,4559.85,3,1,2,1.4303994565599538
34757,703-004-5398,4746.621,2,1,1,0.5597935733806209
34896,703-004-5386,6445.4146,2,1,1,0.4503337561684008
34935,703-004-5399,4270.3354,6,5,1,1.4557504120087257
35003,703-004-5396,2033.2068,6,3,3,1.6163455323194864
35037,703-004-5384,6999.867,3,2,1,0.6884451178625112
35111,703-004-5386,1058.3699,6,4,2,1.0995517074276786
35178,703-004-5399,7319.923,7,3,4,1.267642611379157
35705,703-004-5389,9023.358,3,2,1,0.6858503593477896
36027,703-004-5392,1078.8572,4,1,3,0.5788076039672237
36029,703-004-5380,5174.928,2,0,2,0.27920371738274696
37168,703-004-5387,2705.7595,5,4,1,2.610131271843292
37295,207-008-2398,4146.4717,6,1,5,0.9083669947440088
37648,703-004-5381,4142.44,5,1,4,0.92702190340791
3772,703-004-5398,8178.5654,6,2,4,0.9624107115005303
37831,207-008-2398,3620.8135,7,4,3,1.6910546295859399
37971,207-008-2398,5479.778,3,1,2,0.35831143730785864
38219,703-004-5381,1089.701,8,6,2,3.30338868829747
38547,703-004-5387,360.8185,3,1,2,0.3907908260670611
38670,703-004-5385,6372.2695,5,2,3,0.49848660884078494
38885,703-004-5380,3441.2712,4,1,3,2.058037039973659
3904,207-008-2398,970.4685,6,1,5,0.36010784178115807
3909,207-008-2399,4070.6152,1,1,0,0.4314860782385869
39162,207-008-2398,3617.1365,7,1,6,0.36010784178115807
39215,207-008-2399,3630.2317,3,1,2,0.41504650519164965
39255,703-004-5398,1970.5314,9,5,4,3.2339262054762368
39351,703-004-5388,7558.8447,3,2,1,0.4230808829965438
39435,703-004-5397,6777.9106,2,1,1,0.36450093501495784
39447,703-004-5391,6373.092,2,2,0,0.9400074015806859
39765,207-008-2399,1567.039,3,0,3,0.27920371738274696
39771,703-004-5390,7391.767,3,1,2,1.705695101303544
39893,703-004-5393,7393.9214,5,3,2,1.0433020156683654
39912,703-004-5393,8023.681,3,1,2,0.5013775705669992
40015,703-004-5396,1269.1473,1,1,0,0.7214836630258888
40208,703-004-5390,4645.504,3,3,0,1.910606232744898
40660,703-004-5382,4680.109,8,3,5,0.7579182423323402
40773,703-004-5390,2861.209,1,0,1,0.27920371738274696
40897,703-004-5394,5390.338,4,2,2,1.2227653976390405
40898,703-004-5394,9376.032,1,1,0,0.5112119294783584
41142,703-004-5397,8168.43,8,6,2,2.8274472197415226
41205,703-004-5388,1236.7935,3,2,1,0.5723154776784831
4150,703-004-5385,8164.453,5,2,3,1.2620186579106725
41756,703-004-5393,1558.4589,6,3,3,0.701747932614373
41916,703-004-5385,3694.7446,2,2,0,1.2992313161026943
42331,703-004-5392,6690.137,6,2,4,1.1834201517886418
4243,207-008-2399,889.9421,4,2,2,1.2482792369546452
42544,703-004-5389,86.96079,6,2,4,0.696071880453749
4256,703-004-5382,4142.4946,4,2,2,1.0440822387961255
42846,207-008-2399,6114.5186,1,0,1,0.27920371738274696
42921,703-004-5397,5296.7417,5,2,3,0.9545341405407362
42953,703-004-5384,6063.995,4,2,2,1.1196987253564352
43249,703-004-5389,1381.0277,1,1,0,0.709007560465473
43309,703-004-5397,9458.708,4,3,1,0.8934355263151944
43348,207-008-2399,467.57697,5,4,1,2.069175770344693
43401,703-004-5391,1658.398,3,3,0,0.8834846106483843
43437,207-008-2399,8454.995,2,1,1,1.5501296468957244
43600,703-004-5384,1174.2318,2,1,1,0.35534489781066697
4371,703-004-5394,8786.458,9,7,2,2.4778077698594405
43739,703-004-5383,729.5662,2,2,0,1.1382540184664056
43799,703-004-5386,2705.466,10,3,7,1.5868705694018814
43871,703-004-5388,5278.6606,2,1,1,0.6254525299176233
44082,703-004-5382,8378.961,4,1,3,0.35831143730785864
44248,703-004-5388,5808.46,3,0,3,0.27920371738274696
4444,703-004-5396,4360.027,5,3,2,1.4000985983529441
44740,703-004-5386,1345.4938,6,5,1,1.3780452725719616
44857,703-004-5392,4376.062,4,1,3,0.4640756385908506
44862,703-004-5396,7377.314,1,1,0,0.9513116084298484
45061,703-004-5391,3504.0056,2,1,1,0.9407242062681693
45201,703-004-5381,2236.668,5,4,1,4.031730419750086
45297,703-004-5389,3172.0293,3,2,1,1.5393469002848676
45498,703-004-5386,7332.806,3,2,1,0.9416393626140909
4560,703-004-5389,9169.407,"","","",0.27920371738274696
45730,703-004-5392,8500.174,5,5,0,1.6975863285714237
46114,703-004-5385,6057.688,5,1,4,0.38769963213903735
4646,703-004-5397,2188.7124,6,3,3,1.5907297773427926
46694,703-004-5395,4680.5166,3,1,2,0.3978652972704144
46759,703-004-5383,4784.749,4,2,2,1.8382574043679685
4714,703-004-5399,2157.1738,5,1,4,1.868309098215545
47159,703-004-5390,7215.7524,5,2,3,0.6768606801928281
47618,703-004-5389,5070.1743,3,3,0,4.1371882772295345
47638,703-004-5390,829.494,6,4,2,1.34682323009973
47788,703-004-5394,5489.2593,1,1,0,0.3589087005932932
48227,703-004-5385,7097.4443,3,3,0,1.8923198779851613
48359,703-004-5398,6044.061,6,3,3,1.4724726685603549
48531,703-004-5382,7546.285,4,2,2,1.0031317323376339
48535,207-008-2399,2060.063,6,3,3,1.4977782091579774
48637,703-004-5399,7658.029,4,0,4,0.27920371738274696
48764,703-004-5390,9221.853,4,4,0,1.8752631302621663
48995,703-004-5387,416.60428,8,4,4,2.0892078382542096
49288,703-004-5397,4817.294,5,3,2,1.8158275667158956
49471,703-004-5386,5281.7905,3,1,2,0.5115693122775978
49580,703-004-5396,6484.265,4,3,1,1.296012521560242
49660,703-004-5396,9087.586,4,0,4,0.27920371738274696
49732,703-004-5399,2456.972,5,2,3,1.3312566158455268
49804,703-004-5395,7454.04,4,3,1,0.6722118838120547
49843,703-004-5384,1622.5731,2,2,0,1.0793675316920102
49934,703-004-5385,2996.751,2,2,0,0.9797461520510117
5156,703-004-5394,5708.4526,3,0,3,0.27920371738274696
5686,703-004-5382,4789.1353,8,6,2,1.7692901054777668
573,703-004-5390,1883.3142,3,2,1,0.8756413482683546
609,703-004-5380,8274.378,1,0,1,0.27920371738274696
6577,703-004-5397,389.63675,3,2,1,1.745412770053772
6889,703-004-5395,356.9037,4,2,2,2.5079682542090955
6891,703-004-5387,5882.1353,5,2,3,0.6898051679283217
6919,703-004-5395,6979.345,4,1,3,0.33853450732658075
7315,703-004-5396,5424.169,4,3,1,0.9853315534028216
7415,703-004-5394,3871.3164,4,0,4,0.27920371738274696
7438,703-004-5398,3997.6406,2,0,2,0.27920371738274696
7786,703-004-5388,4181.946,1,1,0,0.3999899332780649
8098,703-004-5398,9102.95,5,1,4,0.3978652972704144
8271,703-004-5391,7596.5146,5,2,3,1.1347094730886462
8338,703-004-5394,9404.8545,7,1,6,1.4202502077270156
8427,703-004-5393,5193.749,3,2,1,1.007408988619158
8428,703-004-5382,3069.3447,4,1,3,0.7094658877893065
850,703-004-5394,8960.84,3,3,0,2.5502921248832737
8580,703-004-5382,7081.653,10,4,6,3.581751318647088
8894,703-004-5391,9922.115,4,4,0,2.361960287026661
8911,703-004-5384,8016.0747,9,3,6,1.2678780166589119
9090,703-004-5393,4862.1255,7,4,3,1.1131866427849961
9157,703-004-5387,6769.442,3,1,2,0.7576641636648718
9299,703-004-5385,7038.883,7,4,3,1.5665653341596308
9397,703-004-5385,9637.516,4,2,2,0.6195868830778093
953,703-004-5392,2321.9246,7,7,0,1.756848691060487
9571,703-004-5381,937.1608,1,1,0,0.5852254343177115
10485,703-004-5390,6247.816,5,3,2,0.802737958234536
10542,703-004-5396,5109.1655,4,0,4,0.27920371738274696
10771,703-004-5398,5198.6885,7,6,1,2.5415259564889343
10793,703-004-5393,5287.8354,6,4,2,1.1767316836633053
11516,703-004-5395,8768.415,4,2,2,0.4605594531729956
11618,703-004-5388,1817.562,5,3,2,0.8733879355199584
12189,703-004-5394,3656.3403,6,2,4,1.4022374322376094
12229,703-004-5398,4925.0386,7,5,2,1.9359281609235124
13612,703-004-5388,4916.773,4,3,1,0.6432383382332213
13645,703-004-5398,7626.2095,4,1,3,1.4810275816697505
13946,703-004-5393,3891.4668,1,0,1,0.27920371738274696
14112,703-004-5398,7614.168,5,1,4,0.6920488596310477
14187,703-004-5393,1538.9508,8,3,5,0.893541184450676
14536,703-004-5394,5277.3726,6,1,5,0.35831143730785864
14538,703-004-5380,6097.7905,5,2,3,0.7414002213435552
14632,207-008-2399,3356.9783,2,0,2,0.27920371738274696
14755,703-004-5391,4079.4915,5,2,3,1.1344297412217699
14889,703-004-5396,5599.1294,8,5,3,1.7641592648903806
14937,703-004-5391,6488.007,2,2,0,1.138563646859615
14956,703-004-5389,2477.2852,7,3,4,0.5414480703157458
14962,703-004-5388,896.0718,2,2,0,0.7023834094879958
1504,703-004-5393,2927.3748,3,2,1,0.6451038446054145
15174,703-004-5393,5933.7705,3,1,2,0.6289429520045002
15379,703-004-5394,5769.735,2,1,1,0.32666834933781397
1547,703-004-5396,8362.81,4,2,2,0.9260443968092237
15486,207-008-2399,3681.828,"","","",0.27920371738274696
15860,703-004-5389,9415.178,4,1,3,0.35831143730785864
1603,207-008-2399,6990.083,6,4,2,1.4722169868611696
16030,703-004-5385,3670.175,6,4,2,1.671759705760345
1604,703-004-5396,5497.8423,3,0,3,0.27920371738274696
16062,703-004-5392,7562.107,5,3,2,1.5890749207947847
16108,703-004-5392,9815.001,5,3,2,1.6300072825253507
16201,703-004-5382,3463.5686,1,0,1,0.27920371738274696
16383,703-004-5381,5471.077,2,1,1,0.5026305728027806
16445,703-004-5387,6192.768,3,1,2,0.44227863980892135
16530,703-004-5397,4384.7275,1,0,1,0.27920371738274696
16726,703-004-5393,9584.098,3,3,0,0.7858987339478157
16799,703-004-5390,8650.426,4,1,3,0.3978652972704144
17166,703-004-5385,7723.2134,4,1,3,0.32666834933781397
17371,703-004-5394,6618.12,2,0,2,0.27920371738274696
1742,207-008-2399,3940.838,2,0,2,0.27920371738274696
17700,703-004-5396,3006.0947,3,1,2,0.430678832410609
17701,703-004-5392,4669.702,5,4,1,0.9780020799824783
17864,703-004-5388,432.7768,4,3,1,1.1533623093876597
18095,703-004-5380,7.62403,6,3,3,0.9606899808319838
18407,703-004-5386,4961.8203,5,4,1,0.8716063476649214
18719,703-004-5395,2283.8486,1,1,0,0.504936877964041
18837,703-004-5382,5679.9136,2,2,0,1.1317620786393756
18926,703-004-5397,8164.5996,4,2,2,1.4910249252295567
19450,703-004-5382,9686.241,3,1,2,0.660258765394852
19856,703-004-5393,9059.092,1,1,0,0.43861118605083066
19900,703-004-5387,5408.3306,3,2,1,1.4798170949785414
1999,703-004-5395,6885.762,6,2,4,1.7014872910501304
20407,207-008-2398,485.79337,5,2,3,0.645311922094088
20541,207-008-2399,5181.177,7,3,4,2.2501249159775574
20698,703-004-5389,6397.2437,4,3,1,1.119328163848242
21068,703-004-5380,1402.4037,6,2,4,1.7040717055255792
21396,703-004-5391,7186.148,2,0,2,0.27920371738274696
21478,703-004-5395,4938.696,5,3,2,1.6490157540510169
21649,703-004-5392,1675.542,6,4,2,1.9732953087989271
22031,703-004-5380,9704.759,4,1,3,1.1601299884386789
22101,703-004-5396,649.0332,3,1,2,0.9487350109005571
22544,703-004-5382,1705.6351,2,1,1,0.5716678759007351
2256,703-004-5390,5421.1743,2,0,2,0.27920371738274696
22616,703-004-5388,1881.8975,1,1,0,0.8890235320861553
23035,703-004-5387,3186.9138,1,0,1,0.27920371738274696
23051,703-004-5397,8335.582,4,2,2,0.6238966031972605
23139,703-004-5395,9461.904,4,3,1,1.4177607736413875
23392,703-004-5398,5458.994,4,1,3,1.0647314120080054
23402,207-008-2399,8507.476,1,0,1,0.27920371738274696
23420,703-004-5382,2256.4614,7,3,4,1.0736930815089996
2346,703-004-5391,8685.514,6,3,3,0.9830144291970354
23697,703-004-5389,5937.9814,2,1,1,0.42224119115075665
23853,703-004-5388,7223.9185,1,0,1,0.27920371738274696
24012,703-004-5383,8411.904,1,1,0,0.4987276401749318
24409,703-004-5396,472.3388,"","","",0.27920371738274696
24578,703-004-5388,3144.98,5,4,1,1.1331681754154552
24756,703-004-5395,7805.9434,7,4,3,1.4387516705269159
24782,703-004-5389,2880.9656,7,4,3,2.004350697995396
24853,703-004-5382,6787.9834,2,0,2,0.27920371738274696
25241,703-004-5397,8439.121,3,3,0,1.1323550158658742
25259,703-004-5395,5057.9507,6,1,5,0.5080929777966029
25275,703-004-5396,9287.868,2,1,1,0.8932252201113446
25327,703-004-5391,356.02332,3,3,0,0.9245920097018104
25523,703-004-5397,6199.219,5,1,4,0.7291059373845108
25643,703-004-5396,1700.1324,6,2,4,0.8998501253158149
26333,703-004-5380,3361.6257,3,1,2,0.5244801951522613
26478,703-004-5399,9401.858,5,3,2,1.2369724980526
26518,703-004-5398,3878.4976,6,2,4,0.8893326257720995
26630,207-008-2398,6789.866,5,3,2,0.6609994340707093
26948,703-004-5399,7944.4053,"","","",0.27920371738274696
27054,703-004-5381,6611.922,4,2,2,0.7400725349078134
27445,703-004-5393,9232.498,3,2,1,0.5197123444939404
27962,703-004-5381,8938.421,3,1,2,0.5183860521667141
28058,703-004-5391,790.2688,6,2,4,1.0211316585523662
28094,207-008-2398,2836.3418,4,1,3,0.35831143730785864
28253,703-004-5393,1404.336,4,2,2,0.738373776395454
28294,703-004-5396,6348.9517,3,1,2,0.6298646339553841
28480,703-004-5397,1009.14716,5,4,1,1.033649647477666
2890,703-004-5381,7903.006,8,4,4,3.5940263744814684
29086,703-004-5383,5952.444,3,1,2,1.3149723564111608
29404,703-004-5387,6659.433,3,2,1,0.6785235135314586
29766,703-004-5397,7101.129,3,2,1,0.6421459118317697
29929,703-004-5398,407.13013,2,1,1,0.4180377658513179
30371,703-004-5382,9721.491,3,1,2,0.509026518174822
30638,703-004-5387,5653.2974,2,1,1,1.3612134231620785
30817,703-004-5394,3786.3606,5,2,3,0.9992325368027748
31006,703-004-5387,7577.2886,2,0,2,0.27920371738274696
31141,703-004-5387,7847.876,3,2,1,0.8629638094493729
31358,703-004-5381,5333.0312,4,1,3,0.5390864950754619
31485,703-004-5396,4728.785,2,1,1,0.7175498172377817
31490,703-004-5396,3435.0735,3,1,2,2.282831316498065
31495,703-004-5387,5138.502,9,6,3,1.5455957082993215
31522,703-004-5383,9837.436,6,2,4,0.4787344000219836
31532,703-004-5388,7132.7783,5,1,4,0.3978652972704144
31753,703-004-5380,8358.054,2,0,2,0.27920371738274696
31897,703-004-5393,8493.083,3,1,2,0.7885701050351424
32084,703-004-5384,8628.607,6,2,4,0.5114207251324275
32207,703-004-5394,889.6053,3,1,2,0.8750270828635794
32240,703-004-5395,115.648506,6,2,4,0.47629684787191195
32410,703-004-5385,7659.283,8,4,4,1.8921639243661295
32712,703-004-5383,9611.915,3,1,2,0.4755772224212032
32893,703-004-5392,9546.235,6,1,5,1.071818179704546
33678,703-004-5389,7142.3926,1,0,1,0.27920371738274696
33723,703-004-5385,3264.9536,3,2,1,1.0361785286542575
33892,703-004-5380,6975.089,5,1,4,0.49619936568651263
34099,703-004-5389,9544.982,3,3,0,2.035129572977268
3417,703-004-5393,7959.4834,8,6,2,1.7018778664082341
34471,703-004-5399,2848.4495,5,3,2,1.279307057669836
34841,703-004-5386,375.31674,2,0,2,0.27920371738274696
35173,703-004-5389,4381.667,4,2,2,0.945959021708192
35231,703-004-5391,1217.5006,8,7,1,3.7130525088718866
3530,703-004-5394,620.6071,3,1,2,0.33853450732658075
3537,207-008-2398,9478.526,7,3,4,1.1712219999408282
3555,703-004-5386,6101.558,4,2,2,0.6571446708031939
36198,703-004-5384,3978.9207,3,3,0,1.270028487740098
36329,703-004-5390,6490.88,2,1,1,0.33853450732658075
36347,703-004-5394,408.5344,2,2,0,0.8678443788075875
36485,207-008-2398,5007.245,3,2,1,0.7756782512610747
36561,703-004-5385,9353.995,1,1,0,0.3978652972704144
36670,703-004-5388,9217.044,8,4,4,1.1475768778717683
36896,207-008-2399,5096.6035,3,1,2,0.45640523353201934
37163,207-008-2399,5395.438,5,2,3,0.9972608292717434
37613,703-004-5391,6556.4556,1,0,1,0.27920371738274696
37824,703-004-5388,2676.1348,6,2,4,0.49580188902169164
37996,703-004-5383,3412.0525,3,0,3,0.27920371738274696
38871,703-004-5383,1730.9099,1,0,1,0.27920371738274696
39022,703-004-5397,4584.3945,5,3,2,0.9907890834704688
39124,703-004-5395,9602.357,3,0,3,0.27920371738274696
39133,703-004-5396,2018.3599,4,1,3,0.4486425649973455
39196,703-004-5392,2841.5293,4,3,1,1.313525874510618
39248,703-004-5386,938.8071,4,1,3,0.6998159042460668
39372,703-004-5397,5487.258,6,2,4,0.7447101478994151
3961,703-004-5382,9991.78,9,4,5,1.322287221257976
3970,703-004-5398,6924.2793,2,1,1,0.5233891818513272
40089,703-004-5386,644.3274,3,2,1,0.5284757709851894
40119,703-004-5382,5781.113,2,1,1,0.35831143730785864
40306,703-004-5393,3793.0996,1,0,1,0.27920371738274696
40916,703-004-5386,8580.002,1,1,0,0.41554731474148804
41502,703-004-5393,1649.5663,8,3,5,2.4872823541237516
41547,703-004-5381,3921.0767,3,1,2,0.7178118802686243
41666,703-004-5382,33.26893,8,4,4,2.0856228828816503
42375,703-004-5381,9055.033,2,0,2,0.27920371738274696
42412,207-008-2398,8072.735,6,4,2,3.629441662362836
42445,207-008-2399,4370.149,5,3,2,1.0296254762485335
42514,703-004-5387,441.75027,3,3,0,1.9704210872776076
42673,703-004-5399,3478.313,6,3,3,1.6437636616785567
42927,703-004-5387,2420.4265,6,3,3,0.7359497767893508
43059,703-004-5384,5520.592,3,2,1,2.0515730986157483
43754,703-004-5388,7242.5723,7,5,2,1.884982658426531
44239,703-004-5384,3550.024,5,2,3,1.0638505039646957
44526,703-004-5382,6500.812,8,2,6,0.5131532795106745
44614,703-004-5391,7616.9253,8,6,2,1.3850836324859064
44700,703-004-5382,6547.092,2,1,1,1.403056436527361
44727,207-008-2399,3523.5728,4,1,3,0.5165268771580819
4554,703-004-5389,3342.132,4,2,2,0.9010777663779195
45719,703-004-5390,4250.9453,5,2,3,0.5684915847226387
45786,703-004-5392,8880.521,"","","",0.27920371738274696
45933,207-008-2399,691.49554,2,2,0,0.826848016827078
45963,703-004-5382,4265.9097,4,2,2,1.2863535334034297
4619,703-004-5390,4144.348,4,0,4,0.27920371738274696
46427,703-004-5398,7236.9395,3,1,2,0.36951836429724944
46539,703-004-5388,9427.311,4,1,3,0.9329000831394604
46651,703-004-5394,6658.8354,1,1,0,0.9407286758287556
46826,703-004-5390,7853.2456,5,4,1,3.7035021958415557
47145,703-004-5387,8012.0303,"","","",0.27920371738274696
47490,703-004-5384,6527.72,2,2,0,0.6683926241497903
47589,703-004-5385,5003.3965,5,5,0,2.070042314224136
47630,703-004-5382,7730.416,2,0,2,0.27920371738274696
4797,703-004-5388,5361.4683,3,1,2,0.39455586733890036
48609,703-004-5398,3427.8792,3,2,1,1.1666806486569623
48622,703-004-5393,1961.3188,3,1,2,0.9477708247623859
48780,703-004-5387,8693.265,6,3,3,1.5032654491480513
49701,207-008-2398,5120.0103,5,3,2,0.8695290887516983
49706,703-004-5390,6406.756,2,2,0,0.36622220930036975
5224,703-004-5396,9936.149,2,1,1,0.33853450732658075
5336,703-004-5397,7286.3423,5,2,3,1.1070314814686175
5463,703-004-5384,9051.158,2,1,1,0.35831143730785864
6016,703-004-5398,3748.2058,5,2,3,0.9858934830694225
6223,703-004-5382,1500.0552,2,1,1,0.4373202725830639
6475,703-004-5387,8140.3555,3,1,2,1.6870561719606496
7170,703-004-5398,8159.067,6,2,4,1.6925004255754643
7187,703-004-5397,4486.2114,3,1,2,0.5811158556309368
7250,703-004-5385,9936.892,2,1,1,4.204952160660754
7262,703-004-5389,2959.9004,9,4,5,1.7214209550298163
7297,703-004-5385,4857.2046,1,0,1,0.27920371738274696
7466,703-004-5397,2493.753,2,1,1,0.9785467498054787
7615,703-004-5381,9381.225,7,4,3,1.6701463986002902
7704,703-004-5391,389.27078,5,4,1,1.9992507295387283
8371,207-008-2399,2828.6648,2,1,1,0.4564807206351785
8705,703-004-5384,9784.079,6,2,4,0.49138192332474284
8795,703-004-5387,1451.3129,1,0,1,0.27920371738274696
8811,703-004-5384,2316.299,3,3,0,0.602264547614587
9129,703-004-5381,5853.71,6,3,3,0.7559691082378481
9593,703-004-5391,5642.1577,3,1,2,0.5047322191196231
9794,703-004-5380,2253.5896,1,0,1,0.27920371738274696
9897,703-004-5385,661.91376,10,6,4,1.8241602208720398
10127,703-004-5387,6267.9727,6,4,2,1.832181344707043
10830,703-004-5395,9508.427,3,1,2,0.42733319518351554
109,703-004-5380,2712.4226,8,4,4,2.3483731255203257
1103,207-008-2398,4332.77,4,2,2,0.45666120899906804
11202,703-004-5380,7978.932,4,2,2,0.8440638120672188
11345,703-004-5382,8685.855,3,1,2,1.4101717674904992
11674,207-008-2399,4383.812,10,7,3,3.025130775390801
12109,703-004-5390,4843.143,5,3,2,0.5937971355384453
123,703-004-5397,7496.5693,8,4,4,0.9934036217350384
12378,703-004-5393,8835.956,8,5,3,3.5877867356915476
12705,703-004-5393,6799.212,2,1,1,0.4440424996375402
12737,703-004-5382,8070.889,5,4,1,2.0256360156407394
12805,703-004-5390,8119.739,3,1,2,0.5509124732747498
12895,703-004-5384,4615.8354,2,1,1,0.4402262570138994
13002,703-004-5386,8288.379,"","","",0.27920371738274696
13135,703-004-5385,6381.0527,8,5,3,1.7477422921055235
13137,703-004-5388,6473.6543,3,3,0,1.8778040423738522
13221,703-004-5380,3865.022,9,5,4,1.9654709495727307
13397,703-004-5389,2162.8726,"","","",0.27920371738274696
13736,703-004-5391,9589.939,9,5,4,2.395668723735342
13898,703-004-5397,1040.3604,2,1,1,0.8013246716202502
14606,703-004-5391,7520.153,6,5,1,2.4211667915483925
14689,703-004-5385,5300.516,3,2,1,0.6856196284980081
14888,703-004-5384,1339.7568,4,1,3,0.5165268771580819
15228,703-004-5385,1365.1019,4,0,4,0.27920371738274696
15246,703-004-5382,2748.7063,4,2,2,0.6343105728077877
15341,703-004-5381,3550.8633,5,1,4,0.6658826305476505
15405,703-004-5383,2375.483,4,0,4,0.27920371738274696
15530,703-004-5394,6706.584,2,0,2,0.27920371738274696
15697,703-004-5394,4918.468,1,1,0,0.5273053039978784
15921,207-008-2398,4925.464,2,0,2,0.27920371738274696
16096,703-004-5398,4094.8247,7,3,4,1.109648477233774
16103,703-004-5398,9179.389,3,1,2,0.49490506542124046
16146,703-004-5392,680.6898,5,1,4,0.37248624285740867
16209,703-004-5394,168.41472,4,2,2,0.9319823722532937
16483,703-004-5398,6715.126,4,2,2,0.8002773532285463
16595,703-004-5381,1674.5132,2,0,2,0.27920371738274696
16719,703-004-5392,3721.4893,4,1,3,0.5080369925201302
16790,703-004-5391,2950.738,1,1,0,1.0034658727175698
17032,703-004-5390,5857.2095,3,1,2,0.33853450732658075
17413,703-004-5391,9647.847,5,2,3,0.6140650477482461
17747,703-004-5395,7534.047,3,2,1,0.7450783352877071
1784,703-004-5394,6075.524,4,2,2,0.8361099249925006
17937,703-004-5389,3229.639,3,2,1,1.023207398432216
17966,703-004-5384,3849.9604,3,1,2,0.36173131313204354
17988,703-004-5390,128.17502,3,3,0,0.5939418187645907
18080,703-004-5392,6787.163,3,1,2,0.5006135598129351
1853,703-004-5380,8763.464,5,2,3,0.7487380309727949
18803,703-004-5385,9487.827,4,3,1,1.0931817085529374
19604,703-004-5384,8300.287,2,1,1,0.5378793985900103
19729,703-004-5394,1695.5364,6,2,4,0.41669204465074183
19745,703-004-5380,3413.6487,1,0,1,0.27920371738274696
19754,703-004-5391,6878.1143,6,3,3,1.55790780098455
19786,703-004-5387,3728.22,3,1,2,0.45325201825202965
19833,703-004-5387,7339.343,2,1,1,0.3670132864996209
20210,207-008-2398,4412.7817,3,1,2,1.7747827086884234
20265,703-004-5386,7228.0283,6,2,4,1.369300445502444
20450,703-004-5387,6678.594,5,4,1,1.5982449791466853
20457,703-004-5381,76.17235,"","","",0.27920371738274696
2067,703-004-5395,8011.6606,1,1,0,0.5067472925745119
2089,703-004-5391,7315.765,5,1,4,0.7562276019669341
21286,703-004-5389,2382.828,7,3,4,0.9525227837192324
21390,703-004-5398,9345.702,2,0,2,0.27920371738274696
21477,703-004-5390,6594.757,5,2,3,0.6447817227761298
215,703-004-5388,4482.096,2,1,1,0.8700149788120131
21501,703-004-5383,3668.27,4,2,2,0.5881525180653441
22067,703-004-5388,3185.8354,2,1,1,0.482128878177922
22083,703-004-5391,437.05344,4,2,2,0.4646800071346634
2241,703-004-5395,3067.0845,4,1,3,0.8937823126033443
22423,703-004-5380,1935.106,3,0,3,0.27920371738274696
22474,703-004-5391,2466.653,2,0,2,0.27920371738274696
2248,703-004-5382,1023.2097,4,3,1,1.7601826808124075
22512,703-004-5395,410.09842,3,0,3,0.27920371738274696
22675,703-004-5393,6523.3457,1,1,0,0.3978652972704144
22801,703-004-5393,3568.7368,8,4,4,2.697189654303586
2292,703-004-5392,8691.916,4,3,1,0.7764857176538671
22936,703-004-5385,4980.053,4,1,3,0.9083311231458816
23023,703-004-5393,7700.6787,5,2,3,1.0365845193773635
23032,703-004-5387,4486.6997,3,2,1,0.6081966608038162
23405,703-004-5391,4082.936,5,1,4,0.37635788591577474
23703,703-004-5387,5139.308,3,2,1,0.6582175278921533
23888,703-004-5385,6297.1133,9,2,7,0.6295509406939693
23944,703-004-5389,5128.464,6,2,4,0.7655154951116787
24055,703-004-5395,2870.9043,3,2,1,0.6310596666716098
24434,703-004-5394,2756.1765,3,2,1,0.7467941976244459
24608,703-004-5389,7604.097,4,3,1,2.167659011210187
24663,207-008-2398,6197.342,3,3,0,1.5936900251160935
24697,703-004-5396,6606.635,6,3,3,0.9550639713845614
24798,207-008-2398,9210.048,5,3,2,0.9686837232201481
25477,703-004-5393,6931.959,2,1,1,0.36141686338598916
25946,207-008-2399,1731.9972,6,5,1,1.7416830812339628
2598,703-004-5388,3358.4749,2,1,1,0.5314760802703759
26001,703-004-5385,3193.9185,3,2,1,0.6360782857182278
26227,703-004-5388,1067.3833,4,3,1,0.8455698097405375
26474,207-008-2399,79.3755,2,1,1,0.53656420227408
26585,703-004-5393,7005.9717,6,1,5,0.6728981436508071
26756,703-004-5395,2263.328,3,2,1,2.0856635246730737
26772,703-004-5380,5970.5537,3,0,3,0.27920371738274696
26927,703-004-5396,2798.1514,2,1,1,0.8127463626000591
27590,703-004-5380,4679.2866,2,2,0,0.8402679920514087
27688,703-004-5399,8500.006,3,1,2,0.579321766898572
27704,703-004-5395,6381.072,4,4,0,1.0076516586647812
27717,703-004-5392,9577.309,5,2,3,1.826839608758522
27758,703-004-5382,191.89,"","","",0.27920371738274696
27852,703-004-5392,1823.1278,2,2,0,1.027279268033416
27910,703-004-5385,1127.0833,5,2,3,0.7662154625034799
2801,207-008-2399,8902.862,4,1,3,0.33853450732658075
28041,703-004-5391,9297.552,5,2,3,0.7052976738293796
28539,207-008-2398,9835.704,3,2,1,0.6673581006263034
28540,703-004-5385,4874.0244,7,3,4,2.8858022454433336
28598,703-004-5391,4176.606,2,1,1,0.4031391452654219
28721,703-004-5391,8555.6455,2,1,1,2.5415015657687072
28870,703-004-5398,5270.7954,5,5,0,3.1530008384736847
29635,703-004-5389,4372.0156,1,1,0,2.413217798797305
29829,703-004-5388,3212.4006,4,2,2,0.9697966478577302
3007,703-004-5386,7738.0635,5,3,2,1.3078758420948913
30304,703-004-5397,5035.153,4,1,3,0.7662106879059947
30348,703-004-5392,7930.9004,5,3,2,1.0099160119891357
30368,703-004-5394,4203.918,4,2,2,0.6323548728015845
30743,703-004-5390,3741.4365,2,1,1,1.5144324500228177
30825,703-004-5383,3535.3845,3,0,3,0.27920371738274696
30959,703-004-5385,7608.971,5,1,4,0.33853450732658075
31063,703-004-5381,4139.252,2,0,2,0.27920371738274696
31228,703-004-5393,8612.897,4,1,3,0.6442076229250204
31515,703-004-5386,6742.8174,3,2,1,0.6049924674993302
32055,703-004-5383,1.5240908,2,1,1,1.1263353993880965
32448,703-004-5385,5981.3335,3,3,0,0.8266599675419255
32462,703-004-5387,4359.2866,7,3,4,1.5773881820446811
32853,703-004-5399,7110.314,8,4,4,1.5384118975619765
32894,703-004-5393,3292.479,3,1,2,0.47541740626969187
33474,703-004-5392,578.61566,4,2,2,0.9317039220670289
33546,703-004-5398,7019.9526,3,3,0,1.1414717647656647
34280,207-008-2399,3544.5034,1,1,0,0.4230808829965438
34478,703-004-5387,9554.959,3,0,3,0.27920371738274696
35109,703-004-5384,4201.863,5,3,2,1.6195981512851654
3513,703-004-5396,8319.385,1,0,1,0.27920371738274696
35434,703-004-5388,9135.983,3,1,2,0.5485940875718657
35594,703-004-5396,4545.8276,2,0,2,0.27920371738274696
35595,703-004-5388,1053.1246,2,0,2,0.27920371738274696
36188,207-008-2398,5244.362,4,1,3,0.3978652972704144
36210,703-004-5386,653.12744,1,0,1,0.27920371738274696
36324,703-004-5384,4707.2754,4,4,0,1.8787004359558446
36351,207-008-2399,8932.808,5,2,3,0.8272551917848551
3637,703-004-5399,2335.1492,2,2,0,0.906050938939829
36478,703-004-5395,8576.443,5,3,2,1.1850277524958195
36653,703-004-5380,9567.907,3,1,2,0.6607466918729703
36922,703-004-5386,6172.687,4,1,3,0.5239432259010611
37064,207-008-2398,5432.571,3,1,2,1.982523915224192
37115,703-004-5383,6547.921,1,0,1,0.27920371738274696
37684,703-004-5395,7087.7124,4,2,2,0.699404798140498
37784,703-004-5384,831.6487,3,3,0,1.1274080140110234
37790,703-004-5380,4519.283,7,3,4,1.544501296385259
37892,703-004-5386,9208.397,6,1,5,0.5437758111464308
38074,207-008-2399,4864.2217,4,1,3,3.8394743919317946
38211,703-004-5392,55.849552,4,3,1,1.1977365048722346
38351,703-004-5382,5615.4136,5,3,2,1.1662324444662786
38435,703-004-5399,5794.8657,9,3,6,0.9789350122785843
38473,703-004-5387,6469.554,4,2,2,1.1625756336696218
38564,703-004-5380,6224.908,5,3,2,0.7744972857401675
3908,703-004-5382,7558.7456,3,2,1,0.6433731202908349
39430,703-004-5381,3045.5679,3,1,2,0.46470022841160946
39511,703-004-5399,5154.671,5,3,2,2.2111780918895985
39579,703-004-5383,1636.1177,1,0,1,0.27920371738274696
396,703-004-5384,3285.2131,7,2,5,0.6216842350553496
40146,703-004-5383,5029.8403,2,1,1,0.6251659842050284
40352,703-004-5398,6621.7363,"","","",0.27920371738274696
40559,703-004-5380,6354.1323,7,5,2,1.313656050461115
40680,703-004-5396,1731.1179,4,4,0,1.4244834393402364
40887,703-004-5387,3764.5793,1,0,1,0.27920371738274696
41073,703-004-5382,5515.518,5,1,4,0.9290126303504679
41189,703-004-5381,2403.8167,2,1,1,0.39611009473457603
4142,703-004-5382,8048.2476,"","","",0.27920371738274696
41469,703-004-5390,3006.193,2,2,0,2.0154891081923183
41884,703-004-5386,5777.803,2,2,0,0.8588354979689427
42107,703-004-5388,9896.919,2,2,0,0.505245878500392
42272,703-004-5387,2799.8882,3,2,1,1.4911487167419843
42310,703-004-5394,6021.728,2,0,2,0.27920371738274696
43168,703-004-5395,2545.9546,3,1,2,0.585176309297469
43340,207-008-2398,8552.79,5,2,3,1.5580979746433237
43486,703-004-5386,5141.5015,6,1,5,0.44829646872267315
43984,703-004-5395,563.0982,2,1,1,0.492671916840759
44122,703-004-5394,1930.2076,6,5,1,2.279167744406545
44159,703-004-5394,2649.228,3,1,2,0.7561322384615446
44267,703-004-5386,9431.592,7,3,4,0.9014002631570789
44409,703-004-5381,530.20715,4,3,1,0.7119078312918464
44476,703-004-5398,5094.426,7,2,5,0.8987078593613744
44529,703-004-5385,401.61847,2,0,2,0.27920371738274696
44588,703-004-5380,7307.937,5,3,2,1.8649709698524568
44820,703-004-5388,8972.691,6,3,3,1.7017914902165392
44854,703-004-5396,1672.4067,7,2,5,0.818155105068429
44997,703-004-5397,9331.266,3,1,2,0.7422420317185398
4504,703-004-5384,4141.4404,2,1,1,0.7838824014042991
45211,703-004-5392,6095.07,4,3,1,0.999194095637991
45313,703-004-5388,6933.465,2,1,1,0.402145227354162
45426,703-004-5397,1826.126,4,3,1,1.393490973637204
45607,703-004-5382,3965.0356,8,3,5,0.9068559499488015
45784,703-004-5396,308.17093,4,4,0,1.4957817770542647
45999,703-004-5391,4293.075,4,2,2,1.5756831487189273
46214,703-004-5396,2798.748,7,1,6,0.6173892200625992
47344,703-004-5395,1123.0701,6,4,2,1.4500812697151086
47410,207-008-2399,8781.3125,5,3,2,1.3251453359164338
48262,703-004-5392,1907.857,5,2,3,2.7639829360243966
48397,703-004-5395,8357.549,1,0,1,0.27920371738274696
48467,207-008-2398,9456.785,3,2,1,0.9946139086504292
48698,703-004-5382,4432.9946,4,3,1,0.7614387010097979
48865,703-004-5386,2903.7368,6,4,2,1.6481611546422732
4893,703-004-5385,445.6812,1,0,1,0.27920371738274696
49007,207-008-2399,4599.9067,6,4,2,2.025392160666317
49110,207-008-2398,7808.8516,6,2,4,0.6226840555465476
49170,703-004-5380,2932.5598,"","","",0.27920371738274696
49203,703-004-5386,6366.752,4,1,3,0.5641653161443255
49323,703-004-5380,744.62,3,0,3,0.27920371738274696
49469,703-004-5381,292.71005,9,6,3,1.7754361650245891
49487,703-004-5399,8753.593,4,3,1,0.9850160670425351
49489,703-004-5385,3111.2856,3,3,0,1.2833005024661572
49545,703-004-5394,8687.605,5,3,2,1.0185099894942402
49818,703-004-5386,9266.601,1,1,0,0.43790949447836197
49989,703-004-5382,3990.7812,6,2,4,0.6392667112012267
49994,703-004-5399,972.06354,5,3,2,1.0514546987382476
5093,703-004-5397,7897.288,8,5,3,1.6822156180838
5252,703-004-5380,2129.693,3,1,2,0.7665702849537979
5337,703-004-5398,724.3496,4,1,3,0.4571759178358126
5481,703-004-5388,4366.7314,4,0,4,0.27920371738274696
5489,703-004-5388,9258.589,5,2,3,1.399358519809488
5625,703-004-5383,3832.5173,7,2,5,0.8715376298076021
5759,703-004-5393,1308.1813,1,0,1,0.27920371738274696
5873,703-004-5384,3268.6716,5,2,3,1.4510078733532659
6102,703-004-5383,7345.2686,1,0,1,0.27920371738274696
6192,207-008-2399,4172.233,5,2,3,0.9531106305598112
6256,703-004-5381,8085.046,3,2,1,2.592222328579666
6564,207-008-2398,9626.89,1,1,0,0.7485784617956199
6751,703-004-5389,6517.4644,2,1,1,0.7687452519745908
6922,703-004-5388,7070.6387,4,2,2,0.47697301719552604
7068,703-004-5395,8922.081,2,0,2,0.27920371738274696
7204,703-004-5398,6136.1504,2,1,1,0.5313664847038296
7257,703-004-5382,451.4426,6,3,3,1.3470380564766942
7299,703-004-5393,4011.125,2,1,1,0.38169518489447213
7302,703-004-5390,3430.773,7,6,1,1.7620695370377597
7467,703-004-5382,1274.1709,4,3,1,1.5774343216835103
7858,703-004-5394,6106.6978,5,1,4,0.5099051022724175
8121,703-004-5391,1663.6228,3,1,2,0.6149173556063889
8396,703-004-5390,8048.8267,4,2,2,0.8969265542382885
8397,703-004-5386,3147.9019,3,1,2,0.4252967743466629
8797,703-004-5390,8696.507,9,4,5,1.744261189108065
8821,207-008-2398,5091.0884,3,2,1,1.5158085700719908
8831,703-004-5388,1780.0409,5,1,4,0.7231606726694302
8869,703-004-5390,4307.2,5,2,3,0.48401425324801717
900,703-004-5391,1537.3254,4,3,1,1.218565858893045
9042,703-004-5391,3660.4106,5,1,4,0.750512134481482
9062,207-008-2398,9131.638,6,4,2,3.5482776984971482
9247,703-004-5398,451.4873,6,2,4,1.018612621882346
9375,703-004-5380,6246.524,5,3,2,2.7520401265731507
9437,703-004-5382,8855.508,1,0,1,0.27920371738274696
954,703-004-5383,8560.031,7,3,4,1.3151745100841574
9862,703-004-5396,5635.4473,3,2,1,0.6096038432899725
10122,207-008-2399,1466.915,3,3,0,0.9787192488758585
1026,703-004-5381,6759.841,7,2,5,0.6352913295144975
10540,703-004-5392,6966.794,3,2,1,0.7758458797257122
1083,703-004-5384,2980.653,3,2,1,0.9465130898175032
11096,703-004-5381,5722.2485,4,2,2,1.0803088002311183
11148,703-004-5399,0.5429983,"","","",0.27920371738274696
1118,703-004-5382,2906.5466,4,1,3,0.5165268771580819
11404,703-004-5391,2860.697,2,2,0,1.4271771338702108
11409,703-004-5398,2139.3496,7,3,4,2.6448318900478727
1151,703-004-5382,939.06104,3,2,1,0.7709126308805857
11651,703-004-5391,7791.3022,5,0,5,0.27920371738274696
11715,703-004-5390,5382.694,3,1,2,0.3978652972704144
11750,703-004-5381,6437.441,2,1,1,0.35114230018964543
11868,703-004-5395,5292.165,5,2,3,0.6748768207331466
12205,703-004-5384,6706.2886,4,2,2,2.33487055446873
1246,207-008-2398,4529.41,3,3,0,1.9352383452935782
12590,703-004-5398,2695.1045,3,2,1,0.6296357690358161
13,703-004-5395,5117.4883,6,4,2,1.3471967209685665
13426,703-004-5381,7345.181,2,2,0,1.1197937581038182
1350,703-004-5388,684.9712,3,0,3,0.27920371738274696
13582,703-004-5384,5057.309,5,2,3,0.7205619407625432
13632,703-004-5399,7018.581,6,4,2,1.0747105796105465
14015,207-008-2398,1310.6614,8,4,4,1.4808809533771201
14312,703-004-5392,3822.2378,6,6,0,2.5773010127269207
14360,703-004-5383,8387.88,5,4,1,1.401416393005398
14574,703-004-5386,3878.7817,5,2,3,1.7260216367695016
14747,703-004-5380,9264.212,3,1,2,0.3835853532054506
14759,207-008-2398,6887.135,2,2,0,0.604675479360349
14816,703-004-5390,1222.3601,8,7,1,2.3116439115007306
15191,703-004-5391,9974.352,4,2,2,0.7545007996980337
15629,703-004-5392,9247.868,5,3,2,1.0337866168802075
15665,703-004-5393,4607.912,3,2,1,0.7680467683627429
15690,703-004-5388,9712.521,5,2,3,0.5017352009096587
1588,703-004-5384,1472.0046,4,1,3,0.393704267640317
16060,703-004-5397,5778.9995,5,4,1,1.4919474442170668
16315,703-004-5391,3525.6362,5,4,1,1.196733912931278
16532,703-004-5398,8301.008,6,2,4,0.5678058580821099
16629,703-004-5390,1382.6936,2,1,1,0.39406153440401537
16648,703-004-5397,2982.5186,3,2,1,0.6778062273943134
16741,703-004-5396,453.7201,2,1,1,2.2080314352225856
16926,703-004-5386,5412.2837,4,2,2,1.0287422872404208
17282,703-004-5387,3511.5986,6,3,3,2.430656270132593
17323,703-004-5384,9874.906,1,0,1,0.27920371738274696
17503,703-004-5384,6678.67,8,5,3,1.3916559128100823
17600,703-004-5384,7129.987,2,1,1,0.8113087146090446
17610,703-004-5396,5191.4487,4,2,2,0.669178027143536
17712,703-004-5392,7849.8374,2,1,1,0.4393377309329882
17929,703-004-5385,521.51324,7,5,2,2.72651614711073
17983,207-008-2398,7341.725,2,1,1,0.6722341137400459
18032,703-004-5391,1682.6659,3,2,1,0.948597875201402
18124,703-004-5386,6813.8706,4,1,3,0.8074740910876366
18181,703-004-5392,869.8827,3,2,1,0.8457536829767052
1819,703-004-5398,980.6675,1,0,1,0.27920371738274696
18233,207-008-2399,9764.978,1,1,0,0.3131070259220805
18262,207-008-2399,7793.7095,4,3,1,0.5715969988299376
18295,703-004-5383,2143.8545,5,4,1,2.818450369337375
18345,703-004-5382,4862.5835,5,3,2,1.5632652607131339
18426,703-004-5397,1408.3922,3,1,2,0.4854261060980632
18950,703-004-5395,183.30217,2,1,1,0.45643981288555957
19064,703-004-5389,9217.933,6,2,4,0.8413177726742718
19114,703-004-5397,7304.4233,6,1,5,1.0531346459953463
19156,703-004-5392,9274.002,7,1,6,0.4368593994826073
19164,703-004-5394,4793.4263,1,0,1,0.27920371738274696
19165,703-004-5397,2505.067,9,3,6,1.4865810716460117
19218,703-004-5391,4439.872,5,4,1,1.173215010994077
19480,703-004-5380,3513.2324,2,2,0,1.6483281866389055
19550,703-004-5398,924.04663,7,3,4,0.9426534397955842
19609,703-004-5395,8332.505,5,2,3,0.554068161778634
19972,207-008-2399,4625.9307,4,2,2,0.920466879895325
20137,703-004-5394,6283.899,2,0,2,0.27920371738274696
20151,703-004-5381,5805.556,3,1,2,0.73901216053523
20193,703-004-5397,8100.3423,3,1,2,0.6742083398988107
20313,703-004-5399,8018.21,4,2,2,0.8266002504157064
20837,703-004-5397,4218.0156,5,4,1,1.8490307558818098
21049,703-004-5391,5058.087,1,1,0,0.3367545836282657
21074,207-008-2398,3951.0984,5,1,4,1.1481218148141898
21416,703-004-5392,7260.2188,4,1,3,0.6049530575811662
21482,703-004-5396,6209.666,3,2,1,0.53664149821879
21581,703-004-5380,5999.0913,6,3,3,1.4392661962667592
21667,703-004-5394,3911.8564,5,2,3,0.7162064498653234
21726,703-004-5386,1439.5833,13,8,5,2.788543894096917
21901,207-008-2399,8818.459,3,1,2,0.6028819953618467
22600,703-004-5393,7535.017,6,3,3,1.004791339062255
22892,703-004-5381,8094.471,4,2,2,2.0013173836205556
22934,703-004-5383,1669.0433,8,4,4,1.6534726793111163
23027,703-004-5391,1184.5034,4,3,1,2.753367779489076
23086,703-004-5389,5827.107,3,2,1,1.0068029320550251
23340,703-004-5398,9912.064,3,2,1,0.6157994183706436
23572,703-004-5397,5706.828,3,3,0,1.4449412627090483
23579,703-004-5391,1048.9607,6,2,4,1.0972126584947937
23716,703-004-5391,6856.207,4,2,2,1.4674215441749199
2408,703-004-5385,4742.21,6,5,1,1.839758158891539
24099,207-008-2399,9587.631,1,1,0,0.3919322182760311
24223,207-008-2399,8407.273,4,2,2,1.0064368273444773
24275,703-004-5396,6675.3716,7,4,3,4.011844410861678
249,703-004-5384,6337.394,1,1,0,0.37512182779194486
25092,703-004-5389,3929.8462,5,4,1,1.0716412765982535
25318,703-004-5393,2678.845,6,2,4,0.5501476581262543
25576,703-004-5382,9840.748,2,0,2,0.27920371738274696
25580,703-004-5387,5494.006,2,2,0,0.5994201068013184
26038,207-008-2399,932.65173,4,1,3,0.3918388272177862
26318,703-004-5393,2710.436,6,5,1,2.0579642178305058
26370,703-004-5395,8874.727,2,1,1,1.5558433424706557
26698,703-004-5399,6911.162,5,3,2,2.368971739134964
27326,703-004-5393,6808.424,7,6,1,3.5946148769759425
27418,703-004-5382,8620.723,6,3,3,2.452680579539453
27597,703-004-5384,5367.2446,5,1,4,1.003117571982102
27702,207-008-2399,2207.1528,4,1,3,0.39907663423176776
27844,703-004-5396,6709.9653,6,3,3,2.1391902435817776
2785,703-004-5398,3414.1565,"","","",0.27920371738274696
2796,207-008-2398,3974.1619,1,1,0,1.9357065863355543
27960,703-004-5382,5654.2324,3,1,2,0.44829646872267315
27998,207-008-2399,2001.5084,3,1,2,0.585943987519148
28277,703-004-5384,9754.552,8,2,6,0.6568004891134509
28318,703-004-5391,5671.58,4,2,2,0.6778385808614568
28333,703-004-5381,8388.414,5,1,4,0.5523144210117175
28388,703-004-5380,9600.08,5,3,2,0.8639054561694709
28698,703-004-5381,6959.3345,"","","",0.27920371738274696
29017,703-004-5399,6371.7627,5,1,4,0.7175498172377817
29029,703-004-5382,4380.2803,"","","",0.27920371738274696
29091,703-004-5388,4682.1304,2,2,0,0.5189989934057416
3024,703-004-5391,522.2243,7,2,5,0.864418719826359
30441,703-004-5383,1928.5542,2,1,1,0.5137086864493052
30504,703-004-5387,6578.7896,1,0,1,0.27920371738274696
30549,207-008-2398,4.5388937,3,1,2,0.6679577229801696
30781,207-008-2398,4395.9097,2,0,2,0.27920371738274696
30788,703-004-5387,4062.6877,5,4,1,0.92666005344736
30833,703-004-5390,506.6824,1,0,1,0.27920371738274696
30997,703-004-5384,9588.84,2,1,1,0.8855368514313322
31323,703-004-5397,2586.165,3,1,2,0.3804107659965474
31617,703-004-5381,639.8588,3,3,0,0.913147643502229
31734,703-004-5398,2786.954,5,4,1,2.0633434186000885
32096,703-004-5397,9893.16,2,1,1,0.563139609424008
32313,703-004-5392,6394.076,6,3,3,1.2326532866610551
32335,703-004-5384,8272.207,2,1,1,3.1237753336486316
32533,207-008-2399,4663.9683,5,1,4,0.8914167118908548
32682,703-004-5393,2666.5527,4,1,3,0.35831143730785864
32983,703-004-5393,2362.2585,6,2,4,1.0382858922294005
33179,703-004-5392,9291.387,4,2,2,0.6898953084391305
33708,703-004-5393,5141.088,5,3,2,1.5215873952839298
33741,703-004-5399,7277.228,1,1,0,0.3978652972704144
33778,703-004-5397,1199.5226,"","","",0.27920371738274696
33925,703-004-5397,1137.9719,4,2,2,1.454035443095203
3413,703-004-5382,1473.1395,4,2,2,0.8342265288028772
34410,703-004-5396,218.96838,6,3,3,2.332877733420442
34473,703-004-5389,1881.0433,2,1,1,0.33853450732658075
34546,703-004-5396,5122.0347,2,1,1,0.6056423570972506
34726,703-004-5392,4812.5146,5,1,4,0.3978652972704144
34808,703-004-5397,3076.0598,5,2,3,0.47916259292284435
3499,207-008-2398,2870.2192,7,5,2,4.61467535988151
35105,703-004-5389,3641.8127,2,1,1,0.5123510607964099
35311,703-004-5387,5093.457,4,3,1,1.1078444301121135
35415,703-004-5389,4212.874,6,4,2,1.522454693343706
35419,703-004-5385,7902.0337,5,3,2,1.4398966462882063
35455,703-004-5398,3506.679,4,0,4,0.27920371738274696
35526,703-004-5390,9816.791,2,0,2,0.27920371738274696
35593,703-004-5381,8759.568,1,1,0,0.5023380217478577
3562,207-008-2398,7236.8413,4,2,2,0.7228908296409886
35695,703-004-5398,7570.3574,6,1,5,1.9843534386574053
35799,703-004-5382,8933.838,5,1,4,0.6010782784537468
36045,703-004-5399,4516.1255,3,1,2,0.3769113378077091
36189,703-004-5393,5809.4956,3,1,2,0.8486729610095121
36273,703-004-5383,8968.998,8,2,6,2.5575825890342148
36293,703-004-5384,9927.881,5,3,2,4.302598780696682
36314,703-004-5392,2019.9424,4,4,0,2.773979976108823
36466,703-004-5390,5935.5493,5,3,2,1.319137131146551
36489,703-004-5381,1.6987324,5,4,1,1.2443071455929993
36543,703-004-5390,4327.371,4,1,3,0.7894375758862013
36741,703-004-5383,3660.149,4,1,3,0.9897529415398667
36784,703-004-5398,2873.724,3,3,0,1.3937577119573397
36918,703-004-5390,1006.2313,8,4,4,2.176153829060488
37109,703-004-5391,3821.9458,2,2,0,1.195981231943446
37120,703-004-5380,6107.313,5,1,4,0.4403957504995141
37290,703-004-5397,2348.0708,4,3,1,2.10454944953333
37518,703-004-5386,3585.49,2,1,1,0.3648707857516491
3754,703-004-5389,7385.629,3,2,1,0.7301177209558832
37721,703-004-5383,8152.8354,1,1,0,1.3528898063853918
37804,207-008-2398,9413.485,"","","",0.27920371738274696
38147,703-004-5395,2936.0957,5,2,3,0.6574329919152772
38209,703-004-5388,9220.174,5,2,3,0.7880875342741543
38236,703-004-5386,5202.1,3,2,1,0.673403554754476
3853,703-004-5391,4039.4133,5,3,2,0.6845729128967816
38698,703-004-5389,2791.6365,4,0,4,0.27920371738274696
38717,703-004-5381,6145.94,4,1,3,0.4648266860320246
38851,703-004-5388,2227.3738,1,1,0,0.6638252729610779
39206,703-004-5399,6562.2812,5,3,2,1.1362527874485937
39328,703-004-5394,5981.882,8,6,2,3.0849736647395485
39424,703-004-5398,7716.275,3,2,1,1.0899481158518758
39718,703-004-5385,9878.966,8,3,5,1.2011870102486806
39795,703-004-5394,4297.2305,8,2,6,0.84675667490085
39863,703-004-5386,2587.893,3,2,1,0.9269190522362296
4010,703-004-5389,7316.0566,5,3,2,1.089652603648599
40189,703-004-5394,7293.8745,1,0,1,0.27920371738274696
4027,207-008-2399,9089.652,7,5,2,1.7744856075781157
40499,703-004-5388,4266.0957,5,3,2,1.1136378870671282
41011,207-008-2399,2688.4253,6,3,3,1.0192876521525074
4153,703-004-5393,2624.377,4,3,1,2.078215841176349
4155,703-004-5387,8377.764,1,0,1,0.27920371738274696
41577,703-004-5393,6474.17,4,1,3,0.9429017025003127
41726,703-004-5388,9294.841,3,3,0,2.4981537101444675
41854,703-004-5386,8563.157,10,4,6,2.963165062795501
41887,703-004-5388,8026.04,8,4,4,1.2575059658193863
41889,703-004-5398,1989.6471,3,1,2,0.3978652972704144
41894,703-004-5393,288.54608,4,2,2,1.1716330578963985
4213,703-004-5386,3533.6113,6,3,3,1.4475873573974958
42411,703-004-5396,2853.2058,3,2,1,1.0491732581807567
43007,703-004-5384,736.9316,6,1,5,0.6414074898855319
43227,703-004-5386,6354.6694,6,4,2,2.2971467497842677
43293,703-004-5388,8009.541,2,2,0,0.8295048080603157
43597,703-004-5396,8900.84,6,5,1,1.5667305749063438
43671,703-004-5396,938.645,3,1,2,0.35831143730785864
43760,703-004-5399,6289.051,4,1,3,0.4341398801946117
43829,703-004-5390,6334.9043,2,2,0,0.6957032436009817
43971,703-004-5393,5148.474,5,2,3,0.5879335680350187
44131,703-004-5386,9283.206,6,2,4,0.9468006888454947
44156,207-008-2399,6777.6196,4,4,0,3.0975961936851633
44278,703-004-5385,4446.46,4,1,3,0.35831143730785864
445,207-008-2399,1244.421,5,3,2,1.439647474966941
4460,703-004-5395,1476.8105,4,2,2,0.8642694296320365
4486,207-008-2398,5691.6226,3,2,1,1.019083761482815
45133,207-008-2398,9241.077,8,4,4,1.2517094629084635
45381,703-004-5384,4746.2886,"","","",0.27920371738274696
45443,703-004-5397,3467.4622,5,3,2,1.4642082085787473
45917,703-004-5398,3628.0793,5,2,3,0.5753375979410866
45942,703-004-5384,9495.146,2,2,0,1.5064525818242072
46062,703-004-5388,9455.909,2,1,1,0.5941718921545651
46471,703-004-5397,3489.5813,1,1,0,0.36473854572562975
46648,703-004-5397,8826.241,6,3,3,0.7932228183220105
46789,703-004-5380,8871.138,2,1,1,0.5309552628300697
47156,703-004-5390,7681.235,2,1,1,0.3919322182760311
47402,703-004-5397,5880.905,6,4,2,1.9424284361851203
4753,703-004-5383,4268.9316,2,0,2,0.27920371738274696
47584,703-004-5396,161.13937,1,1,0,0.430678832410609
47601,703-004-5380,2774.899,4,2,2,0.9124959390725013
47803,703-004-5396,5196.436,2,1,1,0.4613207513891604
4840,703-004-5387,4143.21,"","","",0.27920371738274696
48542,703-004-5382,4975.6963,"","","",0.27920371738274696
49009,703-004-5386,869.09534,5,3,2,1.0120941049241594
49441,703-004-5385,1112.8992,2,1,1,0.5501302803155708
49663,703-004-5383,4144.6,5,3,2,0.624730558344063
49718,703-004-5390,4828.091,9,6,3,1.5929188059610082
49853,703-004-5382,1254.1628,7,3,4,1.433788149652696
5293,703-004-5384,43.876766,1,1,0,1.2429611133563898
5695,703-004-5387,1707.0919,4,4,0,1.112750843630384
5790,703-004-5383,5370.4663,4,1,3,0.8117321065311125
5868,207-008-2398,5287.868,3,1,2,0.4737573522920102
602,703-004-5390,6513.779,3,2,1,0.838916131730096
6490,703-004-5393,9547.233,4,1,3,0.8734614540831167
6610,703-004-5393,5755.7954,2,1,1,0.3978652972704144
6677,703-004-5392,5979.695,2,1,1,0.6646380512619117
676,703-004-5390,6090.9795,1,1,0,1.0011836180148928
6800,703-004-5399,3776.0073,6,1,5,0.7546770839089452
6821,703-004-5387,6323.2188,1,0,1,0.27920371738274696
7044,703-004-5391,2171.477,3,3,0,2.353163798976752
706,703-004-5397,589.1669,7,2,5,1.332011954547746
7403,703-004-5393,7865.074,5,3,2,1.331762786105103
7461,703-004-5391,4594.352,4,1,3,0.4228045622309853
7703,703-004-5395,6082.323,3,0,3,0.27920371738274696
7973,703-004-5396,4694.1274,6,2,4,1.2531641068528758
810,703-004-5397,8196.355,1,1,0,0.4180377658513179
8238,703-004-5388,1769.5367,7,2,5,1.137050919403889
8240,703-004-5394,470.9953,4,2,2,1.6272007627366152
8617,703-004-5388,6775.6826,2,2,0,0.9124624811421908
9149,703-004-5390,4513.1655,6,2,4,0.6705404257062116
9213,207-008-2398,3254.208,1,0,1,0.27920371738274696
9382,703-004-5386,1259.2554,6,5,1,1.3002131335523666
9457,703-004-5381,364.18616,7,5,2,1.9932310000702826
9709,207-008-2399,8255.677,2,2,0,0.5021886029216555
9768,703-004-5382,4863.2705,1,1,0,0.8749923254706625
9798,703-004-5398,8612.527,6,4,2,1.1715528547987788
996,703-004-5392,5984.683,3,1,2,1.5846037391035726
10336,703-004-5380,2472.537,3,2,1,0.41764222725169237
1073,703-004-5391,2697.484,2,1,1,0.447163621262387
10823,703-004-5386,7170.5317,2,1,1,0.35831143730785864
10852,703-004-5399,7710.3667,3,0,3,0.27920371738274696
11041,703-004-5387,1689.4078,6,3,3,1.1541432440843467
11085,703-004-5383,8742.495,8,3,5,1.2059041173520924
11086,703-004-5397,7395.152,7,1,6,0.8355723935257353
11092,703-004-5384,9822.492,9,3,6,1.5010538638069464
11315,703-004-5387,7195.4453,1,1,0,0.5568718143198889
11458,703-004-5388,7408.9653,7,4,3,1.0104086708807358
11627,703-004-5396,8231.74,3,2,1,1.5951135524287483
11647,703-004-5393,4619.7124,2,0,2,0.27920371738274696
11665,703-004-5398,6617.5615,5,0,5,0.27920371738274696
11885,703-004-5381,7673.404,7,5,2,1.3861698995361855
12093,207-008-2398,3329.134,5,1,4,1.2409539396121354
1219,703-004-5398,2796.008,7,4,3,2.2090324649216906
12867,703-004-5395,4385.2407,"","","",0.27920371738274696
13295,703-004-5398,296.01395,7,4,3,1.946049144062954
13417,703-004-5391,2903.3547,1,0,1,0.27920371738274696
13496,703-004-5392,6664.5234,5,4,1,1.5709787886415139
13502,703-004-5382,8105.601,5,1,4,0.32666834933781397
13505,703-004-5386,5830.5723,3,3,0,1.9817778537403348
13650,703-004-5386,7417.15,5,2,3,0.4397216737523252
13812,703-004-5387,1711.3203,"","","",0.27920371738274696
14006,703-004-5383,9775.116,5,4,1,2.151389602106755
14021,703-004-5389,7943.2417,2,1,1,0.8062677418268511
14031,207-008-2398,4202.2227,4,1,3,0.5562626087844937
14088,703-004-5382,6889.083,4,3,1,1.02623109236586
14333,207-008-2398,272.35806,5,2,3,0.5629087221966739
14765,703-004-5395,5225.7285,3,2,1,0.8201659804646089
14893,703-004-5392,4174.791,3,1,2,0.49494530231601236
15169,703-004-5385,3230.8298,8,6,2,1.7239755865342314
15181,703-004-5389,3095.0552,2,0,2,0.27920371738274696
15427,703-004-5381,7021.513,6,4,2,1.6744421373221159
15559,207-008-2398,8896.43,3,2,1,2.2738553106508146
15796,703-004-5389,9722.327,5,4,1,1.1258246405580978
15941,703-004-5380,6442.7495,3,2,1,1.282782288636895
15999,703-004-5388,8655.926,2,2,0,0.5024300462751768
16275,703-004-5381,541.80743,"","","",0.27920371738274696
1634,703-004-5395,2739.4778,4,3,1,1.155665354837993
1649,703-004-5384,8572.982,4,2,2,2.1169171475961077
16524,207-008-2399,3464.846,6,1,5,0.42528473342939505
16807,207-008-2399,7529.708,4,3,1,2.577066150787573
16870,703-004-5380,9739.222,4,1,3,0.6189059643840229
1719,703-004-5395,3060.273,5,2,3,1.0974579410467216
17230,703-004-5388,2083.8398,5,2,3,0.6467138132088073
17544,703-004-5397,1971.0332,5,4,1,1.2670067710703508
1761,703-004-5387,498.9314,6,4,2,2.557805383909113
17659,703-004-5385,8726.272,4,1,3,0.6216374662829848
17871,703-004-5389,1930.7101,2,0,2,0.27920371738274696
17887,703-004-5396,5177.0103,5,3,2,1.9370848650915329
18137,703-004-5382,1912.4061,5,3,2,0.6278743285927681
18572,703-004-5398,3903.7979,5,4,1,1.3826183820139175
1913,703-004-5390,7422.471,1,0,1,0.27920371738274696
19302,703-004-5391,4038.7422,4,1,3,1.1516128556025527
19800,703-004-5381,3069.2314,2,1,1,0.7491652955349142
19884,703-004-5384,4796.1094,3,0,3,0.27920371738274696
19953,703-004-5388,6523.1753,5,3,2,2.114728961205189
20130,703-004-5382,400.14386,4,1,3,0.5338648412856255
20583,207-008-2398,903.46576,1,1,0,0.48616355453664795
20874,703-004-5390,8518.019,1,0,1,0.27920371738274696
20981,207-008-2399,5022.1997,6,2,4,0.8358665494485163
21187,703-004-5386,378.4138,1,1,0,0.3889656787788394
21236,703-004-5385,4867.417,1,1,0,0.35831143730785864
21298,703-004-5399,1639.4258,1,0,1,0.27920371738274696
21630,703-004-5387,1180.8527,4,2,2,1.435480270388657
21865,703-004-5383,5720.099,1,0,1,0.27920371738274696
2226,703-004-5388,1543.724,6,2,4,0.5733459969942933
22292,703-004-5394,2230.5835,5,4,1,1.138066209739435
22597,207-008-2398,1822.4651,3,3,0,1.147476939806137
22799,703-004-5399,3201.3691,3,2,1,0.7013359530781579
22842,703-004-5395,3961.6423,4,2,2,1.0145602541913012
2301,703-004-5386,5202.356,8,5,3,3.0830730651853515
23105,703-004-5387,6888.074,2,1,1,0.728377884047878
23297,703-004-5388,7205.3115,6,4,2,2.5116900713895554
23564,703-004-5384,8620.716,3,1,2,0.35831143730785864
23605,703-004-5383,2509.492,2,0,2,0.27920371738274696
23746,703-004-5380,8581.841,3,1,2,0.4483873464627329
2378,703-004-5386,911.64233,7,3,4,1.8603889643601466
23839,703-004-5387,9998.189,3,0,3,0.27920371738274696
2399,703-004-5383,3681.2593,2,1,1,0.8611398820818494
24237,703-004-5392,5141.956,2,1,1,0.42983889103007383
24382,703-004-5397,647.82855,2,1,1,0.5081258348049519
24550,703-004-5381,2581.5427,7,4,3,1.5910376601339653
24564,703-004-5391,4079.6555,5,3,2,0.878524361570552
24867,703-004-5399,122.14303,"","","",0.27920371738274696
24908,703-004-5388,8631.734,5,2,3,0.6351884570457493
24943,703-004-5383,9720.052,5,2,3,0.6351884570457493
25118,703-004-5393,8490.102,5,1,4,0.3131070259220805
2527,703-004-5384,1836.8125,4,2,2,0.5107960054352114
25301,703-004-5384,6074.653,7,3,4,2.1218312893303786
2548,703-004-5395,5165.622,5,5,0,1.8477325655146741
25518,703-004-5385,6962.177,1,0,1,0.27920371738274696
25729,703-004-5380,1473.7821,6,1,5,0.8202916168260638
25938,703-004-5385,8977.085,6,3,3,0.7279171159889162
26468,703-004-5397,5697.8657,4,2,2,1.770132106964547
26555,703-004-5381,7095.514,"","","",0.27920371738274696
26618,703-004-5394,6279.141,3,1,2,0.7182515629671166
26721,703-004-5392,5472.229,5,3,2,1.1277833440945724
27147,703-004-5381,9669.872,3,1,2,1.199631587766892
27272,207-008-2398,7720.0625,4,1,3,0.4660607159825171
27655,703-004-5384,7188.9053,4,3,1,1.0348439648890766
27817,207-008-2399,7002.647,4,0,4,0.27920371738274696
27875,703-004-5398,3513.0198,5,0,5,0.27920371738274696
27917,703-004-5393,8459.757,5,4,1,1.1009872431316483
28210,703-004-5383,3459.1406,5,3,2,2.8001214971652746
28392,703-004-5398,5052.0664,1,0,1,0.27920371738274696
28588,207-008-2399,7962.431,6,1,5,0.5665978285588981
2883,207-008-2399,1730.4093,4,1,3,0.911330606342658
28836,703-004-5393,275.38895,"","","",0.27920371738274696
28842,703-004-5398,7640.815,4,2,2,0.7376121426823635
29198,703-004-5380,8690.578,2,2,0,0.7738829450679835
2990,703-004-5387,9044.301,4,3,1,0.6390181032489193
30046,703-004-5388,5741.7153,3,1,2,0.3250491131955969
30340,703-004-5380,4878.668,2,0,2,0.27920371738274696
30898,703-004-5395,2718.584,5,3,2,0.7803304314306381
31058,703-004-5385,1128.2832,4,2,2,1.6930554451005662
31142,207-008-2398,9162.869,6,3,3,0.6993323676732148
31238,703-004-5399,3383.1494,7,4,3,2.257706898891518
31296,703-004-5398,5147.0576,6,3,3,1.2787532794910983
31300,703-004-5397,3181.5017,2,1,1,0.3978652972704144
31412,703-004-5397,5139.463,6,3,3,0.683649727527654
32197,703-004-5392,8432.626,1,1,0,0.44815638213530573
32239,703-004-5386,7730.338,8,7,1,4.587230467110042
32386,703-004-5383,8181.653,2,1,1,0.32666834933781397
32421,703-004-5390,5263.8574,6,2,4,0.4053650799367522
32451,703-004-5390,8265.291,8,3,5,1.3044249755060722
32569,703-004-5382,6541.615,5,3,2,0.7374517752054278
33490,207-008-2398,8625.147,8,4,4,1.4372893796705435
33618,703-004-5388,8396.227,9,4,5,1.4911174475521758
33672,703-004-5390,789.0505,2,2,0,0.6050005291928238
34125,703-004-5390,9952.764,1,1,0,0.834690718262921
34321,703-004-5386,9622.66,7,4,3,1.3907487625767005
34517,207-008-2398,1113.1173,7,3,4,0.7845734019448911
34737,703-004-5391,8869.918,4,4,0,2.590317818446413
34754,703-004-5399,3125.7463,2,1,1,0.5120957856778032
34845,703-004-5394,165.60971,1,0,1,0.27920371738274696
34948,703-004-5393,1738.3706,4,2,2,0.545243041683207
35168,703-004-5389,9387.585,5,1,4,3.8657268402742435
35477,703-004-5394,945.068,2,1,1,2.414054829047449
3571,703-004-5390,2435.7683,1,1,0,0.33853450732658075
3587,207-008-2399,2376.833,6,4,2,3.779692432999166
35932,703-004-5397,1751.1844,6,5,1,3.715184443340076
36072,703-004-5386,3770.4067,7,5,2,1.929621945607061
36515,703-004-5388,7499.541,7,1,6,0.37008690983227377
36529,703-004-5393,6515.809,5,3,2,1.7415237544231206
36556,703-004-5387,4358.9165,7,5,2,1.8445604759327119
36731,703-004-5384,6345.315,3,0,3,0.27920371738274696
36754,207-008-2398,5835.8706,5,0,5,0.27920371738274696
37036,703-004-5399,4336.629,"","","",0.27920371738274696
37063,703-004-5389,8781.647,6,2,4,1.5869890548588133
37184,703-004-5388,3411.9033,3,3,0,1.558105939565363
37195,703-004-5399,668.3725,4,2,2,0.5473093054592422
37534,703-004-5380,2886.5212,4,2,2,0.4517459841977722
37701,703-004-5397,5258.4336,5,1,4,0.7911214808683369
38067,703-004-5398,3354.7974,4,1,3,0.6056551524477339
38257,703-004-5393,3813.1143,6,3,3,1.5432539916808892
38638,703-004-5384,7691.1074,"","","",0.27920371738274696
38960,703-004-5389,124.915245,4,3,1,1.3997322912485435
39057,703-004-5388,2832.6929,6,3,3,0.9559137477542137
392,207-008-2398,865.7861,3,2,1,1.2454840957286926
39437,703-004-5387,9223.613,3,2,1,0.7808903375336702
39962,207-008-2398,9846.206,1,1,0,0.33853450732658075
40082,703-004-5395,6628.048,5,3,2,0.8663500177711498
40430,703-004-5392,7243.6694,1,1,0,0.35831143730785864
4061,703-004-5391,3146.2795,3,2,1,0.6628761590195383
40892,703-004-5388,9368.661,5,1,4,0.40569644009299677
41047,703-004-5384,6402.5234,7,4,3,2.62641940731583
41081,703-004-5386,1151.5283,2,1,1,0.9970229799846317
41083,703-004-5392,5236.845,5,3,2,2.6404314610366635
41735,703-004-5392,8202.364,3,3,0,1.9502292094849245
41819,703-004-5382,4838.5303,3,1,2,0.5773448684057402
41861,207-008-2399,7584.0386,2,1,1,0.33853450732658075
42220,703-004-5399,3989.663,3,0,3,0.27920371738274696
42323,703-004-5384,2585.916,4,3,1,0.624242943731005
42702,703-004-5388,3752.6953,5,4,1,1.2675223363393628
42733,703-004-5394,2348.9243,4,2,2,1.3793399322995132
42757,703-004-5384,5369.165,7,5,2,1.6773146510710901
4281,703-004-5391,5390.978,6,1,5,1.6762396600243776
42825,703-004-5387,8872.975,3,1,2,0.5102755174472782
4284,703-004-5392,5644.3013,4,2,2,0.8084954603810441
43219,703-004-5389,9737.358,5,3,2,1.8018109679848293
43236,703-004-5391,3968.8325,8,5,3,1.0243734496222363
43276,207-008-2399,3908.8809,1,1,0,0.4476431389689293
43314,703-004-5393,4753.6016,4,0,4,0.27920371738274696
43350,207-008-2399,2773.6277,2,2,0,0.6576880536583598
43402,703-004-5386,1272.9401,3,1,2,0.40475810027308573
43530,703-004-5382,6276.2637,9,5,4,1.865730214969445
43725,703-004-5381,6413.933,6,3,3,1.348467772501758
43934,703-004-5397,1801.6696,4,2,2,0.7970852340172568
44211,703-004-5396,2074.8896,5,4,1,1.8540431237832735
4426,703-004-5387,8283.836,5,2,3,1.5203210313137505
44518,703-004-5385,4824.0967,6,3,3,1.0013279860197397
44595,703-004-5398,5239.655,6,5,1,1.1142111414255
45067,703-004-5397,4000.3652,6,2,4,0.40442464571420494
45217,703-004-5383,3702.4224,4,2,2,1.0264667293645633
45255,703-004-5385,9720.983,3,0,3,0.27920371738274696
4534,703-004-5384,5207.9087,5,2,3,0.7321907670092779
45681,703-004-5381,3509.141,4,1,3,0.3978652972704144
45766,207-008-2399,2970.732,5,3,2,2.1081922773584205
45768,703-004-5383,1249.0111,4,3,1,2.6128107641533678
45825,703-004-5386,6948.1655,8,6,2,5.028897177048673
45943,703-004-5381,1473.0853,7,5,2,1.7774451502724729
45966,703-004-5394,6757.204,2,2,0,0.5678960462018642
46209,703-004-5389,3189.4827,4,1,3,1.22487741889966
46922,703-004-5394,5085.856,3,3,0,1.2348311032954797
46952,703-004-5385,5962.652,3,3,0,1.7262196627645567
47011,703-004-5383,6654.2114,4,2,2,0.9025667054076548
47233,703-004-5396,9478.134,7,2,5,1.0290893379113562
47427,703-004-5396,6494.791,7,5,2,1.5409265705406867
47500,703-004-5394,751.87805,2,2,0,1.4941473560793834
47537,703-004-5398,1275.7504,5,2,3,1.2187075989530107
47546,703-004-5398,8690.448,2,1,1,0.3486207416170325
47971,207-008-2399,7027.2534,5,2,3,1.7372482549034558
48093,703-004-5391,8161.618,7,5,2,1.7803509954604173
48097,703-004-5392,48.453808,1,1,0,0.8402931693380966
48292,703-004-5390,6281.1167,6,3,3,1.0975078726786103
48364,703-004-5386,3759.032,4,3,1,2.444956316958791
48458,703-004-5384,8398.588,4,1,3,1.1657629290158873
48578,207-008-2399,4498.6206,3,3,0,5.014041900692079
48595,703-004-5384,5704.7837,3,1,2,0.6153462219935957
48938,703-004-5399,5767.9253,4,2,2,0.4759269925691846
4922,703-004-5387,3380.741,4,1,3,0.6512334137654763
49333,703-004-5393,2936.1594,3,3,0,0.6644639654478087
49766,207-008-2399,9474.88,6,5,1,1.3065484517941306
49860,703-004-5397,4790.799,5,3,2,1.599488725495503
5061,703-004-5390,4403.8306,4,4,0,2.2932444314529494
5296,207-008-2398,516.03436,1,1,0,1.0535936112183668
5371,703-004-5392,6802.0845,1,1,0,0.35831143730785864
637,703-004-5381,2180.3325,5,2,3,0.5819054461484705
6505,207-008-2399,840.80817,4,2,2,1.698629359908817
6541,207-008-2399,6383.701,5,4,1,1.5536990687551642
6553,703-004-5398,3328.8694,5,2,3,0.5857281555679512
677,703-004-5394,6659.73,4,2,2,3.786302840176274
7275,703-004-5392,7075.0713,6,3,3,0.6689084731476185
7285,703-004-5387,339.58435,5,3,2,1.033085675880426
7390,703-004-5390,8454.387,2,0,2,0.27920371738274696
7536,703-004-5392,2804.6655,2,1,1,0.35831143730785864
758,703-004-5395,9653.219,3,1,2,0.393704267640317
7623,703-004-5389,2164.8467,4,1,3,0.7711058276543064
7679,703-004-5389,7513.5,5,1,4,0.3978652972704144
7721,703-004-5390,2091.7087,2,1,1,0.3805604835367963
8243,703-004-5389,2400.4858,8,5,3,3.1440294110086615
8506,703-004-5381,6744.695,3,1,2,0.43296880319456466
8696,207-008-2398,8751.292,1,0,1,0.27920371738274696
884,703-004-5386,6103.95,3,1,2,0.3978652972704144
8924,703-004-5390,8322.965,7,4,3,1.4947492710953711
9038,703-004-5398,6661.193,4,2,2,1.6732087842792398
9162,207-008-2399,1474.9474,3,2,1,1.6063299983893298
923,703-004-5385,7995.4834,2,2,0,0.7072669626734726
9231,207-008-2399,7181.9746,4,1,3,0.42678268439979633
9547,703-004-5398,7080.149,1,1,0,0.37747528245971695
9743,703-004-5392,3986.5256,"","","",0.27920371738274696
10136,703-004-5387,3012.501,6,4,2,0.8646135509660178
10149,703-004-5397,4373.5415,3,1,2,0.7140053538417999
10299,703-004-5399,2510.215,4,0,4,0.27920371738274696
11018,703-004-5399,9043.802,5,0,5,0.27920371738274696
11075,703-004-5380,8753.118,8,1,7,0.3838169528275135
11368,703-004-5393,1182.7319,6,6,0,1.8899064744405198
11525,703-004-5385,1530.9775,3,1,2,0.5868047472057191
11591,703-004-5399,6303.4263,3,3,0,1.2402179131696536
11609,703-004-5395,1515.4552,5,4,1,1.3328658372000333
11691,703-004-5383,7825.218,4,2,2,0.9633921034833456
11713,703-004-5389,556.4714,4,2,2,1.3063472008859829
11735,703-004-5387,5166.9126,6,3,3,1.7601214835722747
11789,703-004-5384,8509.047,1,1,0,0.6858898815323933
1182,703-004-5396,3186.6199,5,2,3,0.9495321890104916
11999,703-004-5383,8798.148,6,2,4,0.49861849349580184
12071,703-004-5381,1685.636,9,3,6,1.7531056285987323
12217,703-004-5383,3924.465,7,3,4,1.212226057238029
12245,703-004-5381,7878.1455,1,1,0,0.36112964983019075
12494,703-004-5399,4846.9717,3,2,1,0.624790547001221
12502,703-004-5398,5196.6963,2,1,1,0.33853450732658075
12627,703-004-5391,836.8898,6,5,1,2.484024292040466
12669,703-004-5399,7262.308,1,1,0,1.4304113824815545
12849,703-004-5395,9851.867,1,1,0,0.3999899332780649
13042,703-004-5395,3800.084,2,2,0,0.9608095254480152
13279,703-004-5399,3603.1348,8,3,5,3.7399232848068245
13317,703-004-5399,2842.968,4,0,4,0.27920371738274696
13438,703-004-5398,8163.415,3,0,3,0.27920371738274696
13439,703-004-5386,6009.6816,4,3,1,0.8283640618974798
13988,703-004-5396,7447.0728,7,3,4,1.406704964006598
14704,703-004-5386,3801.2915,1,1,0,0.33853450732658075
14814,703-004-5389,8350.572,5,4,1,1.9748975587151878
14990,703-004-5386,4834.498,6,3,3,0.7106621660868011
15113,703-004-5385,1691.8623,9,5,4,2.109878325176235
15135,207-008-2399,2744.5103,"","","",0.27920371738274696
15200,703-004-5396,5092.262,2,1,1,0.5165268771580819
15479,207-008-2399,2645.0806,6,5,1,1.5808358832691913
15497,703-004-5388,8822.991,3,2,1,0.533337267642168
15682,703-004-5389,3786.8267,3,1,2,2.5980692075064695
15953,703-004-5399,9447.822,5,1,4,0.6589127307276549
16094,703-004-5380,681.6125,4,1,3,0.5165268771580819
16124,703-004-5396,213.58847,3,0,3,0.27920371738274696
1657,703-004-5394,353.9425,4,4,0,1.5284647930726214
16577,703-004-5384,7580.3804,7,5,2,1.6309630318044959
16916,703-004-5386,3600.3489,5,3,2,2.2861651973248547
17063,703-004-5398,4283.233,4,1,3,0.4951940128214833
17197,703-004-5388,629.99963,3,3,0,0.6382968262461931
17343,703-004-5384,6970.074,3,2,1,1.7960414812504222
17689,207-008-2399,1279.6635,6,1,5,0.35534489781066697
17698,207-008-2399,9679.751,8,3,5,1.9402935327763948
17847,703-004-5396,8416.82,5,1,4,0.35831143730785864
18003,703-004-5380,6230.733,5,3,2,2.0748960462095387
18344,703-004-5397,3715.2712,3,1,2,0.49569296668019786
1863,207-008-2399,4785.3247,4,2,2,0.5208757159058791
18801,703-004-5386,388.74686,3,1,2,0.4891265419049676
19047,703-004-5381,6704.0767,3,0,3,0.27920371738274696
19502,703-004-5386,7103.4165,3,0,3,0.27920371738274696
19854,703-004-5380,8649.005,1,1,0,0.3557651575727691
19920,703-004-5385,8144.078,5,3,2,0.6305375944335427
20258,703-004-5399,8880.3955,5,3,2,2.0187013515428496
20473,703-004-5389,4260.945,3,2,1,1.9319702887614576
21383,703-004-5388,2845.7124,4,1,3,0.5465317252983052
21631,703-004-5393,5029.5757,4,1,3,0.5126242791230045
21773,703-004-5396,7925.5264,11,7,4,3.813701297133256
21900,703-004-5385,4470.6006,3,1,2,0.3978652972704144
224,703-004-5388,3879.0906,4,2,2,0.6811068017325457
22805,703-004-5387,3656.7837,2,0,2,0.27920371738274696
23268,207-008-2398,2910.8096,5,3,2,1.2856608054068335
23504,703-004-5385,2076.6343,9,5,4,2.8148649540459734
23541,703-004-5399,1.2421608,3,2,1,0.49438067096504695
2357,207-008-2399,9320.07,3,1,2,0.35831143730785864
23903,703-004-5395,2951.7747,7,3,4,1.0287447830062197
24080,703-004-5386,6276.038,4,2,2,0.7302076666340177
24772,703-004-5393,8635.066,4,1,3,0.38311378820222286
24950,703-004-5394,7842.478,4,1,3,0.5788905443360659
25300,703-004-5380,4231.7007,2,1,1,0.9199189633681026
25728,703-004-5387,2512.927,7,3,4,1.6155733061321917
25763,703-004-5392,1508.776,3,0,3,0.27920371738274696
25929,703-004-5391,2849.6062,6,4,2,1.3837854513871093
25941,703-004-5396,3517.9866,1,1,0,1.2172228938016199
25987,703-004-5388,7619.2373,7,3,4,0.7215110927226813
26069,703-004-5399,9587.984,6,3,3,1.1613350954886614
2649,703-004-5397,3760.11,2,1,1,0.32751593205129725
26616,703-004-5398,8191.7495,5,2,3,1.2105519969113328
26726,703-004-5395,7770.0977,3,3,0,0.927204299020314
26753,703-004-5390,8632.459,5,5,0,1.4357533832736413
26776,207-008-2398,7737.3423,4,3,1,0.5347094751080439
26953,703-004-5386,3647.5813,3,2,1,0.6881064815482147
27051,703-004-5393,7743.9297,3,0,3,0.27920371738274696
27082,703-004-5383,8633.841,3,2,1,1.1654907583503296
27169,703-004-5386,8896.348,2,0,2,0.27920371738274696
2723,703-004-5388,527.4373,4,3,1,0.7556962245772518
27456,703-004-5383,2146.2876,2,1,1,1.6036310865097994
27708,703-004-5395,6474.163,3,2,1,1.9479728501233982
27745,703-004-5387,9692.831,4,2,2,0.8105729115138227
27840,703-004-5384,8010.5933,3,1,2,0.5868186334139149
28140,703-004-5388,8363.046,8,3,5,1.8244011271755864
28146,207-008-2399,8082.9043,7,4,3,1.7178359047591896
28476,703-004-5396,2481.649,4,3,1,0.8785622140122686
29015,703-004-5386,6679.59,3,2,1,0.8889160056760427
29068,703-004-5386,6591.203,1,1,0,0.6886565716082491
29157,703-004-5383,8119.7627,3,1,2,1.5509765017411512
29169,207-008-2399,1097.0759,5,3,2,1.0450842766141244
2935,207-008-2398,1073.4153,4,2,2,1.81859658446337
29414,703-004-5388,7659.0596,1,1,0,0.3978652972704144
29446,703-004-5386,2365.5635,4,2,2,0.901197135339025
29822,703-004-5399,715.0829,6,3,3,1.8424474393071026
29954,703-004-5394,9654.325,2,1,1,0.6409237667403199
30052,703-004-5397,4850.3945,6,3,3,2.5307375099284997
30333,703-004-5396,5066.3457,"","","",0.27920371738274696
30669,703-004-5380,475.5193,10,3,7,1.49710895824588
30806,207-008-2398,7672.9556,4,3,1,1.7911228457113837
30914,703-004-5382,2095.241,1,1,0,0.4658552387189306
3092,703-004-5396,1763.5482,3,1,2,0.4368229157555847
30943,703-004-5387,1421.7329,5,3,2,0.7742145065428884
31263,703-004-5383,7601.2354,2,2,0,0.9744963975488737
31829,703-004-5397,2418.9187,"","","",0.27920371738274696
31830,703-004-5380,8672.709,4,2,2,0.9503717259256443
31903,703-004-5388,5364.301,3,2,1,0.8548193558129411
3213,703-004-5390,9034.6045,2,0,2,0.27920371738274696
32449,703-004-5384,511.1319,1,0,1,0.27920371738274696
32455,703-004-5394,3996.6714,3,1,2,1.676890510489438
3252,703-004-5384,467.74625,2,2,0,0.7992454682072662
32687,703-004-5389,7742.2666,7,4,3,1.1803531030964531
32973,703-004-5385,5768.098,5,2,3,0.5009319291795172
33012,207-008-2398,4932.835,2,2,0,0.5701590510277149
33072,703-004-5384,6028.8564,4,3,1,1.3063629637327545
33099,703-004-5383,2550.698,2,1,1,0.4662232875051713
33107,703-004-5393,3776.0632,7,4,3,1.2714822333784812
33386,703-004-5388,6653.108,7,3,4,1.3869064201600276
33412,703-004-5397,5411.0884,4,1,3,0.33853450732658075
33856,703-004-5396,2852.2258,2,0,2,0.27920371738274696
33872,703-004-5380,2756.1497,5,3,2,1.8065854583874983
33881,703-004-5381,6179.9067,3,2,1,0.7887983863130344
34693,703-004-5391,6425.392,3,2,1,0.45719608721424815
34857,207-008-2399,3401.0405,1,1,0,0.5101447019003971
35135,703-004-5380,8185.9385,3,1,2,0.8155885178280363
35369,703-004-5396,2152.1855,2,1,1,1.006464608752529
3549,703-004-5393,7562.3145,9,4,5,1.4310733157784075
35598,703-004-5386,998.227,5,3,2,0.9067455374765456
35629,207-008-2398,5748.9307,5,3,2,1.2185461754056244
35686,703-004-5381,437.29007,3,0,3,0.27920371738274696
35875,703-004-5390,5074.727,7,6,1,2.6374729531797834
35948,703-004-5390,7463.241,4,2,2,1.7913059536906442
36005,703-004-5380,7711.8022,4,3,1,0.9055294505332684
36240,703-004-5390,6599.0107,8,6,2,1.3676340279574322
364,703-004-5384,849.28754,5,4,1,1.08124934525642
36643,703-004-5398,9255.448,4,3,1,0.9987450600402187
36714,703-004-5392,2840.4646,7,4,3,1.5559488407287494
36870,703-004-5395,4998.048,3,1,2,1.2088108803544513
37041,703-004-5382,300.59933,3,0,3,0.27920371738274696
37191,703-004-5383,9761.478,3,0,3,0.27920371738274696
37210,207-008-2399,3523.3052,1,0,1,0.27920371738274696
37517,703-004-5386,3821.3467,6,3,3,5.050537769982301
37874,703-004-5390,9767.268,8,3,5,1.1304373566181374
38189,703-004-5393,4914.9697,3,1,2,0.5243122310790037
38907,703-004-5394,9624.152,1,1,0,0.8150245353665744
39142,703-004-5390,3200.2139,2,2,0,0.5908197825377725
39313,703-004-5390,409.4666,4,1,3,0.7785451256962561
39360,703-004-5399,8819.166,5,3,2,0.875457864449736
39653,703-004-5380,8880.813,1,1,0,0.5165268771580819
39666,703-004-5388,8457.243,4,3,1,1.550134795000346
39799,703-004-5389,3816.4038,2,1,1,0.7594259892077707
39902,703-004-5383,6865.507,2,1,1,0.3982129695191947
39915,703-004-5394,7218.31,8,2,6,1.1989181542697502
39930,703-004-5383,797.894,"","","",0.27920371738274696
40190,703-004-5386,9732.182,3,2,1,0.4513322274747992
40192,703-004-5386,4454.8457,"","","",0.27920371738274696
40218,703-004-5381,243.8271,4,1,3,0.3978652972704144
40291,703-004-5390,5199.979,5,1,4,0.3646286934234064
40339,703-004-5380,7011.776,2,1,1,0.4032545106903127
40894,703-004-5381,5607.5884,4,2,2,0.6043584656203834
41082,703-004-5392,824.9408,2,0,2,0.27920371738274696
41272,703-004-5386,8051.101,6,2,4,1.8110015172102873
41584,207-008-2399,3486.2292,4,4,0,1.5552140679040771
41646,703-004-5397,5303.5527,4,0,4,0.27920371738274696
41648,703-004-5384,5416.961,7,4,3,1.35340236255176
41754,703-004-5386,7562.9575,3,3,0,0.7224817887542707
41853,703-004-5391,8157.9824,4,2,2,0.6400776579590122
41864,207-008-2399,7967.4194,5,3,2,1.1625885292409335
43547,207-008-2399,9894.748,5,3,2,1.740626903328832
43646,703-004-5383,9985.991,2,0,2,0.27920371738274696
43744,703-004-5395,9376.269,10,4,6,1.38880223133547
43843,703-004-5394,4616.3867,4,0,4,0.27920371738274696
43973,703-004-5381,8339.713,4,2,2,1.3657653813282058
44116,703-004-5384,1703.9597,2,1,1,0.4319617150204775
44138,703-004-5384,5276.532,5,2,3,2.124856628093455
44312,703-004-5392,4910.906,3,0,3,0.27920371738274696
44360,703-004-5396,6547.956,4,3,1,0.9241666651384454
44650,703-004-5389,6219.872,12,8,4,2.654725939740078
44651,703-004-5397,5270.305,2,1,1,0.5409373922798595
45025,703-004-5398,7467.5063,6,3,3,1.3123306518188773
45598,703-004-5386,4753.683,1,0,1,0.27920371738274696
45642,703-004-5394,6656.763,4,2,2,0.5933805024815814
45723,703-004-5397,2963.6501,3,0,3,0.27920371738274696
45780,207-008-2399,5283.4946,4,2,2,1.7781996409186007
4590,703-004-5385,876.00055,5,3,2,0.6994262475452603
45946,703-004-5387,1818.1217,4,2,2,0.7531576383743847
45981,703-004-5383,3658.4138,1,0,1,0.27920371738274696
46201,703-004-5395,7449.232,1,1,0,0.4383449099133477
46203,207-008-2398,6436.9575,3,0,3,0.27920371738274696
46249,703-004-5391,1246.9048,4,1,3,0.5789519703608036
46586,703-004-5391,6617.7446,2,1,1,0.649640524316669
46776,703-004-5394,9377.834,5,2,3,0.7322720735301359
47071,703-004-5391,6470.4644,8,0,8,0.27920371738274696
47219,703-004-5384,9846.906,2,0,2,0.27920371738274696
47550,703-004-5389,1513.3435,2,1,1,0.5866336874071768
47635,703-004-5383,5971.278,6,3,3,1.3539310008509673
47678,207-008-2398,5777.9326,2,2,0,0.9771558462681292
48391,703-004-5388,7919.6836,4,2,2,0.5757271136128282
48399,703-004-5386,1210.0989,3,1,2,0.5491963502734664
48451,703-004-5391,3324.4824,10,5,5,2.542950833341014
48756,703-004-5383,5750.108,2,2,0,1.1293870074512153
48880,703-004-5388,7609.4023,7,5,2,1.399820927912
48966,703-004-5391,5344.57,2,0,2,0.27920371738274696
49046,703-004-5381,8312.76,6,2,4,1.1432875759597472
49097,703-004-5396,3232.6604,4,1,3,0.4071750767918802
4919,703-004-5382,2666.554,6,2,4,1.1608703804712306
49785,703-004-5380,2056.6082,3,2,1,0.7829524923545236
5010,703-004-5387,7516.925,7,1,6,0.528427599072477
5028,703-004-5391,8933.398,4,3,1,0.5646230480519032
505,703-004-5388,4384.204,6,3,3,1.4237114869487637
5792,703-004-5390,21.693707,2,1,1,0.35831143730785864
5840,703-004-5386,6346.0986,4,3,1,2.777168323624297
5912,703-004-5389,7123.4854,2,0,2,0.27920371738274696
6339,703-004-5394,5969.41,5,3,2,1.1350141782709104
6349,703-004-5393,4483.5347,2,1,1,0.9973934916719719
6701,703-004-5396,832.60236,3,1,2,0.37635788591577474
6729,703-004-5386,6460.886,6,3,3,1.1400896244594725
6733,207-008-2398,6345.9175,3,2,1,0.6959439309522261
684,703-004-5399,4257.928,3,2,1,0.773605899591253
6989,207-008-2399,3308.9412,1,1,0,1.2465474388728761
7237,703-004-5387,2500.4583,3,2,1,0.7394304281805874
7269,703-004-5390,9689.834,5,3,2,1.1200191510043052
7312,703-004-5397,1594.6716,3,3,0,0.9682706001497451
7373,703-004-5380,2258.101,8,1,7,0.7340927166687764
7550,703-004-5390,9780.799,6,3,3,1.5887711466433374
7723,703-004-5398,4104.8926,1,1,0,0.5393449250865477
8044,703-004-5386,841.6808,2,1,1,1.4888396621743298
8069,703-004-5399,85.60062,2,1,1,0.868358346596324
8227,703-004-5387,479.31134,3,2,1,3.5888514509790026
8334,703-004-5389,7591.1206,2,2,0,1.0357144614038258
8413,703-004-5381,5449.8857,7,4,3,1.9562026177693908
9011,703-004-5388,6186.8467,6,4,2,0.8296145880626415
9013,703-004-5381,8263.473,6,4,2,2.086436288712514
9066,703-004-5381,9462.533,1,0,1,0.27920371738274696
9188,703-004-5391,9612.582,10,2,8,1.1596180357018409
9430,703-004-5391,2233.709,2,2,0,0.4965072819896371
981,703-004-5397,2040.6478,7,3,4,1.7992423611618966
9833,703-004-5387,3975.6543,3,1,2,0.48144145378646047
10055,703-004-5382,421.5163,1,0,1,0.27920371738274696
10210,703-004-5399,2811.4856,4,2,2,0.6202617858790447
10358,703-004-5383,923.96436,"","","",0.27920371738274696
10729,703-004-5382,3671.3313,6,3,3,1.273573250817382
10996,703-004-5387,9794.764,7,4,3,2.202431100592425
11422,703-004-5394,928.59265,5,3,2,1.4274310592815223
11631,703-004-5388,5549.174,4,3,1,0.7249434473776453
12154,703-004-5395,3281.886,4,3,1,0.7152554344125376
12219,703-004-5390,2812.9114,2,0,2,0.27920371738274696
1238,703-004-5390,122.457146,2,2,0,0.5142169732187304
12564,703-004-5381,5167.415,4,3,1,1.2894230059544283
1263,703-004-5390,2131.1016,5,0,5,0.27920371738274696
12697,703-004-5385,771.0934,3,0,3,0.27920371738274696
1275,703-004-5384,9535.263,3,2,1,1.682296938732103
12819,703-004-5383,4492.741,1,0,1,0.27920371738274696
12823,207-008-2398,4226.1772,6,4,2,1.0569091624984044
13069,703-004-5396,899.1587,1,1,0,1.4338999588154737
13125,703-004-5384,4789.956,5,1,4,1.0224479956345962
13200,703-004-5389,1740.6243,3,2,1,0.44092199144863864
13277,703-004-5383,133.84222,9,5,4,2.3292772178612347
13449,703-004-5383,7485.3267,7,3,4,0.9030231048082565
13727,703-004-5387,4933.136,1,1,0,0.5122652375952216
13817,703-004-5395,8606.247,3,2,1,0.43741915723297026
1421,703-004-5397,612.6356,7,3,4,1.7842969569852047
14243,703-004-5381,9580.146,3,2,1,0.47850083684038613
14560,703-004-5398,3068.6797,5,3,2,2.234209452245409
14572,703-004-5395,2356.1985,6,4,2,2.1390828395207375
14578,703-004-5395,6408.2197,5,2,3,0.46755445353140423
14607,703-004-5398,3727.3748,3,3,0,1.387384994028592
14650,207-008-2398,9842.369,2,0,2,0.27920371738274696
14740,703-004-5385,65.38093,3,3,0,1.3439837369489647
14782,703-004-5383,2845.1765,4,3,1,0.8661563136321253
14852,703-004-5399,1353.3306,3,1,2,0.6418158953311136
15400,703-004-5390,8649.444,5,4,1,1.4425610324895055
15724,703-004-5397,6459.663,4,1,3,0.42555299924420353
16162,703-004-5383,320.19974,5,2,3,0.7107368443204997
16429,703-004-5390,1692.5323,4,4,0,2.0426951903327795
17310,703-004-5397,2891.2734,1,1,0,0.35831143730785864
17795,703-004-5382,2520.0056,1,1,0,1.6148165236024858
1798,703-004-5395,8147.6216,6,2,4,0.932104151426275
17995,207-008-2399,4872.517,6,2,4,1.6566719839831758
1845,703-004-5391,9681.246,1,1,0,0.4746432307518288
18476,703-004-5389,2861.7234,6,2,4,0.9295021189847377
18593,703-004-5395,7540.4863,4,2,2,0.6838561181446979
18602,703-004-5396,7685.4736,5,3,2,1.297658571146117
18621,703-004-5398,6803.5776,5,3,2,1.2701171206892072
18813,703-004-5391,2561.7087,4,4,0,2.1473612028561933
18815,703-004-5399,1676.0206,3,2,1,0.8858215867718684
18864,703-004-5381,895.14197,4,4,0,3.3890481193463784
18907,703-004-5394,6476.2783,6,2,4,0.7439137806516345
19042,703-004-5382,9327.481,6,4,2,1.6230126722105092
19257,703-004-5394,4368.2026,4,2,2,0.5692694358913954
19357,703-004-5380,9247.727,1,1,0,0.44829646872267315
19562,703-004-5397,3520.2217,3,2,1,0.8893280063168935
19629,703-004-5395,4904.234,2,2,0,0.9674805156997218
19655,703-004-5385,8974.416,5,2,3,2.8985603659646086
19723,703-004-5396,4147.1143,2,0,2,0.27920371738274696
19763,703-004-5384,9640.051,2,2,0,1.6867534103561284
20107,207-008-2399,388.02026,5,2,3,2.756160554782873
20318,703-004-5393,8258.682,3,1,2,0.36408761245740096
20642,703-004-5396,6114.2207,4,2,2,0.5956345970831934
20684,703-004-5391,9663.642,7,3,4,2.054263680799887
20980,703-004-5387,6220.288,5,2,3,0.9402039656866353
20988,703-004-5394,3424.6504,4,2,2,0.5751109666201366
21378,703-004-5382,1139.1383,4,1,3,0.33853450732658075
21420,703-004-5390,4370.944,3,2,1,1.862098909566483
21434,703-004-5391,4058.8276,2,1,1,0.7028989668424072
21459,703-004-5392,2009.7363,3,0,3,0.27920371738274696
21653,207-008-2398,4216.956,3,2,1,0.4995489685233657
21713,703-004-5386,3413.2046,6,3,3,1.1893741339518293
22192,703-004-5386,2830.1782,2,1,1,0.449903344283652
22228,703-004-5399,171.03671,1,1,0,0.4252967743466629
22490,703-004-5393,9014.476,5,4,1,2.4878359461970074
23072,703-004-5382,6039.421,1,1,0,0.4402373697553024
2308,703-004-5380,3986.1147,4,4,0,1.0045624706939094
23475,703-004-5397,2365.1772,1,1,0,0.37616818228492155
23676,703-004-5395,6994.47,5,1,4,0.33473733677017536
23686,703-004-5386,4669.9937,6,2,4,0.9585679235876372
23729,703-004-5392,3939.692,4,1,3,0.8021940740382649
23844,703-004-5380,3992.9514,2,2,0,0.8689843079443266
24157,703-004-5386,2969.8848,3,1,2,0.5517305763999629
24238,703-004-5382,4494.9263,3,2,1,0.5994303407204774
24878,703-004-5394,628.5828,7,1,6,0.4611839418929776
24918,703-004-5399,7382.0903,4,3,1,1.1641783217792783
25461,703-004-5393,6036.9985,3,2,1,0.43176860580974796
25481,703-004-5395,8533.062,2,1,1,0.48177395437479614
25568,703-004-5380,4204.1904,3,1,2,1.2217375790353806
26152,703-004-5385,9777.182,3,2,1,0.8796424683120302
26171,703-004-5396,7601.2593,6,3,3,1.0703178709121148
26590,207-008-2399,3961.6047,4,1,3,0.9655924002215587
26701,703-004-5381,624.3575,3,0,3,0.27920371738274696
26751,703-004-5394,1406.6023,7,1,6,0.4820717867648829
26862,703-004-5380,9375.855,7,4,3,1.6523073328344309
27087,703-004-5395,6372.4204,2,1,1,0.35831143730785864
27350,703-004-5389,712.9294,2,1,1,1.068367066515808
274,703-004-5381,2247.0825,5,5,0,1.5436018734546397
27553,703-004-5387,2777.1802,4,2,2,0.5728474281224888
28114,703-004-5385,4020.1157,3,2,1,0.519869352511831
28396,703-004-5381,2288.7778,2,2,0,1.7013968342713532
28438,703-004-5380,8720.379,1,0,1,0.27920371738274696
28439,703-004-5392,597.3053,5,3,2,1.468604678629192
28817,703-004-5389,1211.021,6,2,4,0.6426053576066038
28841,207-008-2398,4849.2993,2,0,2,0.27920371738274696
28957,703-004-5383,5435.8237,4,3,1,1.2260502037195404
28967,703-004-5387,6355.875,1,1,0,0.44829646872267315
29101,703-004-5393,8507.802,6,5,1,1.7778487924947446
29136,703-004-5395,4716.5513,4,3,1,1.0005175171023806
29208,703-004-5391,617.1197,2,1,1,0.395890967952681
29261,703-004-5386,5553.915,"","","",0.27920371738274696
2929,207-008-2399,6483.6333,5,1,4,0.5859682668078328
29495,703-004-5398,6933.437,5,3,2,2.8608259929881377
29521,703-004-5390,926.7682,5,2,3,0.940704470350458
29594,703-004-5395,6056.2603,2,1,1,0.6298960631510644
30016,703-004-5384,5672.8105,4,1,3,0.4875612329526905
30232,703-004-5390,8057.6914,4,2,2,1.204193760811237
30443,703-004-5389,9415.405,2,0,2,0.27920371738274696
30505,703-004-5394,2499.9148,2,2,0,0.5560458575201864
30616,703-004-5394,84.11765,6,4,2,1.1436566253903868
30713,703-004-5387,5930.1416,3,2,1,1.1266205936099303
30729,703-004-5386,9247.925,2,0,2,0.27920371738274696
30786,703-004-5390,3668.654,3,2,1,0.6159511075633024
30835,703-004-5383,3243.3867,4,2,2,0.443196721539727
30922,703-004-5386,9954.407,6,5,1,2.149007944604358
3112,703-004-5391,7870.2603,6,3,3,1.3078269449775772
31364,703-004-5393,706.386,5,3,2,2.260973322862518
3139,703-004-5391,3201.9978,9,3,6,1.1749709097059757
31605,703-004-5389,9125.78,2,0,2,0.27920371738274696
31621,703-004-5392,9602.276,5,1,4,0.3401166617250829
31690,703-004-5388,1057.2064,5,2,3,3.8027068584305685
31769,703-004-5393,7024.773,2,0,2,0.27920371738274696
32196,207-008-2399,122.14959,6,4,2,2.300744033726239
32243,703-004-5383,3926.2874,6,6,0,2.870772771366179
32866,703-004-5391,7383.768,3,2,1,0.7375939665533726
33353,703-004-5397,3382.7317,4,1,3,0.5462293721999921
33393,703-004-5395,3933.2783,6,4,2,1.160403135866727
33423,703-004-5399,4140.2017,"","","",0.27920371738274696
33884,703-004-5387,1560.8406,5,2,3,0.6972124134432273
34225,703-004-5386,7195.0083,1,0,1,0.27920371738274696
34233,703-004-5389,2964.9531,4,2,2,0.8996775666215772
34653,703-004-5380,9834.487,5,2,3,0.7948809806412177
34720,703-004-5394,4546.148,6,3,3,0.8664503742344137
34794,703-004-5397,3625.539,4,2,2,0.8616555200959798
3482,703-004-5384,3895.9055,4,1,3,0.32666834933781397
34928,703-004-5390,9451.306,3,1,2,0.5127643162291436
35052,703-004-5381,2812.4011,5,4,1,2.4023986912139117
35113,703-004-5380,6369.143,3,2,1,1.488224581044785
35332,703-004-5398,6826.752,4,2,2,0.904753592074968
35439,703-004-5382,3147.8418,5,2,3,0.8127237844814499
35806,703-004-5384,6109.5386,3,1,2,0.5599167018648945
35908,703-004-5392,843.7818,2,1,1,0.3695741929225091
36120,703-004-5383,3387.5232,7,3,4,0.7185627208556578
36196,703-004-5397,4364.8154,5,1,4,0.5127632655797385
36265,703-004-5382,8410.203,2,1,1,0.6226822604351002
36304,703-004-5380,2148.7026,5,3,2,0.8747085618188737
36463,703-004-5388,3113.4795,5,2,3,0.4475953662543524
36745,703-004-5393,8920.303,5,2,3,0.776970589875214
3693,703-004-5388,2420.9355,4,1,3,1.0244228525900552
37233,703-004-5386,8202.902,3,1,2,1.6454135341735607
3737,703-004-5389,6108.118,4,2,2,1.0028898218858562
37668,703-004-5397,744.2224,5,2,3,0.8474559240984703
37706,703-004-5395,3653.2622,7,3,4,0.7471671308749264
37846,703-004-5384,2472.016,"","","",0.27920371738274696
37888,703-004-5388,1547.5875,5,4,1,1.8095584117768775
38030,207-008-2399,6791.0234,4,3,1,0.9032612666639911
38033,703-004-5393,7294.5566,7,3,4,0.8411598098301393
38037,207-008-2398,8148.8496,4,1,3,0.3525563506833067
38042,703-004-5382,4409.055,2,2,0,1.0051793807626637
38149,703-004-5381,9579.879,1,0,1,0.27920371738274696
38490,703-004-5386,8174.187,3,2,1,3.3224513096751362
38706,703-004-5386,9592.05,2,1,1,0.4584522121609208
38853,703-004-5386,8328.983,3,2,1,0.6467453148367921
38997,703-004-5396,3537.7705,3,1,2,0.9717495115294359
3919,703-004-5391,2637.9175,2,1,1,0.6239676841864807
39484,703-004-5384,8555.13,3,2,1,0.8471818673518937
39496,703-004-5385,2567.4517,6,1,5,0.9460034450652963
39598,703-004-5399,7080.281,3,1,2,0.44783898461809496
40059,703-004-5399,1785.6926,5,0,5,0.27920371738274696
4030,703-004-5390,9858.162,3,0,3,0.27920371738274696
40362,703-004-5384,5671.789,1,1,0,0.39713460020793445
41014,207-008-2398,3629.329,3,1,2,2.1531303150020786
41045,703-004-5389,566.2364,3,1,2,0.4364842944668793
41056,703-004-5395,5716.0444,7,3,4,3.208799007651571
42143,703-004-5389,9011.913,"","","",0.27920371738274696
42168,703-004-5383,3366.8267,4,3,1,0.9214534772906668
42373,703-004-5382,5221.9717,2,1,1,0.39748898624160406
42415,703-004-5391,2313.3672,4,2,2,1.1208574616720477
42528,703-004-5388,2834.0542,5,3,2,1.3398046327989388
42718,703-004-5394,8221.494,5,3,2,1.2271517283566296
42816,703-004-5381,1221.2092,4,3,1,2.2088460980513944
42866,207-008-2399,2120.9663,2,1,1,0.7543938572493023
43099,703-004-5388,353.1766,4,3,1,1.1215373247417615
43111,703-004-5387,3868.2454,2,1,1,0.32666834933781397
43132,703-004-5396,3495.6091,5,3,2,0.5715369640319407
43158,703-004-5382,3965.95,2,2,0,1.8382137470817401
43299,703-004-5390,2388.3706,3,1,2,0.5165268771580819
4345,703-004-5392,3359.9443,3,2,1,1.5252614426951967
43477,703-004-5398,2873.6638,2,2,0,0.5562383338773751
43495,703-004-5388,711.66754,3,3,0,1.133136014339578
43943,703-004-5391,3451.8003,1,0,1,0.27920371738274696
44162,703-004-5396,1503.2113,6,2,4,0.9662174574048733
44263,703-004-5385,7389.6074,2,1,1,1.2073158669338775
44296,703-004-5389,6428.6147,1,0,1,0.27920371738274696
44401,703-004-5388,1729.2172,2,1,1,0.37175974969512765
44489,703-004-5390,4064.628,7,4,3,1.809063360458646
44508,703-004-5384,9568.823,4,1,3,0.4318574067496931
44582,703-004-5388,7079.3037,1,1,0,0.7337463156538592
4489,703-004-5391,4701.9604,4,2,2,1.2439542694135297
449,703-004-5397,4856.66,3,1,2,1.8825103153407923
45008,703-004-5398,8940.493,4,2,2,1.5541284057084477
45033,703-004-5388,5852.198,3,1,2,0.9148118240489889
45118,703-004-5396,2210.133,3,1,2,0.33853450732658075
45412,703-004-5387,1906.122,1,1,0,0.34439664482504373
45601,703-004-5393,4024.0442,10,4,6,1.7142673062789806
4563,703-004-5396,9077.968,4,2,2,0.9333461509790751
46206,703-004-5388,5378.216,2,0,2,0.27920371738274696
46498,703-004-5383,6950.4873,3,1,2,0.6279767340354074
46524,703-004-5395,6919.196,4,2,2,0.6709472171289066
46660,703-004-5392,5007.606,8,4,4,1.736794101916734
46700,703-004-5389,4799.011,2,2,0,1.0540571485135273
46703,703-004-5399,8034.2637,6,4,2,2.743374658730818
47034,703-004-5382,468.80246,3,2,1,1.1217116202816355
47120,703-004-5380,3049.612,4,1,3,1.68480902594911
47255,703-004-5397,7178.7407,4,3,1,1.8345804222072162
47616,207-008-2398,3972.6733,6,3,3,0.8840343754183876
47633,703-004-5396,2491.905,5,2,3,0.6034950500924778
47851,703-004-5398,478.82617,3,2,1,2.441992304559991
47938,703-004-5390,6238.8486,6,3,3,1.7727159771283567
48096,703-004-5393,6858.936,5,3,2,1.8423525543414916
48414,703-004-5395,5807.9883,7,4,3,1.5478553827116162
48417,703-004-5393,2907.5884,4,3,1,2.372583718073817
48446,703-004-5385,2897.4634,3,3,0,2.759672178735876
48613,703-004-5386,2998.993,1,1,0,0.544798916644555
48705,703-004-5395,1209.5994,6,5,1,3.3994679191534125
48933,703-004-5398,6255.271,2,1,1,0.34721788714710256
493,703-004-5398,1138.4219,5,1,4,0.3557651575727691
49327,703-004-5399,9670.669,4,2,2,0.6466991428841568
49383,207-008-2398,1573.4166,5,2,3,0.894067055536551
49406,703-004-5399,5676.383,4,3,1,1.0746224410254794
49692,703-004-5381,3752.78,5,2,3,0.8214309051520313
49949,703-004-5384,1920.1898,5,3,2,1.4895286873161078
4998,703-004-5395,5201.514,5,3,2,3.5204178882233306
5258,703-004-5391,652.42114,6,1,5,0.4987276401749318
5573,703-004-5391,8255.127,2,2,0,1.8770542999421367
5738,703-004-5387,4409.3438,6,3,3,1.7832248092861316
5768,703-004-5399,1554.8557,1,0,1,0.27920371738274696
5776,703-004-5398,8387.38,3,2,1,0.5029703820285745
5824,703-004-5398,3456.1099,2,2,0,0.5943758778937601
6012,703-004-5384,6716.885,5,3,2,1.0175610857334185
6130,207-008-2399,8822.673,4,2,2,1.8005649297693427
6195,703-004-5395,2877.5442,2,1,1,0.7666058046559756
639,207-008-2399,4284.635,3,1,2,0.49183538007645644
6419,207-008-2398,1272.3363,6,4,2,2.5520821591283007
667,703-004-5386,6445.0586,7,5,2,2.206801172759804
7268,207-008-2398,2401.4146,2,1,1,0.627814465231513
75,703-004-5397,1254.3959,3,2,1,0.7374225230230376
7863,703-004-5383,6141.1865,6,1,5,1.051049029681561
8356,703-004-5392,1138.3981,1,0,1,0.27920371738274696
8557,207-008-2398,326.23053,4,1,3,0.6849669898086257
8715,703-004-5386,5031.59,2,2,0,0.948656745328493
9012,703-004-5386,5869.316,4,1,3,0.3755634985013655
9187,703-004-5392,5320.8213,7,5,2,2.0657214676723457
9264,703-004-5384,2964.341,2,1,1,0.46783525004462356
9381,207-008-2399,1863.9153,5,4,1,0.9026841245966528
9486,703-004-5384,8273.195,8,6,2,2.011666114712034
9489,703-004-5388,1592.8894,1,1,0,0.3187575773453028
9689,703-004-5385,8935.623,5,1,4,0.6013878708404703
9771,703-004-5383,3481.6497,4,1,3,0.6274699192124602
9847,703-004-5382,9295.568,4,2,2,1.0294792672872715
997,703-004-5395,5282.501,4,0,4,0.27920371738274696
999,207-008-2399,5915.8022,"","","",0.27920371738274696
10280,703-004-5382,3469.8896,4,4,0,1.273358392953028
10382,703-004-5392,9083.401,6,2,4,0.8594886254323957
10613,703-004-5380,7893.9014,4,1,3,0.36795269067373165
10618,703-004-5389,788.09143,4,2,2,0.758589568890804
1079,703-004-5385,3238.7668,1,0,1,0.27920371738274696
11044,703-004-5384,3239.0637,10,5,5,2.286197567216248
11047,703-004-5391,4358.647,5,3,2,0.8889752023571736
11097,703-004-5397,2186.6858,4,4,0,2.977981819000493
11418,703-004-5399,9217.591,3,1,2,0.35290739119047443
11438,703-004-5389,6736.469,8,7,1,2.413140313734226
12191,703-004-5385,3423.8262,2,0,2,0.27920371738274696
12457,703-004-5388,2691.872,4,3,1,1.8527769180007083
12500,703-004-5384,7803.002,2,1,1,0.3914907213872841
1254,703-004-5397,1929.2944,6,4,2,0.9780172623684673
12585,703-004-5381,9795.925,6,4,2,1.7204158220667685
12675,703-004-5398,9821.618,7,4,3,2.01071058194143
12802,207-008-2399,7282.923,"","","",0.27920371738274696
12927,703-004-5382,7252.4204,4,2,2,2.576664968575179
13070,703-004-5393,360.7005,3,2,1,1.3589420361565576
13794,703-004-5388,8172.7427,6,3,3,2.7388292058575736
1383,703-004-5389,5522.386,4,2,2,1.0319535842594705
14097,703-004-5384,3004.6362,5,2,3,0.9057262125533349
14141,207-008-2399,9539.926,4,0,4,0.27920371738274696
14422,703-004-5389,3472.584,5,2,3,0.4830422639049128
14486,207-008-2399,4521.5605,7,4,3,1.5108321224525059
14844,703-004-5394,996.7339,7,5,2,1.350880937595371
14866,703-004-5397,2550.2349,4,3,1,0.8017432076632391
15171,703-004-5386,8262.173,4,0,4,0.27920371738274696
15781,703-004-5393,1970.2936,6,5,1,2.5352904224826376
15812,703-004-5395,3612.0361,3,1,2,0.4246979777910949
16134,703-004-5384,2444.0264,2,1,1,0.48399336228564316
1616,703-004-5396,274.44064,5,3,2,1.2642334261273855
16240,703-004-5380,1692.1002,3,2,1,0.6236551988621618
16637,703-004-5395,9798.044,5,3,2,0.9278153838630399
16729,703-004-5395,9904.29,1,0,1,0.27920371738274696
16770,703-004-5396,1623.9423,3,1,2,1.236442034860729
16772,703-004-5380,781.67737,2,1,1,0.9230325870184602
16940,703-004-5398,2406.6968,4,2,2,0.47697301719552604
17059,703-004-5381,7165.844,7,3,4,1.1217718242569417
17194,703-004-5385,1157.3643,2,2,0,0.6060820392693493
17344,703-004-5380,59.965252,4,2,2,0.893748674884362
17397,703-004-5380,7042.7515,2,1,1,0.3889656787788394
1749,207-008-2398,3563.0513,4,0,4,0.27920371738274696
17730,703-004-5381,6685.022,3,3,0,0.9394426473712814
18030,703-004-5396,9797.843,4,1,3,0.33853450732658075
18066,207-008-2398,451.33652,6,4,2,1.2944015346947215
18147,703-004-5388,3240.2188,"","","",0.27920371738274696
18443,703-004-5381,7013.263,5,3,2,1.9548718392622506
18446,703-004-5388,7432.5723,3,1,2,0.3925462251919355
18453,703-004-5397,2622.0947,5,3,2,1.1331726880452881
1874,703-004-5399,5060.3516,5,3,2,1.1687573970768868
18982,703-004-5391,8214.883,3,1,2,1.3530121480553043
19000,703-004-5389,9788.064,3,2,1,0.8643133553891073
1901,703-004-5397,2484.4397,4,3,1,1.1269430405292296
19342,703-004-5384,1345.1278,5,3,2,1.9097648352469463
19612,703-004-5387,904.6185,"","","",0.27920371738274696
19784,703-004-5399,6007.7266,5,1,4,0.4322892293794864
19936,703-004-5384,8876.139,1,1,0,0.4148410448635108
19945,703-004-5381,1202.6799,2,0,2,0.27920371738274696
20157,207-008-2398,9221.262,3,2,1,1.0814401294181026
20161,703-004-5381,4939.784,4,2,2,1.4942571155403475
20363,703-004-5397,6098.1167,5,2,3,0.873843237070878
20515,703-004-5387,51.39649,4,4,0,2.2741807990798435
20551,703-004-5389,7330.454,2,2,0,0.6124449875672797
20623,703-004-5398,4060.6301,2,1,1,0.5659337372705341
20690,207-008-2398,1288.2954,3,2,1,0.41765870802667676
20747,703-004-5384,9384.154,1,0,1,0.27920371738274696
20812,207-008-2399,3979.2395,2,1,1,0.5073044100310276
20849,703-004-5384,1481.7477,1,1,0,0.3978652972704144
2098,703-004-5392,5177.661,2,1,1,0.5269762034611302
2118,703-004-5386,1599.1622,2,2,0,1.2037497225078764
21443,703-004-5389,6319.5527,3,2,1,0.5854992305810378
21446,703-004-5391,1337.4167,5,1,4,0.35831143730785864
21499,703-004-5399,6505.068,3,0,3,0.27920371738274696
21696,703-004-5384,8107.624,2,0,2,0.27920371738274696
21925,703-004-5383,2772.8838,1,1,0,0.4735653422879187
22001,703-004-5380,8442.878,5,2,3,0.5165268771580819
22193,703-004-5396,9313.673,6,5,1,1.5384733598965545
22195,703-004-5392,5059.7026,4,2,2,0.5671123586606979
22282,703-004-5398,5239.688,8,2,6,0.562563877214566
22459,207-008-2398,724.9957,4,3,1,1.1848605100967702
22586,703-004-5399,7645.254,5,2,3,0.6078884534703812
22611,703-004-5391,49.357414,2,2,0,0.948225741034597
22909,703-004-5389,7969.0723,3,1,2,0.3978652972704144
23646,207-008-2398,3640.0615,1,1,0,0.4703901247874721
23776,703-004-5383,3609.9941,2,0,2,0.27920371738274696
23898,703-004-5386,5841.223,3,2,1,1.1778340492722141
24039,703-004-5396,5932.091,4,1,3,0.44508568149151667
2426,703-004-5393,1999.9248,3,2,1,0.8355097339616455
2437,703-004-5394,401.15237,1,0,1,0.27920371738274696
24515,703-004-5386,7925.2183,4,1,3,0.6016068622102476
24701,703-004-5393,9553.75,2,1,1,1.5092891721218973
24742,703-004-5394,8191.3506,5,3,2,1.6149157569314494
24749,703-004-5385,4776.847,3,0,3,0.27920371738274696
25075,207-008-2398,1557.9414,2,1,1,0.3543362743816218
25112,703-004-5394,4702.5024,5,2,3,0.5278351823193208
25237,703-004-5390,2524.6184,5,2,3,1.0218234209908303
25490,703-004-5381,8048.6484,4,2,2,1.413261459434227
2554,703-004-5396,8867.534,5,3,2,0.7444065528673565
25703,703-004-5396,6850.5,3,1,2,0.35831143730785864
2571,703-004-5380,2161.8735,5,2,3,0.9326035694242245
25739,703-004-5384,9218.175,3,1,2,2.5207390971094803
2603,207-008-2399,3680.8003,1,0,1,0.27920371738274696
26596,703-004-5391,1872.3262,3,0,3,0.27920371738274696
26870,703-004-5382,3806.1804,4,0,4,0.27920371738274696
26943,703-004-5394,9168.683,7,5,2,1.350187198084717
26986,703-004-5382,2263.8923,5,3,2,1.8254855326789132
27166,703-004-5395,69.32437,3,0,3,0.27920371738274696
27591,703-004-5395,1831.1316,5,3,2,2.0683656717969994
27632,703-004-5385,7554.391,1,0,1,0.27920371738274696
27662,703-004-5388,5309.78,5,4,1,1.2341550720196193
27782,703-004-5398,3460.3894,3,2,1,0.8687937899343658
28093,703-004-5382,7699.8613,6,3,3,1.7576699800127507
28303,703-004-5385,7914.4233,6,2,4,0.6032142306071596
2831,703-004-5395,6201.621,6,3,3,3.561378498652631
28322,703-004-5383,1564.6648,5,2,3,1.0248078182140787
28413,207-008-2399,5512.861,3,1,2,0.517342565372907
28419,703-004-5391,7058.17,7,4,3,1.3743544583303737
29373,703-004-5387,5659.248,1,1,0,0.9796240382138905
29451,703-004-5386,7711.346,5,2,3,0.7573590692378609
29533,703-004-5396,5820.0684,3,2,1,0.5249427488521696
29820,703-004-5396,9301.122,4,0,4,0.27920371738274696
30035,703-004-5398,9938.31,4,1,3,0.9014337939450683
30187,703-004-5387,5448.721,4,4,0,3.845759297464445
30381,703-004-5390,3026.7383,1,1,0,1.3090115613103528
30439,703-004-5394,3783.5347,1,1,0,0.35831143730785864
30451,703-004-5380,6209.4854,2,1,1,0.9665703434014701
30499,703-004-5399,707.2526,5,2,3,1.6226660675961275
30676,703-004-5384,9491.941,8,1,7,0.39829505709890495
30830,703-004-5398,7630.435,3,1,2,0.921334251884058
31134,703-004-5390,9601.152,3,3,0,1.0354417253185415
31232,703-004-5396,8779.326,4,3,1,1.5003022002488395
3224,703-004-5387,7369.2476,7,4,3,2.408291717756681
32318,703-004-5389,5069.4106,6,5,1,2.0966074994360326
32339,703-004-5396,8579.325,10,7,3,1.4379570072170187
32359,703-004-5390,8647.679,4,3,1,1.5112447475858197
32418,207-008-2398,912.96497,"","","",0.27920371738274696
32507,703-004-5392,6876.2554,5,3,2,0.7311065674549471
32548,703-004-5390,1430.8274,3,2,1,0.7094925313067704
32632,703-004-5390,3927.796,4,1,3,0.5727117327021842
3285,703-004-5383,4414.819,3,1,2,0.4393377309329882
32993,703-004-5389,2298.8267,6,4,2,3.5264596560686825
33368,207-008-2399,9446.363,3,1,2,0.6173892200625992
3340,703-004-5389,6082.296,4,4,0,1.46631016604886
33509,207-008-2399,2155.0798,3,2,1,0.5609623426710164
33694,703-004-5392,4429.605,5,2,3,1.0821291489512743
33766,703-004-5385,6969.8833,3,1,2,2.0408973091127938
33904,703-004-5398,2952.7224,6,3,3,1.1022779394832036
33934,703-004-5397,4416.0493,4,3,1,0.7465393286231204
33993,703-004-5383,6135.268,2,1,1,0.5342587992581095
34284,703-004-5389,621.58704,2,0,2,0.27920371738274696
34332,703-004-5397,3350.058,6,2,4,0.6006430092772114
34385,703-004-5380,6997.017,2,2,0,1.1132650196395244
34535,703-004-5386,8019.773,"","","",0.27920371738274696
34578,703-004-5395,3866.8364,7,2,5,0.8367332213281296
34632,703-004-5382,6389.7837,4,3,1,1.121401793187823
35001,703-004-5394,5592.1577,6,3,3,1.5874642218914667
35005,703-004-5390,8018.6616,9,2,7,1.1351156794173665
35192,703-004-5391,7609.6587,9,4,5,2.2517540102609486
35254,703-004-5396,2818.2798,4,4,0,1.538149815953561
35324,703-004-5380,609.3764,3,2,1,1.0419711336037785
35333,703-004-5380,5322.1216,4,1,3,0.3978652972704144
35503,703-004-5391,3194.0813,4,2,2,0.4493665860433788
35694,703-004-5382,853.16895,4,3,1,1.1885939281306104
36055,703-004-5394,2098.17,3,0,3,0.27920371738274696
36270,703-004-5382,2911.982,4,2,2,0.6750270094815292
36410,207-008-2398,2310.502,3,3,0,1.221259581250915
36513,703-004-5393,4291.334,2,1,1,0.4408040032895532
36866,703-004-5381,6491.929,4,1,3,1.0194682976014962
36960,703-004-5380,3433.6936,5,3,2,1.1034344403280978
37048,703-004-5391,8024.2705,3,1,2,0.3978652972704144
37900,703-004-5399,5059.858,4,1,3,0.6173892200625992
38024,703-004-5392,1596.9307,4,1,3,0.47123789969818375
38675,703-004-5391,6870.171,3,0,3,0.27920371738274696
38757,703-004-5384,5536.4683,2,0,2,0.27920371738274696
3892,703-004-5381,8513.338,2,2,0,1.4482263378740265
38996,703-004-5392,9913.237,2,1,1,0.703204808963103
39038,703-004-5383,5850.647,2,1,1,0.6028202149763912
39055,703-004-5383,2722.46,6,4,2,1.803484246881475
39148,703-004-5395,891.3654,2,0,2,0.27920371738274696
39408,703-004-5396,7323.7173,6,2,4,0.9463490869904737
39997,703-004-5388,3558.8396,6,3,3,0.8889678449556222
40069,703-004-5381,4188.316,5,2,3,1.1672383375316056
40087,703-004-5380,5807.8076,5,1,4,0.8637727274532118
40296,703-004-5390,7423.8726,4,2,2,1.70195634091082
40330,703-004-5399,4168.9473,10,4,6,1.1939348490020916
40373,703-004-5387,520.1691,5,2,3,0.5614943858680047
40606,703-004-5385,6526.0645,2,0,2,0.27920371738274696
40619,703-004-5385,4496.2524,4,0,4,0.27920371738274696
40638,703-004-5395,6174.213,4,1,3,0.6095439141096463
40782,207-008-2398,8132.584,2,0,2,0.27920371738274696
41005,703-004-5383,5011.199,4,1,3,0.3896103737346791
41021,703-004-5395,9757.664,3,1,2,0.7777831829899142
41046,703-004-5394,1825.4637,5,1,4,0.47049561270104523
41120,207-008-2398,1819.7065,3,0,3,0.27920371738274696
41370,703-004-5397,5566.357,8,4,4,2.5438492000290993
41454,703-004-5384,3551.7227,3,0,3,0.27920371738274696
41723,703-004-5394,3772.182,"","","",0.27920371738274696
41845,703-004-5397,6760.883,2,1,1,0.3464986635249618
41938,703-004-5385,6757.5933,2,1,1,0.6991349243411096
42104,703-004-5395,209.046,6,4,2,1.9392717117389602
42227,703-004-5395,4579.3794,5,2,3,0.7439615719427779
42619,703-004-5391,2584.8972,4,0,4,0.27920371738274696
4280,703-004-5393,2878.5627,5,3,2,0.9372259817270719
42895,703-004-5397,4283.3965,3,1,2,0.5540186429836695
42929,703-004-5385,1548.3821,3,1,2,0.4662275519056985
42999,703-004-5390,5609.3037,5,2,3,0.5397999210247287
43201,207-008-2398,2822.3772,3,3,0,2.618771260614856
43260,703-004-5393,1919.7887,1,0,1,0.27920371738274696
43369,703-004-5397,5446.9453,3,3,0,2.021912089403785
43410,703-004-5398,3019.0176,5,4,1,1.3640692462006465
44066,703-004-5398,4926.256,4,2,2,0.6539464743803437
44570,703-004-5390,1457.3425,5,2,3,0.9508251650927171
44919,703-004-5394,1406.43,5,3,2,1.4856499427465644
45114,703-004-5382,784.97766,4,2,2,0.7489803153728678
45124,703-004-5398,2503.0898,7,4,3,1.3878274011441045
46375,703-004-5393,3635.5466,6,2,4,0.7796138662747364
46671,703-004-5386,8521.024,4,2,2,0.5161972616583939
47345,703-004-5394,1053.13,4,1,3,0.35534489781066697
47446,703-004-5393,1756.9858,3,0,3,0.27920371738274696
47472,703-004-5395,7987.52,4,2,2,0.8081273191553507
4752,703-004-5393,6813.817,4,1,3,0.39819627197623936
47608,703-004-5394,7772.7646,6,4,2,3.1078668990434464
47955,703-004-5389,4185.772,5,3,2,1.671297230592593
47958,703-004-5392,4467.073,7,1,6,0.44829646872267315
48209,703-004-5390,2599.7205,5,3,2,2.23225544377888
48277,703-004-5395,3116.1653,2,0,2,0.27920371738274696
48318,703-004-5381,8337.483,4,2,2,1.2773373711243132
48320,703-004-5391,4652.1816,3,3,0,2.252292924833407
48568,703-004-5384,2377.2866,3,2,1,0.46511557824275296
48958,703-004-5395,6999.1826,5,3,2,0.6968979791002493
49030,703-004-5395,9195.019,4,2,2,1.007071788127886
49151,703-004-5389,692.6751,6,4,2,1.8061106247426795
49277,703-004-5399,3893.8772,6,5,1,1.2682976550168623
49304,703-004-5386,6487.8584,3,2,1,0.6486481055004787
4954,703-004-5391,3187.9758,4,2,2,0.6068415240725843
49757,703-004-5385,3810.4624,3,1,2,0.559163307964043
5536,703-004-5385,7319.0254,3,1,2,0.6656864134814271
5742,207-008-2398,8173.4385,4,3,1,1.5533940457616033
6025,703-004-5384,5647.834,2,0,2,0.27920371738274696
6180,703-004-5389,5639.779,3,2,1,1.328159543278986
6200,703-004-5383,3861.382,3,1,2,0.6388224679298091
6513,703-004-5395,3800.54,5,4,1,1.2052040135112188
6984,207-008-2398,6515.721,10,5,5,1.7108691793267266
7048,703-004-5389,1435.331,2,2,0,1.2470715528969856
7115,207-008-2399,8586.958,5,1,4,0.4262734019874917
7321,703-004-5383,8708.653,3,1,2,2.1957704997819794
7559,703-004-5389,1331.2799,2,1,1,0.33853450732658075
7782,703-004-5398,3822.1575,4,2,2,0.9257823441596612
7909,703-004-5383,1558.7949,6,2,4,0.6366745276065428
7925,207-008-2399,5900.4526,4,1,3,1.630062786289591
8095,703-004-5389,8738.083,2,0,2,0.27920371738274696
8225,703-004-5388,5227.343,1,1,0,0.3486207416170325
8412,703-004-5388,6967.2603,2,0,2,0.27920371738274696
8659,703-004-5393,767.9832,6,3,3,1.454688033843416
8674,703-004-5393,5186.4326,6,3,3,0.8283345925105752
8922,703-004-5381,9389.777,1,0,1,0.27920371738274696
8969,703-004-5385,6626.174,5,4,1,2.1116290185736846
9014,703-004-5398,5078.6025,8,2,6,0.51515315668581
912,703-004-5395,9566.37,6,3,3,1.1476080993272737
9161,703-004-5394,7125.2334,5,3,2,1.5364373180163082
9246,703-004-5395,6934.2466,9,5,4,1.0319018239964546
9288,703-004-5386,8747.203,3,0,3,0.27920371738274696
9604,703-004-5390,1549.9473,1,0,1,0.27920371738274696
9729,703-004-5396,8013.564,"","","",0.27920371738274696
10027,703-004-5396,7536.5293,4,1,3,0.6092639436751501
10036,703-004-5384,2983.3484,8,5,3,2.4393002986180625
10320,703-004-5385,5664.698,3,2,1,1.166459519959225
10471,703-004-5387,2802.6038,1,0,1,0.27920371738274696
10839,703-004-5390,2202.6848,5,1,4,0.5352374420000654
10865,207-008-2398,7576.403,2,1,1,0.46430068360046334
11011,703-004-5399,2080.645,3,3,0,1.4404333333022727
11157,703-004-5383,8197.702,4,2,2,1.1721663055729852
11165,703-004-5391,8758.835,1,0,1,0.27920371738274696
1122,703-004-5393,8589.666,3,2,1,1.1771558789861483
1129,207-008-2399,109.618904,7,2,5,0.7964643616187344
11337,703-004-5386,5380.459,3,2,1,0.6106567136096392
11465,703-004-5395,2324.9697,3,1,2,0.7025752374717709
11702,703-004-5383,8119.891,7,4,3,3.429024136316681
11904,703-004-5387,8953.127,1,0,1,0.27920371738274696
12117,703-004-5386,2819.0005,2,2,0,0.7753516836580763
12345,703-004-5386,6950.7314,2,2,0,1.1922847976883666
1239,703-004-5381,4165.814,7,5,2,1.3399816384536436
1248,703-004-5384,3585.9358,3,2,1,0.533805648158767
1264,703-004-5398,7427.7305,4,0,4,0.27920371738274696
13134,703-004-5390,8874.293,4,3,1,1.1488560714596334
1321,703-004-5392,7004.281,3,0,3,0.27920371738274696
13316,703-004-5388,6921.74,3,0,3,0.27920371738274696
13555,703-004-5389,6784.3945,4,2,2,0.6453494668518559
13711,703-004-5385,6762.984,1,1,0,0.43846397245755536
13862,207-008-2399,427.21332,3,2,1,1.011376734707559
13951,703-004-5393,8399.133,4,2,2,0.6641676669260209
13977,703-004-5399,4589.402,5,2,3,2.2593744949276053
14070,703-004-5387,1009.01483,5,4,1,1.8141412382665545
14148,703-004-5381,1752.144,4,1,3,0.7835560390663884
14277,703-004-5397,2056.2773,4,3,1,1.0399540200698703
14415,703-004-5387,646.314,9,6,3,4.398492964997524
14555,703-004-5382,7329.984,4,1,3,0.35831143730785864
14673,703-004-5395,8977.919,3,0,3,0.27920371738274696
14798,703-004-5387,4327.83,5,3,2,2.6185079312038972
15028,703-004-5382,3186.6807,5,3,2,2.8770067092225804
15523,703-004-5387,8098.4604,1,1,0,0.6602150186662091
15603,703-004-5383,8616.607,3,0,3,0.27920371738274696
15648,703-004-5381,6431.668,"","","",0.27920371738274696
15735,703-004-5382,9653.909,2,0,2,0.27920371738274696
15937,703-004-5388,2568.5798,5,2,3,1.1469926682114866
15971,703-004-5387,533.8824,3,1,2,1.811721461271567
1628,703-004-5392,1804.263,4,4,0,1.2445049906357413
16280,703-004-5399,3160.035,3,3,0,0.9701733025138803
16356,703-004-5381,8926.573,5,3,2,1.6944451230084974
16464,703-004-5389,4882.062,4,1,3,0.8333995333024212
16765,703-004-5383,1749.0267,3,2,1,0.7957169244949626
16832,703-004-5390,7375.8984,8,4,4,2.078507995050991
16864,703-004-5396,9932.034,2,0,2,0.27920371738274696
16999,703-004-5391,3533.3193,3,2,1,0.6101089819009474
17109,703-004-5389,6978.9497,9,4,5,1.4299633876394546
17358,703-004-5382,6326.362,1,0,1,0.27920371738274696
17458,703-004-5392,6580.9824,6,3,3,1.6823395121420677
17477,703-004-5397,8048.291,7,4,3,1.4582467639862526
17487,703-004-5397,3683.8877,7,6,1,2.0031596527625766
17494,703-004-5386,4122.4014,7,3,4,1.0651778614015988
17667,703-004-5384,8933.593,"","","",0.27920371738274696
17680,703-004-5386,5951.662,1,0,1,0.27920371738274696
17968,703-004-5399,9762.596,1,0,1,0.27920371738274696
18366,207-008-2398,5800.4863,3,1,2,0.41824047938362596
18422,207-008-2398,2208.5298,3,1,2,0.460682329201231
18712,703-004-5391,3087.7292,3,1,2,0.5666185240377998
18767,703-004-5392,5523.337,7,5,2,2.3043513756343255
18937,703-004-5382,3300.8337,3,2,1,1.138141970661247
18996,703-004-5391,3343.3152,2,0,2,0.27920371738274696
19066,703-004-5381,8125.7554,2,2,0,1.1094301031834168
19115,703-004-5394,3252.4902,6,3,3,1.154646317171235
19541,703-004-5385,9284.526,3,1,2,0.5367807620347516
19880,703-004-5383,3687.9343,3,1,2,0.4731824389491145
20034,703-004-5397,1766.9088,4,2,2,0.8742295901396772
2007,703-004-5395,2120.7834,3,1,2,1.2073207885191954
20087,703-004-5393,4911.708,8,4,4,2.0611275529954733
20284,703-004-5397,4260.545,1,1,0,0.6004071010422987
20444,703-004-5384,5091.222,4,2,2,0.5227691853251644
21055,703-004-5397,7023.403,4,2,2,0.5943609016500566
21251,703-004-5399,8201.809,3,1,2,0.4906829626175723
21655,703-004-5393,3140.7046,3,1,2,0.4617985239244568
21767,703-004-5396,1467.7793,7,2,5,0.42296004925326003
21805,703-004-5380,4130.123,4,3,1,1.2842478296954127
21806,703-004-5380,6744.347,4,2,2,3.50398066231055
21877,703-004-5386,7949.3857,7,2,5,0.6155785185170008
22040,703-004-5381,9953.276,3,1,2,0.35534489781066697
22230,703-004-5389,6518.5703,4,2,2,0.691495024779946
22419,703-004-5384,9250.439,5,3,2,0.9032116508058804
22435,703-004-5390,3629.2332,5,2,3,0.870173464878738
22720,703-004-5381,3826.6033,3,3,0,1.073740067411842
22815,703-004-5390,3027.5972,4,3,1,1.1403911673761822
23060,703-004-5387,2649.3323,2,2,0,0.643691468721384
23612,703-004-5390,5509.524,4,2,2,1.1062758789825446
23778,703-004-5383,9191.0,7,3,4,1.0242119106586982
23809,703-004-5387,4996.8164,7,6,1,2.4123562981623374
24152,703-004-5395,8727.227,4,1,3,0.9515991325487386
2457,703-004-5382,8724.947,4,1,3,0.5303345997640049
24655,703-004-5382,832.24835,10,5,5,1.291391345813055
24739,703-004-5392,2857.5085,3,1,2,0.3807252912866403
24780,207-008-2398,848.70636,3,2,1,0.7669421625432453
25100,703-004-5386,7996.217,8,5,3,1.4267021622700267
2594,703-004-5381,8212.53,3,1,2,0.7495701059243406
26166,703-004-5392,83.044174,4,1,3,0.7005774362513558
26263,703-004-5392,9118.998,"","","",0.27920371738274696
2641,703-004-5389,7753.9653,6,2,4,0.5137828281231795
26418,703-004-5394,9035.662,3,0,3,0.27920371738274696
26437,703-004-5394,1267.4713,3,3,0,2.7361028506594467
2645,703-004-5385,4520.2466,1,0,1,0.27920371738274696
26777,703-004-5380,5317.942,4,3,1,1.386366570438616
26950,703-004-5383,6454.2715,5,1,4,0.3978652972704144
26999,703-004-5384,7534.039,5,3,2,1.4280911272263317
27403,207-008-2398,3611.391,2,2,0,0.6813932934909495
2743,703-004-5390,8118.2627,2,2,0,0.47697301719552604
27796,207-008-2398,165.36356,2,1,1,0.7750199676508401
27825,703-004-5380,6225.522,4,2,2,1.077162744670298
27904,703-004-5383,2537.961,4,1,3,0.35925857632168884
27940,703-004-5394,4103.852,2,2,0,0.9935987201122523
28052,703-004-5398,3338.312,4,1,3,0.4290353316913857
28111,703-004-5380,3161.5657,4,1,3,0.36721723609005286
28259,703-004-5398,8391.053,3,0,3,0.27920371738274696
28464,703-004-5394,4016.9854,2,0,2,0.27920371738274696
28781,703-004-5384,6368.684,11,5,6,1.41701601319476
28864,703-004-5399,5534.9683,6,3,3,0.9003828892035836
28910,703-004-5393,6981.491,1,1,0,0.37512182779194486
29004,703-004-5396,6181.7173,8,6,2,1.2888783426334016
29666,703-004-5387,4013.3357,8,6,2,1.9674015565710798
2987,703-004-5391,5076.8237,8,4,4,1.5654044667690863
29985,703-004-5380,5673.9365,2,1,1,0.5449279902694412
29994,703-004-5398,8197.286,6,3,3,0.9575897005058203
3009,703-004-5396,8739.704,6,4,2,3.423638634344881
30214,703-004-5392,6133.0293,2,1,1,1.1437756638416352
30449,207-008-2399,8319.034,2,2,0,0.484220716107993
30472,703-004-5393,1728.7004,6,4,2,1.4831188361990624
3085,703-004-5397,1043.0592,3,0,3,0.27920371738274696
31014,703-004-5393,3006.4565,2,0,2,0.27920371738274696
31112,703-004-5396,2940.467,"","","",0.27920371738274696
31480,703-004-5380,7801.4834,1,0,1,0.27920371738274696
31500,703-004-5383,4589.319,6,4,2,2.8680131085713043
31607,703-004-5382,9798.941,2,1,1,1.0683231073821826
31645,703-004-5394,5571.8643,2,2,0,0.5968103271606642
31852,703-004-5382,7845.8066,4,1,3,0.35831143730785864
32031,703-004-5399,3789.0012,6,3,3,1.751538019467589
32045,207-008-2399,7967.926,6,2,4,0.9347342638195113
32146,703-004-5387,5652.1953,3,2,1,0.4492334890704021
3217,703-004-5397,6078.6943,3,2,1,0.6228285058326001
32200,703-004-5389,7171.205,5,2,3,0.5776951285502753
32226,207-008-2399,1209.0444,5,3,2,1.6503055024278321
32364,207-008-2398,2760.3083,3,1,2,0.624461666534076
32437,703-004-5394,5623.426,9,5,4,2.024907543900887
32847,703-004-5388,2939.2146,4,2,2,1.2601879985766913
32950,703-004-5393,6923.453,6,2,4,0.7848196756577388
33295,703-004-5392,328.3602,4,3,1,0.8953337042216253
33387,703-004-5390,7678.5767,7,6,1,2.3802063450011595
33893,703-004-5382,2088.4114,5,3,2,0.6198685552967302
34020,703-004-5393,6250.5166,5,3,2,0.6144519292920854
34069,703-004-5385,5639.079,4,1,3,0.3187575773453028
34688,703-004-5396,910.00916,4,2,2,1.3793958003183426
34710,703-004-5384,1391.1825,3,0,3,0.27920371738274696
34821,703-004-5382,5757.031,8,3,5,1.7358076799528714
34924,703-004-5389,3149.4744,4,0,4,0.27920371738274696
35154,703-004-5389,4500.1133,2,2,0,1.2809339086461224
35294,703-004-5399,1212.2148,3,1,2,0.49111268562980454
35929,703-004-5390,5402.643,4,2,2,2.017867813659465
360,703-004-5394,3382.1536,4,2,2,1.4163360592330843
36258,703-004-5397,9688.706,6,2,4,0.5288881726668736
36477,703-004-5390,7626.857,3,1,2,0.5108004307562994
36486,703-004-5391,369.159,5,2,3,0.7007489799336856
36531,703-004-5387,6708.175,4,2,2,1.22349975766614
36553,703-004-5399,4019.2139,7,4,3,1.5169051685404649
36611,703-004-5380,3678.7617,5,1,4,0.44190745027559614
36735,207-008-2398,6142.67,7,4,3,1.4458849787506065
36748,703-004-5384,2732.0593,2,1,1,0.4072588583222511
36992,703-004-5396,5170.623,6,2,4,0.9393925052163677
36997,703-004-5391,268.33655,5,4,1,2.4864780354935347
37098,703-004-5385,3211.8892,7,3,4,0.8438154021570246
37148,703-004-5384,6000.758,5,1,4,0.5620265146143838
37182,207-008-2398,9381.849,2,0,2,0.27920371738274696
3736,703-004-5388,8312.039,7,2,5,0.5569188743655376
37605,703-004-5389,8287.628,8,6,2,1.7938514849150895
37788,703-004-5380,8570.28,4,1,3,0.7035424712935411
37908,703-004-5388,4642.1226,4,2,2,0.8425090971858668
37927,703-004-5384,959.86365,"","","",0.27920371738274696
3813,703-004-5383,9483.312,8,3,5,1.4917497814649767
38266,703-004-5398,4963.153,2,1,1,0.8445202937133952
38588,703-004-5380,277.38333,5,2,3,0.5734793437249941
38667,207-008-2399,5764.179,5,2,3,2.4715361215287053
38773,703-004-5392,275.3359,1,1,0,0.4511229238737584
3900,703-004-5390,2964.5623,5,3,2,0.5046607191693151
39604,703-004-5382,9026.952,1,0,1,0.27920371738274696
39714,703-004-5380,2258.6882,2,1,1,1.1166231897125014
39838,703-004-5394,2137.693,2,1,1,0.6899750514132085
40164,703-004-5384,3641.661,5,2,3,0.40627049251245756
40650,703-004-5399,3926.7754,2,1,1,1.1477627746301895
40893,703-004-5397,8816.284,3,2,1,0.7392600295790493
40976,703-004-5382,4911.731,7,5,2,1.7687932433810802
41125,703-004-5381,6529.6597,5,3,2,1.2095685313506288
416,703-004-5389,5312.9526,3,2,1,0.40627049251245756
41602,703-004-5389,2996.8022,4,0,4,0.27920371738274696
41863,703-004-5394,7485.1353,5,4,1,1.29508798808373
42190,703-004-5397,2029.5643,1,1,0,0.33853450732658075
42317,703-004-5387,2689.4683,3,1,2,0.8365337852551463
42403,703-004-5387,6113.6113,5,3,2,3.946206337334807
42563,703-004-5394,9328.016,3,1,2,0.5886849226477696
42669,703-004-5386,3504.8955,"","","",0.27920371738274696
42687,703-004-5385,7024.6045,3,3,0,4.262144796513778
42867,703-004-5386,5069.6646,1,0,1,0.27920371738274696
42875,703-004-5386,2059.021,5,1,4,0.5568718143198889
43366,703-004-5395,761.1358,8,4,4,1.4507803615122432
43576,703-004-5390,3634.4004,4,1,3,1.471867824383182
43634,703-004-5384,5675.606,7,6,1,3.009633005508315
437,703-004-5383,7538.6094,5,3,2,0.7361816541943772
43819,703-004-5387,9984.672,4,2,2,0.704258825550753
43870,703-004-5395,9637.873,6,3,3,1.2660381805478007
43921,703-004-5390,3304.1882,3,3,0,0.912211824958194
44091,703-004-5391,4542.646,2,1,1,0.3640890016146154
44305,703-004-5388,2810.0217,4,1,3,1.2255489509003312
44339,703-004-5399,1925.8463,2,2,0,0.7143729066888087
44434,703-004-5380,3270.1487,4,1,3,0.7446201333643178
44584,703-004-5383,5324.8535,2,1,1,0.3892985904335242
44615,703-004-5392,8365.207,3,2,1,0.5782624515192359
45023,703-004-5387,1733.6577,3,3,0,1.4379123216706962
45109,703-004-5399,2135.4658,5,3,2,1.313568216058743
45195,703-004-5389,7878.4443,7,2,5,0.43176860580974796
46108,703-004-5399,6008.9263,5,2,3,0.9128763309128726
46257,703-004-5391,9339.469,3,2,1,1.578445713120356
46300,703-004-5390,3531.882,3,2,1,1.3714182907710324
46372,703-004-5390,3486.3757,5,3,2,2.0662837294359386
46749,703-004-5392,9963.453,3,2,1,0.5599601055422778
46836,703-004-5395,8505.881,7,1,6,0.8372220716749833
46902,703-004-5391,1436.5267,5,2,3,1.0068406011513522
47064,703-004-5382,6315.2554,4,2,2,0.4598330112117519
47134,703-004-5399,8101.938,5,3,2,0.6723190761437918
47195,703-004-5382,1304.924,2,2,0,0.9060020194431355
47264,703-004-5395,507.35294,3,2,1,0.7276947781970748
47361,207-008-2399,1097.8062,8,7,1,2.5350821858801478
47502,703-004-5397,5467.304,3,2,1,1.0091677493594957
47565,703-004-5396,2783.0757,4,2,2,1.4334035923474933
47607,207-008-2399,3123.0342,9,3,6,1.2464158009585338
47823,703-004-5395,1985.6382,7,4,3,0.8449208709764064
48505,703-004-5384,6508.4346,3,0,3,0.27920371738274696
48671,703-004-5388,8990.839,6,3,3,2.0289260183906475
48985,703-004-5386,6870.72,5,0,5,0.27920371738274696
49005,703-004-5392,5827.2886,3,1,2,0.5165268771580819
49043,703-004-5382,3777.7197,4,1,3,0.4872236748989989
49062,703-004-5397,5622.335,4,1,3,0.5512806546360479
49414,703-004-5383,4274.4893,4,1,3,0.9351042068378368
49465,207-008-2398,9827.018,6,5,1,1.3294460166191167
49628,703-004-5394,4167.367,5,3,2,2.2566898453459414
49707,703-004-5397,6473.3105,4,2,2,1.5761590355148318
49745,703-004-5393,1862.0348,8,5,3,1.7054537277656712
5088,703-004-5392,4142.5127,5,3,2,1.8431057520422909
5278,703-004-5390,2737.5496,3,1,2,0.679771863956117
5317,703-004-5393,2337.302,7,3,4,0.7585707689356599
5423,207-008-2399,1316.7816,1,0,1,0.27920371738274696
5476,703-004-5389,2250.7454,6,4,2,2.7168312960018786
5638,703-004-5385,3568.0474,4,3,1,2.3069290249457786
5659,703-004-5385,937.6836,2,2,0,0.8249643048946831
5777,703-004-5381,3364.759,1,0,1,0.27920371738274696
5997,703-004-5397,4140.179,8,3,5,0.6870028137833492
6027,703-004-5398,9229.451,4,2,2,0.8214533720072433
6303,703-004-5397,647.0048,4,2,2,0.8765922211009027
6630,207-008-2399,7246.6157,2,2,0,2.0933546291242133
6861,703-004-5389,9171.819,6,4,2,2.168158984400532
6871,207-008-2398,6487.513,3,2,1,0.40731060621938925
6893,703-004-5392,8199.176,3,1,2,0.8933651352765918
7053,703-004-5397,8013.6753,3,2,1,0.3741329812928809
7065,703-004-5382,132.81525,3,3,0,1.1860810772767707
751,703-004-5383,1578.2201,4,2,2,1.5656261212739246
7602,207-008-2398,5408.3306,3,0,3,0.27920371738274696
7651,207-008-2399,15.193224,4,3,1,1.8393992201139906
7788,703-004-5393,8366.33,7,4,3,2.5236862111758565
8067,703-004-5382,2764.8145,4,2,2,0.7703568265092539
8131,703-004-5387,4355.8525,3,2,1,0.9520034864856688
8260,703-004-5385,5293.7246,1,0,1,0.27920371738274696
8484,703-004-5382,9895.823,3,0,3,0.27920371738274696
8752,703-004-5398,4346.711,4,1,3,1.7289393925705114
9254,703-004-5382,527.5077,2,1,1,0.3217763059632784
9629,703-004-5380,7827.313,9,5,4,1.1227012355479624
9673,703-004-5399,8776.29,4,1,3,0.33853450732658075
9757,703-004-5397,1398.6534,1,1,0,0.35831143730785864
10301,207-008-2399,2989.7517,3,0,3,0.27920371738274696
10453,703-004-5393,7742.266,3,1,2,0.33853450732658075
10690,703-004-5389,613.87775,2,1,1,0.3486207416170325
10768,703-004-5395,8274.59,4,0,4,0.27920371738274696
1080,703-004-5382,2196.9443,2,1,1,1.3476722426242496
10907,207-008-2398,2871.107,3,2,1,0.5318013095633493
11015,703-004-5381,3911.3223,3,1,2,0.3978652972704144
11144,703-004-5393,3136.5413,2,1,1,0.5506446349149104
11233,703-004-5380,1574.3535,5,3,2,1.041392918403303
11686,703-004-5389,3121.6848,2,1,1,0.3486207416170325
11852,703-004-5383,461.0181,6,1,5,0.5141805145979875
12106,703-004-5397,7005.309,2,0,2,0.27920371738274696
12186,703-004-5383,2642.408,4,3,1,1.717532642873773
12252,703-004-5394,7390.2637,5,4,1,1.196428919716909
12416,703-004-5386,3911.9429,3,0,3,0.27920371738274696
12446,703-004-5389,5183.06,6,5,1,1.48793355741992
12475,703-004-5383,9261.293,4,2,2,1.5383354767540531
12528,703-004-5393,3829.301,3,1,2,0.39081152557709203
12872,703-004-5387,1346.553,6,5,1,3.3648848284408985
13269,703-004-5382,7259.9023,2,1,1,0.40468009772646313
13330,703-004-5391,3703.9321,3,2,1,1.1331708272097978
13425,703-004-5388,5590.6665,3,2,1,0.6339973490565834
1363,703-004-5390,2720.3774,7,5,2,1.380507278199909
13653,703-004-5382,9161.891,5,3,2,0.9740464059044184
13737,703-004-5383,9362.735,3,1,2,0.5310250386292411
13975,703-004-5392,7434.09,1,1,0,0.4395830829884218
14052,703-004-5391,8033.0684,1,0,1,0.27920371738274696
14263,703-004-5386,9698.193,4,2,2,0.8363605305229183
14388,703-004-5383,2854.0242,1,0,1,0.27920371738274696
14423,703-004-5395,1041.9482,3,1,2,1.1415559886336022
14510,703-004-5381,6832.4346,1,1,0,1.4273448618990954
14712,703-004-5394,9659.469,5,2,3,1.0422206280354256
14766,703-004-5397,9876.232,2,1,1,0.6931103250540959
15167,703-004-5394,8413.609,2,1,1,0.8055950159005346
15295,703-004-5380,1766.9421,4,1,3,0.4262301875064751
1561,703-004-5391,1091.73,5,0,5,0.27920371738274696
15714,703-004-5382,9171.861,4,3,1,1.853754586487123
15767,703-004-5382,5195.177,4,2,2,0.6765564632782657
15857,703-004-5385,3843.2478,5,3,2,1.2672131801234388
15891,703-004-5381,9068.109,9,3,6,0.9954722721295052
16702,703-004-5399,1458.1132,3,1,2,1.2921075916268818
16917,703-004-5386,6377.0264,8,4,4,1.4640633735797262
17153,703-004-5390,5541.4795,7,3,4,2.40139492841195
17214,703-004-5395,8112.956,3,2,1,0.7193523952929726
17963,703-004-5397,4843.5386,2,0,2,0.27920371738274696
18100,703-004-5383,4880.906,5,3,2,1.6221272767323722
18135,703-004-5391,1850.1365,4,3,1,1.105633486266931
18494,703-004-5398,5026.2744,1,0,1,0.27920371738274696
18597,703-004-5397,1418.1357,4,4,0,1.9643098369311296
18616,703-004-5388,9937.993,"","","",0.27920371738274696
18654,703-004-5395,3826.719,5,4,1,1.864863087592092
18722,207-008-2399,2626.9412,3,1,2,0.3791588801760325
19031,703-004-5398,7969.685,2,1,1,0.7049857966372497
19176,703-004-5394,5553.937,3,2,1,1.028130452533181
19322,703-004-5391,9008.5205,8,6,2,2.6424269186241505
19396,703-004-5395,8192.279,7,2,5,0.7205522316983606
19689,703-004-5388,1774.4541,2,0,2,0.27920371738274696
20319,703-004-5399,6939.8384,2,1,1,0.46447740347418853
20803,703-004-5397,46.794415,7,4,3,2.2227643538569377
21203,703-004-5394,9179.634,5,3,2,1.6897672748069688
21356,703-004-5398,7154.3516,6,1,5,1.1738731259490773
21634,703-004-5391,1828.5405,3,0,3,0.27920371738274696
21842,703-004-5390,5391.9014,3,3,0,0.8268018673877112
21986,703-004-5384,8755.54,7,2,5,1.0963757313648979
22220,703-004-5380,5516.1436,3,2,1,0.4886229268338408
2240,703-004-5390,7972.04,3,0,3,0.27920371738274696
22886,703-004-5397,7889.559,3,1,2,0.5236530209238793
22901,703-004-5382,2226.8235,8,5,3,1.9673332300626238
2352,703-004-5395,1692.2456,5,3,2,0.48459586986145214
24180,703-004-5392,6351.476,3,2,1,1.7736754068401996
24428,703-004-5398,4681.113,4,2,2,1.4118938052262182
24471,703-004-5397,3307.517,5,2,3,1.8930075826408568
24625,703-004-5385,6944.787,3,1,2,0.5165268771580819
25025,703-004-5387,2663.9568,6,3,3,1.5764883355499186
25215,703-004-5386,7326.996,3,2,1,1.542678828067498
25265,703-004-5392,3207.9172,4,1,3,1.3949861008426299
25373,703-004-5390,952.60205,3,1,2,0.402391752355257
25374,207-008-2398,3315.3623,6,3,3,2.4389363331509424
25596,207-008-2399,1758.16,3,1,2,0.5425833371299429
25838,207-008-2398,8800.118,2,2,0,0.7639047311948801
2589,703-004-5380,7824.1987,5,2,3,1.70236376452944
26229,703-004-5396,3390.491,2,2,0,0.5819591559259361
26648,703-004-5391,1911.4023,4,1,3,0.5639204357710287
27269,703-004-5380,7959.4,4,2,2,0.6610309731873419
27415,703-004-5398,5516.3438,3,1,2,0.432468714045152
27573,207-008-2399,7545.547,5,2,3,0.946582419840194
2761,703-004-5395,5955.051,4,3,1,1.8546846311761693
27612,703-004-5384,42.06717,4,4,0,1.4016589694529922
27793,703-004-5398,4963.4136,3,2,1,0.9299918350108799
2792,703-004-5396,2745.9424,4,3,1,1.4216372122865755
27987,703-004-5390,3941.4907,4,3,1,0.9041427218066872
28492,703-004-5384,146.07608,4,1,3,0.8264893696460396
28631,703-004-5382,8540.74,4,1,3,0.9678896605869816
28847,703-004-5385,4786.616,7,5,2,2.76565017342029
29039,207-008-2398,2887.5034,5,2,3,0.9045640634201807
29164,703-004-5388,1104.3608,8,5,3,1.5061550025782826
29443,207-008-2398,7372.6167,3,1,2,0.7777850071765254
29463,703-004-5393,5879.468,5,4,1,0.7770341986141993
29609,703-004-5393,6535.1963,7,5,2,2.0458849819850853
30415,703-004-5394,1544.2473,7,4,3,1.0206708182862438
30641,703-004-5386,7222.2334,4,2,2,1.9139976416132902
31765,703-004-5381,1931.7335,1,0,1,0.27920371738274696
31898,703-004-5399,2403.2295,1,0,1,0.27920371738274696
31900,207-008-2398,9477.915,3,0,3,0.27920371738274696
31924,703-004-5382,1288.8801,7,2,5,0.7214915122582641
32069,207-008-2398,5006.252,4,3,1,2.0055667893287867
32147,207-008-2399,6204.524,3,1,2,0.4615554239215286
32170,703-004-5395,2186.233,4,2,2,0.9503797475103544
3232,703-004-5381,5361.2363,2,1,1,0.7359278325088039
32484,703-004-5395,2272.522,5,2,3,0.6308231117717569
3253,207-008-2399,1950.0166,"","","",0.27920371738274696
32868,703-004-5388,6395.41,5,1,4,0.3861232944531969
33779,703-004-5381,4523.745,4,3,1,1.1698068648040716
33885,703-004-5387,6812.171,6,5,1,1.5109540796153762
33919,207-008-2398,6.36518,1,0,1,0.27920371738274696
34341,703-004-5390,86.17163,3,1,2,0.7220368385222072
34514,703-004-5387,7984.767,1,0,1,0.27920371738274696
34627,703-004-5382,7751.663,5,2,3,0.7440356168084773
34733,703-004-5394,9011.58,2,0,2,0.27920371738274696
34964,703-004-5398,7906.322,4,2,2,1.280864774899176
35351,703-004-5385,3087.4968,3,2,1,0.9835933436223324
35492,703-004-5383,4054.725,3,1,2,1.2010491476057754
35576,703-004-5395,7876.1504,4,3,1,0.764208204011111
35814,703-004-5389,867.79297,4,4,0,1.500320801064049
35853,703-004-5389,5014.4897,1,1,0,0.910377209163341
35860,207-008-2399,1100.3995,5,1,4,0.912532113307357
36417,703-004-5393,9159.035,4,1,3,0.32666834933781397
36533,703-004-5392,6027.6304,4,3,1,0.9689231866556515
36551,703-004-5381,5030.463,4,2,2,0.8749556677429341
36673,703-004-5387,5640.774,4,2,2,1.0780627278525015
37266,207-008-2398,6579.751,2,2,0,0.41922438165019454
3751,703-004-5393,8063.967,7,3,4,1.3171180375356955
37551,703-004-5390,4416.0205,3,1,2,0.5646610836588809
37739,703-004-5389,9354.454,6,3,3,0.984645705840494
37866,703-004-5399,2978.899,3,2,1,2.656007335541751
38204,703-004-5391,7594.648,1,1,0,0.41868893869250406
38289,703-004-5391,1830.1367,4,2,2,0.9580602415868315
38377,703-004-5384,7162.3115,6,5,1,1.3856118319928072
3851,703-004-5397,5058.942,"","","",0.27920371738274696
38665,207-008-2399,97.3928,3,2,1,1.7704490146014389
39111,703-004-5399,952.3588,4,1,3,0.511652373575392
39165,207-008-2398,9109.349,9,8,1,2.23364871136754
3918,207-008-2399,9189.297,3,1,2,0.4129478330532932
39261,703-004-5383,8711.494,5,4,1,2.6502972609136477
39308,703-004-5394,5718.815,6,5,1,1.7869508982229336
39384,703-004-5396,3641.2693,2,1,1,0.933233788625901
39396,703-004-5394,7856.592,3,1,2,0.5017247271791191
39658,703-004-5389,3589.3213,3,1,2,0.35831143730785864
39905,703-004-5383,1161.3536,2,0,2,0.27920371738274696
40338,207-008-2398,7497.887,3,1,2,0.8484972417206957
40494,703-004-5384,57.46126,6,3,3,1.0698351132751747
40626,703-004-5393,3313.7388,3,0,3,0.27920371738274696
40795,703-004-5392,5080.323,1,0,1,0.27920371738274696
4090,703-004-5394,2028.0635,2,1,1,0.46737626192211096
40938,703-004-5380,506.58228,4,1,3,0.3866439496029123
41094,703-004-5394,3338.6392,8,5,3,1.4591063469069292
41156,207-008-2398,6054.812,1,0,1,0.27920371738274696
41447,703-004-5383,518.1438,3,0,3,0.27920371738274696
41517,703-004-5381,9602.758,5,1,4,1.131706497414251
41607,703-004-5390,6299.0327,6,1,5,1.0613547394155738
41665,703-004-5387,8936.334,4,4,0,4.816623434252131
41787,703-004-5395,6221.7183,4,4,0,1.7821806775890583
42106,703-004-5392,6201.409,3,0,3,0.27920371738274696
42109,703-004-5380,2669.1401,3,2,1,0.4889204460059346
42121,703-004-5380,8762.194,3,2,1,0.8471358994013019
42242,703-004-5387,3368.6895,3,3,0,0.7207912503922124
42467,703-004-5395,9926.419,11,5,6,1.5766401232345097
42676,703-004-5397,5151.981,2,0,2,0.27920371738274696
43332,703-004-5388,22.636652,2,1,1,0.47267659631577863
43489,703-004-5382,2510.4534,1,1,0,0.3978652972704144
43632,703-004-5393,4774.801,7,5,2,2.286716031957952
43972,207-008-2398,3701.1028,5,2,3,0.7068972143887128
44048,703-004-5387,1374.6798,7,4,3,1.2260781932410272
4434,703-004-5390,6208.312,2,2,0,1.1986193933308755
44980,703-004-5394,2251.2578,3,1,2,1.0768968825473548
45664,703-004-5392,8990.788,4,1,3,0.32666834933781397
45793,703-004-5391,9409.949,5,3,2,1.1762606604859362
45908,703-004-5383,810.1231,4,2,2,0.9092278593299591
45930,703-004-5388,9347.411,3,2,1,1.51913293002652
46025,703-004-5394,7538.7334,7,4,3,1.32156004039982
46076,703-004-5393,404.95813,4,2,2,0.7634131573607298
46284,703-004-5398,3158.7224,6,4,2,1.4127013454299422
46318,703-004-5394,3670.9458,8,3,5,1.729772637811209
46477,703-004-5392,1883.5468,3,1,2,1.1268910373703878
46832,703-004-5384,1649.9049,2,1,1,1.026363692023301
46853,703-004-5386,8329.579,5,3,2,1.0413326009319868
47223,703-004-5395,7539.6943,4,3,1,0.63680496328493
47484,703-004-5387,2695.8882,7,5,2,1.219157299492964
47557,703-004-5389,4408.5024,8,6,2,4.098444456004042
47609,703-004-5398,4264.744,4,2,2,1.0203460248621068
47986,207-008-2398,3436.3455,4,1,3,0.9214108410770624
48022,703-004-5389,8724.304,4,2,2,0.8194249414536686
4807,703-004-5390,6970.7686,2,2,0,0.6389618273198422
48521,703-004-5391,9566.217,5,3,2,1.9277106690566863
48530,703-004-5391,9305.6045,5,2,3,1.3510052292664587
48576,703-004-5390,607.7921,3,1,2,0.3553938045104331
48621,703-004-5392,3464.805,7,3,4,0.6178042890499482
48688,703-004-5388,2512.2935,3,2,1,0.5044283155208727
48902,703-004-5386,502.91122,4,2,2,0.9057350396757539
48943,703-004-5399,3760.084,3,2,1,0.5881291380884259
48975,703-004-5387,2788.7917,4,2,2,1.2102259995610019
49830,703-004-5393,3512.376,1,1,0,1.28342541121798
49837,703-004-5382,3161.801,4,2,2,0.9384220634005956
49895,703-004-5396,6088.627,3,2,1,0.5254407367655622
511,703-004-5394,7554.4473,4,0,4,0.27920371738274696
5146,703-004-5384,2091.3809,2,0,2,0.27920371738274696
5381,703-004-5382,7499.305,4,2,2,0.5793361379620517
616,703-004-5386,5851.5464,4,1,3,0.5733277548473692
6233,703-004-5381,1087.3127,6,4,2,1.1918319224894032
6496,703-004-5393,6168.772,3,1,2,0.5349760600754163
6749,703-004-5386,3047.1426,6,6,0,3.490903490632724
7034,703-004-5388,6446.455,1,1,0,0.9109623991042474
7173,703-004-5399,4137.3057,2,1,1,0.43974464019969967
7203,703-004-5383,2753.5386,2,1,1,0.4966939331428257
731,207-008-2398,9188.46,4,3,1,0.6376490110246965
7486,703-004-5395,6534.6675,2,2,0,1.195407570082263
7549,703-004-5386,5204.128,2,2,0,1.0091649290979596
7632,703-004-5394,4351.079,5,3,2,1.2966950825677737
7713,703-004-5380,5706.3613,5,3,2,0.9379343952782694
7859,703-004-5380,4304.2695,2,0,2,0.27920371738274696
8204,703-004-5388,9607.783,6,3,3,1.726516081473177
8210,703-004-5395,4426.958,6,3,3,0.9298507275483943
8363,703-004-5391,1125.7922,5,4,1,1.194912036209411
8459,703-004-5390,5655.035,6,4,2,1.080034582188204
8489,703-004-5397,3415.5737,4,3,1,1.7451093295113265
8550,207-008-2398,7897.2827,5,1,4,0.8642363939238611
9092,703-004-5391,5992.104,2,1,1,0.5568718143198889
9135,703-004-5381,2175.1147,3,0,3,0.27920371738274696
9294,703-004-5384,4037.8838,7,3,4,0.6560149136794868
9298,703-004-5390,3974.3877,3,3,0,1.2127097575979517
9355,703-004-5386,8148.2534,5,1,4,0.7464238694799563
9620,703-004-5382,7374.057,5,1,4,0.4540906508655392
9704,207-008-2399,1387.8822,4,1,3,0.5165268771580819
9753,703-004-5389,5077.374,3,2,1,1.6555502098219022
10049,703-004-5390,2749.688,6,2,4,1.0768326913875723
10139,207-008-2398,6198.0645,7,3,4,0.8839123797663992
1050,703-004-5396,8604.333,3,2,1,0.6401728705655346
10701,703-004-5399,2311.6846,1,0,1,0.27920371738274696
10722,703-004-5389,9974.402,3,0,3,0.27920371738274696
10976,703-004-5385,5378.759,5,0,5,0.27920371738274696
10981,703-004-5392,7370.8022,1,0,1,0.27920371738274696
114,703-004-5391,9244.653,3,2,1,0.9240135274161373
11786,703-004-5389,586.57947,4,0,4,0.27920371738274696
11903,703-004-5393,395.91968,4,1,3,0.7823852230530647
11936,703-004-5389,7942.627,1,0,1,0.27920371738274696
12178,703-004-5395,4127.754,5,2,3,0.9588314116898965
12238,703-004-5395,4350.059,5,3,2,0.7074823165568439
12291,703-004-5387,2893.508,3,2,1,0.6527867187801729
12330,703-004-5399,7835.4053,1,0,1,0.27920371738274696
12398,703-004-5395,2764.389,4,3,1,1.2097609711129704
12426,703-004-5396,9046.645,3,2,1,0.711078681879386
1317,703-004-5386,5568.7646,1,1,0,0.35831143730785864
13320,703-004-5387,8885.711,4,2,2,1.5709580525944373
13338,207-008-2399,4488.2466,7,2,5,0.7618416492863146
13365,703-004-5390,1565.1292,9,2,7,0.9129980848047585
13435,703-004-5384,5088.896,4,3,1,0.9220590394888722
13598,703-004-5386,4625.4785,1,0,1,0.27920371738274696
13905,703-004-5390,2816.2366,5,3,2,2.7687941480658504
14405,703-004-5383,2329.15,1,1,0,0.5165268771580819
14594,207-008-2398,4217.383,5,4,1,2.887668659562075
14945,703-004-5381,8742.154,4,4,0,1.5906268036490108
14999,207-008-2398,1062.8843,3,0,3,0.27920371738274696
15219,703-004-5394,2017.6364,1,0,1,0.27920371738274696
15266,207-008-2398,6959.151,6,3,3,0.7425568952298783
15700,703-004-5384,490.66306,6,3,3,1.5934579492889662
1582,703-004-5387,1359.5957,1,1,0,0.4768400827494778
15834,207-008-2399,4148.169,6,4,2,1.3786797092060281
15952,703-004-5399,7437.8438,"","","",0.27920371738274696
16278,703-004-5388,5566.3633,3,0,3,0.27920371738274696
1646,703-004-5383,2194.1172,2,1,1,0.5165268771580819
16520,703-004-5381,7914.7544,3,3,0,1.2994713461393326
16937,703-004-5388,9790.324,2,0,2,0.27920371738274696
16967,703-004-5395,5061.886,3,1,2,0.7631954736407062
1744,703-004-5390,6727.967,6,2,4,0.8581595588022809
17468,703-004-5395,5932.467,3,3,0,1.1556251890729246
17628,703-004-5391,6185.9326,2,1,1,0.759936444476743
17922,703-004-5387,9486.728,3,2,1,0.8519716068178737
18091,703-004-5397,8831.468,6,2,4,4.224858965055656
18184,703-004-5390,3743.6174,4,2,2,1.2609683011115176
18278,207-008-2399,7418.639,4,4,0,3.4385463956355906
18404,703-004-5383,5141.635,3,3,0,1.1038543718332487
18653,703-004-5393,2807.0403,7,4,3,3.187392853000045
18703,703-004-5380,1612.9679,3,2,1,0.6707279046287017
18938,207-008-2398,2687.5513,3,2,1,0.6254536068206021
18995,703-004-5381,7809.7456,1,1,0,1.0323979253811533
19071,703-004-5385,7079.8213,6,3,3,2.8693262213707187
19290,703-004-5381,905.2682,3,2,1,1.5690365102503412
19344,703-004-5397,5804.514,2,0,2,0.27920371738274696
20303,703-004-5392,5823.286,1,1,0,0.46651753114154887
20345,207-008-2399,5001.164,4,3,1,2.319825154411543
20506,703-004-5389,428.0275,7,2,5,1.1533432387151814
20518,703-004-5386,6083.059,4,3,1,1.8500752563670713
20641,703-004-5383,7763.5386,5,4,1,1.5359513889637284
20683,703-004-5392,9047.413,5,2,3,0.5029055166334768
20792,703-004-5384,5207.796,2,1,1,0.5358675503126186
21008,703-004-5388,2925.3584,3,1,2,0.47682450256163866
21106,703-004-5395,1599.0227,4,2,2,0.6867651354239341
21239,703-004-5388,6369.4253,6,3,3,1.201149175623134
21496,703-004-5390,9313.213,5,3,2,0.9538429181557647
21553,703-004-5391,4185.3022,1,1,0,0.7485784617956199
21555,703-004-5390,4826.111,7,3,4,1.7467525141919957
21851,703-004-5389,511.37625,3,1,2,0.5251790850713571
21873,703-004-5386,5769.523,3,1,2,0.37401789788199935
22068,703-004-5381,8457.629,2,1,1,0.35831143730785864
22634,703-004-5397,4329.351,5,3,2,1.6387366790383266
23017,703-004-5394,8487.323,4,1,3,0.6414654831372593
23122,703-004-5387,3312.7893,4,3,1,0.7557995017736495
23304,703-004-5397,1617.1289,5,4,1,1.9613816720198385
23307,703-004-5388,9407.1,2,2,0,0.6735563472326735
23491,703-004-5394,2279.265,5,4,1,1.9893219443964443
23648,703-004-5380,8611.037,2,2,0,1.0552121823791956
23967,207-008-2399,7325.285,1,0,1,0.27920371738274696
242,703-004-5399,7004.3945,2,1,1,0.3489715349125753
24779,703-004-5398,3575.4675,1,1,0,0.4457749101500602
24935,703-004-5381,6438.19,5,3,2,1.5893588589912644
25419,703-004-5381,6348.5234,8,4,4,1.1356910300987113
25499,703-004-5380,9267.112,9,4,5,2.6767325294835733
25533,703-004-5397,433.3538,5,1,4,0.3902113946368101
25645,703-004-5380,4538.1987,4,1,3,0.46495608121802057
25916,207-008-2399,3997.5525,2,1,1,0.8229092168924274
26201,703-004-5394,782.6477,7,4,3,2.46907783212854
26289,703-004-5398,375.1558,5,3,2,0.9411930596141818
26455,703-004-5391,8023.527,5,3,2,1.9248812764960581
26890,703-004-5389,3524.8362,4,1,3,0.35831143730785864
27023,703-004-5382,9032.741,3,3,0,1.1480823853265316
27380,703-004-5394,5771.211,6,3,3,0.762000149742846
27419,703-004-5399,6290.539,5,3,2,1.1458987541723473
27427,703-004-5389,6902.5713,5,2,3,0.4341725200722282
27455,703-004-5392,2768.0903,8,5,3,1.9502661190729607
28084,207-008-2398,9250.412,7,4,3,1.6071402598576576
28103,703-004-5385,1409.4633,4,3,1,1.1685905458202952
28115,703-004-5383,9347.22,2,2,0,0.7461645147161096
28712,703-004-5381,2383.607,5,1,4,0.3419578618603885
2897,703-004-5391,6296.547,9,5,4,1.3196293446672323
29238,703-004-5398,1458.1425,4,3,1,0.9239026099958985
29599,703-004-5385,1805.8324,7,2,5,1.5411820533896405
29616,703-004-5385,9753.263,1,1,0,0.4258359818941489
29683,703-004-5384,9897.979,3,2,1,0.8058348887089265
29837,703-004-5389,4721.638,6,1,5,0.4936872927176388
2986,703-004-5395,9989.06,6,3,3,1.3690552685750788
30022,703-004-5399,9016.087,2,1,1,0.5650233743662004
30254,703-004-5398,102.0354,3,3,0,1.1011209259250574
30347,207-008-2399,9120.256,1,0,1,0.27920371738274696
30732,703-004-5398,6201.628,4,3,1,1.183283907185261
30739,703-004-5396,5135.306,3,1,2,0.5613218762708928
30823,703-004-5392,7693.7256,3,0,3,0.27920371738274696
30870,703-004-5386,257.99335,4,2,2,1.578259182809626
30912,703-004-5390,2023.6539,4,4,0,1.0609406289280072
30930,703-004-5397,1730.9893,8,3,5,1.6264505015282336
31257,703-004-5380,8050.0317,4,4,0,1.3641246085823966
31408,703-004-5395,7721.6484,6,3,3,1.6585125097727613
31860,703-004-5388,3342.9426,4,1,3,0.3131070259220805
31990,703-004-5398,3805.1199,3,3,0,1.2214365178620792
32008,703-004-5386,6966.8623,9,6,3,2.2887630637060887
32072,703-004-5394,9166.582,1,1,0,1.2197786913941044
32108,703-004-5391,5189.87,1,1,0,1.6009479432972995
32248,703-004-5385,3218.5935,3,2,1,0.8094480041960451
32250,703-004-5383,1527.986,4,3,1,1.0541158094573464
32440,703-004-5386,7269.8193,6,3,3,1.4142870079553775
3257,703-004-5382,1436.6937,5,2,3,1.2581471445722439
32783,703-004-5384,1019.6412,3,1,2,0.7151858148164835
33,703-004-5385,3555.938,3,1,2,0.46258530063414643
33495,703-004-5386,2886.4043,1,0,1,0.27920371738274696
33581,703-004-5395,6855.3013,1,1,0,0.5666485234102153
34261,703-004-5387,2889.4097,7,5,2,2.2908161624252927
34606,703-004-5387,1492.3162,3,1,2,1.6392579584752838
34655,703-004-5390,3125.564,7,5,2,2.0644146707908893
34704,703-004-5394,9651.007,4,1,3,0.6288983506803213
350,703-004-5395,2361.8083,4,1,3,0.44880078043719573
35150,703-004-5391,5158.3213,3,2,1,1.1364391573959374
35276,703-004-5392,2530.8645,1,1,0,0.5239320329167088
35326,703-004-5382,9156.403,5,4,1,2.3405297151012383
3564,703-004-5399,6621.3774,4,1,3,0.932189577539678
35658,703-004-5388,9732.631,7,2,5,1.190902083255912
3589,703-004-5397,8724.976,5,4,1,0.9067789613851424
35943,703-004-5380,6036.41,3,3,0,1.1889501205005761
35947,207-008-2399,7687.4106,5,2,3,0.627094401390406
36020,703-004-5386,9081.082,5,3,2,0.7334459454314595
36388,703-004-5381,5772.973,4,4,0,2.2462350966814926
36448,703-004-5395,2715.0244,4,2,2,0.4512024413717971
36574,703-004-5384,5423.352,1,1,0,0.9480853874214323
366,703-004-5394,5527.99,4,1,3,1.0728581828773187
36974,703-004-5382,3221.3557,5,4,1,2.6834348622646473
37096,703-004-5386,9237.334,"","","",0.27920371738274696
37146,703-004-5389,4133.1167,3,0,3,0.27920371738274696
37213,703-004-5384,2454.36,5,1,4,0.5273989344230835
37391,703-004-5389,4502.2944,"","","",0.27920371738274696
37671,703-004-5389,2237.6025,4,1,3,0.35534489781066697
38179,703-004-5389,7795.6416,5,2,3,0.9795730194252058
38272,703-004-5386,2806.03,3,3,0,0.9559399828111169
38734,703-004-5395,6250.379,3,2,1,0.5929549072644433
38898,703-004-5399,8863.802,4,1,3,0.35534489781066697
38991,703-004-5397,6057.777,5,1,4,0.7611180587015365
3906,703-004-5380,696.1197,2,1,1,0.9942931172851314
39073,703-004-5381,4625.769,5,3,2,1.3415805788917345
39250,703-004-5393,3610.9937,4,0,4,0.27920371738274696
39644,703-004-5398,3992.8096,4,2,2,0.47697301719552604
39850,703-004-5388,5284.363,2,2,0,0.7876490462390707
39851,703-004-5384,509.1095,5,4,1,1.4597909062678809
40325,703-004-5384,2659.167,1,1,0,0.4608228511077748
40555,703-004-5380,4830.0283,2,1,1,0.5294269699591949
40797,703-004-5399,387.47073,4,2,2,0.7775823529109502
40858,703-004-5391,2149.989,8,3,5,1.0186745919247384
4092,703-004-5380,8012.075,2,2,0,0.6605590537011713
40951,207-008-2398,5257.4634,2,0,2,0.27920371738274696
40958,703-004-5387,8174.544,3,2,1,0.46332557880454844
40963,703-004-5382,9349.248,6,3,3,1.0892773375517568
4098,703-004-5394,3280.557,3,3,0,0.9272386136432861
41044,703-004-5389,2527.154,5,4,1,1.1490840292181022
41296,703-004-5382,6534.6665,5,3,2,1.0670113901431584
41361,703-004-5388,8164.7617,2,2,0,0.7732958082065224
41545,703-004-5383,8175.8403,4,2,2,1.2851458605883155
4156,703-004-5397,5244.1514,2,2,0,0.5019695116192066
41565,703-004-5398,9996.042,3,3,0,0.8042451259506991
41634,703-004-5397,944.8725,5,2,3,0.9862969220760226
41981,703-004-5389,4813.5835,4,1,3,0.37175974969512765
42488,703-004-5396,8759.274,3,2,1,0.5296228984451852
42620,703-004-5391,769.30225,5,2,3,0.7955322931963633
42968,703-004-5392,9661.708,5,4,1,1.5666555452635649
430,703-004-5397,9861.307,5,1,4,0.3807252912866403
43285,703-004-5399,4678.949,3,0,3,0.27920371738274696
43507,703-004-5393,8033.54,4,1,3,0.41747482074228265
4391,703-004-5382,588.578,3,2,1,1.038574482285255
43977,703-004-5397,5619.4746,5,3,2,0.6765704947328818
44054,703-004-5386,7305.289,4,2,2,1.0998940607868326
44114,703-004-5394,3425.455,5,3,2,1.0402256866884347
44375,703-004-5388,1792.6108,3,2,1,0.9330621038981338
44481,703-004-5392,4662.381,3,0,3,0.27920371738274696
45065,703-004-5397,8819.622,2,1,1,0.9423167962916328
45477,703-004-5380,7582.983,5,2,3,1.461073151379733
45520,703-004-5398,5005.4727,5,2,3,3.0939018063864676
45583,703-004-5380,186.40994,5,1,4,0.6197779832166407
45783,703-004-5391,3964.6924,6,4,2,1.04608274589916
45983,703-004-5386,5887.2407,2,1,1,1.0342538444788647
46007,703-004-5382,6944.3423,6,3,3,2.040365432506763
46302,703-004-5388,5249.9004,1,1,0,0.4314860782385869
46407,703-004-5388,5922.4707,3,1,2,0.5691162328765698
46617,703-004-5399,2508.9192,8,3,5,1.167780127980784
46670,207-008-2398,6652.12,7,6,1,2.1600785529326805
47029,703-004-5391,5344.165,4,1,3,0.48582619141375494
47094,703-004-5388,811.0958,3,1,2,1.269738637770688
47176,703-004-5397,8386.945,3,1,2,0.4118968608508865
47222,703-004-5382,7901.272,6,2,4,1.2399238197911122
47574,703-004-5383,7833.894,5,1,4,0.7509272486834967
47600,703-004-5397,8438.636,4,2,2,0.9231290921983119
47805,207-008-2398,6482.998,6,2,4,1.3387074194508202
47890,703-004-5395,8180.046,2,1,1,0.43367350727428217
47908,703-004-5381,4270.749,6,2,4,0.6210788109004663
48057,703-004-5384,3280.9316,5,2,3,1.1309917726667345
48270,703-004-5395,7026.618,4,2,2,1.1574167300507276
48795,703-004-5397,4794.7373,4,3,1,1.2169435486378433
48821,703-004-5393,3290.1335,8,3,5,1.7048534828684823
49022,703-004-5398,3271.7961,4,1,3,0.32666834933781397
49091,703-004-5391,5430.889,5,3,2,0.9862661592624751
49649,207-008-2399,3101.455,4,4,0,1.8872424373426462
49735,703-004-5394,7959.0024,6,3,3,0.8548001424920317
49962,703-004-5394,3319.077,5,1,4,0.478385542759702
540,703-004-5383,6367.4165,7,3,4,0.9923851307240426
5419,703-004-5381,7659.9766,6,3,3,1.9488293335510032
5631,703-004-5383,5889.5166,5,3,2,1.4956304500103466
5646,703-004-5382,1769.5206,4,2,2,0.6077516277769663
5687,703-004-5388,2750.8818,7,4,3,1.5403360054979203
5812,703-004-5389,6857.2114,11,5,6,4.022059906557776
5908,703-004-5389,5071.3403,3,0,3,0.27920371738274696
5921,207-008-2399,1059.2955,4,1,3,0.5806104004665149
5947,703-004-5392,9221.94,5,0,5,0.27920371738274696
6187,703-004-5385,188.78639,3,2,1,0.907491018553262
622,703-004-5396,1881.2877,3,0,3,0.27920371738274696
6259,703-004-5384,1455.9192,2,1,1,0.40447480700475974
6263,703-004-5385,2971.0752,2,1,1,0.3187575773453028
6290,703-004-5383,2711.5303,1,1,0,0.5100822233022837
6487,207-008-2398,1440.8087,5,1,4,0.698306876266171
6782,703-004-5396,4329.929,9,2,7,0.8911442244689222
682,703-004-5382,6705.085,3,2,1,0.6812555192821392
6865,703-004-5381,70.47653,9,6,3,1.883041455779886
6927,703-004-5399,9201.065,4,4,0,2.0945121386141
7071,703-004-5397,3309.3333,5,2,3,1.1742880588387492
708,703-004-5382,5814.3223,5,2,3,0.48955566510475745
7290,703-004-5392,5190.8706,5,4,1,1.625527236985745
7613,703-004-5392,2138.2666,5,1,4,0.8622207191151537
7648,703-004-5399,9514.923,4,3,1,0.756035027461295
7730,703-004-5383,4320.6226,4,2,2,0.7571232950058426
778,703-004-5388,4613.6157,3,3,0,1.4852288133612586
7806,703-004-5389,6839.527,4,3,1,2.967425790205124
8277,703-004-5387,4783.881,1,0,1,0.27920371738274696
9037,703-004-5388,6050.513,1,1,0,0.35114230018964543
9116,703-004-5385,6098.5186,"","","",0.27920371738274696
916,703-004-5398,9238.107,6,2,4,0.7929926136606937
9218,703-004-5382,1714.4066,4,0,4,0.27920371738274696
9242,703-004-5392,8773.098,7,3,4,0.6873253887088934
9503,207-008-2399,6898.6987,1,0,1,0.27920371738274696
9758,703-004-5386,7737.6274,7,2,5,0.5139558762605158
9779,703-004-5393,8149.784,3,2,1,1.0287326634364613
9960,703-004-5384,8232.759,4,2,2,1.6852158515901594
10050,703-004-5385,5527.0923,4,2,2,0.8942902046980744
10317,703-004-5389,1068.6243,5,2,3,0.9937023405737212
10479,703-004-5388,3037.7966,4,2,2,0.48657895461500394
10546,703-004-5397,6234.0195,2,1,1,0.515441693237308
10559,703-004-5390,6860.695,1,1,0,1.5615699298819292
10568,703-004-5387,2968.1785,5,2,3,2.0714368187395893
10779,703-004-5386,370.03458,6,4,2,1.1236874922690117
10989,703-004-5383,7130.279,4,3,1,1.4848726800619014
11212,703-004-5384,3645.9558,3,2,1,0.9058579440614706
1127,703-004-5383,9482.604,7,4,3,1.6598917143668444
11775,703-004-5397,3360.7852,6,2,4,0.7292328544129918
1179,207-008-2399,4943.63,2,1,1,1.1206860101893548
11906,703-004-5383,7460.205,2,1,1,0.33853450732658075
11957,703-004-5396,1119.6953,5,3,2,0.9941154922175696
12382,703-004-5381,2365.306,4,1,3,0.7830953700165848
1256,703-004-5397,182.57379,3,2,1,0.52231002207758
12569,703-004-5385,9331.667,2,1,1,0.4336692525091717
12602,703-004-5387,7735.4824,4,4,0,0.9746328453264724
12742,703-004-5389,1005.885,5,2,3,0.4824116729403775
12928,703-004-5390,2288.074,6,4,2,3.729924489242497
13717,703-004-5393,5378.115,4,2,2,0.7605961291410525
14196,703-004-5381,6915.194,4,1,3,0.956070653314717
14651,703-004-5398,9928.206,2,1,1,0.5549091413163878
14800,703-004-5381,3850.053,8,5,3,2.373484802747966
15057,703-004-5392,4571.584,2,2,0,0.9773743771505055
15152,703-004-5391,5851.626,3,3,0,0.8778755480454575
15254,703-004-5398,7184.622,4,1,3,0.35831143730785864
15473,703-004-5382,5408.296,4,1,3,0.5440533434746554
15495,703-004-5399,5950.103,2,1,1,0.41533074383022356
15788,703-004-5387,561.1944,1,1,0,0.33853450732658075
1594,703-004-5397,6818.861,3,0,3,0.27920371738274696
16313,703-004-5399,215.24191,2,2,0,0.8272245147094001
16334,703-004-5399,275.20596,3,1,2,0.7277701440199165
16338,703-004-5385,3790.4363,5,4,1,1.224180981177359
16394,703-004-5382,5325.3223,3,3,0,1.51155502204152
16497,703-004-5390,1610.2761,4,3,1,0.7015855497180851
16609,703-004-5390,8033.551,4,1,3,0.42555299924420353
16660,703-004-5382,2881.524,3,1,2,0.4338129780614656
16889,703-004-5383,2639.5994,3,2,1,0.6678957217471257
17078,703-004-5386,4717.6816,5,3,2,2.8739018412290385
17345,703-004-5385,5637.3438,1,1,0,0.47530751622177275
18038,703-004-5383,9826.005,6,6,0,2.5257355028929704
18203,703-004-5383,6554.974,3,2,1,1.1778683721632743
18218,703-004-5394,7507.0444,6,3,3,1.2419097530139094
18325,703-004-5387,4776.851,5,1,4,0.33853450732658075
18658,703-004-5395,5606.8374,4,3,1,0.7475991682537705
18692,703-004-5393,9393.879,5,2,3,0.9336621784293488
18886,703-004-5385,2290.412,2,2,0,0.7910328980688662
19123,703-004-5393,5885.818,2,0,2,0.27920371738274696
19600,703-004-5390,998.79083,7,2,5,0.5976043194311575
19643,703-004-5394,7733.9487,9,4,5,2.2416390403928577
19743,703-004-5390,6017.1074,2,1,1,1.2263035412383338
19824,703-004-5385,8178.698,3,2,1,0.4969341689067467
19911,703-004-5388,8015.18,1,0,1,0.27920371738274696
20367,703-004-5383,3439.2888,4,1,3,0.3612285344800972
20394,207-008-2399,3984.272,2,2,0,1.0797002924861456
20467,703-004-5392,5139.0674,5,3,2,1.1218827625588081
2074,703-004-5383,6038.9287,5,1,4,0.3401166617250829
20810,703-004-5385,6020.306,7,6,1,2.5226560512769436
20928,703-004-5394,5529.9233,6,3,3,1.109278344596458
213,703-004-5388,3922.546,5,2,3,1.0961070096103358
21339,703-004-5389,8535.622,3,2,1,0.605190540945003
21695,703-004-5396,3414.9993,4,4,0,5.135153772964027
21858,207-008-2398,2741.0786,3,2,1,0.6075362482035452
22441,703-004-5380,3443.8586,2,0,2,0.27920371738274696
2266,703-004-5381,21.190048,5,3,2,1.2538803595001258
22823,703-004-5381,3191.9707,7,4,3,0.7206791994538235
23103,207-008-2399,7304.858,2,1,1,0.8585874773616727
23134,703-004-5399,4619.192,8,2,6,1.1755579382381398
23196,703-004-5385,3891.7976,4,0,4,0.27920371738274696
23277,207-008-2399,7911.753,5,3,2,0.8566930908995498
23583,703-004-5390,7841.7437,4,0,4,0.27920371738274696
23724,703-004-5398,8210.355,"","","",0.27920371738274696
24028,703-004-5386,3202.8699,5,3,2,0.7853914938731171
24444,703-004-5394,6010.874,3,1,2,0.35831143730785864
24705,703-004-5397,2098.308,3,1,2,0.5319640064499414
24849,703-004-5384,9340.385,3,1,2,1.4393979605583322
24991,703-004-5385,1532.4861,6,4,2,1.6856014044262644
25120,703-004-5380,7658.7983,4,0,4,0.27920371738274696
25179,703-004-5382,518.0818,5,2,3,1.2897681955401972
25566,703-004-5392,4828.6587,4,3,1,1.1913737260128638
25585,703-004-5398,2801.4695,10,5,5,1.0628131075079095
2560,207-008-2398,6444.399,4,1,3,0.3978652972704144
25675,703-004-5382,972.7049,3,2,1,1.963519200537607
25710,703-004-5392,3609.8933,5,3,2,1.550018949213633
25878,703-004-5399,7908.6216,5,3,2,0.7227537317942366
25905,703-004-5394,4993.545,3,2,1,4.581435942862137
26287,703-004-5387,5694.879,5,4,1,2.1328466971022366
26323,703-004-5398,8933.788,6,1,5,0.6075361720664149
26770,703-004-5399,3559.3433,4,2,2,0.9692591428653131
26926,703-004-5393,1071.1205,4,2,2,3.5708475225696463
27017,703-004-5394,1394.1598,4,3,1,0.8063975530345762
27086,703-004-5380,8129.5757,6,1,5,0.5390864950754619
27110,207-008-2398,4124.77,4,4,0,1.5097475694850948
27374,703-004-5399,361.57907,3,0,3,0.27920371738274696
27971,703-004-5399,6811.7783,7,4,3,1.612382556715832
28007,703-004-5398,487.56122,3,1,2,0.32666834933781397
28359,703-004-5383,6385.814,5,2,3,1.34768229437709
28390,703-004-5397,4196.0503,6,4,2,2.0895636440440484
28617,703-004-5382,9810.376,1,1,0,1.0229470179982214
28697,703-004-5393,8092.5996,4,2,2,1.4412103357325443
28830,207-008-2399,5018.6587,5,4,1,2.383073204532958
28858,703-004-5397,7638.997,4,3,1,0.9121317593018121
28899,703-004-5380,4063.7046,2,1,1,0.7684326698547396
28900,207-008-2398,5155.6523,2,1,1,1.8297159284289237
291,703-004-5380,2346.2158,4,1,3,0.3978652972704144
29168,703-004-5380,2474.3623,4,3,1,0.9492346352891473
29276,703-004-5390,8964.356,3,0,3,0.27920371738274696
29476,703-004-5388,6265.415,5,4,1,2.2541297956545367
29585,703-004-5382,8258.412,5,1,4,0.35831143730785864
29934,703-004-5393,3163.6052,7,1,6,0.7415629717235306
30220,703-004-5391,8309.512,7,5,2,1.5119958736655679
30296,703-004-5387,8473.477,6,4,2,1.3124875365220785
30418,703-004-5396,3434.6956,6,2,4,0.5463158779423817
30452,703-004-5396,4858.536,2,1,1,0.5991228606541088
30458,703-004-5394,6369.875,4,2,2,1.4907505309571065
30514,703-004-5391,4409.699,9,3,6,1.0863202349531165
30787,703-004-5391,8168.221,7,6,1,2.125042289718838
31062,703-004-5384,1288.6965,4,3,1,2.06072806239307
31276,207-008-2398,1502.0233,4,1,3,0.35831143730785864
31390,703-004-5382,2771.939,4,3,1,0.9286398985552171
31475,703-004-5398,4355.429,2,2,0,1.3211955558752588
31754,207-008-2398,2910.6003,1,0,1,0.27920371738274696
31844,703-004-5390,2444.986,5,4,1,2.171605674893071
32009,703-004-5387,3092.8962,6,5,1,1.6235926334912065
32079,703-004-5398,6932.3594,4,2,2,0.9366718627675247
32518,703-004-5386,2883.3484,4,3,1,0.6283103148884074
32666,703-004-5398,2920.2705,5,2,3,0.5808491470938731
32727,703-004-5394,2027.9073,8,5,3,0.9461222214749005
32941,703-004-5384,2239.5479,4,2,2,0.632989153165597
33232,703-004-5387,363.8172,4,4,0,1.1856629544742185
33633,703-004-5382,741.84656,7,2,5,1.0847116558885017
33801,703-004-5381,7706.0737,3,2,1,0.49011368844975295
33812,703-004-5394,953.95386,4,2,2,1.6492977632826848
33852,703-004-5397,2347.1821,5,2,3,0.47771836024419545
33887,703-004-5381,7759.4434,8,3,5,2.27361113528514
34537,703-004-5397,2024.8502,4,2,2,2.2429493538143768
34692,703-004-5392,7367.942,4,2,2,1.1337947727987512
34826,207-008-2399,3734.219,7,4,3,0.644243818860927
35007,703-004-5386,3984.6475,2,1,1,0.36330026154103034
35218,703-004-5385,4797.2153,3,2,1,1.0471715192130029
35248,207-008-2399,7708.514,2,2,0,0.5338950400443273
35381,703-004-5385,5062.3306,1,0,1,0.27920371738274696
3557,703-004-5396,3383.6836,7,5,2,2.943044786995739
36281,703-004-5395,6953.5215,4,1,3,0.35831143730785864
36322,703-004-5383,8048.274,6,6,0,1.331423710484481
36357,703-004-5397,3509.7546,4,2,2,1.537978737856755
36608,703-004-5383,9658.589,3,2,1,0.6264889646486799
36828,207-008-2398,2328.4841,2,0,2,0.27920371738274696
36889,703-004-5391,1494.0011,4,3,1,2.8187968358405397
36905,703-004-5385,355.8022,4,3,1,1.282286765907416
37253,703-004-5388,3336.4946,3,3,0,0.9747892065996989
37336,703-004-5383,9759.645,6,4,2,2.0370058779359588
37376,703-004-5384,7686.312,4,2,2,1.3600782517558108
3827,703-004-5395,5128.3633,5,2,3,0.44627371368056845
38347,207-008-2399,9203.039,4,3,1,0.9964070667384937
38428,207-008-2399,5266.214,5,0,5,0.27920371738274696
38542,703-004-5382,8154.5786,2,2,0,0.7543913480529649
38748,207-008-2398,846.9987,3,2,1,0.8276317304662613
38922,703-004-5388,2757.0374,5,5,0,2.1107367172546736
39178,703-004-5392,4067.868,4,2,2,1.4021169131368432
39302,703-004-5382,7600.162,7,3,4,1.000171235816175
39456,703-004-5396,4921.8105,4,1,3,1.4088105416291585
39535,703-004-5384,5809.8247,5,3,2,0.90894707354502
39777,703-004-5381,1030.3241,6,3,3,1.3150309849629238
39797,703-004-5394,9219.915,5,2,3,0.988729613585521
39837,703-004-5387,531.08154,6,3,3,2.098977629849997
40036,703-004-5383,4182.706,4,2,2,0.8230188245753615
40177,703-004-5384,9399.188,6,3,3,0.9168905977086216
4056,207-008-2398,933.9583,5,4,1,0.6698111267166604
40563,703-004-5394,418.76733,4,2,2,1.0062661015302485
40843,703-004-5388,2434.9404,4,2,2,0.6312876064489414
4091,703-004-5385,9343.223,3,1,2,0.5262344874459589
40947,703-004-5382,6971.5996,7,4,3,2.325010376529226
40964,703-004-5384,9345.68,3,2,1,0.8112933074108155
41226,703-004-5396,6840.8413,3,2,1,1.1948030058754173
41267,703-004-5395,3190.3213,9,5,4,1.5033286102517396
41269,703-004-5388,2663.6362,4,3,1,1.0578845575898024
41575,703-004-5384,4640.143,2,1,1,0.6014507237361699
41699,703-004-5396,7320.418,4,0,4,0.27920371738274696
42295,703-004-5398,1242.6847,3,2,1,0.7050173228013503
42432,703-004-5395,4560.7754,5,2,3,1.1870067382755185
42442,703-004-5394,9722.353,2,2,0,0.6949767737786943
42465,703-004-5392,2713.4585,"","","",0.27920371738274696
42808,703-004-5380,4186.98,5,4,1,3.0650593754787163
43053,703-004-5383,9240.961,1,0,1,0.27920371738274696
43181,703-004-5383,198.39883,8,5,3,1.8790540655520884
43302,703-004-5395,6120.4893,5,2,3,0.8035730310634108
4337,703-004-5397,6197.9263,4,2,2,0.890716061089224
43431,703-004-5398,8600.327,6,5,1,2.2347228848131473
43617,207-008-2399,8311.29,3,2,1,0.7434561483410143
43996,207-008-2398,5831.085,4,3,1,1.648262620037307
44165,703-004-5394,3004.514,3,0,3,0.27920371738274696
44271,703-004-5396,2730.3374,3,2,1,0.9704196942552288
44912,703-004-5394,8669.218,3,3,0,0.8461567920305667
45063,703-004-5382,9973.581,2,1,1,0.4418787540392712
45404,703-004-5385,5475.9927,7,4,3,1.3695402301609965
45794,703-004-5395,4632.7393,4,2,2,0.7441908945616246
45939,703-004-5392,64.50534,5,2,3,0.44364287469420344
45967,703-004-5394,8741.188,4,2,2,0.8114342980343461
46169,703-004-5384,6271.907,1,0,1,0.27920371738274696
46182,703-004-5391,8214.938,3,3,0,2.1092178344879886
46245,703-004-5395,821.5886,4,3,1,1.7396404514331203
46526,703-004-5380,4035.719,6,5,1,1.9581622786087916
46624,703-004-5395,8685.456,3,0,3,0.27920371738274696
46725,703-004-5394,8946.369,4,3,1,0.669383527724521
46744,703-004-5398,359.90475,1,0,1,0.27920371738274696
46969,703-004-5395,2442.0256,6,2,4,1.4798938222203601
47035,703-004-5385,2465.666,1,1,0,0.3975356817707265
47151,703-004-5383,6952.9194,4,2,2,0.5031602414484005
47294,703-004-5388,6650.7715,4,1,3,0.5023151894817528
47434,703-004-5386,2308.2573,5,3,2,1.1400463802153802
47931,703-004-5391,417.611,6,3,3,0.7485641384813656
48030,703-004-5391,2113.2725,5,5,0,1.5100393973290838
48455,703-004-5398,6662.762,4,2,2,1.7351848388677191
4875,703-004-5397,8836.64,3,1,2,0.8735034090772824
48942,703-004-5381,6753.299,6,2,4,0.8434371227661341
49175,703-004-5382,3569.3813,3,3,0,1.6674165618726542
49314,703-004-5391,4292.6836,5,4,1,2.9134468226409287
49378,207-008-2399,5628.56,2,1,1,0.35831143730785864
4943,703-004-5387,5416.384,3,2,1,0.6414181899898519
49717,703-004-5394,18.280148,2,1,1,0.5588811902214922
49912,207-008-2399,5207.785,7,6,1,1.1425960410087186
49927,703-004-5393,98.447205,2,1,1,0.40358742234499756
5237,703-004-5388,8926.564,2,1,1,0.3870758832472951
5344,703-004-5381,3182.5806,7,4,3,1.0778312452980356
536,703-004-5385,6263.838,1,0,1,0.27920371738274696
5451,703-004-5386,7401.898,5,3,2,0.7738291788134142
5505,703-004-5381,7341.461,4,3,1,1.3083328043827125
5507,703-004-5389,6926.7905,2,2,0,0.5300322619854159
5530,703-004-5396,3357.6006,5,2,3,0.7815204629797664
5578,703-004-5394,5854.0225,4,2,2,0.5765674386150794
6005,703-004-5389,9519.038,5,2,3,0.41917676420815597
6495,703-004-5395,1208.0557,7,3,4,0.9658420819776514
6674,703-004-5387,9027.004,4,2,2,1.195568950613015
7409,703-004-5396,2809.2205,"","","",0.27920371738274696
7518,703-004-5382,3932.9756,4,0,4,0.27920371738274696
7554,703-004-5390,9823.186,3,1,2,0.35831143730785864
759,703-004-5395,86.14242,6,5,1,2.2517756671677174
8048,703-004-5387,5974.477,5,2,3,1.8749394028124542
8062,703-004-5397,840.36115,4,2,2,0.4852195187609449
8664,703-004-5389,8768.298,9,5,4,1.0305995149699663
8698,703-004-5397,6419.62,3,2,1,1.0911380158720603
8799,703-004-5399,1548.441,3,3,0,2.871057911988724
8853,703-004-5382,7662.4473,5,2,3,0.909287907934365
8855,703-004-5397,9137.853,"","","",0.27920371738274696
8912,703-004-5397,688.5236,4,2,2,0.9748278680860915
9326,703-004-5382,9713.895,1,0,1,0.27920371738274696
9384,703-004-5391,6127.0386,4,4,0,0.9034551425594863
9603,703-004-5395,6894.516,4,2,2,0.7947453131623777
9705,703-004-5384,3225.3677,6,4,2,1.579518209649414
9870,703-004-5380,6754.569,7,5,2,1.8928273529160904
9894,703-004-5386,3784.4492,4,3,1,2.691012107826653
9934,207-008-2399,4319.6963,2,0,2,0.27920371738274696
10118,703-004-5395,7091.721,5,1,4,0.5082552828034257
10282,703-004-5383,4378.3633,4,2,2,0.9413036567005669
10461,207-008-2399,8452.601,4,3,1,0.7335975368523744
10942,703-004-5397,1897.7338,7,3,4,0.9380453378487023
10971,703-004-5397,5320.716,2,0,2,0.27920371738274696
11139,703-004-5399,8122.6367,3,1,2,0.5205344989706505
11678,703-004-5385,4334.8784,7,3,4,1.1852671936906967
11736,703-004-5385,684.0539,1,0,1,0.27920371738274696
11801,703-004-5398,3852.7036,5,2,3,0.5914898560832683
11983,703-004-5399,9691.633,6,2,4,1.5625364407332218
12226,703-004-5385,6398.2026,1,0,1,0.27920371738274696
12342,703-004-5397,8630.732,1,1,0,0.6148156385953143
13072,207-008-2398,1005.54944,4,1,3,0.5561950982483029
13097,703-004-5391,5707.453,2,1,1,1.1478656436361183
1333,703-004-5385,2949.5984,3,0,3,0.27920371738274696
13402,703-004-5399,7296.962,3,1,2,0.9068350046939727
1341,703-004-5380,6827.703,5,1,4,1.21007977233172
13445,703-004-5389,6332.896,4,3,1,0.8072914339212618
13706,703-004-5380,3001.6875,6,3,3,0.9469019992630215
13778,703-004-5388,6222.2964,6,4,2,1.1540930798276339
13845,703-004-5388,3050.5574,4,2,2,2.898443121854477
13930,703-004-5399,2554.1877,8,3,5,0.7261090213289256
14197,207-008-2398,1627.9716,2,1,1,1.0184777872509312
14265,703-004-5390,8099.8193,4,2,2,1.4066754898185572
14635,703-004-5391,5171.78,2,1,1,0.831033086128844
14665,703-004-5382,6778.9473,3,2,1,0.7892042307145694
14771,703-004-5387,9832.1875,10,5,5,1.997716943806661
14786,703-004-5389,5150.4653,6,2,4,1.178245857094658
15217,703-004-5386,6400.4927,3,1,2,0.32666834933781397
15281,703-004-5396,747.88214,2,2,0,1.5576185196559627
15294,703-004-5395,516.26086,4,2,2,1.0814441120535006
15628,703-004-5385,7960.208,1,1,0,0.4432713001714537
1586,703-004-5388,8271.285,4,3,1,0.8631143947024247
16020,207-008-2399,9720.129,8,6,2,2.439042631249028
16037,703-004-5387,5902.6865,1,0,1,0.27920371738274696
16065,703-004-5390,9287.965,4,3,1,0.8414189347523358
16447,703-004-5389,8621.131,3,2,1,0.841465469322401
16641,703-004-5390,388.72897,1,1,0,0.5169650226812359
1712,703-004-5390,2596.4749,5,4,1,1.9658258853760728
17437,703-004-5385,8699.887,5,1,4,0.4143460722548127
17462,703-004-5399,7010.705,6,3,3,1.3165157883383023
18136,703-004-5397,6053.689,2,2,0,1.000386717639816
18165,703-004-5398,4516.3257,3,2,1,0.7014355901056148
18544,703-004-5387,1838.7205,6,2,4,1.1553101936236427
18569,703-004-5396,5870.202,6,3,3,0.9082016142329495
18576,703-004-5395,7236.176,2,0,2,0.27920371738274696
18696,703-004-5391,6824.2,"","","",0.27920371738274696
18792,207-008-2399,8541.664,"","","",0.27920371738274696
19007,703-004-5398,6361.3022,5,2,3,0.440056081230474
19351,703-004-5383,5044.9766,6,2,4,1.0005031089119782
19538,703-004-5383,2525.6377,2,1,1,0.42425271803288533
20002,703-004-5383,2271.446,1,0,1,0.27920371738274696
20016,703-004-5396,8189.1865,5,3,2,1.1423168454681847
20148,703-004-5395,6632.9814,6,4,2,1.4565896361792963
20218,703-004-5383,7108.7134,6,3,3,0.9565332789494195
2029,207-008-2399,4780.304,6,5,1,2.0886452464622725
20647,703-004-5382,7671.2515,7,3,4,1.0326559957277313
20819,703-004-5399,7855.4478,1,1,0,0.7436894237346247
20907,703-004-5389,6133.0747,6,4,2,1.5410037416534126
21137,703-004-5380,813.7167,6,4,2,1.7389309168824867
21164,703-004-5397,8470.773,1,1,0,0.8282755686854609
21435,703-004-5396,3275.6555,4,4,0,0.979086585651644
21490,703-004-5386,1028.0651,4,3,1,1.3192545053768183
21537,703-004-5382,5814.6704,2,1,1,0.3800548811984942
21730,703-004-5385,41.413902,6,3,3,2.1128153467478534
21846,703-004-5388,1548.2706,4,1,3,0.928370721119549
21958,207-008-2399,6645.8027,1,1,0,0.3131070259220805
22149,703-004-5398,2500.692,3,0,3,0.27920371738274696
22212,703-004-5388,8835.693,6,3,3,1.475377401784566
22237,703-004-5392,1889.0125,4,0,4,0.27920371738274696
22323,703-004-5385,5941.6177,7,4,3,1.735429661079525
22473,703-004-5394,8312.559,5,2,3,0.9472459975552223
23377,703-004-5389,2018.0911,6,1,5,0.5165268771580819
23409,703-004-5396,8527.788,1,0,1,0.27920371738274696
24481,703-004-5395,3930.3486,5,3,2,3.367855676063976
24603,703-004-5390,4897.9224,7,4,3,1.877976705665276
24789,703-004-5380,2605.1533,4,1,3,0.47113268031855676
24857,703-004-5385,2474.3594,4,3,1,4.065320108140059
24978,703-004-5387,609.99396,1,1,0,0.47302775760699195
25145,703-004-5391,4535.1797,2,1,1,1.2681583529401363
25167,703-004-5389,1131.1442,3,1,2,0.678424611969775
25287,703-004-5388,901.953,4,0,4,0.27920371738274696
25543,703-004-5392,5097.2817,4,2,2,0.9049225420236001
25622,703-004-5391,2621.4368,3,2,1,1.2867184526747115
25836,703-004-5390,242.50627,5,3,2,0.7366155605787174
26093,703-004-5380,8864.083,8,3,5,0.889385711069347
26102,703-004-5381,2623.8257,4,1,3,0.36190424625445744
2620,703-004-5388,8524.29,6,2,4,0.43741915723297026
26398,703-004-5381,600.2176,2,2,0,2.7419122706415773
26427,207-008-2399,7413.959,2,2,0,0.5364891579623452
26552,703-004-5384,8330.39,1,1,0,0.5973210209247806
26752,703-004-5393,8137.2017,1,0,1,0.27920371738274696
26908,703-004-5392,6380.9556,5,3,2,1.6452564549892486
2698,207-008-2399,3392.5796,9,6,3,1.3458498718687182
27154,703-004-5398,2354.009,1,0,1,0.27920371738274696
27181,703-004-5381,6493.5205,4,2,2,1.1582550053469807
27453,703-004-5395,2875.8425,3,1,2,0.3978652972704144
27958,703-004-5380,6724.76,2,0,2,0.27920371738274696
27969,703-004-5388,4681.3975,6,3,3,1.5445902525754305
28237,703-004-5392,9672.358,4,1,3,0.41141395919669627
28536,207-008-2399,4047.0005,4,1,3,0.7233799616482747
28569,703-004-5383,8437.885,3,1,2,0.586828632544742
29327,703-004-5395,278.20767,2,2,0,0.503719194468823
29385,207-008-2398,7847.106,7,4,3,0.8914750557199622
29897,703-004-5383,6768.429,5,3,2,2.3813493678997775
29902,703-004-5393,9681.839,4,2,2,0.6308670299989966
30356,703-004-5380,9659.592,4,4,0,2.8140721428047737
30568,207-008-2399,4637.298,4,3,1,1.157136983039382
30652,703-004-5395,9872.816,3,2,1,0.8312585523308313
3133,703-004-5380,4404.181,4,1,3,1.3108755322889483
31529,703-004-5383,732.798,8,6,2,3.763849962555926
31556,703-004-5391,4754.253,5,2,3,1.6228533287734699
31613,703-004-5394,9972.587,5,2,3,0.9249726752292587
31689,703-004-5390,6732.7603,4,3,1,5.069808041653557
31774,703-004-5381,8775.09,3,3,0,1.4328384744131963
31782,703-004-5391,4023.9536,2,2,0,0.6686330914908886
31938,207-008-2398,1333.3273,4,2,2,0.8196000553936308
32064,703-004-5397,5258.618,5,2,3,1.6391460536098332
32390,703-004-5382,8011.8228,4,2,2,0.7240595215797194
32510,703-004-5386,8371.533,4,2,2,0.5591161552700809
32647,703-004-5389,1334.0592,2,0,2,0.27920371738274696
33009,703-004-5380,612.883,2,1,1,0.34439664482504373
3326,703-004-5393,7912.577,2,0,2,0.27920371738274696
33323,703-004-5391,3330.9514,3,1,2,0.4266110649982019
33434,207-008-2399,2544.2307,4,2,2,0.6669655093211074
33602,703-004-5385,6200.7974,1,1,0,0.7513171321317228
33770,703-004-5390,43.581726,5,2,3,0.7219207545707033
33814,703-004-5392,6733.1157,3,1,2,0.9376272904893275
33879,703-004-5392,8414.804,2,1,1,2.425095693774442
34081,703-004-5381,8489.754,5,3,2,1.3409011010963015
34102,703-004-5386,2383.9766,2,0,2,0.27920371738274696
34132,703-004-5399,8549.101,3,2,1,0.7463803085581662
34141,703-004-5396,7125.6133,7,1,6,0.5977688574436731
34346,703-004-5392,1626.8844,4,3,1,1.17308710081634
34359,703-004-5392,6219.4316,1,0,1,0.27920371738274696
34580,207-008-2398,5790.463,3,3,0,2.406876216839508
34587,207-008-2398,2002.8228,4,1,3,0.6266183369550482
3477,703-004-5394,2284.54,6,4,2,2.6421538871035994
35172,703-004-5381,2133.0828,4,1,3,0.3978652972704144
35259,703-004-5389,654.04297,4,2,2,0.929492575013085
35385,703-004-5394,8388.116,4,1,3,0.4337477713430408
35561,703-004-5385,9637.239,5,2,3,1.3962969742338296
35581,703-004-5398,132.72345,6,3,3,0.8509986013314171
35677,703-004-5393,5917.247,4,2,2,0.832640540348713
35778,703-004-5390,3719.9385,3,1,2,0.5165268771580819
35933,703-004-5380,6323.3726,5,4,1,1.7346158665716425
36190,703-004-5392,81.57492,2,1,1,0.6091721015824052
36495,703-004-5382,9863.36,6,4,2,1.8219013388116665
36674,703-004-5398,9011.299,2,2,0,0.9815463436446773
37001,703-004-5386,3563.7803,4,2,2,0.6649796182531175
37022,703-004-5385,8772.196,3,1,2,1.5968313810380008
37070,207-008-2398,9803.365,"","","",0.27920371738274696
37252,703-004-5381,9916.546,4,3,1,1.6972800960101533
37440,703-004-5390,5829.311,8,3,5,1.7684787541929996
37686,703-004-5394,4810.7656,2,2,0,2.137859999667698
378,703-004-5383,6321.182,3,1,2,0.9766323436280866
3800,703-004-5385,1930.1171,6,4,2,3.73159149135733
38342,703-004-5392,3102.6018,3,1,2,0.463463819784236
38497,703-004-5381,6226.7983,1,1,0,0.4928823890213716
38973,207-008-2398,3965.4153,3,1,2,0.40463786574056565
39007,703-004-5380,7128.1523,5,1,4,0.3919322182760311
3937,703-004-5398,6589.5767,4,2,2,1.310227524190166
39420,703-004-5389,1563.3494,3,2,1,1.5332229393199448
39524,703-004-5390,1023.04755,5,3,2,0.6817572705499491
39594,703-004-5389,377.11145,4,3,1,1.604920048964752
39595,703-004-5388,647.3601,1,0,1,0.27920371738274696
39664,703-004-5389,4513.002,"","","",0.27920371738274696
40027,703-004-5399,5471.891,4,2,2,0.6219546851656833
40125,703-004-5388,674.6417,4,2,2,1.442073575484066
40326,703-004-5386,3394.1138,4,2,2,0.5758008687020973
4069,703-004-5383,4115.324,8,6,2,2.2907308552986985
40713,703-004-5383,4237.9224,3,2,1,0.49942705336381654
40729,703-004-5392,6684.1763,3,1,2,0.34693970256862383
41071,703-004-5385,8190.2607,3,1,2,0.4314627136499012
41115,703-004-5387,1937.3816,3,2,1,0.5239777548414007
41211,703-004-5389,9590.227,"","","",0.27920371738274696
41357,703-004-5381,6617.7134,4,3,1,1.7613786490424745
41407,703-004-5392,5761.8296,2,1,1,0.8081048009710925
41413,703-004-5381,5419.0894,4,2,2,0.7588853377585024
41497,703-004-5390,6513.6265,8,2,6,3.050372329959435
41686,703-004-5389,8543.587,1,0,1,0.27920371738274696
41843,207-008-2399,8208.844,3,2,1,0.8556975794968044
41896,703-004-5386,9593.496,3,2,1,0.567663381369735
41995,703-004-5397,7301.771,4,1,3,1.1993888686350191
42039,703-004-5391,6378.5923,6,3,3,0.7006515409567599
42072,703-004-5384,1162.1761,4,1,3,0.5165268771580819
42207,703-004-5388,9779.643,6,1,5,0.45197706526402215
4222,703-004-5399,307.31796,4,1,3,0.8145275168514599
42226,703-004-5394,5822.552,2,1,1,0.6028966885939152
42268,703-004-5383,3224.346,6,2,4,0.7816469758147252
42704,703-004-5382,2003.0016,9,5,4,2.993583906337148
42823,703-004-5394,8294.9,"","","",0.27920371738274696
42831,703-004-5388,9800.739,4,1,3,0.38187047196105567
42864,703-004-5399,5066.2563,7,4,3,2.6698583321106564
42940,207-008-2398,5765.239,5,3,2,1.5598529061327722
43270,703-004-5397,1265.0907,5,3,2,1.7888054476137283
4329,703-004-5392,692.52075,6,4,2,1.3878174079182473
43311,703-004-5382,2532.6877,1,1,0,1.0072879326509265
43537,703-004-5381,2024.5188,5,2,3,0.7264347248843345
43783,703-004-5394,8366.023,3,2,1,0.5923174244513599
43839,703-004-5384,8594.757,8,6,2,2.4261350728868414
44228,703-004-5387,8880.69,7,1,6,0.32666834933781397
44237,703-004-5391,9615.247,4,0,4,0.27920371738274696
44382,703-004-5387,850.89624,1,0,1,0.27920371738274696
44580,207-008-2398,2743.8027,3,2,1,0.7343421360062504
45012,703-004-5397,9126.402,5,1,4,0.625852074884639
45115,703-004-5386,6214.955,7,3,4,0.6462709700943867
45270,703-004-5392,6377.2666,3,2,1,0.9578443341112812
4529,703-004-5399,3234.8293,5,3,2,0.559484982486879
4629,703-004-5393,3915.894,6,4,2,1.004127746667418
46542,703-004-5392,6742.416,3,3,0,0.7588732829450093
46794,703-004-5380,9197.748,4,1,3,0.8505035370906354
47039,703-004-5383,9855.71,5,3,2,1.0522015838311303
47167,703-004-5394,9091.464,6,3,3,0.5904365606531143
47666,703-004-5388,9524.641,5,0,5,0.27920371738274696
47714,703-004-5398,5167.6235,5,3,2,1.476511595679785
47746,703-004-5387,8001.4424,5,3,2,3.3311926918317765
47765,703-004-5392,5850.7197,5,3,2,1.2431568484122046
47860,703-004-5381,3553.422,2,1,1,0.5165268771580819
4800,703-004-5390,915.7372,2,2,0,1.0667687302942919
48199,207-008-2398,861.482,6,3,3,1.195171494810231
48319,703-004-5383,424.4995,5,3,2,1.174465162850815
4906,703-004-5386,9805.06,3,2,1,0.6014679334202053
49070,703-004-5382,9008.911,1,0,1,0.27920371738274696
49223,703-004-5381,6273.681,5,3,2,1.7991391309944533
49650,703-004-5381,8855.385,1,1,0,0.5969645956244345
49737,703-004-5380,188.63261,4,3,1,0.9366820975233191
49794,703-004-5386,2687.0447,3,1,2,0.4888095097893209
5131,703-004-5390,5813.664,7,3,4,1.5499595546820337
5180,703-004-5398,8589.905,5,3,2,1.3898906799815665
5259,703-004-5383,7674.2554,8,3,5,1.612976584966862
5270,703-004-5398,5273.629,4,1,3,0.33853450732658075
529,703-004-5395,9792.153,5,3,2,1.0875954030986876
5363,703-004-5384,6571.6826,"","","",0.27920371738274696
5379,703-004-5387,8065.2773,1,0,1,0.27920371738274696
5887,703-004-5392,6920.8286,1,1,0,0.5013484388001077
608,703-004-5395,8636.677,"","","",0.27920371738274696
6265,703-004-5384,1858.1182,2,1,1,0.4115260394148933
6524,703-004-5399,1740.3829,3,3,0,1.3556153858108766
674,703-004-5385,86.36594,5,1,4,0.33853450732658075
7322,703-004-5397,7955.438,6,4,2,1.4985719206173012
7472,703-004-5381,4060.6016,"","","",0.27920371738274696
76,703-004-5385,1295.6304,1,1,0,0.6095439141096463
7773,703-004-5382,5682.7427,1,0,1,0.27920371738274696
8387,703-004-5392,2281.4863,4,2,2,0.6199198566969648
8819,703-004-5384,4486.8403,3,0,3,0.27920371738274696
8904,703-004-5397,2711.7205,7,4,3,0.5805114377101173
9153,703-004-5384,1035.462,1,1,0,0.36268717629505864
9379,703-004-5398,4269.199,3,1,2,0.32204793316948477
942,703-004-5381,6791.8433,5,1,4,0.3946218807534849
9935,207-008-2399,3940.1848,6,1,5,0.4314860782385869
